block,genome,chr/contig,start,end,orientation,length
1006,NZ_OX366338,1,836412,837480,+,1068
1006,NZ_OX366338,1,1026882,1027956,+,1074
1005,NZ_OX366348,1,356178,357274,+,1096
1005,NZ_CP054557,1,298542,299638,-,1096
1004,NZ_OX366348,1,353617,354855,+,1238
1004,NZ_CP054557,1,301090,302342,-,1252
1003,NZ_OX366374,1,640741,641384,+,643
1003,NZ_OX366374,1,738029,738672,+,643
1002,NZ_OX366374,1,375507,376469,+,962
1002,NZ_OX366374,1,698814,699777,-,963
1001,NZ_CP072012,1,171163,173065,+,1902
1001,NZ_OX366397,1,1129568,1131470,-,1902
1000,NZ_OX366388,1,385718,386501,+,783
1000,NZ_OX366397,1,525848,526617,+,769
999,NZ_OX366388,1,382776,383377,+,601
999,NZ_OX366397,1,522915,523516,+,601
998,NZ_OX366377,1,1002357,1003364,+,1007
998,NZ_OX366398,1,443444,444451,-,1007
998,NZ_OX366389,1,1339856,1340863,-,1007
997,NZ_OX366377,1,784109,785214,+,1105
997,NZ_OX366398,1,1070968,1072073,+,1105
997,NZ_OX366389,1,579919,581024,+,1105
997,NZ_OX366348,1,867922,869027,+,1105
997,NZ_CP054557,1,509659,510763,-,1104
996,NZ_OX366377,1,741423,742309,+,886
996,NZ_OX366398,1,1271725,1272611,+,886
996,NZ_OX366389,1,454044,454932,-,888
996,NZ_OX366389,1,885101,885987,-,886
995,NZ_OX366377,1,738306,738987,+,681
995,NZ_OX366398,1,1268608,1269289,+,681
994,NZ_OX366377,1,736671,737546,+,875
994,NZ_OX366398,1,1266973,1267848,+,875
994,NZ_OX366389,1,458809,459684,-,875
994,NZ_OX366389,1,889864,890739,-,875
993,NZ_OX366377,1,735135,735710,+,575
993,NZ_OX366398,1,1265437,1266012,+,575
993,NZ_OX366389,1,460646,461221,-,575
993,NZ_OX366389,1,891701,892276,-,575
992,NZ_OX366356,1,496974,497522,+,548
992,NZ_OX366388,1,1068300,1068848,+,548
991,NZ_OX366342,1,1184584,1185491,+,907
991,NZ_OX366338,1,994442,995350,-,908
990,NZ_OX366342,1,139206,140607,+,1401
990,NZ_OX366397,1,596508,597900,+,1392
989,NZ_OX366342,1,137763,139077,+,1314
989,NZ_OX366397,1,595066,596379,+,1313
988,NZ_OX366342,1,137110,137762,+,652
988,NZ_OX366357,1,1350735,1351287,-,552
988,NZ_OX366397,1,594514,595065,+,551
987,NZ_OX366395,1,491813,492428,+,615
987,NZ_OX366397,1,458974,459579,+,605
986,NZ_OX366395,1,216779,218202,+,1423
986,NZ_OX366395,1,1173582,1175005,+,1423
985,NZ_OX366395,1,196201,197180,+,979
985,NZ_OX366395,1,485543,486522,+,979
984,NZ_OX366370,1,1190464,1193431,+,2967
984,NZ_CP072012,1,203603,206570,-,2967
984,NZ_CP072012,1,804420,807388,+,2968
983,NZ_OX366370,1,829684,830919,+,1235
983,NZ_OX366370,1,950877,952112,+,1235
982,NZ_OX366370,1,714897,715575,+,678
982,NZ_OX366395,1,522821,523491,+,670
982,NZ_OX366351,1,901467,902145,+,678
982,NZ_OX366389,1,442842,443520,+,678
982,NZ_OX366389,1,1007380,1008058,+,678
981,NZ_OX366370,1,683843,684352,+,509
981,NZ_OX366370,1,1255886,1256395,+,509
980,NZ_OX366370,1,678483,679746,+,1263
980,NZ_OX366370,1,1250526,1251789,+,1263
979,NZ_OX366370,1,260379,260980,+,601
979,NZ_OX366370,1,732907,733510,+,603
978,NZ_OX366370,1,258199,259830,+,1631
978,NZ_OX366370,1,730727,732358,+,1631
977,NZ_OX366370,1,254544,255154,+,610
977,NZ_OX366370,1,727072,727682,+,610
976,NZ_OX366370,1,253174,254106,+,932
976,NZ_OX366370,1,725702,726634,+,932
975,NZ_OX366355,1,591965,592501,+,536
975,NZ_OX366381,1,862714,863250,+,536
975,NZ_OX366369,1,595134,595670,-,536
974,NZ_OX366355,1,590669,591589,+,920
974,NZ_OX366381,1,861418,862338,+,920
974,NZ_OX366369,1,596046,596967,-,921
973,NZ_OX366355,1,339326,340182,+,856
973,NZ_OX366381,1,841512,842368,-,856
972,NZ_OX366355,1,334782,335284,+,502
972,NZ_OX366381,1,845570,846072,-,502
971,NZ_OX366355,1,330453,331120,+,667
971,NZ_OX366381,1,849734,850362,-,628
971,NZ_OX366369,1,1074681,1075309,-,628
970,NZ_OX366355,1,328067,328832,+,765
970,NZ_OX366355,1,328878,329642,+,764
970,NZ_OX366355,1,329688,330452,+,764
970,NZ_OX366381,1,850364,851245,-,881
970,NZ_OX366381,1,851252,852094,-,842
970,NZ_OX366381,1,852101,852905,-,804
970,NZ_OX366369,1,1075311,1076112,-,801
969,NZ_OX366355,1,325321,328028,+,2707
969,NZ_OX366381,1,852906,855632,-,2726
969,NZ_OX366369,1,1076113,1078839,-,2726
968,NZ_OX366355,1,319742,321333,+,1591
968,NZ_OX366381,1,859620,861212,-,1592
968,NZ_OX366369,1,1082827,1084419,-,1592
967,NZ_OX366339,1,599640,600569,+,929
967,NZ_OX366396,1,888341,889270,+,929
966,NZ_OX366339,1,308447,309618,+,1171
966,NZ_OX366396,1,266163,267334,+,1171
966,NZ_OX366396,1,317800,318971,-,1171
966,NZ_OX366396,1,776162,777333,+,1171
966,NZ_OX366389,1,465963,467134,+,1171
965,NZ_OX366339,1,307078,308260,+,1182
965,NZ_OX366396,1,264719,265976,+,1257
965,NZ_OX366396,1,319159,320416,-,1257
965,NZ_OX366396,1,774719,775975,+,1256
965,NZ_OX366389,1,464519,465776,+,1257
964,NZ_OX366339,1,304402,306212,+,1810
964,NZ_OX366396,1,262043,263853,+,1810
964,NZ_OX366396,1,321282,323092,-,1810
964,NZ_OX366396,1,772882,774692,+,1810
964,NZ_OX366389,1,461842,463653,+,1811
963,NZ_OX366339,1,217041,218039,+,998
963,NZ_OX366395,1,1498199,1499195,+,996
963,NZ_OX366396,1,801637,802635,+,998
962,NZ_OX366339,1,150921,151488,+,567
962,NZ_OX366396,1,411519,412190,+,671
961,NZ_CP037426,1,644866,645374,+,508
961,NZ_OX366338,1,717406,717924,+,518
960,NZ_OX366326,1,1007828,1009233,+,1405
960,NZ_OX366351,1,923928,925333,+,1405
960,NZ_OX366357,1,336038,337460,+,1422
960,NZ_OX366357,1,1228625,1230047,+,1422
960,NZ_OX366389,1,1029913,1031315,+,1402
959,NZ_OX366326,1,1007071,1007824,+,753
959,NZ_OX366351,1,923171,923924,+,753
959,NZ_OX366357,1,335281,336034,+,753
959,NZ_OX366357,1,1227868,1228621,+,753
959,NZ_OX366389,1,1028234,1028987,+,753
958,NZ_OX366326,1,1005972,1007070,+,1098
958,NZ_OX366351,1,922072,923170,+,1098
958,NZ_OX366357,1,150863,151961,+,1098
958,NZ_OX366357,1,334182,335280,+,1098
958,NZ_OX366357,1,1226769,1227867,+,1098
958,NZ_OX366389,1,1027135,1028233,+,1098
957,NZ_OX366326,1,1003926,1005882,+,1956
957,NZ_OX366351,1,919175,921131,+,1956
957,NZ_OX366357,1,148810,150773,+,1963
957,NZ_OX366357,1,332129,334092,+,1963
957,NZ_OX366357,1,1224716,1226679,+,1963
957,NZ_OX366389,1,1025089,1027045,+,1956
956,NZ_OX366326,1,323367,323926,+,559
956,NZ_OX366351,1,863102,863663,-,561
956,NZ_OX366377,1,489815,490376,-,561
956,NZ_OX366389,1,988429,988990,-,561
955,NZ_OX366326,1,322510,323366,+,856
955,NZ_OX366351,1,863665,864520,-,855
955,NZ_OX366377,1,490378,491233,-,855
955,NZ_OX366398,1,20561,21417,+,856
955,NZ_OX366389,1,988992,989847,-,855
954,NZ_OX366326,1,319740,321047,+,1307
954,NZ_OX366351,1,865984,867290,-,1306
954,NZ_OX366377,1,492697,494003,-,1306
954,NZ_OX366398,1,17791,19098,+,1307
954,NZ_OX366389,1,991311,992617,-,1306
953,NZ_OX366367,1,783225,784331,+,1106
953,NZ_OX366339,1,340015,341120,+,1105
953,NZ_OX366396,1,1233283,1234387,-,1104
952,NZ_OX366367,1,401568,402274,+,706
952,NZ_OX366388,1,911392,912077,+,685
951,NZ_OX366367,1,399643,401043,+,1400
951,NZ_OX366367,1,520722,522121,+,1399
951,NZ_OX366355,1,626207,627606,-,1399
951,NZ_OX366355,1,677024,678424,-,1400
951,NZ_OX366388,1,459752,461152,-,1400
951,NZ_OX366357,1,220166,221544,-,1378
950,NZ_OX366367,1,355012,355653,+,641
950,NZ_OX366397,1,561761,562403,-,642
949,NZ_OX366367,1,328085,328933,+,848
949,NZ_OX366338,1,718443,719248,-,805
948,NZ_OX366367,1,327580,328083,+,503
948,NZ_OX366338,1,719657,720194,-,537
947,NZ_OX366327,1,929075,930642,+,1567
947,NZ_OX366388,1,375652,377219,-,1567
946,NZ_OX366327,1,319736,321372,+,1636
946,NZ_OX366327,1,397679,399315,+,1636
945,NZ_OX366362,1,1310840,1312056,+,1216
945,NZ_OX366395,1,1134758,1135984,-,1226
945,NZ_OX366357,1,1100164,1101389,-,1225
944,NZ_OX366362,1,1216714,1217369,+,655
944,NZ_OX366342,1,970744,971395,-,651
944,NZ_OX366342,1,1210994,1211638,+,644
944,NZ_OX366388,1,1414460,1415115,-,655
943,NZ_OX366362,1,1214980,1216113,+,1133
943,NZ_OX366342,1,971956,973090,-,1134
943,NZ_OX366342,1,1209292,1210425,+,1133
942,NZ_OX366362,1,1212869,1213937,+,1068
942,NZ_OX366342,1,1207181,1208249,+,1068
942,NZ_OX366388,1,1417489,1418537,-,1048
941,NZ_OX366362,1,1208543,1211207,+,2664
941,NZ_OX366342,1,1202809,1205469,+,2660
941,NZ_OX366388,1,1420249,1422919,-,2670
940,NZ_OX366362,1,1205346,1208515,+,3169
940,NZ_OX366342,1,1199636,1202781,+,3145
939,NZ_OX366362,1,1203788,1205001,+,1213
939,NZ_OX366342,1,973443,974655,-,1212
939,NZ_OX366342,1,1198078,1199291,+,1213
939,NZ_OX366388,1,1426520,1427742,-,1222
938,NZ_OX366362,1,1202747,1203300,+,553
938,NZ_OX366342,1,975144,975697,-,553
938,NZ_OX366342,1,1197037,1197590,+,553
938,NZ_OX366388,1,1428224,1428783,-,559
937,NZ_OX366362,1,1198487,1201782,+,3295
937,NZ_OX366342,1,976661,979946,-,3285
937,NZ_OX366342,1,1192787,1196072,+,3285
936,NZ_OX366362,1,1186302,1187987,+,1685
936,NZ_OX366395,1,1116146,1117833,-,1687
935,NZ_OX366362,1,955121,955896,+,775
935,NZ_OX366370,1,412094,412869,+,775
934,NZ_OX366362,1,916895,917623,+,728
934,NZ_OX366370,1,1220648,1221371,-,723
933,NZ_OX366362,1,656064,656890,+,826
933,NZ_OX366357,1,925147,925953,-,806
932,NZ_OX366362,1,547531,549008,+,1477
932,NZ_OX366370,1,381778,383254,-,1476
931,NZ_OX366362,1,401872,402693,+,821
931,NZ_OX366395,1,849568,850386,-,818
931,NZ_OX366388,1,19162,20001,-,839
931,NZ_OX366388,1,51981,52820,-,839
931,NZ_OX366388,1,80162,81001,-,839
931,NZ_OX366388,1,243814,244653,+,839
931,NZ_OX366388,1,289976,290815,-,839
931,NZ_OX366388,1,328989,329828,+,839
931,NZ_OX366388,1,341564,342403,-,839
931,NZ_OX366388,1,448167,449006,+,839
931,NZ_OX366388,1,458755,459594,-,839
931,NZ_OX366388,1,487269,488108,-,839
931,NZ_OX366388,1,535327,536166,-,839
931,NZ_OX366388,1,693083,693922,+,839
931,NZ_OX366388,1,778137,778976,+,839
931,NZ_OX366388,1,811317,812156,+,839
931,NZ_OX366388,1,857472,858311,+,839
931,NZ_OX366388,1,895379,896218,-,839
931,NZ_OX366388,1,1043511,1044350,+,839
931,NZ_OX366388,1,1090697,1091536,+,839
931,NZ_OX366388,1,1127657,1128496,-,839
931,NZ_OX366388,1,1222375,1223214,+,839
931,NZ_OX366388,1,1253748,1254587,+,839
931,NZ_OX366388,1,1281653,1282492,-,839
931,NZ_OX366388,1,1365188,1366027,-,839
931,NZ_OX366388,1,1577978,1578817,-,839
931,NZ_OX366388,1,1644580,1645419,-,839
931,NZ_OX366388,1,1661403,1662242,-,839
931,NZ_OX366388,1,1776884,1777723,+,839
930,NZ_OX366362,1,317705,318211,+,506
930,NZ_OX366395,1,1539569,1540077,-,508
929,NZ_OX366362,1,301582,302264,+,682
929,NZ_OX366362,1,363239,363921,-,682
929,NZ_OX366362,1,470226,470908,-,682
929,NZ_OX366362,1,472832,473514,+,682
929,NZ_OX366362,1,567925,568607,+,682
929,NZ_OX366362,1,631005,631687,+,682
929,NZ_OX366362,1,672631,673313,-,682
929,NZ_OX366362,1,829211,829893,+,682
929,NZ_OX366362,1,834020,834702,+,682
929,NZ_OX366362,1,903005,903687,+,682
929,NZ_OX366362,1,910434,911116,+,682
929,NZ_OX366362,1,948373,949055,+,682
929,NZ_OX366362,1,956276,956958,-,682
929,NZ_OX366362,1,964343,965025,-,682
929,NZ_OX366362,1,1077489,1078171,-,682
928,NZ_OX366362,1,190949,191884,+,935
928,NZ_OX366362,1,200170,201105,-,935
927,NZ_OX366362,1,13671,14442,+,771
927,NZ_OX366370,1,268187,268965,-,778
926,NZ_OX366352,1,924081,924809,+,728
926,NZ_OX366355,1,340228,340963,-,735
926,NZ_OX366381,1,840731,841466,+,735
925,NZ_OX366352,1,920968,923232,+,2264
925,NZ_OX366355,1,336355,338628,-,2273
925,NZ_OX366381,1,843065,845338,+,2273
924,NZ_OX366352,1,819321,820575,+,1254
924,NZ_OX366352,1,1365604,1366857,-,1253
924,NZ_OX366352,1,1411628,1412881,-,1253
924,NZ_OX366352,1,1614402,1615655,-,1253
923,NZ_OX366352,1,488670,489170,+,500
923,NZ_OX366352,1,790740,791240,+,500
923,NZ_OX366352,1,1073716,1074216,-,500
923,NZ_OX366352,1,1324724,1325224,-,500
923,NZ_OX366355,1,634566,635066,+,500
922,NZ_OX366352,1,487581,488421,+,840
922,NZ_OX366352,1,789651,790491,+,840
922,NZ_OX366352,1,1074466,1075306,-,840
922,NZ_OX366352,1,1325474,1326314,-,840
922,NZ_OX366355,1,633477,634317,+,840
921,NZ_OX366352,1,86962,87574,+,612
921,NZ_OX366352,1,897691,898303,+,612
920,NZ_OX366344,1,133367,133936,+,569
920,NZ_OX366352,1,83449,84018,+,569
920,NZ_OX366352,1,894178,894747,+,569
920,NZ_CP037426,1,387677,388247,-,570
920,NZ_OX366396,1,729218,729802,-,584
919,NZ_OX366344,1,131654,132459,+,805
919,NZ_OX366352,1,81749,82554,+,805
919,NZ_OX366352,1,892478,893283,+,805
919,NZ_CP037426,1,389148,389948,-,800
919,NZ_OX366397,1,638895,639700,+,805
918,NZ_OX366344,1,71215,71743,+,528
918,NZ_OX366370,1,259832,260351,+,519
918,NZ_OX366370,1,732360,732879,+,519
917,NZ_OX366380,1,1302516,1303671,+,1155
917,NZ_OX366385,1,83847,85003,-,1156
916,NZ_OX366380,1,1301612,1302129,+,517
916,NZ_OX366362,1,51496,52013,-,517
916,NZ_OX366385,1,85390,85907,-,517
916,NZ_OX366374,1,194884,195400,+,516
915,NZ_OX366380,1,1257243,1258085,+,842
915,NZ_OX366385,1,1159004,1159847,-,843
915,NZ_OX366395,1,64209,65052,-,843
915,NZ_OX366357,1,820113,820956,-,843
914,NZ_OX366380,1,1107358,1107962,+,604
914,NZ_OX366385,1,655436,656040,-,604
913,NZ_OX366380,1,1008129,1009031,+,902
913,NZ_OX366385,1,1130913,1131914,-,1001
912,NZ_OX366380,1,1006686,1007603,+,917
912,NZ_OX366385,1,1132008,1133171,-,1163
911,NZ_OX366380,1,992805,995475,+,2670
911,NZ_OX366380,1,1023995,1026665,-,2670
911,NZ_CP037426,1,448514,451182,-,2668
911,NZ_OX366385,1,436220,438864,-,2644
910,NZ_OX366380,1,992018,992562,+,544
910,NZ_OX366380,1,1026907,1027451,-,544
910,NZ_OX366362,1,1049989,1050601,+,612
910,NZ_OX366385,1,425439,425983,+,544
909,NZ_OX366380,1,990897,991610,+,713
909,NZ_OX366380,1,1027860,1028573,-,713
909,NZ_OX366362,1,1048894,1049593,+,699
909,NZ_OX366385,1,424341,425031,+,690
909,NZ_OX366389,1,1035634,1036298,-,664
909,NZ_OX366348,1,656190,656854,-,664
909,NZ_CP054557,1,265532,266195,-,663
908,NZ_OX366380,1,878604,879189,+,585
908,NZ_OX366385,1,460609,461210,-,601
908,NZ_OX366357,1,465364,465952,-,588
907,NZ_OX366380,1,672874,673435,+,561
907,NZ_OX366327,1,663556,664133,+,577
907,NZ_OX366370,1,642690,643244,-,554
907,NZ_OX366385,1,352856,353417,-,561
907,NZ_OX366374,1,778870,779447,+,577
907,NZ_OX366338,1,517917,518492,+,575
906,NZ_OX366380,1,539054,539773,+,719
906,NZ_OX366385,1,697232,697951,+,719
905,NZ_OX366380,1,509369,510017,+,648
905,NZ_OX366385,1,723719,724368,-,649
904,NZ_OX366380,1,278179,278770,+,591
904,NZ_OX366385,1,248857,249454,+,597
903,NZ_OX366380,1,257709,258526,+,817
903,NZ_OX366385,1,227265,228078,+,813
902,NZ_OX366380,1,42010,42746,+,736
902,NZ_OX366380,1,49457,50194,-,737
902,NZ_OX366385,1,775045,775780,+,735
902,NZ_OX366385,1,782318,783054,-,736
901,NZ_OX366349,1,1377375,1377889,+,514
901,NZ_OX366344,1,15796,16301,+,505
900,NZ_OX366349,1,1069734,1070326,+,592
900,NZ_OX366349,1,1563226,1563818,+,592
899,NZ_OX366349,1,1052896,1053397,+,501
899,NZ_OX366369,1,1040191,1040692,+,501
898,NZ_OX366349,1,1005999,1006542,+,543
898,NZ_OX366367,1,493749,494277,-,528
897,NZ_OX366349,1,1004726,1005243,+,517
897,NZ_OX366367,1,495057,495612,-,555
896,NZ_OX366349,1,1002700,1003570,+,870
896,NZ_OX366367,1,497038,497952,-,914
895,NZ_OX366349,1,1000558,1001266,+,708
895,NZ_OX366349,1,1001986,1002699,+,713
895,NZ_OX366367,1,497954,498639,-,685
895,NZ_OX366367,1,499378,500062,-,684
894,NZ_OX366349,1,996759,1000237,+,3478
894,NZ_OX366367,1,500383,503860,-,3477
893,NZ_OX366349,1,983864,984398,+,534
893,NZ_OX366344,1,886675,887209,-,534
893,NZ_OX366399,1,600614,601148,-,534
892,NZ_OX366349,1,966412,967230,+,818
892,NZ_OX366344,1,1314159,1314975,-,816
891,NZ_OX366349,1,865761,866275,+,514
891,NZ_OX366349,1,1190776,1191290,+,514
890,NZ_OX366349,1,750865,751587,+,722
890,NZ_OX366349,1,1515625,1516347,-,722
890,NZ_OX366339,1,507601,508331,-,730
889,NZ_OX366349,1,745411,748626,+,3215
889,NZ_OX366349,1,1518585,1521801,-,3216
888,NZ_OX366349,1,721263,722001,+,738
888,NZ_OX366344,1,231560,232293,-,733
887,NZ_OX366349,1,667890,668416,+,526
887,NZ_OX366344,1,364337,364863,+,526
887,NZ_OX366370,1,129526,130052,-,526
886,NZ_OX366349,1,403606,404866,+,1260
886,NZ_OX366344,1,1257298,1258525,+,1227
885,NZ_OX366349,1,112375,112895,+,520
885,NZ_OX366349,1,183190,183710,+,520
885,NZ_OX366349,1,734229,734749,-,520
885,NZ_OX366349,1,894239,894759,-,520
885,NZ_OX366349,1,978770,979290,+,520
885,NZ_OX366349,1,1551635,1552155,+,520
884,NZ_OX366349,1,16237,16855,+,618
884,NZ_OX366349,1,20594,21253,-,659
883,NZ_OX366359,1,701082,701844,+,762
883,NZ_OX366355,1,332975,333763,-,788
883,NZ_OX366381,1,847092,847879,+,787
883,NZ_CP069055,1,257996,258749,+,753
882,NZ_OX366364,1,1247107,1247897,+,790
882,NZ_OX366367,1,1100261,1101051,+,790
881,NZ_OX366364,1,1215527,1216436,+,909
881,NZ_OX366367,1,1506277,1507186,-,909
880,NZ_OX366364,1,1119287,1119823,+,536
880,NZ_OX366367,1,185590,186125,-,535
879,NZ_OX366364,1,1049564,1050080,+,516
879,NZ_OX366367,1,254194,254711,-,517
878,NZ_OX366364,1,991179,992535,+,1356
878,NZ_OX366362,1,1188901,1190256,+,1355
878,NZ_OX366367,1,562058,563413,-,1355
878,NZ_OX366395,1,1114315,1115669,-,1354
877,NZ_OX366364,1,854225,855153,+,928
877,NZ_OX366362,1,984783,985787,-,1004
877,NZ_OX366367,1,708937,709932,-,995
876,NZ_OX366364,1,832303,832826,+,523
876,NZ_OX366349,1,485047,485573,+,526
876,NZ_OX366367,1,731779,732300,-,521
875,NZ_OX366364,1,831720,832301,+,581
875,NZ_OX366367,1,732301,732882,-,581
874,NZ_OX366364,1,825299,825924,+,625
874,NZ_OX366362,1,1020907,1021609,-,702
873,NZ_OX366364,1,818709,819306,+,597
873,NZ_OX366367,1,743592,744178,-,586
872,NZ_OX366364,1,755797,756381,+,584
872,NZ_OX366367,1,804300,804885,-,585
872,NZ_OX366338,1,1053811,1054394,-,583
871,NZ_OX366364,1,754110,754944,+,834
871,NZ_OX366367,1,805735,806577,-,842
871,NZ_OX366338,1,1056168,1057011,-,843
870,NZ_OX366364,1,735561,736249,+,688
870,NZ_OX366349,1,58953,59640,-,687
870,NZ_OX366344,1,1048969,1049656,-,687
870,NZ_OX366367,1,824369,825056,-,687
870,NZ_OX366370,1,1045478,1046166,+,688
869,NZ_OX366364,1,726089,726728,+,639
869,NZ_OX366367,1,835382,836012,-,630
868,NZ_OX366364,1,722814,723766,+,952
868,NZ_OX366364,1,723879,724865,+,986
868,NZ_OX366367,1,837237,838215,-,978
867,NZ_OX366364,1,489242,489851,+,609
867,NZ_OX366362,1,1380366,1380975,+,609
866,NZ_OX366364,1,471649,472423,+,774
866,NZ_OX366367,1,1479531,1480307,+,776
865,NZ_OX366364,1,462527,463342,+,815
865,NZ_OX366367,1,1288110,1288929,+,819
864,NZ_OX366364,1,219975,221441,+,1466
864,NZ_OX366344,1,972265,973715,+,1450
864,NZ_OX366367,1,1395969,1397442,+,1473
863,NZ_OX366364,1,219426,219973,+,547
863,NZ_OX366367,1,1395421,1395967,+,546
862,NZ_OX366364,1,217531,218361,+,830
862,NZ_OX366367,1,1393526,1394356,+,830
861,NZ_OX366364,1,130517,131274,+,757
861,NZ_OX366367,1,1423712,1424478,-,766
860,NZ_OX366364,1,76044,76818,+,774
860,NZ_OX366367,1,1478500,1479275,-,775
859,NZ_OX366364,1,56466,57002,+,536
859,NZ_OX366364,1,731843,732379,+,536
859,NZ_OX366364,1,1031057,1031592,-,535
859,NZ_OX366367,1,829721,830257,-,536
859,NZ_OX366367,1,1173857,1174393,-,536
859,NZ_OX366367,1,1341329,1341866,+,537
858,NZ_OX366364,1,44070,45563,+,1493
858,NZ_OX366367,1,1328386,1330077,+,1691
858,NZ_OX366374,1,378047,379541,+,1494
858,NZ_OX366338,1,117438,118926,+,1488
857,NZ_OX366363,1,538198,539129,+,931
857,NZ_OX366327,1,533269,534194,-,925
856,NZ_OX366363,1,537204,538076,+,872
856,NZ_OX366327,1,534316,535188,-,872
855,NZ_OX366363,1,394972,398902,+,3930
855,NZ_OX366396,1,919134,923063,-,3929
855,NZ_OX366396,1,1147840,1151770,+,3930
855,NZ_OX366377,1,707228,711146,+,3918
855,NZ_OX366398,1,1241127,1245044,-,3917
854,NZ_OX366363,1,30296,31346,+,1050
854,NZ_OX366352,1,1352457,1353507,+,1050
854,NZ_OX366381,1,475165,476215,+,1050
854,NZ_OX366381,1,803374,804425,-,1051
853,NZ_OX366363,1,28108,29325,+,1217
853,NZ_OX366352,1,1350274,1351486,+,1212
853,NZ_OX366362,1,1130356,1131596,+,1240
853,NZ_OX366381,1,472982,474194,+,1212
853,NZ_OX366381,1,805395,806607,-,1212
852,NZ_OX366363,1,16149,16971,+,822
852,NZ_OX366370,1,70952,71783,+,831
851,NZ_OX366363,1,13395,14417,+,1022
851,NZ_OX366395,1,152879,153915,-,1036
851,NZ_OX366395,1,487665,488678,+,1013
850,NZ_OX366363,1,12599,13393,+,794
850,NZ_OX366395,1,153916,154711,-,795
849,NZ_OU909470,1,1435838,1436627,+,789
849,NZ_OX366380,1,960322,961115,+,793
849,NZ_OX366385,1,794369,795158,+,789
848,NZ_OU909470,1,1375260,1375801,+,541
848,NZ_OX366380,1,555834,556411,+,577
848,NZ_OX366385,1,902948,903525,-,577
847,NZ_OU909470,1,1330820,1331356,+,536
847,NZ_OX366380,1,821851,822387,+,536
847,NZ_OX366339,1,1253371,1253907,+,536
847,NZ_OX366396,1,226293,226829,+,536
846,NZ_OU909470,1,1310877,1311594,+,717
846,NZ_OX366380,1,697759,698475,-,716
846,NZ_OX366385,1,1077744,1078461,+,717
845,NZ_OU909470,1,1280250,1281138,+,888
845,NZ_OX366380,1,988347,989237,+,890
845,NZ_OX366385,1,822309,823198,+,889
844,NZ_OU909470,1,1247264,1247912,+,648
844,NZ_OX366380,1,941720,942367,-,647
844,NZ_OX366385,1,871042,871690,+,648
843,NZ_OU909470,1,1204902,1205664,+,762
843,NZ_OX366395,1,729035,729812,+,777
842,NZ_OU909470,1,1197635,1199089,+,1454
842,NZ_OU909470,1,1347551,1349039,+,1488
841,NZ_OU909470,1,1144237,1144770,+,533
841,NZ_OX366327,1,396435,396974,+,539
841,NZ_OX366338,1,111027,111566,-,539
840,NZ_OU909470,1,1123747,1124343,+,596
840,NZ_OX366349,1,1007608,1008202,-,594
840,NZ_OX366367,1,492090,492683,+,593
839,NZ_OU909470,1,997607,999129,+,1522
839,NZ_OU909470,1,1005372,1006894,+,1522
838,NZ_OU909470,1,900304,901229,+,925
838,NZ_OX366380,1,880579,881505,-,926
838,NZ_OX366344,1,407650,408510,+,860
838,NZ_OX366385,1,458294,459220,+,926
837,NZ_OU909470,1,845294,845940,+,646
837,NZ_OX366349,1,17564,18210,-,646
836,NZ_OU909470,1,844175,844724,+,549
836,NZ_OX366362,1,804348,804881,-,533
835,NZ_OU909470,1,820938,821913,+,975
835,NZ_OX366364,1,215204,216174,+,970
835,NZ_OX366380,1,1241488,1242463,-,975
835,NZ_OX366367,1,1391136,1392100,+,964
835,NZ_OX366370,1,1061444,1062419,-,975
835,NZ_OX366385,1,1178462,1179437,-,975
834,NZ_OU909470,1,703305,703834,+,529
834,NZ_OX366364,1,308525,309056,-,531
834,NZ_OX366367,1,924002,924533,-,531
833,NZ_OU909470,1,621266,621779,+,513
833,NZ_OX366380,1,224205,224718,+,513
833,NZ_OX366370,1,452453,452966,+,513
833,NZ_OX366385,1,633083,633596,-,513
832,NZ_OU909470,1,564378,565131,+,753
832,NZ_OX366380,1,1138863,1139609,+,746
832,NZ_OX366385,1,563607,564360,+,753
831,NZ_OU909470,1,503651,505111,+,1460
831,NZ_OU909470,1,841409,842869,+,1460
831,NZ_OU909470,1,1372075,1373531,+,1456
830,NZ_OU909470,1,503116,503649,+,533
830,NZ_OU909470,1,840873,841407,+,534
829,NZ_OU909470,1,476346,476971,+,625
829,NZ_OX366380,1,361342,361967,+,625
828,NZ_OU909470,1,463106,464450,+,1344
828,NZ_OU909470,1,1126737,1128081,+,1344
827,NZ_OU909470,1,461847,462356,+,509
827,NZ_OU909470,1,1125478,1125987,+,509
826,NZ_OU909470,1,460719,461808,+,1089
826,NZ_OU909470,1,1124345,1125439,+,1094
826,NZ_OX366349,1,1006544,1007607,-,1063
826,NZ_OX366367,1,492685,493748,+,1063
825,NZ_OU909470,1,363354,364026,+,672
825,NZ_OU909470,1,365505,366178,-,673
824,NZ_OU909470,1,361620,362265,+,645
824,NZ_OU909470,1,367266,367911,-,645
823,NZ_OU909470,1,335399,336214,+,815
823,NZ_OX366349,1,21520,22352,+,832
822,NZ_OU909470,1,294636,295161,+,525
822,NZ_OX366380,1,604455,604971,-,516
822,NZ_OX366385,1,208543,209054,+,511
821,NZ_OU909470,1,249518,250049,+,531
821,NZ_OX366380,1,649258,649789,-,531
821,NZ_OX366385,1,909534,910065,+,531
820,NZ_OU909470,1,167889,169021,+,1132
820,NZ_OX366380,1,294954,296087,+,1133
820,NZ_OX366385,1,266485,267606,+,1121
819,NZ_OU909470,1,55460,56006,+,546
819,NZ_OX366364,1,1181853,1182387,+,534
819,NZ_OX366380,1,985039,985585,-,546
819,NZ_OX366367,1,124478,125012,-,534
819,NZ_OX366385,1,819001,819547,-,546
818,NZ_OU909470,1,49141,49643,+,502
818,NZ_OX366339,1,430140,430643,-,503
818,NZ_OX366396,1,93289,93791,+,502
817,NZ_OU909470,1,27015,28071,+,1056
817,NZ_OX366380,1,664632,665709,-,1077
817,NZ_OX366344,1,543931,545209,+,1278
817,NZ_OX366370,1,575378,576505,+,1127
817,NZ_OX366385,1,686222,687371,-,1149
816,NZ_OX366347,1,1376423,1377077,+,654
816,NZ_OX366377,1,1034105,1034738,-,633
816,NZ_OX366398,1,414603,415236,+,633
816,NZ_OX366389,1,1309663,1310296,+,633
816,NZ_OX366348,1,1211510,1212143,+,633
816,NZ_CP054557,1,730116,730749,+,633
815,NZ_OX366347,1,1297844,1298714,+,870
815,NZ_OX366364,1,266583,267431,-,848
815,NZ_OX366349,1,23803,24675,-,872
815,NZ_OX366349,1,117880,118752,-,872
815,NZ_OX366349,1,172875,173747,-,872
815,NZ_OX366349,1,225550,226422,-,872
815,NZ_OX366349,1,249699,250571,-,872
815,NZ_OX366349,1,268431,269303,-,872
815,NZ_OX366349,1,409414,410286,-,872
815,NZ_OX366349,1,455685,456557,-,872
815,NZ_OX366349,1,490789,491661,-,872
815,NZ_OX366349,1,509088,509960,+,872
815,NZ_OX366349,1,570086,570958,+,872
815,NZ_OX366349,1,646665,647537,+,872
815,NZ_OX366349,1,944661,945533,+,872
815,NZ_OX366349,1,990347,991219,+,872
815,NZ_OX366349,1,1145367,1146239,-,872
815,NZ_OX366349,1,1176948,1177820,-,872
815,NZ_OX366349,1,1428235,1429107,-,872
815,NZ_OX366349,1,1548588,1549460,-,872
815,NZ_OX366349,1,1612327,1613199,-,872
815,NZ_OX366349,1,1661832,1662691,-,859
815,NZ_OX366349,1,1667987,1668859,-,872
815,NZ_OX366349,1,1677556,1678428,-,872
815,NZ_OX366362,1,882922,883754,+,832
815,NZ_OX366367,1,1224076,1224932,+,856
815,NZ_OX366355,1,135732,136604,-,872
815,NZ_OX366355,1,652247,653119,+,872
815,NZ_OX366388,1,1214022,1214894,-,872
814,NZ_OX366347,1,1289390,1290260,+,870
814,NZ_OX366367,1,404044,404899,+,855
814,NZ_OX366388,1,913730,914600,+,870
813,NZ_OX366347,1,1288356,1289052,+,696
813,NZ_OX366367,1,402986,403694,+,708
813,NZ_OX366388,1,912786,913494,+,708
812,NZ_OX366347,1,1217607,1219185,+,1578
812,NZ_CP069055,1,600721,602287,+,1566
811,NZ_OX366347,1,1187683,1188316,+,633
811,NZ_OX366357,1,1218248,1218882,-,634
810,NZ_OX366347,1,1133305,1134054,+,749
810,NZ_OX366349,1,1111293,1112043,+,750
810,NZ_OX366381,1,501767,502517,+,750
810,NZ_OX366381,1,777073,777822,-,749
810,NZ_OX366369,1,875627,876376,-,749
810,NZ_OX366388,1,952758,953508,+,750
810,NZ_OX366388,1,1171779,1172528,-,749
810,NZ_OX366388,1,1224174,1224923,-,749
810,NZ_OX366397,1,497067,497817,+,750
809,NZ_OX366347,1,1130926,1131813,+,887
809,NZ_OX366349,1,1107641,1108529,+,888
809,NZ_OX366327,1,347878,348772,+,894
809,NZ_OX366381,1,499416,500275,+,859
809,NZ_OX366381,1,779315,780173,-,858
809,NZ_OX366369,1,877869,878727,-,858
809,NZ_OX366388,1,950407,951266,+,859
809,NZ_OX366388,1,1174021,1174879,-,858
809,NZ_OX366388,1,1226407,1227294,-,887
809,NZ_OX366397,1,494716,495575,+,859
808,NZ_OX366347,1,806825,807570,+,745
808,NZ_OX366347,1,1292633,1293378,+,745
807,NZ_OX366347,1,805625,806324,+,699
807,NZ_OX366347,1,1180726,1181425,+,699
806,NZ_OX366347,1,801612,802149,+,537
806,NZ_OX366367,1,470755,471287,+,532
806,NZ_OX366399,1,645615,646147,+,532
806,NZ_CP072012,1,729794,730342,-,548
805,NZ_OX366347,1,800499,801184,+,685
805,NZ_OX366367,1,469642,470327,+,685
805,NZ_OX366399,1,644502,645187,+,685
805,NZ_CP072012,1,730802,731487,-,685
804,NZ_OX366347,1,710808,711351,+,543
804,NZ_OX366349,1,1071534,1072069,+,535
804,NZ_OX366349,1,1565026,1565561,+,535
803,NZ_OX366347,1,3708,4876,+,1168
803,NZ_OX366347,1,20691,21861,+,1170
803,NZ_OX366347,1,251954,253130,-,1176
803,NZ_OX366347,1,504937,506110,+,1173
803,NZ_OX366347,1,554489,555662,+,1173
803,NZ_OX366347,1,687593,688769,+,1176
803,NZ_OX366347,1,720655,721832,+,1177
803,NZ_OX366347,1,884313,885482,-,1169
803,NZ_OX366347,1,1090759,1091928,-,1169
803,NZ_OX366347,1,1178391,1179568,+,1177
803,NZ_OX366347,1,1274600,1275773,+,1173
803,NZ_OX366347,1,1331197,1332360,+,1163
802,NZ_OX366272,1,1013738,1014382,+,644
802,NZ_OX366395,1,148422,149130,+,708
801,NZ_OX366272,1,984835,985533,+,698
801,NZ_OX366367,1,406984,407693,-,709
800,NZ_OX366272,1,932660,933350,+,690
800,NZ_OX366272,1,1124586,1125276,+,690
800,NZ_OX366349,1,178172,178861,+,689
800,NZ_OX366349,1,371982,372671,+,689
800,NZ_OX366349,1,435641,436330,+,689
800,NZ_OX366349,1,507373,508062,+,689
800,NZ_OX366349,1,658954,659643,-,689
800,NZ_OX366349,1,768488,769177,+,689
800,NZ_OX366349,1,971888,972577,+,689
800,NZ_OX366349,1,994753,995442,+,689
800,NZ_OX366349,1,1027716,1028405,-,689
800,NZ_OX366349,1,1278756,1279445,-,689
800,NZ_OX366349,1,1491057,1491746,+,689
800,NZ_OX366349,1,1537232,1537921,-,689
800,NZ_OX366349,1,1590028,1590717,-,689
799,NZ_OX366272,1,678132,679089,+,957
799,NZ_OX366352,1,116028,116985,+,957
798,NZ_OU953855,1,1625348,1626231,+,883
798,NZ_OX366363,1,300966,301611,+,645
797,NZ_OU953855,1,1446045,1446704,+,659
797,NZ_OX366349,1,1570140,1570799,+,659
796,NZ_OU953855,1,1443009,1444883,+,1874
796,NZ_OX366349,1,1567083,1568957,+,1874
796,NZ_OX366326,1,1046425,1048299,-,1874
795,NZ_OU953855,1,1184942,1185785,+,843
795,NZ_OX366359,1,713095,713941,-,846
795,NZ_OX366362,1,1119321,1120182,+,861
795,NZ_OX366381,1,527242,528088,+,846
795,NZ_OX366369,1,1070983,1071829,-,846
794,NZ_OU953855,1,1136664,1137278,+,614
794,NZ_OU909470,1,1211538,1212131,+,593
793,NZ_OU953855,1,1132879,1134025,+,1146
793,NZ_OU909470,1,1208035,1209181,+,1146
792,NZ_OU953855,1,1077025,1077841,+,816
792,NZ_OX366352,1,857963,858779,+,816
791,NZ_OU953855,1,489453,489999,+,546
791,NZ_OX366327,1,1263795,1264344,+,549
790,NZ_OU953855,1,30562,31461,+,899
790,NZ_OX366367,1,477674,478588,-,914
789,NZ_OU953855,1,28003,29005,+,1002
789,NZ_OU909470,1,1206853,1207835,-,982
788,NZ_OU953855,1,46,608,+,562
788,NZ_OU953855,1,844,1406,+,562
788,NZ_OU953855,1,1644,2207,+,563
788,NZ_OU953855,1,2458,3008,+,550
788,NZ_OU953855,1,3252,3808,+,556
788,NZ_OU953855,1,4047,4611,+,564
788,NZ_OU953855,1,4850,5412,+,562
788,NZ_OU953855,1,5648,6213,+,565
788,NZ_OU953855,1,6450,7010,+,560
788,NZ_OU953855,1,7247,7810,+,563
788,NZ_OU953855,1,8046,8609,+,563
788,NZ_OU953855,1,8846,9408,+,562
788,NZ_OU953855,1,9645,10207,+,562
788,NZ_OU953855,1,10444,11006,+,562
788,NZ_OU953855,1,11243,11805,+,562
788,NZ_OU953855,1,12042,12604,+,562
788,NZ_OU953855,1,12841,13403,+,562
788,NZ_OU953855,1,13639,14205,+,566
788,NZ_OU953855,1,14443,15002,+,559
787,NZ_CP110359,1,1132516,1133620,+,1104
787,NZ_OX366272,1,819344,820447,-,1103
787,NZ_OX366347,1,495724,496827,-,1103
786,NZ_CP110359,1,1010583,1011730,+,1147
786,NZ_OX366272,1,753903,755049,-,1146
786,NZ_OX366347,1,623111,624260,-,1149
786,NZ_OX366364,1,872612,873779,+,1167
786,NZ_OX366367,1,683463,684590,+,1127
786,NZ_OX366338,1,515419,516778,-,1359
785,NZ_CP110359,1,935135,935891,+,756
785,NZ_OX366272,1,978169,978925,+,756
784,NZ_CP110359,1,919146,920346,+,1200
784,NZ_OX366272,1,673642,674807,-,1165
783,NZ_CP110359,1,914362,914883,+,521
783,NZ_OX366272,1,377294,377815,+,521
782,NZ_CP110359,1,913376,914361,+,985
782,NZ_OX366272,1,376304,377293,+,989
782,NZ_OU909470,1,15226,16215,-,989
782,NZ_OX366380,1,800700,801705,+,1005
782,NZ_OX366385,1,558408,559415,-,1007
781,NZ_CP110359,1,910271,912962,+,2691
781,NZ_OX366272,1,373198,375889,+,2691
780,NZ_CP110359,1,693111,694678,+,1567
780,NZ_OX366272,1,393628,395187,+,1559
780,NZ_OX366377,1,719147,720714,-,1567
780,NZ_OX366398,1,1231558,1233126,+,1568
780,NZ_CP054557,1,321287,322855,+,1568
779,NZ_CP110359,1,689369,693110,+,3741
779,NZ_OX366272,1,389887,393627,+,3740
779,NZ_OX366351,1,760270,764007,-,3737
779,NZ_OX366377,1,720716,724456,-,3740
779,NZ_OX366398,1,1227816,1231557,+,3741
779,NZ_CP054557,1,317545,321286,+,3741
778,NZ_CP110359,1,658505,659602,+,1097
778,NZ_OX366363,1,393872,394971,-,1099
778,NZ_OX366396,1,923065,924162,+,1097
778,NZ_OX366396,1,1146741,1147839,-,1098
778,NZ_OX366377,1,706128,707227,-,1099
778,NZ_OX366398,1,1245046,1246144,+,1098
777,NZ_CP110359,1,599747,600562,+,815
777,NZ_CP110359,1,699929,700744,+,815
777,NZ_CP110359,1,954268,955083,-,815
777,NZ_OX366272,1,178021,178836,-,815
777,NZ_OX366272,1,525053,525868,-,815
777,NZ_OX366380,1,904851,905666,-,815
776,NZ_CP110359,1,539761,540379,+,618
776,NZ_CP110359,1,583287,583907,-,620
776,NZ_CP110359,1,907103,907723,-,620
776,NZ_OX366272,1,370029,370649,-,620
776,NZ_OX366272,1,910633,911251,-,618
776,NZ_OX366272,1,996649,997269,-,620
776,NZ_OX366272,1,1052026,1052646,+,620
776,NZ_OU909470,1,1401852,1402482,-,630
776,NZ_OX366380,1,533475,534105,+,630
776,NZ_OX366344,1,180098,180672,+,574
776,NZ_OX366339,1,653129,653749,+,620
776,NZ_OX366339,1,751654,752274,-,620
776,NZ_OX366385,1,416295,416925,+,630
776,NZ_OX366396,1,613320,613940,+,620
776,NZ_OX366396,1,858162,858782,+,620
775,NZ_CP110359,1,538310,539759,+,1449
775,NZ_CP110359,1,583908,585358,-,1450
775,NZ_CP110359,1,907724,909174,-,1450
775,NZ_OX366272,1,370650,372100,-,1450
775,NZ_OX366272,1,911252,912702,-,1450
775,NZ_OX366272,1,997270,998717,-,1447
775,NZ_OX366272,1,1050575,1052024,+,1449
775,NZ_OX366344,1,178692,180088,+,1396
775,NZ_OX366339,1,651678,653127,+,1449
775,NZ_OX366339,1,752275,753725,-,1450
775,NZ_OX366396,1,611874,613318,+,1444
775,NZ_OX366396,1,856716,858160,+,1444
774,NZ_CP110359,1,159450,160138,+,688
774,NZ_OX366272,1,68002,68705,+,703
774,NZ_OX366363,1,954234,954912,-,678
774,NZ_OX366364,1,548624,549322,-,698
774,NZ_OX366367,1,65873,66571,-,698
773,NZ_OX366332,1,676828,677893,+,1065
773,NZ_OX366363,1,1334106,1335171,+,1065
772,NZ_OX366332,1,670691,671374,+,683
772,NZ_OX366363,1,1327969,1328652,+,683
772,NZ_OX366348,1,360973,361656,+,683
772,NZ_CP054557,1,294160,294842,-,682
771,NZ_OX366332,1,655196,656071,+,875
771,NZ_CP072012,1,152783,153658,+,875
770,NZ_OX366332,1,653811,654852,+,1041
770,NZ_CP072012,1,151398,152439,+,1041
769,NZ_OX366332,1,649432,651606,+,2174
769,NZ_CP072012,1,145625,147827,+,2202
768,NZ_OX366332,1,648074,648909,+,835
768,NZ_CP072012,1,144312,145123,+,811
767,NZ_OX366332,1,647234,647864,+,630
767,NZ_CP072012,1,143472,144102,+,630
766,NZ_OX366332,1,618454,620712,+,2258
766,NZ_OX366332,1,700182,702427,+,2245
766,NZ_OX366397,1,501655,503900,+,2245
766,NZ_OX366397,1,572252,574497,+,2245
766,NZ_OX366397,1,645640,647885,+,2245
766,NZ_OX366397,1,1117263,1119506,-,2243
765,NZ_OX366332,1,571566,575164,+,3598
765,NZ_OX366388,1,1129481,1133079,-,3598
764,NZ_OX366332,1,564020,570894,+,6874
764,NZ_OX366388,1,1133626,1140626,-,7000
763,NZ_OX366332,1,563072,563785,+,713
763,NZ_OX366327,1,384110,384826,+,716
762,NZ_OX366332,1,562157,562783,+,626
762,NZ_OX366327,1,383195,383821,+,626
761,NZ_OX366332,1,540153,541244,+,1091
761,NZ_OX366359,1,669810,670916,-,1106
760,NZ_OX366319,1,603947,605214,+,1267
760,NZ_OX366326,1,352548,353815,+,1267
760,NZ_OX366355,1,615909,617176,+,1267
760,NZ_OX366351,1,1002262,1003530,-,1268
760,NZ_OX366381,1,878413,879680,+,1267
760,NZ_OX366369,1,571437,572705,-,1268
759,NZ_OX366319,1,463257,463932,+,675
759,NZ_OX366355,1,386209,386884,+,675
759,NZ_OX366381,1,730942,731616,-,674
758,NZ_OX366319,1,289996,290591,+,595
758,NZ_OX366352,1,504293,504879,+,586
758,NZ_OX366367,1,353645,354240,+,595
758,NZ_OX366367,1,518474,519059,-,585
758,NZ_OX366381,1,400019,400614,+,595
758,NZ_OX366369,1,1029948,1030534,+,586
758,NZ_OX366388,1,893011,893596,-,585
758,NZ_OX366397,1,563175,563769,-,594
757,NZ_OX366319,1,73504,74141,+,637
757,NZ_OX366363,1,794168,794814,-,646
757,NZ_OX366363,1,800267,800913,+,646
757,NZ_OX366355,1,77380,78017,+,637
757,NZ_OX366381,1,184984,185621,+,637
757,NZ_OX366369,1,1296106,1296743,+,637
757,NZ_OX366357,1,675422,676068,+,646
756,NZ_OX366318,1,1231231,1231915,+,684
756,NZ_OX366400,1,1087409,1088093,+,684
756,NZ_OX366326,1,1438776,1439460,+,684
756,NZ_OX366351,1,1384352,1385036,+,684
755,NZ_OX366318,1,886409,886965,+,556
755,NZ_OU953855,1,33451,34001,-,550
755,NZ_OX366272,1,379179,379735,-,556
755,NZ_OX366347,1,887514,888070,+,556
755,NZ_OX366363,1,1315160,1315716,+,556
755,NZ_OX366400,1,783204,783760,+,556
755,NZ_OX366327,1,925463,926013,-,550
755,NZ_OX366388,1,380772,381328,+,556
754,NZ_OX366318,1,885407,886407,+,1000
754,NZ_OX366272,1,379736,380559,-,823
754,NZ_OX366347,1,886512,887512,+,1000
754,NZ_OX366363,1,1314158,1315158,+,1000
754,NZ_OX366400,1,782202,783202,+,1000
754,NZ_OX366327,1,926014,927014,-,1000
754,NZ_OX366388,1,379770,380770,+,1000
753,NZ_OX366318,1,881579,882120,+,541
753,NZ_CP110359,1,688620,689163,+,543
753,NZ_OX366272,1,389138,389681,+,543
753,NZ_OX366400,1,384353,384894,-,541
753,NZ_OX366351,1,765066,765607,-,541
753,NZ_OX366377,1,724663,725205,-,542
753,NZ_OX366398,1,1227067,1227610,+,543
753,NZ_CP054557,1,316796,317339,+,543
752,NZ_OX366318,1,878029,878581,+,552
752,NZ_OX366332,1,670139,670690,-,551
752,NZ_OX366363,1,1327417,1327968,-,551
752,NZ_OX366326,1,973127,973679,+,552
752,NZ_OX366351,1,768605,769283,-,678
752,NZ_OX366377,1,728203,728755,-,552
752,NZ_OX366398,1,1223517,1224069,+,552
752,NZ_OX366348,1,360422,360972,-,550
752,NZ_CP054557,1,294844,295394,+,550
751,NZ_OX366318,1,577756,578483,+,727
751,NZ_OX366400,1,682406,683134,-,728
751,NZ_OX366326,1,670408,671135,+,727
751,NZ_OX366370,1,813133,813867,-,734
751,NZ_OX366351,1,494287,495014,+,727
750,NZ_OX366318,1,286819,287548,+,729
750,NZ_OX366318,1,905029,905758,-,729
750,NZ_OX366326,1,343873,344602,-,729
750,NZ_OX366351,1,844040,844769,+,729
749,NZ_OX366318,1,270729,271248,+,519
749,NZ_OU953855,1,1456083,1456613,+,530
749,NZ_OX366400,1,417265,417784,+,519
749,NZ_OX366326,1,1034579,1035098,-,519
749,NZ_OX366351,1,928686,929205,+,519
748,NZ_OX366318,1,269340,270079,+,739
748,NZ_OX366326,1,1036598,1037334,-,736
748,NZ_OX366351,1,927300,928036,+,736
747,NZ_OX366318,1,260401,261553,+,1152
747,NZ_OX366326,1,331200,332352,-,1152
747,NZ_OX366351,1,856541,857693,+,1152
746,NZ_OX366318,1,257905,259989,+,2084
746,NZ_OX366326,1,332765,334692,-,1927
746,NZ_OX366351,1,854186,856129,+,1943
745,NZ_OX366318,1,256615,257637,+,1022
745,NZ_OX366326,1,335117,336138,-,1021
744,NZ_OX366318,1,255087,255612,+,525
744,NZ_OX366326,1,337141,337666,-,525
744,NZ_OX366351,1,851826,852351,+,525
743,NZ_OX366375,1,826656,827205,+,549
743,NZ_OU909470,1,112407,113122,-,715
743,NZ_CP037426,1,284219,284768,-,549
742,NZ_OX366375,1,676811,677402,+,591
742,NZ_CP110359,1,993369,994060,-,691
742,NZ_OU953855,1,270656,271263,+,607
742,NZ_OX366272,1,696740,697431,-,691
742,NZ_CP037426,1,244217,244908,-,691
742,NZ_OX366338,1,784553,785244,-,691
741,NZ_OX366375,1,654569,657420,+,2851
741,NZ_OX366363,1,303656,306507,+,2851
741,NZ_CP037426,1,625478,628314,-,2836
740,NZ_OX366375,1,652893,653602,+,709
740,NZ_OX366347,1,1161762,1162469,-,707
740,NZ_OX366344,1,97680,98388,-,708
740,NZ_OX366326,1,1001513,1002225,+,712
740,NZ_OX366351,1,916763,917475,+,712
740,NZ_OX366389,1,1022676,1023388,+,712
739,NZ_OX366375,1,651466,652521,+,1055
739,NZ_OX366347,1,1162845,1164046,-,1201
739,NZ_OX366344,1,98761,99962,-,1201
739,NZ_OX366326,1,999964,1001165,+,1201
739,NZ_OX366396,1,757499,758679,+,1180
739,NZ_OX366351,1,915214,916415,+,1201
739,NZ_OX366389,1,1021127,1022328,+,1201
738,NZ_OX366375,1,645364,646007,+,643
738,NZ_OX366362,1,540104,540747,+,643
738,NZ_OX366377,1,102697,103340,+,643
738,NZ_OX366377,1,498703,499346,+,643
738,NZ_OX366377,1,606092,606735,+,643
738,NZ_OX366377,1,650323,650966,+,643
738,NZ_OX366377,1,691445,692088,-,643
738,NZ_OX366377,1,693221,693864,+,643
738,NZ_OX366377,1,769596,770239,-,643
738,NZ_OX366377,1,845957,846600,+,643
738,NZ_OX366377,1,978289,978932,-,643
738,NZ_OX366377,1,1010389,1011032,-,643
738,NZ_OX366377,1,1257096,1257739,+,643
738,NZ_OX366377,1,1265520,1266163,+,643
738,NZ_OX366388,1,930211,930854,+,643
738,NZ_OX366388,1,1194433,1195076,-,643
738,NZ_OX366388,1,1778848,1779491,+,643
738,NZ_OX366398,1,12449,13092,-,643
738,NZ_OX366398,1,137990,138633,+,643
738,NZ_OX366398,1,574347,574990,+,643
738,NZ_OX366398,1,617433,618076,-,643
738,NZ_OX366398,1,622472,623115,+,643
738,NZ_OX366398,1,739295,739938,-,643
738,NZ_OX366398,1,749487,750130,+,643
738,NZ_OX366398,1,1202000,1202643,+,643
737,NZ_OX366375,1,636775,637318,+,543
737,NZ_CP037426,1,598726,599269,-,543
736,NZ_OX366375,1,540463,541768,+,1305
736,NZ_CP037426,1,224242,225547,-,1305
735,NZ_CP091195,1,1414176,1415392,+,1216
735,NZ_OU953855,1,1756513,1757729,+,1216
735,NZ_OX366349,1,1301454,1302679,-,1225
735,NZ_OX366327,1,270373,271589,-,1216
735,NZ_OX366388,1,1511219,1512435,+,1216
735,NZ_OX366378,1,931417,932633,+,1216
734,NZ_CP091195,1,1413642,1414174,+,532
734,NZ_OU953855,1,1755979,1756511,+,532
734,NZ_OX366327,1,271590,272122,-,532
734,NZ_OX366388,1,1510685,1511217,+,532
734,NZ_OX366378,1,930883,931415,+,532
733,NZ_CP091195,1,1355264,1355882,+,618
733,NZ_OX366364,1,522832,523454,+,622
733,NZ_OX366357,1,1126902,1127533,+,631
733,NZ_OX366378,1,1095910,1096528,-,618
732,NZ_CP091195,1,1353438,1354955,+,1517
732,NZ_OX366364,1,521006,522523,+,1517
732,NZ_OX366357,1,1125102,1126603,+,1501
732,NZ_OX366378,1,1096837,1098354,-,1517
731,NZ_CP091195,1,1338324,1338885,+,561
731,NZ_OX366327,1,362380,362935,+,555
731,NZ_OX366378,1,1110464,1111025,-,561
731,NZ_OX366348,1,388225,388780,+,555
731,NZ_CP054557,1,279560,280115,-,555
730,NZ_CP091195,1,1331574,1332209,+,635
730,NZ_OX366332,1,613752,614385,+,633
730,NZ_OX366347,1,1326547,1327181,-,634
730,NZ_OX366396,1,727385,728018,-,633
730,NZ_OX366388,1,1089764,1090399,+,635
730,NZ_OX366378,1,1117140,1117775,-,635
729,NZ_CP091195,1,1317718,1318739,+,1021
729,NZ_OX366380,1,1071602,1072780,-,1178
729,NZ_OX366378,1,801068,802089,+,1021
728,NZ_CP091195,1,1309234,1310539,+,1305
728,NZ_OX366378,1,792583,793888,+,1305
727,NZ_CP091195,1,1179404,1180792,+,1388
727,NZ_OX366378,1,830800,832188,+,1388
726,NZ_CP091195,1,1177455,1178030,+,575
726,NZ_OX366378,1,829256,829831,+,575
725,NZ_CP091195,1,1166260,1172860,+,6600
725,NZ_OX366378,1,818061,824661,+,6600
724,NZ_CP091195,1,1024908,1025807,+,899
724,NZ_OX366363,1,909075,909974,+,899
724,NZ_OX366388,1,74541,75437,-,896
724,NZ_OX366378,1,203405,204305,-,900
723,NZ_CP091195,1,822528,823527,+,999
723,NZ_OX366388,1,1413111,1414110,+,999
722,NZ_CP091195,1,819690,822494,+,2804
722,NZ_OX366362,1,1218758,1221568,-,2810
722,NZ_OX366342,1,966429,969214,+,2785
722,NZ_OX366342,1,1213050,1215851,-,2801
722,NZ_OX366342,1,1513769,1516555,+,2786
722,NZ_OX366388,1,1410267,1413077,+,2810
721,NZ_CP091195,1,816371,819367,+,2996
721,NZ_OX366362,1,1221882,1224902,-,3020
721,NZ_OX366342,1,963092,966106,+,3014
721,NZ_OX366342,1,1216174,1219187,-,3013
721,NZ_OX366342,1,1510432,1513446,+,3014
721,NZ_OX366388,1,1406948,1409944,+,2996
720,NZ_CP091195,1,720521,721438,+,917
720,NZ_OX366344,1,1054350,1055267,+,917
720,NZ_OX366367,1,874657,875575,-,918
720,NZ_OX366388,1,1314442,1315360,-,918
720,NZ_OX366378,1,1046818,1047735,+,917
719,NZ_CP091195,1,583357,584261,+,904
719,NZ_OX366352,1,106429,107324,+,895
718,NZ_CP091195,1,547576,548114,+,538
718,NZ_OX366363,1,357411,357931,-,520
717,NZ_CP091195,1,543030,543572,+,542
717,NZ_OX366363,1,361958,362500,-,542
716,NZ_CP091195,1,521894,523185,+,1291
716,NZ_CP091195,1,1155473,1156764,-,1291
716,NZ_CP091195,1,1307564,1308855,+,1291
716,NZ_OX366349,1,961050,962290,+,1240
716,NZ_OX366367,1,302465,303705,-,1240
716,NZ_OX366367,1,480260,481500,-,1240
716,NZ_OX366378,1,330333,331624,+,1291
716,NZ_OX366378,1,483310,484601,-,1291
716,NZ_OX366378,1,626121,627412,-,1291
716,NZ_OX366378,1,636386,637677,+,1291
716,NZ_OX366378,1,790913,792204,+,1291
716,NZ_OX366378,1,807275,808566,-,1291
715,NZ_CP091195,1,198459,199191,+,732
715,NZ_CP110359,1,759417,760149,-,732
715,NZ_OX366272,1,463233,463965,+,732
715,NZ_OX366347,1,933082,933814,+,732
715,NZ_OX366363,1,189529,190258,+,729
715,NZ_OX366380,1,974507,975218,-,711
715,NZ_OX366362,1,906807,907539,+,732
715,NZ_OX366339,1,594514,595246,-,732
715,NZ_OX366370,1,607110,607842,+,732
715,NZ_OX366385,1,805209,805941,-,732
715,NZ_OX366395,1,820807,821539,+,732
715,NZ_OX366396,1,883216,883948,-,732
715,NZ_OX366356,1,658587,659319,+,732
715,NZ_OX366388,1,619145,619877,+,732
715,NZ_OX366357,1,521620,522352,+,732
715,NZ_OX366378,1,334170,334902,+,732
715,NZ_OX366374,1,149196,149928,+,732
715,NZ_OX366348,1,509119,509845,-,726
715,NZ_OX366338,1,1083549,1084281,-,732
715,NZ_CP054557,1,168075,168801,+,726
714,NZ_CP091195,1,193459,194040,+,581
714,NZ_OX366319,1,515449,516183,-,734
714,NZ_OX366347,1,928084,928818,+,734
714,NZ_OX366363,1,184561,185295,+,734
714,NZ_OX366355,1,452216,452950,+,734
714,NZ_OX366381,1,673051,673785,-,734
714,NZ_OX366369,1,744132,744866,+,734
714,NZ_OX366388,1,614140,614874,+,734
714,NZ_OX366378,1,368958,369692,-,734
713,NZ_CP091195,1,8982,11400,+,2418
713,NZ_CP091195,1,424954,427374,+,2420
713,NZ_CP091195,1,575504,577924,+,2420
713,NZ_CP091195,1,625014,627434,-,2420
713,NZ_CP091195,1,797926,800343,+,2417
713,NZ_CP091195,1,1345709,1348129,+,2420
713,NZ_CP091195,1,1581212,1583645,+,2433
712,NZ_OX366368,1,1118759,1119935,+,1176
712,NZ_CP091195,1,7629,8805,-,1176
712,NZ_CP091195,1,796573,797749,-,1176
712,NZ_CP091195,1,1579831,1581033,-,1202
712,NZ_OX366347,1,1109319,1110495,-,1176
712,NZ_OX366352,1,1080738,1081914,-,1176
712,NZ_OX366326,1,1174026,1175202,+,1176
712,NZ_OX366395,1,1408788,1409964,-,1176
712,NZ_OX366351,1,1122911,1124087,+,1176
712,NZ_OX366388,1,1388235,1389411,-,1176
712,NZ_CP072012,1,1505881,1507057,-,1176
712,NZ_OX366397,1,1277152,1278328,+,1176
712,NZ_OX366378,1,494787,495963,-,1176
711,NZ_OX366368,1,895454,896534,+,1080
711,NZ_OX366368,1,1113836,1114917,-,1081
711,NZ_OX366379,1,585120,586201,-,1081
711,NZ_OX366363,1,1350491,1351572,-,1081
711,NZ_OX366399,1,1020952,1022032,+,1080
710,NZ_OX366368,1,618727,620461,+,1734
710,NZ_OX366379,1,679858,681578,+,1720
710,NZ_CP091195,1,42687,44407,-,1720
710,NZ_OX366344,1,160088,161822,+,1734
709,NZ_OX366368,1,615563,616154,+,591
709,NZ_OX366379,1,676694,677285,+,591
709,NZ_CP091195,1,46980,47571,-,591
709,NZ_OX366344,1,156924,157515,+,591
708,NZ_OX366387,1,1728173,1728720,+,547
708,NZ_OX366319,1,1153590,1154137,+,547
708,NZ_OX366355,1,1322920,1323466,-,546
708,NZ_OX366381,1,1062537,1063084,+,547
708,NZ_OX366369,1,1412140,1412686,-,546
707,NZ_OX366387,1,1461615,1462269,+,654
707,NZ_OX366387,1,1465744,1466399,-,655
707,NZ_CP110359,1,287739,288387,+,648
707,NZ_OX366272,1,1231868,1232522,+,654
707,NZ_OX366272,1,1235988,1236643,-,655
706,NZ_OX366387,1,1395610,1396760,+,1150
706,NZ_OX366369,1,995253,996403,+,1150
705,NZ_OX366387,1,1306937,1307794,+,857
705,NZ_OX366375,1,377728,378582,-,854
705,NZ_OX366349,1,66419,67277,-,858
705,NZ_CP037426,1,494095,494949,-,854
704,NZ_OX366387,1,1258304,1260398,+,2094
704,NZ_OX366367,1,395309,397403,+,2094
703,NZ_OX366387,1,872533,873752,+,1219
703,NZ_OX366363,1,309310,310522,-,1212
703,NZ_OX366363,1,372662,373885,-,1223
702,NZ_OX366387,1,831498,832397,+,899
702,NZ_OX366387,1,1241385,1242285,-,900
702,NZ_OX366369,1,959101,960001,-,900
702,NZ_OX366388,1,405407,406275,+,868
701,NZ_OX366387,1,815653,816224,+,571
701,NZ_OX366344,1,895041,895612,-,571
701,NZ_OX366362,1,531392,531963,+,571
701,NZ_OX366355,1,331876,332447,-,571
701,NZ_OX366381,1,848408,848979,+,571
701,NZ_OX366369,1,906468,907031,-,563
701,NZ_OX366369,1,1073355,1073926,+,571
700,NZ_OX366387,1,812204,812907,+,703
700,NZ_OX366352,1,840067,840783,+,716
699,NZ_OX366387,1,809381,809904,+,523
699,NZ_OX366368,1,618209,618726,+,517
699,NZ_OX366379,1,679340,679857,+,517
699,NZ_CP091195,1,44409,44926,-,517
699,NZ_OX366344,1,159570,160087,+,517
698,NZ_OX366387,1,803833,804690,+,857
698,NZ_OX366363,1,11598,12455,+,857
698,NZ_OX366395,1,154855,155780,-,925
697,NZ_OX366387,1,802859,803831,+,972
697,NZ_OX366363,1,10621,11596,+,975
696,NZ_OX366387,1,745645,746756,+,1111
696,NZ_OU909470,1,1414429,1415547,+,1118
696,NZ_OX366364,1,339474,340591,+,1117
695,NZ_OX366387,1,742401,745643,+,3242
695,NZ_OX366364,1,336245,339472,+,3227
694,NZ_OX366387,1,737532,738349,+,817
694,NZ_OX366338,1,1077329,1078145,+,816
693,NZ_OX366387,1,734011,735181,+,1170
693,NZ_OX366387,1,1250017,1251187,+,1170
693,NZ_OX366388,1,854012,855200,+,1188
692,NZ_OX366387,1,634685,635352,+,667
692,NZ_OX366369,1,994094,994865,+,771
691,NZ_OX366387,1,633121,633648,+,527
691,NZ_OX366369,1,992523,993050,+,527
690,NZ_OX366387,1,620092,620738,+,646
690,NZ_OX366375,1,252932,253583,-,651
690,NZ_OX366319,1,968231,968883,+,652
690,NZ_CP110359,1,1261351,1262002,-,651
690,NZ_OX366272,1,1133551,1134203,+,652
690,NZ_OU909470,1,1254010,1254661,-,651
690,NZ_OX366327,1,236089,236740,-,651
690,NZ_CP037426,1,1204615,1205266,-,651
690,NZ_OX366355,1,1083051,1083703,+,652
690,NZ_OX366381,1,1151887,1152539,+,652
690,NZ_OX366369,1,228884,229535,-,651
690,NZ_OX366356,1,265965,266603,-,638
690,NZ_OX366388,1,1547641,1548293,+,652
690,NZ_OX366357,1,659162,659813,-,651
689,NZ_OX366387,1,512382,513010,+,628
689,NZ_OX366363,1,369913,370537,-,624
689,NZ_OX366352,1,1112231,1112860,-,629
688,NZ_OX366387,1,468968,470032,+,1064
688,NZ_OX366364,1,601246,602307,+,1061
687,NZ_OX366387,1,349997,351205,+,1208
687,NZ_OX366319,1,350749,351956,-,1207
687,NZ_OX366319,1,576134,577342,+,1208
687,NZ_OX366332,1,725205,726412,-,1207
687,NZ_OX366349,1,1187415,1188622,-,1207
687,NZ_OX366352,1,1342513,1343720,-,1207
687,NZ_OX366355,1,365452,366659,-,1207
687,NZ_OX366355,1,754131,755339,+,1208
687,NZ_OX366381,1,465224,466431,-,1207
687,NZ_OX366381,1,750081,751289,+,1208
687,NZ_OX366381,1,813158,814366,+,1208
687,NZ_OX366369,1,849766,850974,+,1208
687,NZ_OX366388,1,1141495,1142703,+,1208
687,NZ_OX366338,1,93163,94371,-,1208
687,NZ_OX366338,1,211879,213087,-,1208
687,NZ_OX366338,1,433901,435109,-,1208
687,NZ_OX366338,1,582104,583313,+,1209
687,NZ_OX366338,1,1042997,1044206,+,1209
686,NZ_OX366387,1,348354,349063,+,709
686,NZ_OX366379,1,616505,617235,-,730
686,NZ_CP072012,1,803491,804201,+,710
686,NZ_OX366338,1,179642,180351,-,709
685,NZ_OX366387,1,346319,347301,+,982
685,NZ_OX366379,1,618295,619277,-,982
685,NZ_CP072012,1,801499,802438,+,939
685,NZ_OX366338,1,181404,182386,-,982
684,NZ_OX366387,1,312317,313635,+,1318
684,NZ_OU909470,1,328362,329698,-,1336
684,NZ_OX366344,1,127747,129059,-,1312
684,NZ_OX366352,1,76265,77583,-,1318
684,NZ_OX366352,1,802200,803518,+,1318
684,NZ_CP037426,1,392431,393750,+,1319
684,NZ_OX366397,1,634966,636284,-,1318
683,NZ_OX366387,1,311806,312315,+,509
683,NZ_OX366344,1,129060,129592,-,532
683,NZ_OX366397,1,636285,636816,-,531
682,NZ_OX366387,1,301669,303371,+,1702
682,NZ_OX366349,1,423227,424920,-,1693
681,NZ_OX366387,1,241789,243099,+,1310
681,NZ_OU953855,1,1154269,1155578,-,1309
681,NZ_OX366380,1,1061491,1062810,+,1319
681,NZ_OX366396,1,733782,735092,+,1310
680,NZ_OX366387,1,241158,241788,+,630
680,NZ_CP091195,1,1326763,1327401,-,638
680,NZ_OU953855,1,1155580,1156206,-,626
680,NZ_OX366380,1,1060850,1061490,+,640
680,NZ_OX366396,1,733151,733781,+,630
680,NZ_OX366378,1,1121948,1122586,+,638
679,NZ_OX366387,1,238397,239016,+,619
679,NZ_OU953855,1,1158347,1158966,-,619
679,NZ_OX366396,1,730390,731009,+,619
678,NZ_OX366387,1,236451,237324,+,873
678,NZ_OU953855,1,1160039,1160913,-,874
677,NZ_OX366387,1,235896,236426,+,530
677,NZ_OU953855,1,1160938,1161468,-,530
677,NZ_OX366364,1,498825,499328,-,503
676,NZ_OX366387,1,209151,209826,+,675
676,NZ_OX366368,1,614870,615562,-,692
676,NZ_OX366379,1,676001,676693,-,692
676,NZ_CP091195,1,47573,48265,+,692
676,NZ_OU909470,1,1122423,1123123,-,700
676,NZ_OX366344,1,156231,156923,-,692
676,NZ_OX366367,1,432029,432714,-,685
676,NZ_OX366388,1,978808,979493,-,685
676,NZ_OX366388,1,1041811,1042511,-,700
675,NZ_OX366387,1,200910,204038,+,3128
675,NZ_OX366396,1,970903,974031,+,3128
675,NZ_OX366369,1,1001807,1004935,+,3128
675,NZ_CP072012,1,723460,726588,+,3128
675,NZ_CP054557,1,330960,334094,+,3134
674,NZ_OX366387,1,102452,103169,+,717
674,NZ_OX366397,1,1141761,1142479,+,718
673,NZ_OX366387,1,77444,77998,+,554
673,NZ_OX366388,1,891530,892084,-,554
672,NZ_OX366387,1,9799,10413,+,614
672,NZ_OX366387,1,70906,71495,-,589
672,NZ_OX366387,1,105376,105970,-,594
672,NZ_OX366387,1,135928,136522,+,594
672,NZ_OX366387,1,199964,200558,-,594
672,NZ_OX366387,1,277980,278574,+,594
672,NZ_OX366387,1,471150,471747,-,597
672,NZ_OX366387,1,587897,588488,+,591
672,NZ_OX366387,1,689686,690280,-,594
672,NZ_OX366387,1,939118,939712,+,594
672,NZ_OX366387,1,1269645,1270242,-,597
672,NZ_OX366387,1,1281167,1281759,+,592
672,NZ_OX366387,1,1337813,1338409,-,596
672,NZ_OX366387,1,1441254,1441844,-,590
672,NZ_OX366387,1,1599188,1599782,+,594
672,NZ_OX366387,1,1683426,1684020,+,594
672,NZ_OX366369,1,904196,904787,+,591
671,NZ_OX366353,1,1003705,1004370,+,665
671,NZ_OX366353,1,1368045,1368710,+,665
671,NZ_OX366272,1,971433,972084,+,651
671,NZ_OX366367,1,992511,993176,+,665
671,NZ_OX366342,1,152719,153383,-,664
671,NZ_CP072012,1,1536939,1537603,+,664
671,NZ_OX366397,1,891223,891887,-,664
670,NZ_OX366353,1,969182,969729,+,547
670,NZ_OX366387,1,73324,73888,+,564
670,NZ_OX366327,1,430004,430564,-,560
670,NZ_OX366388,1,1092995,1093560,-,565
669,NZ_OX366353,1,946209,948103,+,1894
669,NZ_OX366349,1,1016451,1018445,+,1994
668,NZ_OX366353,1,944307,946159,+,1852
668,NZ_OX366349,1,1014175,1016024,+,1849
667,NZ_OX366353,1,889468,890073,+,605
667,NZ_OX366318,1,891269,891866,+,597
667,NZ_OX366319,1,354947,355552,+,605
667,NZ_OX366352,1,928962,929567,+,605
667,NZ_OX366400,1,787213,787810,+,597
667,NZ_OX366327,1,303625,304222,+,597
667,NZ_CP037426,1,421452,422048,-,596
667,NZ_OX366355,1,369650,370255,+,605
667,NZ_OX366399,1,650284,650881,+,597
667,NZ_OX366381,1,746494,747098,-,604
667,NZ_OX366369,1,846176,846772,-,596
667,NZ_OX366397,1,746570,747167,+,597
667,NC_021089,1,318116,318713,+,597
666,NZ_OX366353,1,887771,888427,+,656
666,NZ_OX366318,1,888322,889080,+,758
666,NZ_OX366319,1,352851,353609,+,758
666,NZ_OX366352,1,926866,927624,+,758
666,NZ_OX366400,1,785117,785875,+,758
666,NZ_OX366327,1,301529,302287,+,758
666,NZ_CP037426,1,423288,424147,-,859
666,NZ_OX366355,1,367554,368312,+,758
666,NZ_OX366399,1,648188,648946,+,758
666,NZ_OX366381,1,748338,749195,-,857
666,NZ_OX366369,1,848012,848869,-,857
666,NZ_OX366397,1,744474,745232,+,758
666,NC_021089,1,316119,316877,+,758
665,NZ_OX366353,1,858601,860441,+,1840
665,NZ_OX366353,1,1405360,1407200,+,1840
665,NZ_OX366347,1,1242769,1244599,-,1830
664,NZ_CP041215,1,1283236,1283960,+,724
664,NZ_OX366353,1,803770,804494,-,724
664,NZ_OX366387,1,1467718,1468442,+,724
664,NZ_OX366332,1,1193415,1194139,+,724
664,NZ_OX366359,1,1024027,1024751,+,724
664,NZ_OX366352,1,1191663,1192297,-,634
664,NZ_OX366356,1,1011691,1012411,+,720
664,NZ_OX366377,1,1122886,1123610,-,724
664,NZ_OX366398,1,284546,285270,+,724
664,NZ_OX366389,1,1178131,1178855,+,724
664,NZ_OX366397,1,1418357,1419081,+,724
664,NC_021089,1,843887,844611,+,724
663,NZ_CP041215,1,1112707,1113876,+,1169
663,NZ_OX366332,1,736996,738148,+,1152
662,NZ_CP041215,1,1107845,1111529,+,3684
662,NZ_OX366332,1,732134,735818,+,3684
661,NZ_CP041215,1,1105995,1107729,+,1734
661,NZ_OX366332,1,730284,732018,+,1734
660,NZ_CP041215,1,1072926,1074015,+,1089
660,NZ_CP072012,1,181879,182967,+,1088
660,NZ_OX366397,1,1120584,1121672,-,1088
659,NZ_CP041215,1,1069540,1071571,+,2031
659,NZ_CP072012,1,177575,179605,+,2030
659,NZ_OX366397,1,1123028,1125058,-,2030
658,NZ_CP041215,1,1065035,1068476,+,3441
658,NZ_CP072012,1,173067,176511,+,3444
658,NZ_OX366397,1,1126123,1129567,-,3444
657,NZ_CP041215,1,1048012,1048616,+,604
657,NZ_OX366353,1,17208,17806,+,598
657,NZ_OX366353,1,1024564,1025162,+,598
657,NZ_OX366353,1,1388904,1389502,+,598
657,NZ_OX366347,1,1285103,1285657,-,554
657,NZ_OX366352,1,214428,215033,+,605
657,NZ_OX366352,1,916347,916952,-,605
657,NZ_OX366352,1,1385533,1386136,-,603
657,NZ_OX366352,1,1607960,1608564,-,604
657,NZ_OX366367,1,1012613,1013211,+,598
657,NZ_CP072012,1,20076,20682,+,606
657,NZ_OX366397,1,871178,871784,-,606
657,NZ_OX366397,1,1236347,1236944,-,597
656,NZ_CP041215,1,1045668,1047597,+,1929
656,NZ_OX366353,1,14865,16793,+,1928
656,NZ_OX366353,1,1022221,1024149,+,1928
656,NZ_OX366353,1,1386561,1388489,+,1928
656,NZ_CP091195,1,364617,366546,-,1929
656,NZ_OU953855,1,959188,961103,-,1915
656,NZ_OX366349,1,1088963,1090892,-,1929
656,NZ_OX366362,1,1461001,1462933,+,1932
656,NZ_OX366367,1,1010269,1012198,+,1929
656,NZ_OX366326,1,237767,239699,-,1932
656,NZ_OX366370,1,589613,591545,-,1932
656,NZ_OX366395,1,846920,848849,+,1929
656,NZ_OX366396,1,302819,304751,+,1932
656,NZ_OX366351,1,968955,970887,-,1932
656,NZ_OX366388,1,1244002,1245931,+,1929
656,NZ_OX366357,1,953984,955896,+,1912
656,NZ_CP072012,1,17732,19661,+,1929
656,NZ_OX366389,1,13728,15660,-,1932
656,NZ_OX366389,1,513945,515877,-,1932
656,NZ_OX366397,1,872199,874128,-,1929
656,NZ_OX366397,1,1237926,1239855,-,1929
655,NZ_CP041215,1,1043777,1045052,+,1275
655,NZ_OX366353,1,12962,14249,+,1287
655,NZ_OX366353,1,1020318,1021605,+,1287
655,NZ_OX366353,1,1384658,1385945,+,1287
655,NZ_CP091195,1,368610,369884,-,1274
655,NZ_OX366349,1,1091508,1092782,-,1274
655,NZ_OX366362,1,1459107,1460375,+,1268
655,NZ_OX366367,1,1008378,1009653,+,1275
655,NZ_OX366326,1,240318,241592,-,1274
655,NZ_OX366370,1,592164,593438,-,1274
655,NZ_OX366395,1,845029,846304,+,1275
655,NZ_OX366396,1,300925,302200,+,1275
655,NZ_OX366351,1,971506,972780,-,1274
655,NZ_OX366388,1,1242111,1243381,+,1270
655,NZ_OX366357,1,952091,953366,+,1275
655,NZ_CP072012,1,15841,17116,+,1275
655,NZ_OX366389,1,16279,17553,-,1274
655,NZ_OX366389,1,516496,517770,-,1274
655,NZ_OX366397,1,874744,876018,-,1274
655,NZ_OX366397,1,1240471,1241745,-,1274
654,NZ_CP041215,1,902744,903474,+,730
654,NZ_OX366353,1,200284,201011,-,727
654,NZ_OX366332,1,1161258,1161988,-,730
654,NZ_OX366359,1,989067,989791,-,724
654,NZ_OX366352,1,1223844,1224574,+,730
654,NZ_OX366397,1,1382792,1383520,-,728
654,NC_021089,1,811450,812047,-,597
653,NZ_CP041215,1,780013,780978,+,965
653,NZ_OX366387,1,883401,884359,+,958
653,NZ_OX366368,1,621950,622908,+,958
653,NZ_OX366379,1,922129,923086,-,957
653,NZ_OX366319,1,572799,573756,-,957
653,NZ_OX366332,1,1009528,1010485,-,957
653,NZ_CP110359,1,589948,590905,-,957
653,NZ_OU953855,1,1280876,1281833,-,957
653,NZ_OX366359,1,840178,841135,-,957
653,NZ_OX366352,1,772990,773947,-,957
653,NZ_OX366327,1,919547,920504,-,957
653,NZ_OX366339,1,696541,697497,-,956
653,NZ_OX366355,1,588062,589019,-,957
653,NZ_OX366399,1,915192,916149,-,957
653,NZ_OX366381,1,530278,531236,+,958
653,NZ_OX366369,1,598616,599574,+,958
653,NZ_OX366356,1,514447,515405,+,958
653,NZ_OX366377,1,487026,487983,-,957
653,NZ_CP072012,1,67817,68775,+,958
653,NZ_OX366398,1,22956,23914,+,958
653,NZ_OX366389,1,985651,986597,-,946
653,NZ_OX366397,1,1091425,1092382,-,957
653,NZ_CP069055,1,304440,305398,+,958
653,NZ_OX366348,1,591707,592664,-,957
653,NZ_CP054557,1,259013,259978,-,965
653,NC_021089,1,660307,661264,-,957
652,NZ_CP041215,1,778965,779489,+,524
652,NZ_OX366387,1,881938,882462,+,524
652,NZ_OX366368,1,620487,621011,+,524
652,NZ_OX366379,1,924026,924550,-,524
652,NZ_OX366319,1,574696,575220,-,524
652,NZ_OX366332,1,1011425,1011949,-,524
652,NZ_CP110359,1,591845,592369,-,524
652,NZ_OX366359,1,842075,842599,-,524
652,NZ_OX366352,1,774887,775411,-,524
652,NZ_OX366327,1,921444,921968,-,524
652,NZ_OX366339,1,700075,700597,-,522
652,NZ_OX366355,1,589959,590483,-,524
652,NZ_OX366399,1,917089,917613,-,524
652,NZ_OX366381,1,528815,529339,+,524
652,NZ_OX366369,1,597153,597677,+,524
652,NZ_OX366356,1,512984,513508,+,524
652,NZ_OX366377,1,488922,489446,-,524
652,NZ_CP072012,1,66354,66878,+,524
652,NZ_OX366398,1,21494,22018,+,524
652,NZ_OX366389,1,987536,988060,-,524
652,NZ_OX366397,1,1093322,1093846,-,524
652,NZ_CP069055,1,302977,303501,+,524
652,NZ_OX366348,1,593604,594128,-,524
652,NZ_CP054557,1,260898,261422,-,524
652,NC_021089,1,662204,662728,-,524
651,NZ_CP041215,1,778414,778934,+,520
651,NZ_OX366387,1,881387,881907,+,520
651,NZ_OX366379,1,924581,925101,-,520
651,NZ_OX366332,1,1011980,1012500,-,520
651,NZ_CP110359,1,592400,592920,-,520
651,NZ_OX366359,1,842630,843150,-,520
651,NZ_OX366352,1,1113076,1113596,-,520
651,NZ_OX366327,1,921999,922519,-,520
651,NZ_OX366339,1,700628,701138,-,510
651,NZ_OX366399,1,917644,918164,-,520
651,NZ_OX366356,1,830058,830564,-,506
651,NZ_CP072012,1,727031,727551,-,520
651,NZ_OX366397,1,1093877,1094397,-,520
651,NZ_OX366348,1,594159,594679,-,520
651,NZ_CP054557,1,261453,261972,-,519
651,NC_021089,1,662759,663279,-,520
650,NZ_CP041215,1,776762,778359,+,1597
650,NZ_OX366387,1,879791,881332,+,1541
650,NZ_OX366379,1,925156,926753,-,1597
650,NZ_OX366332,1,1012555,1014095,-,1540
650,NZ_CP110359,1,592975,594508,-,1533
650,NZ_OX366359,1,843205,844745,-,1540
650,NZ_OX366352,1,1113651,1115191,-,1540
650,NZ_OX366327,1,922574,924114,-,1540
650,NZ_OX366399,1,918219,919873,-,1654
650,NZ_OX366356,1,830619,832273,-,1654
650,NZ_CP072012,1,727606,729260,-,1654
650,NZ_OX366397,1,1096072,1097657,-,1585
650,NZ_OX366348,1,594734,596331,-,1597
650,NZ_CP054557,1,262027,263567,-,1540
650,NC_021089,1,663334,664874,-,1540
649,NZ_CP041215,1,774377,775236,+,859
649,NZ_OX366332,1,1015621,1016583,-,962
649,NZ_OX366359,1,846271,847233,-,962
649,NZ_OX366352,1,1116717,1117679,-,962
649,NZ_OX366327,1,931202,932164,-,962
649,NZ_OX366377,1,688393,689351,+,958
649,NZ_OX366388,1,374130,375092,+,962
649,NZ_OX366398,1,614376,615338,+,962
649,NZ_OX366389,1,1038845,1039807,-,962
649,NZ_OX366397,1,1166778,1167740,-,962
649,NZ_OX366348,1,348389,349338,+,949
649,NC_021089,1,666400,667362,-,962
648,NZ_CP041215,1,712708,713422,+,714
648,NZ_OX366353,1,933473,934187,-,714
648,NZ_OX366387,1,117445,118160,-,715
647,NZ_CP041215,1,700978,701672,+,694
647,NZ_OX366353,1,907021,907715,+,694
647,NZ_OX366387,1,776510,777204,+,694
647,NZ_OX366368,1,550289,550983,+,694
647,NZ_OX366379,1,551334,552028,+,694
647,NZ_CP091195,1,532497,533191,+,694
647,NZ_OX366375,1,623792,624486,+,694
647,NZ_OX366319,1,325616,326310,-,694
647,NZ_OX366332,1,660068,660762,+,694
647,NZ_OU953855,1,377536,378230,-,694
647,NZ_OX366352,1,836913,837607,+,694
647,NZ_OX366362,1,845259,845953,-,694
647,NZ_CP037426,1,1089380,1090074,+,694
647,NZ_OX366355,1,316535,317229,+,694
647,NZ_OX366399,1,792869,793563,-,694
647,NZ_OX366399,1,1057421,1058115,-,694
647,NZ_OX366381,1,433610,434304,-,694
647,NZ_OX366369,1,522069,522763,+,694
647,NZ_OX366356,1,833860,834554,-,694
647,NZ_OX366377,1,732949,733643,+,694
647,NZ_CP072012,1,64142,64836,+,694
647,NZ_OX366398,1,1218630,1219324,-,694
647,NZ_OX366397,1,742187,742881,+,694
647,NZ_OX366378,1,526174,526868,-,694
647,NZ_OX366348,1,350949,351643,+,694
647,NZ_CP054557,1,304318,305012,-,694
647,NC_021089,1,268234,268928,+,694
646,NZ_CP041215,1,699994,700976,+,982
646,NZ_OX366353,1,906036,907019,+,983
646,NZ_OX366387,1,775526,776508,+,982
646,NZ_OX366368,1,549305,550287,+,982
646,NZ_OX366379,1,550350,551332,+,982
646,NZ_CP091195,1,531513,532495,+,982
646,NZ_OX366375,1,622808,623790,+,982
646,NZ_OX366319,1,326311,327294,-,983
646,NZ_OX366332,1,659084,660066,+,982
646,NZ_OU953855,1,378231,379214,-,983
646,NZ_OX366352,1,835929,836911,+,982
646,NZ_OX366362,1,845954,846937,-,983
646,NZ_CP037426,1,1088396,1089378,+,982
646,NZ_OX366355,1,315551,316533,+,982
646,NZ_OX366399,1,793564,794547,-,983
646,NZ_OX366399,1,1058116,1059099,-,983
646,NZ_OX366381,1,434305,435288,-,983
646,NZ_OX366369,1,521085,522067,+,982
646,NZ_OX366356,1,834555,835538,-,983
646,NZ_OX366377,1,731965,732947,+,982
646,NZ_CP072012,1,63158,64140,+,982
646,NZ_OX366398,1,1219325,1220308,-,983
646,NZ_OX366397,1,741203,742185,+,982
646,NZ_OX366378,1,526869,527852,-,983
646,NZ_CP054557,1,305013,305996,-,983
646,NC_021089,1,267250,268232,+,982
645,NZ_CP041215,1,698185,699038,+,853
645,NZ_OX366353,1,904788,905641,+,853
645,NZ_OX366387,1,774278,775131,+,853
645,NZ_OX366368,1,548057,548910,+,853
645,NZ_OX366379,1,549102,549955,+,853
645,NZ_CP091195,1,530265,531118,+,853
645,NZ_OX366375,1,621560,622413,+,853
645,NZ_OX366319,1,327689,328542,-,853
645,NZ_OX366332,1,657836,658689,+,853
645,NZ_OU953855,1,379609,380462,-,853
645,NZ_OX366352,1,834681,835534,+,853
645,NZ_OX366362,1,847332,848185,-,853
645,NZ_CP037426,1,1087148,1088001,+,853
645,NZ_OX366355,1,314303,315156,+,853
645,NZ_OX366399,1,794942,795795,-,853
645,NZ_OX366399,1,1059494,1060347,-,853
645,NZ_OX366381,1,435683,436536,-,853
645,NZ_OX366369,1,519837,520690,+,853
645,NZ_OX366356,1,835938,836786,-,848
645,NZ_OX366377,1,730717,731570,+,853
645,NZ_CP072012,1,61910,62763,+,853
645,NZ_OX366398,1,1220703,1221556,-,853
645,NZ_OX366397,1,739955,740808,+,853
645,NZ_OX366378,1,528247,529100,-,853
645,NZ_CP054557,1,306391,307244,-,853
645,NC_021089,1,266002,266855,+,853
644,NZ_CP041215,1,695361,695885,+,524
644,NZ_OX366353,1,65179,65703,+,524
644,NZ_OX366332,1,884985,885510,-,525
644,NZ_OX366364,1,1119840,1120371,-,531
644,NZ_OX366359,1,716746,717271,-,525
644,NZ_OX366352,1,831857,832381,+,524
644,NZ_OX366367,1,185042,185573,+,531
644,NZ_OX366397,1,737131,737655,+,524
644,NC_021089,1,534598,535123,-,525
643,NZ_CP041215,1,634200,635187,+,987
643,NZ_OX366387,1,453725,454712,+,987
643,NZ_OU953855,1,1063152,1064139,+,987
642,NZ_CP041215,1,628412,629073,+,661
642,NZ_OX366353,1,551363,552024,-,661
642,NZ_OX366387,1,621728,622389,+,661
642,NZ_OX366319,1,969459,970120,+,661
642,NZ_OX366332,1,231627,232288,-,661
642,NZ_CP110359,1,1259313,1259974,-,661
642,NZ_OU953855,1,751476,752137,-,661
642,NZ_OX366272,1,1135580,1136241,+,661
642,NZ_OX366347,1,343866,344527,-,661
642,NZ_OX366363,1,705367,706028,+,661
642,NZ_OX366359,1,230460,231121,-,661
642,NZ_OX366352,1,1459110,1459771,+,661
642,NZ_OX366327,1,234051,234712,-,661
642,NZ_OX366367,1,434756,435403,+,647
642,NZ_CP037426,1,425869,426533,-,664
642,NZ_CP037426,1,862753,863413,+,660
642,NZ_OX366355,1,1084279,1084940,+,661
642,NZ_OX366381,1,1153115,1153776,+,661
642,NZ_OX366369,1,227647,228308,-,661
642,NZ_OX366388,1,981535,982182,+,647
642,NZ_OX366388,1,1548722,1549383,+,661
642,NZ_OX366397,1,231333,231994,-,661
642,NZ_OX366338,1,421286,421942,+,656
642,NZ_CP054557,1,324580,325227,-,647
642,NC_021089,1,1247803,1248464,-,661
641,NZ_CP041215,1,356279,357444,+,1165
641,NZ_OX366347,1,804551,805624,+,1073
641,NZ_OX366347,1,1179652,1180725,+,1073
640,NZ_CP041215,1,355580,356277,+,697
640,NZ_OX366347,1,803864,804549,+,685
639,NZ_CP041215,1,352225,352933,+,708
639,NZ_OX366375,1,658016,658758,-,742
639,NZ_OX366363,1,307103,307845,-,742
639,NZ_CP037426,1,624141,624883,+,742
638,NZ_CP041215,1,351002,351542,+,540
638,NZ_OX366375,1,659506,660017,-,511
638,NZ_OX366363,1,308593,309104,-,511
638,NZ_CP037426,1,622882,623393,+,511
637,NZ_CP041215,1,289659,290427,+,768
637,NZ_OX366338,1,459935,460699,+,764
636,NZ_CP041215,1,287759,289490,+,1731
636,NZ_OX366357,1,110383,112090,+,1707
635,NZ_CP041215,1,279195,280412,+,1217
635,NZ_OX366369,1,529375,530625,+,1250
634,NZ_CP041215,1,268131,268664,+,533
634,NZ_CP041215,1,1096200,1096733,+,533
634,NZ_OX366353,1,880945,881476,+,531
634,NZ_OX366387,1,135337,135869,-,532
634,NZ_OX366367,1,467919,468439,+,520
634,NZ_OX366369,1,979038,979570,-,532
633,NZ_CP041215,1,267105,267607,+,502
633,NZ_CP041215,1,1095174,1095676,+,502
633,NZ_OX366353,1,879920,880422,+,502
633,NZ_OX366387,1,136984,137486,-,502
633,NZ_OX366367,1,467172,467712,+,540
633,NZ_OX366369,1,980093,980595,-,502
632,NZ_CP041215,1,266361,266908,+,547
632,NZ_CP041215,1,349771,350310,+,539
632,NZ_CP041215,1,1094430,1094977,+,547
632,NZ_OX366353,1,879176,879723,+,547
632,NZ_OX366387,1,137684,138230,-,546
632,NZ_OX366369,1,980793,981339,-,546
631,NZ_CP041215,1,134399,134994,+,595
631,NZ_OX366353,1,1231653,1232248,-,595
631,NZ_OX366387,1,1721002,1721614,+,612
631,NZ_OX366375,1,1142023,1142635,+,612
631,NZ_OX366332,1,1301994,1302589,+,595
631,NZ_OX366364,1,1102519,1103118,+,599
631,NZ_OX366359,1,1131801,1132396,+,595
631,NZ_OX366352,1,153701,154296,-,595
631,NZ_CP037426,1,786881,787492,-,611
631,NZ_OX366339,1,1145437,1146049,+,612
631,NZ_OX366339,1,1151845,1152456,-,611
631,NZ_OX366395,1,1176127,1176738,+,611
631,NZ_OX366396,1,157392,158004,+,612
631,NZ_OX366356,1,1058200,1058811,-,611
631,NZ_OX366397,1,1528326,1528921,+,595
631,NC_021089,1,951806,952401,+,595
630,NZ_CP041215,1,113060,113567,+,507
630,NZ_OX366353,1,1253003,1253510,-,507
630,NZ_OX366332,1,99868,100375,+,507
630,NZ_CP110359,1,392070,392578,+,508
630,NZ_OX366272,1,173154,173661,-,507
630,NZ_OX366347,1,43242,43748,+,506
630,NZ_OX366359,1,98941,99448,+,507
630,NZ_OX366352,1,1591038,1591545,-,507
630,NZ_OX366362,1,1350774,1351281,-,507
630,NZ_OX366327,1,99933,100440,+,507
630,NZ_OX366339,1,955296,955805,+,509
630,NZ_OX366396,1,1468412,1468921,+,509
630,NZ_OX366397,1,78185,78692,-,507
630,NC_021089,1,1094630,1095137,-,507
629,NZ_CP041215,1,53626,54356,+,730
629,NZ_OX366353,1,1218142,1218872,+,730
629,NZ_OX366332,1,1315372,1316101,-,729
629,NZ_OU909470,1,533810,534536,-,726
629,NZ_OX366359,1,1145178,1145907,-,729
629,NZ_OX366352,1,140189,140919,+,730
629,NZ_OX366397,1,1541704,1542433,-,729
629,NC_021089,1,965184,965913,-,729
628,NZ_CP042904,1,1306900,1307460,+,560
628,NC_012416,1,1351598,1352158,+,560
628,NZ_OU909470,1,398570,399120,+,550
628,NZ_OX366380,1,843187,843747,-,560
628,NZ_OX366388,1,1109708,1110268,-,560
627,NZ_CP042904,1,1303524,1304574,+,1050
627,NC_012416,1,1348222,1349272,+,1050
627,NZ_OU953855,1,15013,16062,-,1049
627,NZ_OU953855,1,1793453,1794502,-,1049
627,NZ_OU909470,1,412836,413858,-,1022
627,NZ_OU909470,1,1215845,1216868,+,1023
627,NZ_OX366364,1,106591,107650,+,1059
627,NZ_OX366380,1,846076,847125,-,1049
627,NZ_OX366344,1,800783,801841,-,1058
627,NZ_OX366327,1,368113,369149,-,1036
627,NZ_OX366367,1,1446225,1447283,-,1058
627,NZ_OX366385,1,126909,127959,+,1050
626,NZ_CP042904,1,1294362,1295039,+,677
626,NC_012416,1,1337953,1338630,+,677
625,NZ_CP042904,1,1192591,1193170,+,579
625,NC_012416,1,1237806,1238385,+,579
625,NZ_OX366327,1,131793,132372,+,579
624,NZ_CP042904,1,1181653,1182275,+,622
624,NC_012416,1,1226868,1227490,+,622
623,NZ_CP042904,1,971648,972302,+,654
623,NC_012416,1,1010750,1011404,+,654
623,NZ_OU909470,1,945990,946645,-,655
623,NZ_OX366380,1,124651,125306,-,655
623,NZ_OX366362,1,546881,547530,-,649
623,NZ_OX366370,1,383256,383935,+,679
623,NZ_OX366385,1,1097805,1098460,-,655
622,NZ_CP042904,1,970615,971646,+,1031
622,NC_012416,1,1009717,1010748,+,1031
622,NZ_OU909470,1,947499,948519,-,1020
622,NZ_OX366380,1,125307,126327,-,1020
622,NZ_OX366385,1,1098461,1099481,-,1020
621,NZ_CP042904,1,929347,930016,+,669
621,NC_012416,1,964930,965599,+,669
621,NZ_CP041215,1,124484,125153,+,669
621,NZ_OX366353,1,1241427,1242093,-,666
621,NZ_OX366319,1,1221754,1222422,-,668
621,NZ_OX366332,1,1292106,1292775,+,669
621,NZ_OX366359,1,1122037,1122706,+,669
621,NZ_OX366352,1,163542,164210,-,668
621,NZ_OX366362,1,1431271,1431939,-,668
621,NZ_OX366327,1,1204727,1205396,+,669
621,NZ_OX366355,1,150527,151195,-,668
621,NZ_OX366381,1,124581,125250,+,669
621,NZ_OX366369,1,1429923,1430591,-,668
621,NZ_OX366397,1,1516803,1517472,+,669
621,NC_021089,1,941891,942560,+,669
620,NZ_CP042904,1,791163,791802,+,639
620,NC_012416,1,826036,826675,+,639
620,NZ_CP041215,1,995855,996494,+,639
620,NZ_OX366353,1,857675,858260,+,585
620,NZ_OX366353,1,1327905,1328490,+,585
620,NZ_OX366353,1,1404434,1405019,+,585
620,NZ_OX366368,1,1130471,1131109,-,638
620,NZ_CP091195,1,784367,785006,+,639
620,NZ_CP091195,1,1567607,1568246,+,639
620,NZ_OX366347,1,777714,778299,+,585
620,NZ_OX366347,1,1244887,1245526,-,639
620,NZ_OX366352,1,1067951,1068590,+,639
620,NZ_OX366352,1,1319028,1319613,+,585
620,NZ_OX366362,1,1256698,1257337,-,639
620,NZ_OX366367,1,952221,952805,+,584
620,NZ_OX366326,1,574784,575423,+,639
620,NZ_OX366326,1,1188993,1189632,-,639
620,NZ_OX366395,1,1397621,1398260,+,639
620,NZ_OX366396,1,272481,273120,+,639
620,NZ_OX366351,1,1136242,1136881,-,639
620,NZ_OX366342,1,961608,962248,+,640
620,NZ_OX366342,1,1246766,1247406,-,640
620,NZ_OX366342,1,1508948,1509588,+,640
620,NZ_OX366388,1,1377105,1377688,+,583
620,NZ_CP072012,1,1494727,1495311,+,584
620,NZ_OX366389,1,472308,472947,-,639
620,NZ_OX366397,1,933817,934455,-,638
620,NZ_OX366397,1,1288855,1289492,-,637
620,NZ_OX366378,1,622845,623484,+,639
619,NZ_CP042904,1,789072,789772,+,700
619,NC_012416,1,823945,824645,+,700
619,NZ_CP041215,1,993764,994464,+,700
619,NZ_OX366353,1,855596,856296,+,700
619,NZ_OX366353,1,1325826,1326526,+,700
619,NZ_OX366353,1,1402355,1403055,+,700
619,NZ_OX366368,1,1132488,1133188,-,700
619,NZ_CP091195,1,782288,782988,+,700
619,NZ_CP091195,1,1565527,1566227,+,700
619,NZ_OX366347,1,775635,776335,+,700
619,NZ_OX366347,1,1246885,1247585,-,700
619,NZ_OX366352,1,1062116,1062816,+,700
619,NZ_OX366352,1,1316949,1317649,+,700
619,NZ_OX366362,1,1258728,1259428,-,700
619,NZ_OX366367,1,950142,950842,+,700
619,NZ_OX366326,1,572711,573405,+,694
619,NZ_OX366326,1,1191011,1191711,-,700
619,NZ_OX366395,1,1395542,1396242,+,700
619,NZ_OX366396,1,270409,271102,+,693
619,NZ_OX366351,1,1138260,1138960,-,700
619,NZ_OX366342,1,959529,960229,+,700
619,NZ_OX366342,1,1248785,1249485,-,700
619,NZ_OX366342,1,1506869,1507569,+,700
619,NZ_OX366388,1,1375026,1375726,+,700
619,NZ_CP072012,1,1492648,1493348,+,700
619,NZ_OX366389,1,475577,476271,-,694
619,NZ_OX366397,1,935834,936534,-,700
619,NZ_OX366397,1,1290871,1291571,-,700
619,NZ_OX366378,1,619847,620547,+,700
618,NZ_CP042904,1,788475,789058,+,583
618,NC_012416,1,823348,823931,+,583
618,NZ_CP041215,1,993167,993750,+,583
618,NZ_OX366353,1,854994,855586,+,592
618,NZ_OX366353,1,1325224,1325816,+,592
618,NZ_OX366353,1,1401753,1402345,+,592
618,NZ_OX366368,1,1133202,1133792,-,590
618,NZ_CP091195,1,781692,782278,+,586
618,NZ_CP091195,1,1564931,1565517,+,586
618,NZ_OX366347,1,775038,775625,+,587
618,NZ_OX366347,1,1247595,1248181,-,586
618,NZ_OX366352,1,1061511,1062106,+,595
618,NZ_OX366352,1,1316353,1316939,+,586
618,NZ_OX366362,1,1259438,1260022,-,584
618,NZ_OX366367,1,949546,950132,+,586
618,NZ_OX366326,1,572115,572701,+,586
618,NZ_OX366326,1,1191721,1192306,-,585
618,NZ_OX366395,1,1394946,1395532,+,586
618,NZ_OX366396,1,193201,193786,-,585
618,NZ_OX366351,1,1138970,1139555,-,585
618,NZ_OX366342,1,958926,959519,+,593
618,NZ_OX366342,1,1249495,1250087,-,592
618,NZ_OX366342,1,1506266,1506859,+,593
618,NZ_OX366388,1,1374424,1375016,+,592
618,NZ_CP072012,1,1492052,1492638,+,586
618,NZ_OX366389,1,476281,476866,-,585
618,NZ_OX366397,1,936544,937129,-,585
618,NZ_OX366397,1,1291581,1292166,-,585
618,NZ_OX366378,1,619251,619837,+,586
617,NZ_CP042904,1,786723,787774,+,1051
617,NC_012416,1,821596,822647,+,1051
617,NZ_CP041215,1,991415,992468,+,1053
617,NZ_OX366353,1,853242,854293,+,1051
617,NZ_OX366353,1,1323472,1324523,+,1051
617,NZ_OX366353,1,1400001,1401052,+,1051
617,NZ_OX366368,1,1134466,1135536,-,1070
617,NZ_CP091195,1,779940,780991,+,1051
617,NZ_CP091195,1,1563179,1564230,+,1051
617,NZ_OX366347,1,773286,774337,+,1051
617,NZ_OX366352,1,1059767,1060818,+,1051
617,NZ_OX366352,1,1314601,1315652,+,1051
617,NZ_OX366362,1,1260714,1261766,-,1052
617,NZ_OX366367,1,947794,948845,+,1051
617,NZ_OX366326,1,1192989,1194059,-,1070
617,NZ_OX366395,1,1393194,1394264,+,1070
617,NZ_OX366351,1,1140238,1141308,-,1070
617,NZ_OX366342,1,957174,958225,+,1051
617,NZ_OX366342,1,1250788,1251840,-,1052
617,NZ_OX366342,1,1504514,1505565,+,1051
617,NZ_OX366388,1,1372672,1373723,+,1051
617,NZ_CP072012,1,1490300,1491351,+,1051
617,NZ_OX366397,1,937830,938882,-,1052
617,NZ_OX366397,1,1292849,1293919,-,1070
617,NZ_OX366378,1,617499,618550,+,1051
616,NZ_CP042904,1,784616,785451,+,835
616,NC_012416,1,819489,820324,+,835
616,NZ_CP041215,1,989305,990140,+,835
616,NZ_OX366353,1,851132,851967,+,835
616,NZ_OX366353,1,1321362,1322197,+,835
616,NZ_OX366353,1,1397891,1398726,+,835
616,NZ_OX366387,1,1667525,1668360,-,835
616,NZ_OX366368,1,1136811,1137646,-,835
616,NZ_CP091195,1,777836,778671,+,835
616,NZ_CP091195,1,1561075,1561910,+,835
616,NZ_OX366347,1,771176,772011,+,835
616,NZ_OX366347,1,1251481,1252316,-,835
616,NZ_OX366352,1,1057663,1058498,+,835
616,NZ_OX366352,1,1312491,1313326,+,835
616,NZ_OX366362,1,1263035,1263870,-,835
616,NZ_OX366367,1,945684,946519,+,835
616,NZ_OX366326,1,567981,568816,+,835
616,NZ_OX366326,1,1195331,1196166,-,835
616,NZ_OX366395,1,1391087,1391922,+,835
616,NZ_OX366396,1,197011,197846,-,835
616,NZ_OX366351,1,791111,791946,+,835
616,NZ_OX366351,1,1142580,1143415,-,835
616,NZ_OX366342,1,955075,955899,+,824
616,NZ_OX366342,1,1253115,1253950,-,835
616,NZ_OX366342,1,1502380,1503215,+,835
616,NZ_OX366388,1,1370562,1371397,+,835
616,NZ_CP072012,1,1488196,1489031,+,835
616,NZ_OX366389,1,247811,248646,+,835
616,NZ_OX366389,1,480166,481001,-,835
616,NZ_OX366397,1,940157,940992,-,835
616,NZ_OX366397,1,1295194,1296029,-,835
616,NZ_OX366378,1,615395,616230,+,835
615,NZ_CP042904,1,783408,784053,+,645
615,NC_012416,1,818281,818926,+,645
615,NZ_CP041215,1,988068,988713,+,645
615,NZ_OX366353,1,849918,850563,+,645
615,NZ_OX366353,1,1320148,1320793,+,645
615,NZ_OX366353,1,1396677,1397322,+,645
615,NZ_OX366387,1,1668924,1669569,-,645
615,NZ_OX366368,1,1138210,1138855,-,645
615,NZ_CP091195,1,776627,777272,+,645
615,NZ_CP091195,1,1559866,1560511,+,645
615,NZ_OX366347,1,769744,770389,+,645
615,NZ_OX366347,1,1252878,1253523,-,645
615,NZ_OX366352,1,1056455,1057100,+,645
615,NZ_OX366352,1,1311277,1311922,+,645
615,NZ_OX366362,1,1264434,1265079,-,645
615,NZ_OX366367,1,944470,945115,+,645
615,NZ_OX366326,1,566760,567411,+,651
615,NZ_OX366326,1,1196729,1197374,-,645
615,NZ_OX366395,1,1389879,1390524,+,645
615,NZ_OX366396,1,198416,199067,-,651
615,NZ_OX366351,1,789890,790541,+,651
615,NZ_OX366351,1,1143978,1144623,-,645
615,NZ_OX366342,1,1254514,1255159,-,645
615,NZ_OX366342,1,1501150,1501816,+,666
615,NZ_OX366388,1,1369304,1369970,+,666
615,NZ_CP072012,1,1486982,1487627,+,645
615,NZ_OX366389,1,246590,247241,+,651
615,NZ_OX366389,1,481571,482222,-,651
615,NZ_OX366397,1,941561,942206,-,645
615,NZ_OX366397,1,1296621,1297266,-,645
615,NZ_OX366378,1,614186,614831,+,645
614,NZ_CP042904,1,719194,720921,+,1727
614,NC_012416,1,717315,719043,-,1728
614,NZ_OX366353,1,19874,21601,+,1727
614,NZ_OX366353,1,1027230,1028957,+,1727
614,NZ_OX366353,1,1391570,1393297,+,1727
614,NZ_OX366368,1,1064981,1066700,-,1719
614,NZ_CP091195,1,835423,837155,+,1732
614,NZ_CP091195,1,859853,861580,+,1727
614,NZ_OX366272,1,941339,943067,-,1728
614,NZ_OX366347,1,817125,818832,+,1707
614,NZ_OX366349,1,418663,420383,-,1720
614,NZ_OX366352,1,252370,254098,-,1728
614,NZ_OX366362,1,394394,396114,-,1720
614,NZ_OX366362,1,1196112,1197848,-,1736
614,NZ_OX366367,1,1014914,1016641,+,1727
614,NZ_OX366326,1,231668,233396,-,1728
614,NZ_OX366326,1,1122724,1124452,-,1728
614,NZ_OX366395,1,1459538,1461265,+,1727
614,NZ_OX366396,1,308666,310393,+,1727
614,NZ_OX366351,1,963416,965144,-,1728
614,NZ_OX366351,1,1072105,1073833,-,1728
614,NZ_OX366342,1,131743,133471,-,1728
614,NZ_OX366342,1,980605,982340,+,1735
614,NZ_OX366342,1,1190393,1192129,-,1736
614,NZ_OX366388,1,1432006,1433730,+,1724
614,NZ_CP072012,1,22752,24479,+,1727
614,NZ_OX366397,1,867380,869108,-,1728
614,NZ_OX366397,1,1230942,1232670,-,1728
614,NZ_OX366378,1,141063,142790,+,1727
613,NZ_CP042904,1,714719,715647,+,928
613,NC_012416,1,722589,723517,-,928
613,NZ_OX366368,1,1070246,1071174,-,928
613,NZ_OX366326,1,1128849,1129777,-,928
613,NZ_OX366395,1,1454212,1455140,+,928
613,NZ_OX366351,1,1078231,1079159,-,928
613,NZ_OX366374,1,2315,3243,-,928
613,NZ_OX366374,1,594667,595595,-,928
612,NZ_CP042904,1,713790,714718,+,928
612,NC_012416,1,723519,724447,-,928
612,NZ_OX366368,1,1071176,1072104,-,928
612,NZ_OX366352,1,255940,256880,-,940
612,NZ_OX366326,1,1129779,1130707,-,928
612,NZ_OX366395,1,1453283,1454211,+,928
612,NZ_OX366351,1,1079161,1080089,-,928
612,NZ_OX366374,1,3245,4173,-,928
612,NZ_OX366374,1,595597,596525,-,928
611,NZ_CP042904,1,711243,712268,+,1025
611,NC_012416,1,725969,726994,-,1025
611,NZ_OX366368,1,1073626,1074651,-,1025
611,NZ_OX366352,1,258402,259427,-,1025
611,NZ_OX366362,1,1120656,1121689,-,1033
611,NZ_OX366326,1,1132229,1133254,-,1025
611,NZ_OX366395,1,1450736,1451761,+,1025
611,NZ_OX366351,1,1081611,1082636,-,1025
611,NZ_OX366374,1,7402,8427,-,1025
611,NZ_OX366374,1,599754,600779,-,1025
610,NZ_CP042904,1,709543,711071,+,1528
610,NC_012416,1,727165,728694,-,1529
610,NZ_OX366368,1,1074822,1076351,-,1529
610,NZ_OX366352,1,259598,261127,-,1529
610,NZ_OX366362,1,1121860,1123385,-,1525
610,NZ_OX366326,1,1133425,1134954,-,1529
610,NZ_OX366395,1,1449036,1450564,+,1528
610,NZ_OX366351,1,1082807,1084336,-,1529
610,NZ_OX366374,1,8598,10127,-,1529
610,NZ_OX366374,1,600950,602479,-,1529
609,NZ_CP042904,1,709025,709541,+,516
609,NC_012416,1,728695,729212,-,517
609,NZ_OX366368,1,1076352,1076863,-,511
609,NZ_OX366352,1,261128,261639,-,511
609,NZ_OX366362,1,1123386,1123891,-,505
609,NZ_OX366326,1,1134955,1135466,-,511
609,NZ_OX366395,1,1448524,1449034,+,510
609,NZ_OX366351,1,1084337,1084848,-,511
608,NZ_CP042904,1,706618,708573,+,1955
608,NC_012416,1,729664,731619,-,1955
608,NZ_OX366368,1,1077315,1079271,-,1956
608,NZ_OX366352,1,262091,264047,-,1956
608,NZ_OX366326,1,1135918,1137873,-,1955
608,NZ_OX366395,1,1446117,1448072,+,1955
608,NZ_OX366351,1,1085300,1087255,-,1955
607,NZ_CP042904,1,705424,705984,+,560
607,NC_012416,1,732252,732813,-,561
607,NZ_OX366368,1,1079904,1080465,-,561
607,NZ_OX366349,1,450107,450667,+,560
607,NZ_OX366349,1,1561138,1561699,-,561
607,NZ_OX366352,1,264680,265241,-,561
607,NZ_OX366367,1,448554,449115,-,561
607,NZ_OX366326,1,1138506,1139067,-,561
607,NZ_OX366395,1,1444923,1445483,+,560
606,NZ_CP042904,1,699579,701063,+,1484
606,NC_012416,1,737174,738658,-,1484
606,NZ_OX366368,1,1083206,1084686,-,1480
606,NZ_OX366352,1,268903,270383,-,1480
606,NZ_OX366326,1,1141807,1143287,-,1480
606,NZ_OX366395,1,1440702,1442183,+,1481
606,NZ_OX366351,1,1090692,1092172,-,1480
606,NZ_OX366342,1,148425,149905,-,1480
605,NZ_CP042904,1,696790,698660,+,1870
605,NC_012416,1,739576,741446,-,1870
605,NZ_OX366368,1,1084688,1086559,-,1871
605,NZ_OX366352,1,270385,272256,-,1871
605,NZ_OX366326,1,1143289,1145160,-,1871
605,NZ_OX366395,1,1438829,1440701,+,1872
605,NZ_OX366351,1,1092174,1094045,-,1871
605,NZ_OX366342,1,149907,151783,-,1876
604,NZ_CP042904,1,683925,684532,+,607
604,NC_012416,1,753704,754312,-,608
604,NZ_CP041215,1,306630,307239,-,609
604,NZ_OX366353,1,991279,991887,+,608
604,NZ_OX366353,1,1355619,1356227,+,608
604,NZ_OX366368,1,1098816,1099425,-,609
604,NZ_OX366272,1,956755,957363,+,608
604,NZ_OX366352,1,284512,285120,-,608
604,NZ_OX366362,1,1440926,1441515,+,589
604,NZ_OX366367,1,980083,980691,+,608
604,NZ_OX366326,1,260015,260624,-,609
604,NZ_OX366326,1,1157416,1158024,-,608
604,NZ_OX366395,1,1425966,1426573,+,607
604,NZ_OX366396,1,282725,283333,+,608
604,NZ_OX366351,1,815475,816083,+,608
604,NZ_OX366351,1,1106301,1106909,-,608
604,NZ_OX366342,1,17193,17790,+,597
604,NZ_CP072012,1,1524514,1525121,+,607
604,NZ_OX366389,1,35126,35735,-,609
604,NZ_OX366397,1,903685,904295,-,610
604,NZ_OX366397,1,1259288,1259898,-,610
603,NZ_CP042904,1,681772,682459,+,687
603,NC_012416,1,755778,756465,-,687
603,NZ_CP041215,1,308705,309392,-,687
603,NZ_OX366353,1,989132,989818,+,686
603,NZ_OX366353,1,1353472,1354158,+,686
603,NZ_OX366368,1,1100886,1101573,-,687
603,NZ_CP091195,1,813963,814649,+,686
603,NZ_OX366272,1,954602,955289,+,687
603,NZ_OX366352,1,286581,287268,-,687
603,NZ_OX366362,1,1226665,1227367,-,702
603,NZ_OX366367,1,977935,978622,+,687
603,NZ_OX366326,1,262094,262780,-,686
603,NZ_OX366326,1,1159485,1160171,-,686
603,NZ_OX366395,1,1423819,1424505,+,686
603,NZ_OX366396,1,280471,281255,+,784
603,NZ_OX366351,1,813319,814005,+,686
603,NZ_OX366351,1,1108370,1109056,-,686
603,NZ_OX366342,1,15033,15720,+,687
603,NZ_OX366342,1,1220950,1221637,-,687
603,NZ_OX366388,1,1404534,1405221,+,687
603,NZ_CP072012,1,1522366,1523053,+,687
603,NZ_OX366389,1,38163,38810,-,647
603,NZ_OX366397,1,905760,906447,-,687
603,NZ_OX366397,1,1261359,1262046,-,687
602,NZ_CP042904,1,681176,681757,+,581
602,NC_012416,1,756480,757061,-,581
602,NZ_CP041215,1,309407,309988,-,581
602,NZ_OX366353,1,988536,989117,+,581
602,NZ_OX366353,1,1352876,1353457,+,581
602,NZ_OX366368,1,1101588,1102169,-,581
602,NZ_CP091195,1,813367,813948,+,581
602,NZ_OX366272,1,954022,954587,+,565
602,NZ_OX366352,1,287283,287864,-,581
602,NZ_OX366362,1,1227382,1227963,-,581
602,NZ_OX366367,1,977339,977920,+,581
602,NZ_OX366326,1,262795,263375,-,580
602,NZ_OX366326,1,1160186,1160767,-,581
602,NZ_OX366395,1,1423223,1423804,+,581
602,NZ_OX366351,1,812724,813304,+,580
602,NZ_OX366351,1,1109071,1109652,-,581
602,NZ_OX366342,1,14437,15018,+,581
602,NZ_OX366342,1,1221652,1222233,-,581
602,NZ_OX366388,1,1403938,1404519,+,581
602,NZ_CP072012,1,1521786,1522351,+,565
602,NZ_OX366389,1,38825,39405,-,580
602,NZ_OX366397,1,906462,907042,-,580
602,NZ_OX366397,1,1262061,1262626,-,565
601,NZ_CP042904,1,678629,679441,+,812
601,NC_012416,1,758796,759608,-,812
601,NZ_CP041215,1,311723,312535,-,812
601,NZ_OX366353,1,985993,986810,+,817
601,NZ_OX366353,1,1350333,1351150,+,817
601,NZ_OX366368,1,1103895,1104713,-,818
601,NZ_CP091195,1,810831,811649,+,818
601,NZ_OX366272,1,951462,952280,+,818
601,NZ_OX366352,1,289590,290408,-,818
601,NZ_OX366362,1,1229680,1230497,-,817
601,NZ_OX366367,1,974795,975613,+,818
601,NZ_OX366326,1,265094,265911,-,817
601,NZ_OX366326,1,1162493,1163311,-,818
601,NZ_OX366395,1,1420679,1421497,+,818
601,NZ_OX366351,1,809269,810086,+,817
601,NZ_OX366351,1,1111378,1112196,-,818
601,NZ_OX366342,1,11884,12702,+,818
601,NZ_OX366342,1,1223968,1224786,-,818
601,NZ_OX366388,1,1400109,1400927,+,818
601,NZ_CP072012,1,1517742,1518560,+,818
601,NZ_OX366389,1,41124,41941,-,817
601,NZ_OX366397,1,908760,909578,-,818
601,NZ_OX366397,1,1264359,1265177,-,818
600,NZ_CP042904,1,675728,676280,+,552
600,NC_012416,1,761957,762508,-,551
600,NZ_CP041215,1,1016342,1016894,+,552
600,NZ_OX366362,1,1134802,1135356,-,554
600,NZ_OX366362,1,1232890,1233444,-,554
600,NZ_OX366388,1,1397205,1397757,+,552
599,NZ_CP042904,1,666495,668733,+,2238
599,NC_012416,1,768803,771040,-,2237
599,NZ_CP041215,1,1008722,1010960,+,2238
599,NZ_OX366353,1,1339848,1342091,+,2243
599,NZ_OX366368,1,1116358,1118600,-,2242
599,NZ_CP091195,1,11402,13645,+,2243
599,NZ_CP091195,1,800345,802588,+,2243
599,NZ_CP091195,1,1583647,1585931,+,2284
599,NZ_OX366352,1,1082072,1084315,+,2243
599,NZ_OX366362,1,1240070,1242393,-,2323
599,NZ_OX366367,1,964303,966546,+,2243
599,NZ_OX366326,1,589902,592145,+,2243
599,NZ_OX366326,1,1171625,1173867,-,2242
599,NZ_OX366395,1,1410122,1412365,+,2243
599,NZ_OX366351,1,798718,800961,+,2243
599,NZ_OX366351,1,1120510,1122752,-,2242
599,NZ_OX366342,1,1373,3616,+,2243
599,NZ_OX366342,1,1233054,1235296,-,2242
599,NZ_OX366388,1,1389569,1391812,+,2243
599,NZ_CP072012,1,1507215,1509453,+,2238
599,NZ_OX366397,1,920124,922366,-,2242
599,NZ_OX366397,1,1274756,1276993,-,2237
599,NZ_OX366378,1,496121,498357,+,2236
598,NZ_CP042904,1,501981,503316,+,1335
598,NC_012416,1,505300,506635,+,1335
598,NZ_OX366318,1,852619,853972,-,1353
598,NZ_OX366363,1,60323,61658,+,1335
598,NZ_OX366400,1,407655,409008,-,1353
598,NZ_OX366327,1,893541,894876,-,1335
598,NZ_OX366326,1,948571,949924,-,1353
598,NZ_OX366351,1,956278,957631,-,1353
597,NZ_CP042904,1,401978,402868,+,890
597,NC_012416,1,414270,415161,-,891
597,NZ_CP041215,1,898770,899660,+,890
597,NZ_OX366353,1,26898,27788,+,890
597,NZ_OX366332,1,897161,898052,-,891
597,NZ_OX366359,1,728555,729446,-,891
597,NZ_OX366352,1,961678,962569,-,891
597,NZ_OX366395,1,1097771,1098668,-,897
597,NZ_OX366397,1,978411,979302,-,891
597,NC_021089,1,546350,547241,-,891
596,NZ_CP042904,1,390773,391294,+,521
596,NC_012416,1,393338,393874,+,536
596,NZ_OX366318,1,629710,630231,-,521
596,NZ_OX366347,1,641099,641636,-,537
596,NZ_OX366400,1,620345,620866,+,521
596,NZ_OX366326,1,723683,724204,-,521
596,NZ_OX366351,1,545516,546037,-,521
596,NZ_OX366356,1,750665,751202,+,537
596,NZ_OX366377,1,635082,635603,-,521
596,NZ_OX366398,1,1186759,1187280,-,521
596,NZ_OX366389,1,704500,705021,-,521
596,NZ_OX366348,1,725669,726190,+,521
596,NZ_CP054557,1,1253803,1254324,-,521
595,NZ_CP042904,1,383852,384788,+,936
595,NC_012416,1,384942,385878,+,936
595,NZ_CP041215,1,1124634,1125571,-,937
595,NZ_OX366353,1,40460,41397,-,937
595,NZ_CP091195,1,648682,649618,+,936
595,NZ_OX366332,1,755225,756162,-,937
595,NZ_OU953855,1,267183,268119,+,936
595,NZ_OX366359,1,522174,523111,-,937
595,NZ_OX366344,1,476702,477639,-,937
595,NZ_OX366352,1,978582,979518,+,936
595,NZ_OX366388,1,732815,733751,+,936
595,NZ_OX366397,1,771923,772860,-,937
595,NZ_OX366378,1,705224,706161,-,937
595,NZ_OX366348,1,720781,721717,+,936
595,NZ_CP054557,1,1258276,1259213,-,937
595,NC_021089,1,521516,522452,+,936
594,NZ_CP042904,1,315426,315948,+,522
594,NC_012416,1,316519,317041,+,522
594,NZ_OX366327,1,764669,765191,+,522
594,NZ_OX366369,1,759790,760311,-,521
593,NZ_CP042904,1,302745,303877,+,1132
593,NC_012416,1,303838,304970,+,1132
593,NZ_OX366387,1,1060137,1061277,-,1140
593,NZ_OX366375,1,820720,821860,-,1140
593,NZ_OX366327,1,737864,739004,-,1140
593,NZ_CP037426,1,289558,290699,+,1141
593,NZ_OX366374,1,824380,825520,-,1140
592,NZ_CP042904,1,301168,302015,+,847
592,NC_012416,1,302261,303108,+,847
592,NZ_CP110359,1,723199,723959,-,760
592,NZ_OX366272,1,498854,499701,+,847
592,NZ_OX366347,1,967008,967757,+,749
592,NZ_OU909470,1,116985,117832,-,847
592,NZ_OX366327,1,739735,740582,-,847
592,NZ_OX366339,1,565106,565953,-,847
592,NZ_OX366396,1,851167,852014,-,847
592,NZ_OX366356,1,692639,693486,+,847
592,NZ_OX366377,1,896692,897539,-,847
592,NZ_OX366388,1,672376,673223,+,847
592,NZ_OX366398,1,672364,673211,-,847
592,NZ_OX366389,1,768111,768958,-,847
592,NZ_OX366348,1,473830,474677,-,847
592,NZ_OX366338,1,767499,768362,-,863
592,NZ_CP054557,1,210067,210914,+,847
591,NZ_CP042904,1,277355,277943,+,588
591,NC_012416,1,279939,280527,+,588
591,NZ_CP041215,1,1192519,1193113,+,594
591,NZ_OX366353,1,408332,408926,+,594
591,NZ_OX366318,1,708719,709225,-,506
591,NZ_OX366332,1,822485,823079,+,594
591,NZ_CP110359,1,745111,745705,-,594
591,NZ_OX366272,1,477069,477662,+,593
591,NZ_OU909470,1,1433821,1434415,-,594
591,NZ_OX366363,1,202580,203173,+,593
591,NZ_OX366359,1,596527,597122,-,595
591,NZ_OX366352,1,551539,552133,+,594
591,NZ_OX366400,1,537285,537790,+,505
591,NZ_OX366327,1,762340,762934,-,594
591,NZ_OX366326,1,803543,804049,-,506
591,NZ_OX366351,1,628029,628535,-,506
591,NZ_OX366377,1,921346,921852,-,506
591,NZ_OX366398,1,195070,195575,+,505
591,NZ_OX366389,1,826689,827195,-,506
591,NZ_OX366397,1,840180,840774,+,594
591,NC_021089,1,390219,390814,-,595
590,NZ_CP042904,1,173355,174080,+,725
590,NC_012416,1,175937,176662,+,725
590,NZ_CP041215,1,526836,527561,+,725
590,NZ_OX366353,1,525212,525936,-,724
590,NZ_OX366375,1,481071,481795,-,724
590,NZ_OX366332,1,447935,448660,+,725
590,NZ_OX366359,1,446210,446935,+,725
590,NZ_OX366352,1,681600,682324,-,724
590,NZ_OX366327,1,597504,598229,+,725
590,NZ_CP037426,1,704788,705512,-,724
590,NZ_OX366377,1,554277,555011,+,734
590,NZ_OX366388,1,1248162,1248886,-,724
590,NZ_OX366398,1,1108523,1109257,+,734
590,NZ_OX366389,1,619609,620343,+,734
590,NZ_OX366397,1,395404,396129,+,725
590,NC_021089,1,167278,168003,+,725
589,NZ_CP042904,1,103888,105777,+,1889
589,NC_012416,1,106469,108358,+,1889
589,NZ_OX366319,1,774091,775981,-,1890
589,NZ_OX366355,1,920346,922236,-,1890
589,NZ_OX366381,1,160641,162531,-,1890
589,NZ_OX366369,1,385032,386921,+,1889
588,NZ_CP042904,1,30307,31037,+,730
588,NC_012416,1,30308,31038,+,730
588,NZ_OX366353,1,770012,770742,+,730
588,NZ_CP091195,1,1369568,1370299,-,731
588,NZ_OX366375,1,330506,331236,+,730
588,NZ_OX366319,1,889705,890436,-,731
588,NZ_OX366332,1,310772,311502,+,730
588,NZ_OU953855,1,58449,59179,+,730
588,NZ_OX366359,1,309231,309961,+,730
588,NZ_OX366352,1,1022109,1022840,-,731
588,NZ_OX366327,1,459286,460016,+,730
588,NZ_CP037426,1,30065,30795,+,730
588,NZ_OX366339,1,1081123,1081853,+,730
588,NZ_OX366355,1,1003565,1004296,-,731
588,NZ_OX366395,1,457468,458198,+,730
588,NZ_OX366396,1,374507,375237,+,730
588,NZ_OX366381,1,1375080,1375810,+,730
588,NZ_OX366369,1,306743,307473,+,730
588,NZ_OX366388,1,1467496,1468227,-,731
588,NZ_OX366397,1,310631,311361,+,730
588,NZ_OX366378,1,886809,887540,-,731
588,NZ_OX366338,1,1488631,1489361,+,730
588,NC_021089,1,30262,30992,+,730
587,NZ_CP076228,1,605326,610387,+,5061
587,NZ_CP076228,1,638007,642004,+,3997
586,NZ_CP069060,1,1259662,1260661,+,999
586,NZ_CP069052,1,362983,363981,-,998
586,NZ_CP076228,1,1072059,1073056,-,997
586,NZ_CP069053,1,1172819,1173817,-,998
586,NZ_OX366388,1,639656,640654,-,998
586,NZ_CP072012,1,463195,464193,-,998
585,NZ_CP069060,1,1258910,1259465,+,555
585,NZ_CP069052,1,364178,364733,-,555
585,NZ_CP076228,1,1073251,1073806,-,555
585,NZ_CP069053,1,1174014,1174569,-,555
585,NZ_CP072012,1,464390,464945,-,555
584,NZ_CP069060,1,1257228,1258797,+,1569
584,NZ_CP069052,1,364846,366416,-,1570
584,NZ_CP076228,1,1073919,1075489,-,1570
584,NZ_CP069053,1,1174682,1176252,-,1570
584,NZ_OX366388,1,641515,643076,-,1561
584,NZ_CP072012,1,465058,466628,-,1570
583,NZ_CP069060,1,1255949,1256504,+,555
583,NZ_CP069052,1,367140,367695,-,555
583,NZ_CP076228,1,1076213,1076768,-,555
583,NZ_CP069053,1,1176976,1177531,-,555
583,NZ_OX366388,1,643827,644382,-,555
583,NZ_CP072012,1,467352,467907,-,555
582,NZ_CP069060,1,1253998,1255923,+,1925
582,NZ_CP069052,1,368640,370565,-,1925
582,NZ_CP076228,1,864017,865942,-,1925
582,NZ_CP069053,1,1177557,1179482,-,1925
582,NZ_OX366388,1,644408,646363,-,1955
582,NZ_CP072012,1,468852,470801,-,1949
581,NZ_CP069060,1,1248905,1253996,+,5091
581,NZ_CP069052,1,370567,375658,-,5091
581,NZ_CP069053,1,1179484,1184575,-,5091
581,NZ_OX366388,1,646365,651433,-,5068
581,NZ_CP072012,1,470803,475894,-,5091
580,NZ_CP069060,1,1209822,1212238,+,2416
580,NZ_CP069052,1,655822,658238,+,2416
580,NZ_CP069053,1,1090007,1092423,+,2416
579,NZ_CP069060,1,1208536,1209457,+,921
579,NZ_CP069052,1,654536,655457,+,921
579,NZ_CP069053,1,1088721,1089642,+,921
578,NZ_CP069060,1,1041229,1041944,+,715
578,NZ_CP069060,1,1127919,1128634,-,715
578,NZ_CP069052,1,607995,608710,+,715
578,NZ_CP069053,1,1042180,1042895,+,715
578,NZ_CP069053,1,1244123,1244838,+,715
578,NZ_CP041215,1,354805,355520,-,715
578,NZ_OU909470,1,1199614,1200329,-,715
578,NZ_OX366326,1,1012329,1013044,+,715
577,NZ_CP069060,1,1039184,1039919,+,735
577,NZ_CP069060,1,1129944,1130679,-,735
577,NZ_CP069052,1,606186,606921,+,735
577,NZ_CP069053,1,1040135,1040870,+,735
577,NZ_CP069053,1,1242078,1242813,+,735
577,NZ_OU909470,1,1202259,1202995,-,736
577,NZ_OX366326,1,1010520,1011255,+,735
577,NZ_OX366396,1,906323,907058,-,735
577,NZ_OX366396,1,975518,976253,+,735
577,NZ_OX366396,1,1029213,1029948,+,735
576,NZ_CP069060,1,1038569,1039163,+,594
576,NZ_CP069060,1,1130700,1131294,-,594
576,NZ_CP069052,1,605571,606165,+,594
576,NZ_CP069053,1,1039520,1040114,+,594
576,NZ_CP069053,1,1241463,1242057,+,594
576,NZ_CP041215,1,357511,358105,-,594
576,NZ_OU909470,1,1203016,1203610,-,594
576,NZ_OX366326,1,1009905,1010499,+,594
576,NZ_OX366396,1,907079,907673,-,594
576,NZ_OX366396,1,974903,975497,+,594
576,NZ_OX366396,1,1028598,1029192,+,594
575,NZ_CP069060,1,1035474,1036157,+,683
575,NZ_CP069052,1,961356,962039,-,683
575,NZ_CP069053,1,1035506,1036189,+,683
575,NC_021089,1,455216,455899,-,683
574,NZ_CP069060,1,1034760,1035473,+,713
574,NZ_CP069052,1,962041,962754,-,713
574,NZ_CP069053,1,1034792,1035505,+,713
574,NZ_OU953855,1,1078426,1079139,+,713
574,NZ_OX366352,1,859364,860077,+,713
574,NC_021089,1,455901,456614,-,713
573,NZ_CP069060,1,1034177,1034738,+,561
573,NZ_CP069052,1,962776,963337,-,561
573,NZ_CP069053,1,1034209,1034770,+,561
573,NZ_OX366387,1,468443,468967,+,524
573,NZ_OU953855,1,1077843,1078404,+,561
573,NZ_OX366364,1,600721,601245,+,524
573,NZ_OX366352,1,858781,859342,+,561
573,NC_021089,1,456636,457197,-,561
572,NZ_CP069060,1,1030641,1033194,+,2553
572,NZ_CP069052,1,964319,966873,-,2554
572,NZ_CP069053,1,1030673,1033226,+,2553
572,NZ_OX366387,1,464895,467451,+,2556
572,NZ_OU953855,1,1074286,1076842,+,2556
572,NZ_OX366364,1,597173,599729,+,2556
572,NC_021089,1,458179,460745,-,2566
571,NZ_CP069060,1,1027397,1030627,+,3230
571,NZ_CP069052,1,966887,970117,-,3230
571,NZ_CP069053,1,1027429,1030659,+,3230
571,NZ_OX366387,1,461663,464881,+,3218
571,NZ_OU953855,1,1071054,1074272,+,3218
571,NZ_OX366364,1,593606,596824,+,3218
571,NC_021089,1,460759,463989,-,3230
570,NZ_CP069060,1,1024644,1025648,+,1004
570,NZ_CP069052,1,971866,972869,-,1003
570,NZ_CP069053,1,1024676,1025680,+,1004
570,NZ_OX366387,1,458916,459917,+,1001
570,NZ_OU953855,1,1068334,1069335,+,1001
570,NZ_OX366364,1,590994,591998,+,1004
570,NC_021089,1,465738,466741,-,1003
569,NZ_CP069060,1,1023157,1024643,+,1486
569,NZ_CP069052,1,972871,974356,-,1485
569,NZ_CP069053,1,1023189,1024675,+,1486
569,NZ_OX366387,1,457429,458915,+,1486
569,NZ_OU953855,1,1066853,1068333,+,1480
569,NZ_OX366364,1,589507,590993,+,1486
569,NZ_OX366352,1,853978,855456,+,1478
569,NC_021089,1,466743,468228,-,1485
568,NZ_CP069060,1,1021336,1023156,+,1820
568,NZ_CP069052,1,974358,976178,-,1820
568,NZ_CP069053,1,1021368,1023188,+,1820
568,NZ_CP041215,1,636080,637903,+,1823
568,NZ_OX366387,1,455605,457428,+,1823
568,NZ_OU953855,1,1065029,1066852,+,1823
568,NZ_OX366364,1,587684,589506,+,1822
568,NZ_OX366352,1,852154,853977,+,1823
568,NC_021089,1,468230,470050,-,1820
567,NZ_CP069060,1,1019462,1020148,+,686
567,NZ_CP069052,1,977366,978051,-,685
567,NZ_CP069053,1,1019494,1020180,+,686
567,NZ_OX366364,1,585762,586448,+,686
567,NZ_OX366352,1,850256,850942,+,686
567,NC_021089,1,471238,471923,-,685
566,NZ_CP069060,1,474601,475525,+,924
566,NZ_CP069052,1,681002,681926,+,924
566,NZ_CP069053,1,474609,475533,+,924
566,NZ_OX366368,1,999220,1000144,+,924
566,NZ_OX366379,1,997754,998678,+,924
566,NZ_OX366318,1,887131,888055,-,924
566,NZ_OU953855,1,32130,33054,+,924
566,NZ_OX366272,1,378089,379013,+,924
566,NZ_OX366347,1,889334,890258,-,924
566,NZ_OX366363,1,1315873,1316797,-,924
566,NZ_OX366400,1,783926,784850,-,924
566,NZ_OX366327,1,924369,925297,+,928
566,NZ_OX366399,1,574530,575454,-,924
566,NZ_OX366388,1,381494,382418,-,924
566,NZ_CP072012,1,867231,868155,+,924
565,NZ_CP072672,1,1221517,1222280,+,763
565,NZ_CP069060,1,1362416,1363179,+,763
565,NZ_CP072667,1,1221491,1222254,+,763
565,NZ_CP072671,1,1221499,1222262,+,763
565,NZ_CP072668,1,1221486,1222249,+,763
565,NZ_CP072666,1,1221499,1222262,+,763
565,NZ_CP090902,1,1221652,1222415,+,763
565,NZ_CP090948,1,1221650,1222413,+,763
565,NZ_CP069052,1,1306716,1307479,+,763
565,NZ_CP076228,1,1242247,1243010,+,763
565,NZ_CP042445,1,1221639,1222402,+,763
565,NZ_CP042904,1,1349042,1349805,+,763
565,NC_012416,1,1393740,1394503,+,763
565,NZ_CP069053,1,1347714,1348477,+,763
565,NZ_CP042446,1,1221649,1222412,+,763
565,NZ_OX366368,1,234934,235697,+,763
565,NZ_OX366379,1,235952,236715,+,763
565,NZ_CP091195,1,900852,901615,-,763
565,NZ_CP046925,1,1221499,1222262,+,763
565,NZ_OX366318,1,325315,326078,+,763
565,NZ_CP090900,1,1221654,1222417,+,763
565,NZ_OX366400,1,234296,235059,+,763
565,NZ_CP042444,1,1223005,1223768,+,763
565,NZ_OX366326,1,560386,561137,-,751
565,NZ_CP046922,1,1283454,1284217,+,763
565,NZ_OX366399,1,234436,235199,+,763
565,NZ_OX366351,1,174788,175539,-,751
565,NZ_OX366377,1,350000,350763,-,763
565,NZ_CP072012,1,1082351,1083114,-,763
565,NZ_OX366398,1,958523,959286,-,763
565,NC_002978,6,1221650,1222413,+,763
565,NZ_OX366389,1,291413,292176,+,763
565,NZ_OX366378,1,1014213,1014976,+,763
565,NZ_CP090903,1,1221654,1222417,+,763
565,NZ_CP090901,1,1221654,1222417,+,763
565,NZ_CP046923,1,1199702,1200465,+,763
565,NZ_CP069055,1,1221652,1222415,+,763
565,NZ_CP072670,1,1221479,1222242,+,763
565,NZ_CP090899,1,1221654,1222417,+,763
565,NZ_CP046924,1,1220640,1221403,+,763
565,NZ_OX366348,1,1017495,1018246,-,751
565,NZ_CP046921,1,1283454,1284217,+,763
565,NZ_CP054557,1,583079,583839,-,760
565,NZ_CP072669,1,1221502,1222265,+,763
564,NZ_CP072672,1,1174674,1175248,+,574
564,NZ_CP069060,1,1315507,1316081,+,574
564,NZ_CP072667,1,1174648,1175222,+,574
564,NZ_CP072671,1,1174656,1175230,+,574
564,NZ_CP072668,1,1174643,1175217,+,574
564,NZ_CP072666,1,1174656,1175230,+,574
564,NZ_CP090902,1,1174808,1175382,+,574
564,NZ_CP090948,1,1174806,1175380,+,574
564,NZ_CP069052,1,1259807,1260381,+,574
564,NZ_CP076228,1,1194296,1194870,+,574
564,NZ_CP042445,1,1174796,1175370,+,574
564,NZ_CP069053,1,1300805,1301379,+,574
564,NZ_CP042446,1,1174806,1175380,+,574
564,NZ_OX366368,1,187851,188425,+,574
564,NZ_OX366379,1,188869,189443,+,574
564,NZ_CP091195,1,948895,949468,-,573
564,NZ_CP046925,1,1174656,1175230,+,574
564,NZ_CP110359,1,1211448,1212022,+,574
564,NZ_OU953855,1,464529,465103,+,574
564,NZ_OX366363,1,753255,753828,-,573
564,NZ_OX366364,1,1159075,1159650,-,575
564,NZ_CP090900,1,1174810,1175384,+,574
564,NZ_OX366367,1,146662,147332,+,670
564,NZ_CP042444,1,1176162,1176736,+,574
564,NZ_CP046922,1,1236611,1237185,+,574
564,NZ_OX366399,1,187353,187927,+,574
564,NZ_OX366356,1,216729,217303,+,574
564,NZ_OX366377,1,189518,190092,+,574
564,NZ_OX366388,1,1630276,1630850,+,574
564,NZ_CP072012,1,1129624,1130197,-,573
564,NZ_OX366398,1,835457,836031,+,574
564,NC_002978,6,1174806,1175380,+,574
564,NZ_OX366389,1,62181,62754,-,573
564,NZ_OX366378,1,966277,966851,+,574
564,NZ_CP090903,1,1174810,1175384,+,574
564,NZ_CP090901,1,1174810,1175384,+,574
564,NZ_CP046923,1,1152859,1153433,+,574
564,NZ_CP069055,1,1174764,1175338,+,574
564,NZ_CP072670,1,1174636,1175210,+,574
564,NZ_CP090899,1,1174810,1175384,+,574
564,NZ_CP046924,1,1173797,1174371,+,574
564,NZ_OX366348,1,1064669,1065242,-,573
564,NZ_CP046921,1,1236611,1237185,+,574
564,NZ_CP054557,1,630338,630911,-,573
564,NZ_CP072669,1,1174656,1175230,+,574
563,NZ_CP072672,1,1141305,1142054,+,749
563,NZ_CP069060,1,984259,985023,-,764
563,NZ_CP072667,1,1141279,1142028,+,749
563,NZ_CP072671,1,1141287,1142036,+,749
563,NZ_CP072668,1,1141274,1142023,+,749
563,NZ_CP072666,1,1141287,1142036,+,749
563,NZ_CP090902,1,1141439,1142188,+,749
563,NZ_CP090948,1,1141437,1142186,+,749
563,NZ_CP069052,1,1012491,1013255,+,764
563,NZ_CP076228,1,1152376,1153137,-,761
563,NZ_CP042445,1,1141427,1142176,+,749
563,NZ_CP042904,1,1216531,1217291,+,760
563,NC_012416,1,1261747,1262507,+,760
563,NZ_CP069053,1,984291,985055,-,764
563,NZ_CP042446,1,1141437,1142186,+,749
563,NZ_CP041215,1,164898,165658,+,760
563,NZ_OX366353,1,671127,671888,-,761
563,NZ_OX366387,1,181204,181964,+,760
563,NZ_OX366368,1,154472,155232,+,760
563,NZ_OX366379,1,154570,155330,+,760
563,NZ_CP091195,1,1195826,1196586,+,760
563,NZ_OX366375,1,157107,157867,+,760
563,NZ_CP046925,1,1141287,1142036,+,749
563,NZ_OX366318,1,149199,149960,+,761
563,NZ_OX366319,1,1046653,1047414,-,761
563,NZ_OX366332,1,152486,153246,+,760
563,NZ_CP110359,1,138576,139340,+,764
563,NZ_OU953855,1,534652,535412,+,760
563,NZ_OX366272,1,108423,109183,+,760
563,NZ_OX366347,1,263758,264518,+,760
563,NZ_OX366363,1,786131,786892,-,761
563,NZ_OX366359,1,151611,152371,+,760
563,NZ_CP090900,1,1141440,1142189,+,749
563,NZ_OX366352,1,1538159,1538920,-,761
563,NZ_OX366400,1,20996,21757,-,761
563,NZ_OX366327,1,151455,152219,+,764
563,NZ_CP042444,1,1142793,1143542,+,749
563,NZ_OX366326,1,152923,153682,+,759
563,NZ_CP037426,1,989059,989820,-,761
563,NZ_OX366339,1,1174536,1175296,+,760
563,NZ_OX366355,1,1163428,1164189,-,761
563,NZ_CP046922,1,1203251,1204000,+,749
563,NZ_OX366399,1,153973,154733,+,760
563,NZ_OX366395,1,293980,294740,+,760
563,NZ_OX366396,1,25594,26353,+,759
563,NZ_OX366351,1,160338,161097,+,759
563,NZ_OX366381,1,1230309,1231070,-,761
563,NZ_OX366369,1,150230,150990,+,760
563,NZ_OX366356,1,185400,186160,+,760
563,NZ_OX366377,1,156631,157391,+,760
563,NZ_OX366388,1,1596545,1597305,+,760
563,NZ_OX366357,1,381911,382670,+,759
563,NZ_CP072012,1,1161715,1162475,-,760
563,NZ_OX366398,1,803421,804181,+,760
563,NC_002978,6,1141437,1142186,+,749
563,NZ_OX366389,1,95280,96041,-,761
563,NZ_OX366397,1,152184,152944,+,760
563,NZ_OX366378,1,1161757,1162518,-,761
563,NZ_CP090903,1,1141440,1142189,+,749
563,NZ_CP090901,1,1141440,1142189,+,749
563,NZ_CP046923,1,1119499,1120248,+,749
563,NZ_CP069055,1,1141384,1142144,+,760
563,NZ_CP072670,1,1141267,1142016,+,749
563,NZ_CP090899,1,1141440,1142189,+,749
563,NZ_CP046924,1,1140437,1141186,+,749
563,NZ_OX366348,1,1098776,1099536,-,760
563,NZ_CP046921,1,1203251,1204000,+,749
563,NZ_CP054557,1,667701,668462,-,761
563,NZ_CP072669,1,1141287,1142036,+,749
563,NC_021089,1,1168719,1169479,+,760
562,NZ_CP072672,1,1030554,1032139,+,1585
562,NZ_CP069060,1,876290,877875,+,1585
562,NZ_CP072667,1,1030528,1032113,+,1585
562,NZ_CP072671,1,1030536,1032121,+,1585
562,NZ_CP072668,1,1030523,1032108,+,1585
562,NZ_CP072666,1,1030536,1032121,+,1585
562,NZ_CP090902,1,1030688,1032273,+,1585
562,NZ_CP090948,1,1030686,1032271,+,1585
562,NZ_CP069052,1,778196,779781,-,1585
562,NZ_CP076228,1,892503,894088,+,1585
562,NZ_CP042445,1,1030676,1032261,+,1585
562,NZ_CP042904,1,1153008,1154593,+,1585
562,NC_012416,1,1198223,1199808,+,1585
562,NZ_CP069053,1,876298,877883,+,1585
562,NZ_CP042446,1,1030686,1032271,+,1585
562,NZ_CP041215,1,1408295,1409880,-,1585
562,NZ_OX366353,1,1085601,1087186,-,1585
562,NZ_OX366387,1,46797,48382,+,1585
562,NZ_OX366368,1,42092,43677,+,1585
562,NZ_OX366379,1,42110,43695,+,1585
562,NZ_OX366375,1,43017,44602,+,1585
562,NZ_CP046925,1,1030536,1032121,+,1585
562,NZ_OX366318,1,41265,42850,+,1585
562,NZ_OX366319,1,42824,44420,+,1596
562,NZ_OX366332,1,42561,44146,+,1585
562,NZ_CP110359,1,425504,427089,-,1585
562,NZ_OX366272,1,1176959,1178544,+,1585
562,NZ_OX366359,1,42544,44129,+,1585
562,NZ_OX366344,1,912691,914276,+,1585
562,NZ_CP090900,1,1030688,1032273,+,1585
562,NZ_OX366352,1,45133,46718,+,1585
562,NZ_OX366362,1,218725,220308,-,1583
562,NZ_OX366400,1,131259,132844,-,1585
562,NZ_OX366327,1,43348,44931,+,1583
562,NZ_CP042444,1,1032042,1033627,+,1585
562,NZ_OX366326,1,44594,46179,+,1585
562,NZ_CP037426,1,1291354,1292939,+,1585
562,NZ_OX366339,1,1110129,1111714,-,1585
562,NZ_OX366355,1,46621,48206,+,1585
562,NZ_CP046922,1,1092605,1094190,+,1585
562,NZ_OX366399,1,42088,43673,+,1585
562,NZ_OX366395,1,46283,47866,-,1583
562,NZ_OX366396,1,1439803,1441388,-,1585
562,NZ_OX366351,1,49507,51092,+,1585
562,NZ_OX366381,1,44647,46232,+,1585
562,NZ_OX366369,1,43637,45222,+,1585
562,NZ_OX366356,1,41017,42706,+,1689
562,NZ_OX366377,1,41698,43283,+,1585
562,NZ_OX366357,1,145399,146962,-,1563
562,NZ_CP072012,1,1294615,1296200,+,1585
562,NZ_OX366398,1,513057,514642,+,1585
562,NC_002978,6,1030686,1032271,+,1585
562,NZ_OX366389,1,208154,209739,-,1585
562,NZ_OX366397,1,59037,60622,-,1585
562,NZ_CP090903,1,1030688,1032273,+,1585
562,NZ_OX366374,1,460004,461589,+,1585
562,NZ_CP090901,1,1030688,1032273,+,1585
562,NZ_CP046923,1,1008853,1010438,+,1585
562,NZ_CP069055,1,981935,983520,+,1585
562,NZ_CP072670,1,1030528,1032113,+,1585
562,NZ_CP090899,1,1030688,1032273,+,1585
562,NZ_CP046924,1,1029791,1031376,+,1585
562,NZ_OX366348,1,41860,43445,+,1585
562,NZ_CP046921,1,1092605,1094190,+,1585
562,NZ_CP054557,1,823887,825472,+,1585
562,NZ_CP072669,1,1030536,1032121,+,1585
562,NC_021089,1,1058889,1060474,+,1585
561,NZ_CP072672,1,991980,992679,+,699
561,NZ_CP069060,1,836788,837487,+,699
561,NZ_CP072667,1,991954,992653,+,699
561,NZ_CP072671,1,991962,992661,+,699
561,NZ_CP072668,1,991949,992648,+,699
561,NZ_CP072666,1,991962,992661,+,699
561,NZ_CP090902,1,992114,992813,+,699
561,NZ_CP090948,1,992114,992813,+,699
561,NZ_CP069052,1,818584,819283,-,699
561,NZ_CP076228,1,991205,991904,-,699
561,NZ_CP042445,1,992102,992801,+,699
561,NZ_CP042904,1,1115451,1116151,-,700
561,NC_012416,1,1159476,1160176,-,700
561,NZ_CP069053,1,836796,837495,+,699
561,NZ_CP042446,1,992112,992811,+,699
561,NZ_CP041215,1,1445286,1445986,-,700
561,NZ_OX366353,1,1124101,1124801,-,700
561,NZ_OX366387,1,3349,4049,+,700
561,NZ_OX366368,1,3349,4048,+,699
561,NZ_OX366379,1,3349,4048,+,699
561,NZ_CP091195,1,1083541,1084241,-,700
561,NZ_OX366375,1,4200,4900,+,700
561,NZ_CP046925,1,991962,992661,+,699
561,NZ_OX366318,1,4280,4968,+,688
561,NZ_OX366332,1,3415,4115,+,700
561,NZ_OU953855,1,562494,563194,+,700
561,NZ_OX366272,1,3350,4050,+,700
561,NZ_OX366347,1,721915,722615,+,700
561,NZ_OU909470,1,929824,930524,-,700
561,NZ_OX366363,1,1009568,1010268,+,700
561,NZ_OX366359,1,3415,4115,+,700
561,NZ_OX366380,1,3358,4058,+,700
561,NZ_CP090900,1,992114,992813,+,699
561,NZ_OX366352,1,3415,4115,+,700
561,NZ_OX366400,1,4280,4968,+,688
561,NZ_OX366327,1,3349,4049,+,700
561,NZ_CP042444,1,993468,994167,+,699
561,NZ_OX366326,1,4280,4968,+,688
561,NZ_CP037426,1,1183057,1183757,+,700
561,NZ_OX366339,1,3349,4049,+,700
561,NZ_OX366355,1,4327,5027,+,700
561,NZ_CP046922,1,1054010,1054709,+,699
561,NZ_OX366385,1,3358,4058,+,700
561,NZ_OX366399,1,3349,4048,+,699
561,NZ_OX366351,1,4280,4968,+,688
561,NZ_OX366381,1,3314,4014,+,700
561,NZ_OX366369,1,3348,4048,+,700
561,NZ_OX366356,1,3373,4073,+,700
561,NZ_OX366377,1,3349,4049,+,700
561,NZ_OX366388,1,3275,3975,+,700
561,NZ_OX366357,1,3282,3982,+,700
561,NZ_CP072012,1,1254039,1254738,+,699
561,NZ_OX366398,1,473830,474530,+,700
561,NC_002978,6,992114,992813,+,699
561,NZ_OX366389,1,3349,4049,+,700
561,NZ_OX366397,1,3415,4115,+,700
561,NZ_OX366378,1,3350,4050,+,700
561,NZ_CP090903,1,992114,992813,+,699
561,NZ_OX366374,1,395414,396114,+,700
561,NZ_CP090901,1,992114,992813,+,699
561,NZ_CP046923,1,970258,970957,+,699
561,NZ_CP069055,1,1049581,1050280,-,699
561,NZ_CP072670,1,991954,992653,+,699
561,NZ_CP090899,1,992114,992813,+,699
561,NZ_CP046924,1,991196,991895,+,699
561,NZ_OX366348,1,3349,4126,+,777
561,NZ_CP046921,1,1054010,1054709,+,699
561,NZ_CP054557,1,787128,787828,+,700
561,NZ_CP072669,1,991962,992661,+,699
561,NC_021089,1,1021127,1021827,+,700
560,NZ_CP072672,1,932501,933154,+,653
560,NZ_CP069060,1,737149,737802,+,653
560,NZ_CP072667,1,932475,933128,+,653
560,NZ_CP072671,1,932483,933136,+,653
560,NZ_CP072668,1,932470,933123,+,653
560,NZ_CP072666,1,932483,933136,+,653
560,NZ_CP090902,1,932635,933288,+,653
560,NZ_CP090948,1,932635,933288,+,653
560,NZ_CP069052,1,922704,923357,+,653
560,NZ_CP076228,1,975484,976137,+,653
560,NZ_CP042445,1,932623,933276,+,653
560,NZ_CP069053,1,732721,733375,-,654
560,NZ_CP042446,1,932633,933286,+,653
560,NZ_OX366387,1,1736597,1737250,+,653
560,NZ_OX366368,1,1378059,1378712,+,653
560,NZ_OX366379,1,1297552,1298205,+,653
560,NZ_CP046925,1,932483,933136,+,653
560,NZ_CP090900,1,932635,933288,+,653
560,NZ_CP042444,1,933070,933723,+,653
560,NZ_OX366339,1,59020,59679,+,659
560,NZ_CP046922,1,994531,995184,+,653
560,NZ_OX366399,1,1331168,1331821,+,653
560,NZ_OX366395,1,1190739,1191392,+,653
560,NZ_OX366396,1,171176,171835,+,659
560,NZ_CP072012,1,282496,283149,+,653
560,NC_002978,6,932635,933288,+,653
560,NZ_CP090903,1,932635,933288,+,653
560,NZ_CP090901,1,932635,933288,+,653
560,NZ_CP046923,1,910779,911432,+,653
560,NZ_CP069055,1,911862,912497,-,635
560,NZ_CP072670,1,932475,933128,+,653
560,NZ_CP090899,1,932635,933288,+,653
560,NZ_CP046924,1,931717,932370,+,653
560,NZ_CP046921,1,994531,995184,+,653
560,NZ_CP072669,1,932483,933136,+,653
559,NZ_CP072672,1,917051,917589,+,538
559,NZ_CP069060,1,721732,722270,+,538
559,NZ_CP072667,1,917025,917563,+,538
559,NZ_CP072671,1,917033,917571,+,538
559,NZ_CP072668,1,917020,917558,+,538
559,NZ_CP072666,1,917033,917571,+,538
559,NZ_CP090902,1,917185,917723,+,538
559,NZ_CP090948,1,917185,917723,+,538
559,NZ_CP069052,1,907287,907825,+,538
559,NZ_CP076228,1,958168,958706,+,538
559,NZ_CP042445,1,917173,917711,+,538
559,NZ_CP042904,1,937568,938106,+,538
559,NC_012416,1,973151,973689,+,538
559,NZ_CP069053,1,748253,748791,-,538
559,NZ_CP042446,1,917183,917721,+,538
559,NZ_CP041215,1,132688,133226,+,538
559,NZ_OX366353,1,1233421,1233959,-,538
559,NZ_OX366387,1,1719291,1719829,+,538
559,NZ_OX366368,1,1362573,1363111,+,538
559,NZ_OX366379,1,1282066,1282604,+,538
559,NZ_CP091195,1,1152797,1153335,-,538
559,NZ_OX366375,1,1140312,1140850,+,538
559,NZ_CP046925,1,917033,917571,+,538
559,NZ_OX366318,1,1215333,1215871,+,538
559,NZ_OX366319,1,1213743,1214281,-,538
559,NZ_OX366332,1,1300310,1300848,+,538
559,NZ_CP110359,1,176098,176636,-,538
559,NZ_OU953855,1,654162,654700,-,538
559,NZ_OX366272,1,121087,121625,+,538
559,NZ_OX366347,1,1361410,1361948,+,538
559,NZ_OX366363,1,937911,938449,+,538
559,NZ_OX366359,1,1130091,1130629,+,538
559,NZ_CP090900,1,917185,917723,+,538
559,NZ_OX366352,1,155469,156007,-,538
559,NZ_OX366400,1,1072249,1072787,+,538
559,NZ_OX366327,1,1212862,1213400,+,538
559,NZ_CP042444,1,917620,918158,+,538
559,NZ_OX366326,1,1423894,1424432,+,538
559,NZ_CP037426,1,788665,789203,-,538
559,NZ_OX366339,1,1143726,1144264,+,538
559,NZ_OX366339,1,1153629,1154167,-,538
559,NZ_OX366355,1,142516,143054,-,538
559,NZ_CP046922,1,979081,979619,+,538
559,NZ_OX366399,1,1315682,1316220,+,538
559,NZ_OX366396,1,155683,156221,+,538
559,NZ_OX366351,1,1369470,1370008,+,538
559,NZ_OX366381,1,132722,133260,+,538
559,NZ_OX366369,1,1421911,1422449,-,538
559,NZ_OX366356,1,1059984,1060508,-,524
559,NZ_OX366377,1,1049566,1050104,-,538
559,NZ_OX366388,1,1689790,1690328,-,538
559,NZ_OX366357,1,70196,70734,-,538
559,NZ_CP072012,1,267010,267548,+,538
559,NZ_OX366398,1,399237,399775,+,538
559,NC_002978,6,917185,917723,+,538
559,NZ_OX366389,1,1293379,1293917,+,538
559,NZ_OX366397,1,1526615,1527153,+,538
559,NZ_OX366378,1,1233513,1234051,+,538
559,NZ_CP090903,1,917185,917723,+,538
559,NZ_OX366374,1,195782,196327,-,545
559,NZ_CP090901,1,917185,917723,+,538
559,NZ_CP046923,1,895329,895867,+,538
559,NZ_CP069055,1,927444,927982,-,538
559,NZ_CP072670,1,917025,917563,+,538
559,NZ_CP090899,1,917185,917723,+,538
559,NZ_CP046924,1,916267,916805,+,538
559,NZ_OX366348,1,63556,64094,-,538
559,NZ_CP046921,1,979081,979619,+,538
559,NZ_CP054557,1,925957,926495,-,538
559,NZ_CP072669,1,917033,917571,+,538
559,NC_021089,1,950095,950633,+,538
558,NZ_CP072672,1,887374,888187,+,813
558,NZ_CP069060,1,776798,777701,-,903
558,NZ_CP072667,1,887348,888161,+,813
558,NZ_CP072671,1,887356,888169,+,813
558,NZ_CP072668,1,887343,888156,+,813
558,NZ_CP072666,1,887356,888169,+,813
558,NZ_CP090902,1,887508,888321,+,813
558,NZ_CP090948,1,887508,888321,+,813
558,NZ_CP069052,1,878370,879273,+,903
558,NZ_CP076228,1,1078081,1078939,+,858
558,NZ_CP042445,1,887496,888309,+,813
558,NZ_CP069053,1,776806,777709,-,903
558,NZ_CP042446,1,887508,888321,+,813
558,NZ_OX366368,1,1333700,1334558,+,858
558,NZ_OX366379,1,1221686,1222544,-,858
558,NZ_CP091195,1,1241869,1242759,+,890
558,NZ_CP046925,1,887356,888169,+,813
558,NZ_OU909470,1,336975,337872,+,897
558,NZ_OX366344,1,837972,838866,+,894
558,NZ_CP090900,1,887508,888321,+,813
558,NZ_CP042444,1,887943,888756,+,813
558,NZ_CP046922,1,949404,950217,+,813
558,NZ_OX366399,1,1286809,1287667,+,858
558,NZ_OX366388,1,1756304,1757198,-,894
558,NZ_CP072012,1,678686,679544,-,858
558,NC_002978,6,887508,888321,+,813
558,NZ_OX366378,1,1186385,1187275,+,890
558,NZ_CP090903,1,887508,888321,+,813
558,NZ_CP090901,1,887508,888321,+,813
558,NZ_CP046923,1,865652,866465,+,813
558,NZ_CP069055,1,1010072,1010930,+,858
558,NZ_CP072670,1,887348,888161,+,813
558,NZ_CP090899,1,887508,888321,+,813
558,NZ_CP046924,1,886590,887403,+,813
558,NZ_CP046921,1,949404,950217,+,813
558,NZ_CP072669,1,887356,888169,+,813
557,NZ_CP072672,1,739831,740362,+,531
557,NZ_CP069060,1,582772,583303,+,531
557,NZ_CP072667,1,739813,740344,+,531
557,NZ_CP072671,1,739813,740344,+,531
557,NZ_CP072668,1,739800,740331,+,531
557,NZ_CP072666,1,739813,740344,+,531
557,NZ_CP090902,1,739965,740496,+,531
557,NZ_CP090948,1,739965,740496,+,531
557,NZ_CP069052,1,1133762,1134293,+,531
557,NZ_CP076228,1,799355,799888,-,533
557,NZ_CP042445,1,739953,740484,+,531
557,NZ_CP042904,1,619774,620305,+,531
557,NC_012416,1,655429,655960,+,531
557,NZ_CP069053,1,582780,583311,+,531
557,NZ_CP042446,1,739965,740496,+,531
557,NZ_CP041215,1,940235,940767,-,532
557,NZ_OX366353,1,103777,104309,-,532
557,NZ_OX366387,1,713906,714438,-,532
557,NZ_OX366368,1,1185675,1186206,+,531
557,NZ_OX366379,1,1105190,1105721,+,531
557,NZ_CP091195,1,1514841,1515384,-,543
557,NZ_OX366375,1,1031954,1032485,+,531
557,NZ_CP046925,1,739813,740344,+,531
557,NZ_OX366318,1,1037132,1037663,+,531
557,NZ_OX366319,1,182021,182553,-,532
557,NZ_OX366332,1,1123158,1123689,+,531
557,NZ_CP110359,1,466332,466867,-,535
557,NZ_OU953855,1,230318,230850,-,532
557,NZ_OX366272,1,1362002,1362536,+,534
557,NZ_OX366347,1,171279,171805,+,526
557,NZ_OX366363,1,1202818,1203350,-,532
557,NZ_OX366364,1,193935,194441,+,506
557,NZ_OX366359,1,950959,951490,+,531
557,NZ_CP090900,1,739965,740496,+,531
557,NZ_OX366352,1,1264476,1265008,-,532
557,NZ_OX366362,1,413772,414298,-,526
557,NZ_OX366400,1,900382,900913,+,531
557,NZ_OX366327,1,1036771,1037302,+,531
557,NZ_OX366367,1,1371493,1371999,+,506
557,NZ_CP042444,1,740400,740931,+,531
557,NZ_OX366326,1,1244615,1245146,+,531
557,NZ_CP037426,1,829667,830198,+,531
557,NZ_OX366339,1,852730,853261,+,531
557,NZ_OX366355,1,206391,206923,-,532
557,NZ_CP046922,1,801778,802309,+,531
557,NZ_OX366399,1,1139818,1140349,+,531
557,NZ_OX366395,1,1341099,1341631,-,532
557,NZ_OX366396,1,1348740,1349272,-,532
557,NZ_OX366351,1,1191040,1191571,+,531
557,NZ_OX366381,1,292882,293414,-,532
557,NZ_OX366369,1,1227145,1227676,+,531
557,NZ_OX366356,1,944134,944677,+,543
557,NZ_OX366377,1,1190448,1190980,-,532
557,NZ_OX366388,1,220902,221445,+,543
557,NZ_OX366357,1,1023396,1023930,+,534
557,NZ_CP072012,1,1441364,1441896,-,532
557,NZ_OX366398,1,218427,218958,+,531
557,NC_002978,6,739965,740496,+,531
557,NZ_OX366389,1,1136977,1137509,-,532
557,NZ_OX366397,1,1344659,1345190,+,531
557,NZ_OX366378,1,569260,569803,-,543
557,NZ_CP090903,1,739965,740496,+,531
557,NZ_OX366374,1,48701,49203,-,502
557,NZ_CP090901,1,739965,740496,+,531
557,NZ_CP046923,1,718026,718557,+,531
557,NZ_CP069055,1,739294,739826,+,532
557,NZ_CP072670,1,739805,740336,+,531
557,NZ_CP090899,1,739965,740496,+,531
557,NZ_CP046924,1,738964,739495,+,531
557,NZ_OX366348,1,241627,242158,-,531
557,NZ_CP046921,1,801778,802309,+,531
557,NZ_OX366338,1,322475,323006,+,531
557,NZ_CP054557,1,1068361,1068893,-,532
557,NZ_CP072669,1,739813,740344,+,531
557,NC_021089,1,773396,773927,+,531
556,NZ_CP072672,1,716315,716962,+,647
556,NZ_CP069060,1,557769,558416,+,647
556,NZ_CP072667,1,716297,716944,+,647
556,NZ_CP072671,1,716297,716944,+,647
556,NZ_CP072668,1,716284,716931,+,647
556,NZ_CP072666,1,716297,716944,+,647
556,NZ_CP090902,1,716449,717096,+,647
556,NZ_CP090948,1,716449,717096,+,647
556,NZ_CP069052,1,1108758,1109405,+,647
556,NZ_CP076228,1,711225,711872,+,647
556,NZ_CP042445,1,716437,717084,+,647
556,NZ_CP042904,1,759838,760484,-,646
556,NC_012416,1,794711,795357,-,646
556,NZ_CP069053,1,557777,558424,+,647
556,NZ_CP042446,1,716449,717096,+,647
556,NZ_CP041215,1,964826,965472,-,646
556,NZ_OX366353,1,826735,827381,-,646
556,NZ_OX366387,1,971780,972427,+,647
556,NZ_OX366368,1,1159719,1160366,+,647
556,NZ_OX366379,1,1081104,1081751,+,647
556,NZ_CP091195,1,1538349,1538995,-,646
556,NZ_OX366375,1,1006576,1007223,+,647
556,NZ_CP046925,1,716297,716944,+,647
556,NZ_OX366318,1,1011494,1012141,+,647
556,NZ_OX366319,1,205662,206308,-,646
556,NZ_OX366332,1,1098844,1099491,+,647
556,NZ_CP110359,1,489558,490204,-,646
556,NZ_OU953855,1,256584,257230,-,646
556,NZ_OX366272,1,1337847,1338494,+,647
556,NZ_OX366347,1,746080,746726,-,646
556,NZ_OU909470,1,1404599,1405236,+,637
556,NZ_OX366363,1,1227749,1228395,-,646
556,NZ_OX366359,1,927940,928587,+,647
556,NZ_OX366380,1,530721,531357,-,636
556,NZ_CP090900,1,716449,717096,+,647
556,NZ_OX366352,1,1288095,1288741,-,646
556,NZ_OX366362,1,375598,376244,-,646
556,NZ_OX366400,1,873890,874537,+,647
556,NZ_OX366327,1,1013005,1013652,+,647
556,NZ_CP042444,1,716986,717633,+,647
556,NZ_OX366326,1,1218126,1218773,+,647
556,NZ_CP037426,1,753347,753994,+,647
556,NZ_OX366339,1,973775,974422,+,647
556,NZ_OX366355,1,229933,230579,-,646
556,NZ_CP046922,1,778163,778810,+,647
556,NZ_OX366385,1,413541,414177,-,636
556,NZ_OX366399,1,1115732,1116379,+,647
556,NZ_OX366395,1,1364541,1365187,-,646
556,NZ_OX366396,1,444469,445115,-,646
556,NZ_OX366351,1,1165375,1166022,+,647
556,NZ_OX366381,1,316523,317169,-,646
556,NZ_OX366369,1,1202424,1203071,+,647
556,NZ_OX366356,1,920049,920691,+,642
556,NZ_OX366377,1,1215526,1216172,-,646
556,NZ_OX366388,1,136264,136910,-,646
556,NZ_OX366357,1,598698,599344,-,646
556,NZ_CP072012,1,1465422,1466068,-,646
556,NZ_OX366398,1,699968,700614,-,646
556,NC_002978,6,716449,717096,+,647
556,NZ_OX366389,1,1160848,1161494,-,646
556,NZ_OX366397,1,1319957,1320604,+,647
556,NZ_OX366378,1,592669,593315,-,646
556,NZ_CP090903,1,716449,717096,+,647
556,NZ_OX366374,1,633022,633668,-,646
556,NZ_CP090901,1,716449,717096,+,647
556,NZ_CP046923,1,694411,695058,+,647
556,NZ_CP069055,1,715495,716142,+,647
556,NZ_CP072670,1,716289,716936,+,647
556,NZ_CP090899,1,716449,717096,+,647
556,NZ_CP046924,1,715349,715996,+,647
556,NZ_OX366348,1,266022,266668,-,646
556,NZ_CP046921,1,778163,778810,+,647
556,NZ_OX366338,1,985286,985948,+,662
556,NZ_CP054557,1,1093112,1093758,-,646
556,NZ_CP072669,1,716297,716944,+,647
556,NC_021089,1,749379,750026,+,647
555,NZ_CP072672,1,715250,716314,+,1064
555,NZ_CP069060,1,556704,557768,+,1064
555,NZ_CP072667,1,715232,716296,+,1064
555,NZ_CP072671,1,715232,716296,+,1064
555,NZ_CP072668,1,715219,716283,+,1064
555,NZ_CP072666,1,715232,716296,+,1064
555,NZ_CP090902,1,715384,716448,+,1064
555,NZ_CP090948,1,715384,716448,+,1064
555,NZ_CP069052,1,1107693,1108757,+,1064
555,NZ_CP076228,1,710181,711224,+,1043
555,NZ_CP042445,1,715372,716436,+,1064
555,NZ_CP042904,1,760486,761550,-,1064
555,NC_012416,1,795359,796423,-,1064
555,NZ_CP069053,1,556712,557776,+,1064
555,NZ_CP042446,1,715384,716448,+,1064
555,NZ_CP041215,1,965474,966538,-,1064
555,NZ_OX366353,1,827383,828447,-,1064
555,NZ_OX366387,1,970715,971779,+,1064
555,NZ_OX366368,1,1158654,1159718,+,1064
555,NZ_OX366379,1,1080039,1081103,+,1064
555,NZ_CP091195,1,1538997,1540061,-,1064
555,NZ_OX366375,1,1005511,1006575,+,1064
555,NZ_CP046925,1,715232,716296,+,1064
555,NZ_OX366318,1,1010429,1011493,+,1064
555,NZ_OX366319,1,206310,207374,-,1064
555,NZ_OX366332,1,1097779,1098843,+,1064
555,NZ_CP110359,1,490206,491270,-,1064
555,NZ_OU953855,1,257232,258296,-,1064
555,NZ_OX366272,1,1336782,1337846,+,1064
555,NZ_OX366347,1,746728,747791,-,1063
555,NZ_OU909470,1,1403534,1404598,+,1064
555,NZ_OX366363,1,1228397,1229461,-,1064
555,NZ_OX366359,1,926875,927939,+,1064
555,NZ_OX366380,1,531359,532423,-,1064
555,NZ_CP090900,1,715384,716448,+,1064
555,NZ_OX366352,1,1288743,1289807,-,1064
555,NZ_OX366362,1,376246,377310,-,1064
555,NZ_OX366400,1,872825,873889,+,1064
555,NZ_OX366327,1,1011940,1013004,+,1064
555,NZ_CP042444,1,715921,716985,+,1064
555,NZ_OX366326,1,1217061,1218125,+,1064
555,NZ_CP037426,1,752282,753346,+,1064
555,NZ_OX366339,1,972710,973774,+,1064
555,NZ_OX366355,1,230581,231645,-,1064
555,NZ_CP046922,1,777098,778162,+,1064
555,NZ_OX366385,1,414179,415243,-,1064
555,NZ_OX366399,1,1114667,1115731,+,1064
555,NZ_OX366395,1,1365189,1366253,-,1064
555,NZ_OX366396,1,445117,446181,-,1064
555,NZ_OX366351,1,1164310,1165374,+,1064
555,NZ_OX366381,1,317171,318235,-,1064
555,NZ_OX366369,1,1201359,1202423,+,1064
555,NZ_OX366356,1,918984,920048,+,1064
555,NZ_OX366377,1,1216174,1217238,-,1064
555,NZ_OX366388,1,136912,137976,-,1064
555,NZ_OX366357,1,599346,600410,-,1064
555,NZ_CP072012,1,1466070,1467134,-,1064
555,NZ_OX366398,1,700616,701680,-,1064
555,NC_002978,6,715384,716448,+,1064
555,NZ_OX366389,1,1161496,1162560,-,1064
555,NZ_OX366397,1,1318892,1319956,+,1064
555,NZ_OX366378,1,593317,594381,-,1064
555,NZ_CP090903,1,715384,716448,+,1064
555,NZ_OX366374,1,633670,634729,-,1059
555,NZ_CP090901,1,715384,716448,+,1064
555,NZ_CP046923,1,693346,694410,+,1064
555,NZ_CP069055,1,714430,715494,+,1064
555,NZ_CP072670,1,715224,716288,+,1064
555,NZ_CP090899,1,715384,716448,+,1064
555,NZ_CP046924,1,714284,715348,+,1064
555,NZ_OX366348,1,266670,267734,-,1064
555,NZ_CP046921,1,777098,778162,+,1064
555,NZ_OX366338,1,983383,984392,+,1009
555,NZ_CP054557,1,1093760,1094824,-,1064
555,NZ_CP072669,1,715232,716296,+,1064
555,NC_021089,1,748314,749378,+,1064
554,NZ_CP072672,1,714431,715025,+,594
554,NZ_CP069060,1,555885,556479,+,594
554,NZ_CP072667,1,714413,715007,+,594
554,NZ_CP072671,1,714413,715007,+,594
554,NZ_CP072668,1,714400,714994,+,594
554,NZ_CP072666,1,714413,715007,+,594
554,NZ_CP090902,1,714565,715159,+,594
554,NZ_CP090948,1,714565,715159,+,594
554,NZ_CP069052,1,1106874,1107468,+,594
554,NZ_CP076228,1,708423,709017,+,594
554,NZ_CP042445,1,714553,715147,+,594
554,NZ_CP042904,1,761775,762369,-,594
554,NC_012416,1,796648,797242,-,594
554,NZ_CP069053,1,555893,556487,+,594
554,NZ_CP042446,1,714565,715159,+,594
554,NZ_CP041215,1,966763,967357,-,594
554,NZ_OX366353,1,828672,829266,-,594
554,NZ_OX366387,1,969896,970490,+,594
554,NZ_OX366368,1,1157835,1158429,+,594
554,NZ_OX366379,1,1079220,1079814,+,594
554,NZ_CP091195,1,1540286,1540880,-,594
554,NZ_OX366375,1,1004692,1005286,+,594
554,NZ_CP046925,1,714413,715007,+,594
554,NZ_OX366318,1,1009610,1010204,+,594
554,NZ_OX366319,1,207599,208193,-,594
554,NZ_OX366332,1,1096960,1097554,+,594
554,NZ_CP110359,1,491495,492092,-,597
554,NZ_OU953855,1,258521,259118,-,597
554,NZ_OX366272,1,1335960,1336557,+,597
554,NZ_OX366347,1,748390,748949,-,559
554,NZ_OU909470,1,1402746,1403309,+,563
554,NZ_OX366363,1,1229686,1230280,-,594
554,NZ_OX366359,1,926056,926650,+,594
554,NZ_OX366380,1,532648,533211,-,563
554,NZ_CP090900,1,714565,715159,+,594
554,NZ_OX366352,1,1290032,1290626,-,594
554,NZ_OX366362,1,377535,378098,-,563
554,NZ_OX366400,1,872006,872600,+,594
554,NZ_OX366327,1,1011121,1011715,+,594
554,NZ_CP042444,1,715102,715696,+,594
554,NZ_OX366326,1,1216242,1216836,+,594
554,NZ_CP037426,1,751463,752057,+,594
554,NZ_OX366339,1,971891,972485,+,594
554,NZ_OX366355,1,231870,232464,-,594
554,NZ_CP046922,1,776279,776873,+,594
554,NZ_OX366385,1,415468,416031,-,563
554,NZ_OX366399,1,1113848,1114442,+,594
554,NZ_OX366395,1,1366482,1367072,-,590
554,NZ_OX366396,1,446406,447000,-,594
554,NZ_OX366351,1,1163491,1164085,+,594
554,NZ_OX366381,1,318460,319054,-,594
554,NZ_OX366369,1,1200540,1201134,+,594
554,NZ_OX366356,1,918165,918759,+,594
554,NZ_OX366377,1,1217463,1218057,-,594
554,NZ_OX366388,1,138201,138798,-,597
554,NZ_OX366357,1,600635,601229,-,594
554,NZ_CP072012,1,1467359,1467953,-,594
554,NZ_OX366398,1,701905,702499,-,594
554,NC_002978,6,714565,715159,+,594
554,NZ_OX366389,1,1162785,1163379,-,594
554,NZ_OX366397,1,1318073,1318667,+,594
554,NZ_OX366378,1,594606,595200,-,594
554,NZ_CP090903,1,714565,715159,+,594
554,NZ_OX366374,1,634959,635553,-,594
554,NZ_CP090901,1,714565,715159,+,594
554,NZ_CP046923,1,692527,693121,+,594
554,NZ_CP069055,1,713611,714205,+,594
554,NZ_CP072670,1,714405,714999,+,594
554,NZ_CP090899,1,714565,715159,+,594
554,NZ_CP046924,1,713465,714059,+,594
554,NZ_OX366348,1,267959,268553,-,594
554,NZ_CP046921,1,776279,776873,+,594
554,NZ_OX366338,1,982564,983154,+,590
554,NZ_CP054557,1,1095049,1095643,-,594
554,NZ_CP072669,1,714413,715007,+,594
554,NC_021089,1,747495,748089,+,594
553,NZ_CP072672,1,623355,624589,+,1234
553,NZ_CP069060,1,1043127,1044352,+,1225
553,NZ_CP069060,1,1125511,1126736,-,1225
553,NZ_CP072667,1,623337,624571,+,1234
553,NZ_CP072671,1,623337,624571,+,1234
553,NZ_CP072668,1,623324,624558,+,1234
553,NZ_CP072666,1,623337,624571,+,1234
553,NZ_CP090902,1,623489,624723,+,1234
553,NZ_CP090948,1,623489,624723,+,1234
553,NZ_CP069052,1,609893,611118,+,1225
553,NZ_CP076228,1,491000,492231,+,1231
553,NZ_CP042445,1,623477,624711,+,1234
553,NZ_CP042904,1,573994,575228,+,1234
553,NZ_CP042904,1,1041891,1043125,+,1234
553,NC_012416,1,577989,579223,+,1234
553,NC_012416,1,1084448,1085682,+,1234
553,NZ_CP069053,1,1044078,1045303,+,1225
553,NZ_CP069053,1,1246021,1247246,+,1225
553,NZ_CP042446,1,623489,624723,+,1234
553,NZ_OX366387,1,280338,281563,+,1225
553,NZ_OX366387,1,510197,511422,-,1225
553,NZ_OX366368,1,865029,866263,+,1234
553,NZ_OX366379,1,614473,615707,-,1234
553,NZ_CP046925,1,623337,624571,+,1234
553,NZ_CP110359,1,595258,596483,+,1225
553,NZ_CP110359,1,695440,696665,+,1225
553,NZ_OX366272,1,1015180,1016414,+,1234
553,NZ_OX366344,1,67383,68606,-,1223
553,NZ_CP090900,1,623489,624723,+,1234
553,NZ_CP042444,1,624026,625260,+,1234
553,NZ_CP037426,1,356244,357467,+,1223
553,NZ_OX366355,1,661171,662405,+,1234
553,NZ_CP046922,1,685203,686437,+,1234
553,NZ_OX366399,1,991446,992680,+,1234
553,NZ_OX366356,1,510968,512193,-,1225
553,NC_002978,6,623489,624723,+,1234
553,NZ_CP090903,1,623489,624723,+,1234
553,NZ_CP090901,1,623489,624723,+,1234
553,NZ_CP046923,1,601451,602685,+,1234
553,NZ_CP069055,1,300971,302196,-,1225
553,NZ_CP072670,1,623329,624563,+,1234
553,NZ_CP090899,1,623489,624723,+,1234
553,NZ_CP046924,1,622389,623623,+,1234
553,NZ_OX366348,1,597070,598304,+,1234
553,NZ_CP046921,1,685203,686437,+,1234
553,NZ_CP072669,1,623337,624571,+,1234
552,NZ_CP072672,1,621082,622048,+,966
552,NZ_CP069060,1,1134121,1135087,-,966
552,NZ_CP072667,1,621064,622030,+,966
552,NZ_CP072671,1,621064,622030,+,966
552,NZ_CP072668,1,621051,622017,+,966
552,NZ_CP072666,1,621064,622030,+,966
552,NZ_CP090902,1,621216,622182,+,966
552,NZ_CP090948,1,621216,622182,+,966
552,NZ_CP069052,1,602697,603663,+,966
552,NZ_CP076228,1,488729,489695,+,966
552,NZ_CP042445,1,621204,622170,+,966
552,NZ_CP042904,1,571721,572687,+,966
552,NZ_CP042904,1,1039618,1040584,+,966
552,NC_012416,1,575716,576682,+,966
552,NC_012416,1,1082175,1083141,+,966
552,NZ_CP069053,1,1238589,1239555,+,966
552,NZ_CP042446,1,621216,622182,+,966
552,NZ_OX366387,1,820391,821360,-,969
552,NZ_OX366368,1,997441,998407,+,966
552,NZ_OX366379,1,619856,620822,-,966
552,NZ_OX366379,1,995975,996941,+,966
552,NZ_CP091195,1,586276,587242,-,966
552,NZ_CP046925,1,621064,622030,+,966
552,NZ_OX366332,1,662911,663880,-,969
552,NZ_OX366363,1,1317620,1318589,-,969
552,NZ_CP090900,1,621216,622182,+,966
552,NZ_CP042444,1,621753,622719,+,966
552,NZ_CP037426,1,445808,446774,+,966
552,NZ_CP046922,1,682930,683896,+,966
552,NZ_OX366399,1,989173,990139,+,966
552,NZ_OX366396,1,259672,260636,+,964
552,NZ_OX366396,1,770511,771475,+,964
552,NZ_OX366396,1,908893,909857,-,964
552,NZ_OX366396,1,1026414,1027378,+,964
552,NZ_OX366369,1,970995,971964,+,969
552,NZ_CP072012,1,207298,208264,-,966
552,NC_002978,6,621216,622182,+,966
552,NZ_CP090903,1,621216,622182,+,966
552,NZ_CP090901,1,621216,622182,+,966
552,NZ_CP046923,1,599178,600144,+,966
552,NZ_CP072670,1,621056,622022,+,966
552,NZ_CP090899,1,621216,622182,+,966
552,NZ_CP046924,1,620116,621082,+,966
552,NZ_CP046921,1,682930,683896,+,966
552,NZ_CP072669,1,621064,622030,+,966
552,NC_021089,1,270869,271835,-,966
551,NZ_CP072672,1,614609,615240,+,631
551,NZ_CP069060,1,1140948,1141560,-,612
551,NZ_CP072667,1,614591,615222,+,631
551,NZ_CP072671,1,614591,615222,+,631
551,NZ_CP072668,1,614578,615209,+,631
551,NZ_CP072666,1,614591,615222,+,631
551,NZ_CP090902,1,614743,615374,+,631
551,NZ_CP090948,1,614743,615374,+,631
551,NZ_CP069052,1,596224,596836,+,612
551,NZ_CP076228,1,482376,483004,+,628
551,NZ_CP042445,1,614731,615362,+,631
551,NZ_CP042904,1,565562,566193,+,631
551,NZ_CP042904,1,1033145,1033776,+,631
551,NC_012416,1,569243,569874,+,631
551,NC_012416,1,1075702,1076333,+,631
551,NZ_CP069053,1,1232116,1232728,+,612
551,NZ_CP042446,1,614743,615374,+,631
551,NZ_OX366387,1,629493,630106,+,613
551,NZ_OX366368,1,990968,991599,+,631
551,NZ_OX366379,1,989502,990133,+,631
551,NZ_CP091195,1,593083,593693,-,610
551,NZ_CP046925,1,614591,615222,+,631
551,NZ_CP090900,1,614743,615374,+,631
551,NZ_CP042444,1,615280,615911,+,631
551,NZ_CP037426,1,439358,439971,+,613
551,NZ_CP046922,1,676457,677088,+,631
551,NZ_OX366399,1,982700,983331,+,631
551,NZ_OX366369,1,988895,989508,+,613
551,NZ_CP072012,1,75898,76529,-,631
551,NC_002978,6,614743,615374,+,631
551,NZ_CP090903,1,614743,615374,+,631
551,NZ_CP090901,1,614743,615374,+,631
551,NZ_CP046923,1,592705,593336,+,631
551,NZ_CP069055,1,247360,247991,-,631
551,NZ_CP072670,1,614583,615214,+,631
551,NZ_CP090899,1,614743,615374,+,631
551,NZ_CP046924,1,613643,614274,+,631
551,NZ_CP046921,1,676457,677088,+,631
551,NZ_OX366338,1,446222,446853,-,631
551,NZ_CP072669,1,614591,615222,+,631
551,NC_021089,1,277663,278294,-,631
550,NZ_CP072672,1,591804,592563,+,759
550,NZ_CP069060,1,1163606,1164366,-,760
550,NZ_CP072667,1,591786,592545,+,759
550,NZ_CP072671,1,591786,592545,+,759
550,NZ_CP072668,1,591773,592532,+,759
550,NZ_CP072666,1,591786,592545,+,759
550,NZ_CP090902,1,591938,592697,+,759
550,NZ_CP090948,1,591938,592697,+,759
550,NZ_CP069052,1,573418,574177,+,759
550,NZ_CP042445,1,591926,592685,+,759
550,NZ_CP042904,1,1075478,1076237,+,759
550,NC_012416,1,613066,613825,+,759
550,NC_012416,1,1119525,1120284,+,759
550,NZ_CP069053,1,1209310,1210069,+,759
550,NZ_CP042446,1,591938,592697,+,759
550,NZ_OX366368,1,968162,968921,+,759
550,NZ_OX366379,1,966696,967455,+,759
550,NZ_CP091195,1,616626,617386,-,760
550,NZ_CP046925,1,591786,592545,+,759
550,NZ_OX366318,1,207660,208419,+,759
550,NZ_OX366318,1,228281,229040,+,759
550,NZ_OX366318,1,922015,922775,-,760
550,NZ_OX366332,1,531366,532125,-,759
550,NZ_CP110359,1,663054,663813,+,759
550,NZ_OU909470,1,1166618,1167377,-,759
550,NZ_OX366359,1,678945,679703,+,758
550,NZ_CP090900,1,591938,592697,+,759
550,NZ_OX366327,1,343382,344141,-,759
550,NZ_OX366327,1,421325,422084,-,759
550,NZ_CP042444,1,592475,593234,+,759
550,NZ_OX366326,1,616195,616955,-,760
550,NZ_CP046922,1,653652,654411,+,759
550,NZ_OX366399,1,959894,960653,+,759
550,NZ_OX366351,1,988966,989726,-,760
550,NZ_CP072012,1,98527,99287,-,760
550,NC_002978,6,591938,592697,+,759
550,NZ_CP090903,1,591938,592697,+,759
550,NZ_CP090901,1,591938,592697,+,759
550,NZ_CP046923,1,569900,570659,+,759
550,NZ_CP069055,1,645703,646456,+,753
550,NZ_CP072670,1,591778,592537,+,759
550,NZ_CP090899,1,591938,592697,+,759
550,NZ_CP046924,1,590838,591597,+,759
550,NZ_CP046921,1,653652,654411,+,759
550,NZ_CP072669,1,591786,592545,+,759
550,NC_021089,1,250615,251374,-,759
549,NZ_CP072672,1,577534,578074,+,540
549,NZ_CP069060,1,1178992,1179532,-,540
549,NZ_CP072667,1,577516,578056,+,540
549,NZ_CP072671,1,577516,578056,+,540
549,NZ_CP072668,1,577503,578043,+,540
549,NZ_CP072666,1,577516,578056,+,540
549,NZ_CP090902,1,577668,578208,+,540
549,NZ_CP090948,1,577668,578208,+,540
549,NZ_CP069052,1,558251,558791,+,540
549,NZ_CP042445,1,577656,578196,+,540
549,NZ_CP042904,1,588532,589072,-,540
549,NZ_CP042904,1,1056733,1057273,-,540
549,NC_012416,1,593750,594290,-,540
549,NC_012416,1,1100209,1100749,-,540
549,NZ_CP069053,1,1118981,1119521,-,540
549,NZ_CP042446,1,577668,578208,+,540
549,NZ_OX366368,1,879847,880387,-,540
549,NZ_OX366379,1,600348,600888,+,540
549,NZ_OX366375,1,922699,923239,-,540
549,NZ_CP046925,1,577516,578056,+,540
549,NZ_CP090900,1,577668,578208,+,540
549,NZ_CP042444,1,578205,578745,+,540
549,NZ_CP037426,1,378385,378925,+,540
549,NZ_CP046922,1,639382,639922,+,540
549,NZ_OX366399,1,1006264,1006804,-,540
549,NZ_CP072012,1,821551,822080,-,529
549,NC_002978,6,577668,578208,+,540
549,NZ_CP090903,1,577668,578208,+,540
549,NZ_CP090901,1,577668,578208,+,540
549,NZ_CP046923,1,555630,556170,+,540
549,NZ_CP069055,1,286833,287373,+,540
549,NZ_CP072670,1,577508,578048,+,540
549,NZ_CP090899,1,577668,578208,+,540
549,NZ_CP046924,1,576568,577108,+,540
549,NZ_CP046921,1,639382,639922,+,540
549,NZ_CP072669,1,577516,578056,+,540
548,NZ_CP072672,1,537118,537965,+,847
548,NZ_CP069060,1,1273543,1274390,+,847
548,NZ_CP072667,1,537100,537947,+,847
548,NZ_CP072671,1,537100,537947,+,847
548,NZ_CP072668,1,537087,537934,+,847
548,NZ_CP072666,1,537100,537947,+,847
548,NZ_CP090902,1,537252,538099,+,847
548,NZ_CP090948,1,537252,538099,+,847
548,NZ_CP069052,1,516897,517744,+,847
548,NZ_CP076228,1,347689,348635,+,946
548,NZ_CP042445,1,537240,538087,+,847
548,NZ_CP069053,1,1159091,1159937,-,846
548,NZ_CP042446,1,537252,538099,+,847
548,NZ_OX366368,1,525753,526797,-,1044
548,NZ_OX366379,1,526798,527842,-,1044
548,NZ_CP046925,1,537100,537947,+,847
548,NZ_CP090900,1,537252,538099,+,847
548,NZ_OX366327,1,678897,679740,-,843
548,NZ_CP042444,1,537789,538636,+,847
548,NZ_CP046922,1,598768,599813,+,1045
548,NZ_OX366399,1,525290,526334,-,1044
548,NZ_OX366357,1,1130729,1131575,-,846
548,NZ_CP072012,1,448062,449106,-,1044
548,NC_002978,6,537252,538099,+,847
548,NZ_CP090903,1,537252,538099,+,847
548,NZ_CP090901,1,537252,538099,+,847
548,NZ_CP046923,1,515016,516061,+,1045
548,NZ_CP069055,1,554083,555128,+,1045
548,NZ_CP072670,1,537092,537939,+,847
548,NZ_CP090899,1,537252,538099,+,847
548,NZ_CP046924,1,535954,536999,+,1045
548,NZ_CP046921,1,598768,599813,+,1045
548,NZ_CP072669,1,537100,537947,+,847
547,NZ_CP072672,1,533249,533892,+,643
547,NZ_CP069060,1,1269675,1270318,+,643
547,NZ_CP072667,1,533231,533874,+,643
547,NZ_CP072671,1,533231,533874,+,643
547,NZ_CP072668,1,533218,533861,+,643
547,NZ_CP072666,1,533231,533874,+,643
547,NZ_CP090902,1,533383,534026,+,643
547,NZ_CP090948,1,533383,534026,+,643
547,NZ_CP069052,1,513029,513672,+,643
547,NZ_CP076228,1,343822,344465,+,643
547,NZ_CP042445,1,533371,534014,+,643
547,NZ_CP069053,1,1163163,1163806,-,643
547,NZ_CP042446,1,533383,534026,+,643
547,NZ_OX366368,1,530023,530666,-,643
547,NZ_OX366379,1,531068,531711,-,643
547,NZ_CP046925,1,533231,533874,+,643
547,NZ_OX366318,1,633455,634098,-,643
547,NZ_CP110359,1,989308,989950,+,642
547,NZ_OX366272,1,1064297,1064940,+,643
547,NZ_OX366347,1,645785,646428,-,643
547,NZ_OX366363,1,280771,281414,+,643
547,NZ_OX366349,1,781460,782103,+,643
547,NZ_CP090900,1,533383,534026,+,643
547,NZ_OX366400,1,616479,617122,+,643
547,NZ_OX366327,1,682966,683609,-,643
547,NZ_OX366367,1,128023,128666,-,643
547,NZ_CP042444,1,533920,534563,+,643
547,NZ_OX366326,1,727428,728071,-,643
547,NZ_OX366339,1,358287,358930,-,643
547,NZ_CP046922,1,594899,595542,+,643
547,NZ_OX366399,1,529560,530203,-,643
547,NZ_OX366396,1,1012126,1012769,-,643
547,NZ_OX366351,1,549261,549904,-,643
547,NZ_OX366356,1,746713,747353,+,640
547,NZ_OX366377,1,638817,639457,-,640
547,NZ_CP072012,1,452332,452975,-,643
547,NZ_OX366398,1,1190494,1191134,-,640
547,NC_002978,6,533383,534026,+,643
547,NZ_OX366389,1,708235,708875,-,640
547,NZ_CP090903,1,533383,534026,+,643
547,NZ_OX366374,1,870093,870736,+,643
547,NZ_CP090901,1,533383,534026,+,643
547,NZ_CP046923,1,511147,511790,+,643
547,NZ_CP069055,1,550215,550858,+,643
547,NZ_CP072670,1,533223,533866,+,643
547,NZ_CP090899,1,533383,534026,+,643
547,NZ_CP046924,1,532085,532728,+,643
547,NZ_CP046921,1,594899,595542,+,643
547,NZ_CP072669,1,533231,533874,+,643
546,NZ_CP072672,1,494638,497037,+,2399
546,NZ_CP069060,1,1219844,1222245,+,2401
546,NZ_CP072667,1,494620,497019,+,2399
546,NZ_CP072671,1,494620,497019,+,2399
546,NZ_CP072668,1,494607,497006,+,2399
546,NZ_CP072666,1,494620,497019,+,2399
546,NZ_CP090902,1,494772,497171,+,2399
546,NZ_CP090948,1,494772,497171,+,2399
546,NZ_CP069052,1,665844,668245,+,2401
546,NZ_CP042445,1,494772,497171,+,2399
546,NZ_CP069053,1,1100029,1102430,+,2401
546,NZ_CP042446,1,494772,497171,+,2399
546,NZ_CP046925,1,494620,497019,+,2399
546,NZ_OU953855,1,1198295,1200695,-,2400
546,NZ_CP090900,1,494772,497171,+,2399
546,NZ_CP042444,1,495273,497672,+,2399
546,NZ_CP046922,1,403547,405945,-,2398
546,NZ_CP046922,1,424485,426883,-,2398
546,NZ_CP046922,1,445423,447821,-,2398
546,NZ_CP046922,1,466361,468759,-,2398
546,NC_002978,6,494772,497171,+,2399
546,NZ_CP090903,1,494772,497171,+,2399
546,NZ_CP090901,1,494772,497171,+,2399
546,NZ_CP072670,1,494612,497011,+,2399
546,NZ_CP090899,1,494772,497171,+,2399
546,NZ_CP046924,1,403547,405945,-,2398
546,NZ_CP046921,1,403547,405945,-,2398
546,NZ_CP046921,1,424485,426883,-,2398
546,NZ_CP046921,1,445423,447821,-,2398
546,NZ_CP046921,1,466361,468759,-,2398
546,NZ_CP072669,1,494620,497019,+,2399
545,NZ_CP072672,1,470219,471217,+,998
545,NZ_CP069060,1,457848,458845,+,997
545,NZ_CP072667,1,470201,471199,+,998
545,NZ_CP072671,1,470201,471199,+,998
545,NZ_CP072668,1,470188,471186,+,998
545,NZ_CP072666,1,470201,471199,+,998
545,NZ_CP090902,1,470353,471351,+,998
545,NZ_CP090948,1,470353,471351,+,998
545,NZ_CP069052,1,412574,413571,-,997
545,NZ_CP076228,1,241409,242407,-,998
545,NZ_CP042445,1,470353,471351,+,998
545,NZ_CP069053,1,88424,89421,-,997
545,NZ_CP042446,1,470353,471351,+,998
545,NZ_CP041215,1,1233014,1234011,+,997
545,NZ_OX366353,1,1276256,1277253,+,997
545,NZ_OX366387,1,1112000,1112997,-,997
545,NZ_OX366368,1,762573,763571,-,998
545,NZ_OX366379,1,718778,719776,-,998
545,NZ_CP091195,1,449900,450889,+,989
545,NZ_OX366375,1,803336,804333,-,997
545,NZ_CP046925,1,470201,471199,+,998
545,NZ_OX366318,1,669722,670720,-,998
545,NZ_OX366319,1,621107,622104,+,997
545,NZ_OX366332,1,862307,863304,+,997
545,NZ_CP110359,1,704243,705241,-,998
545,NZ_OU953855,1,178915,179913,-,998
545,NZ_OX366272,1,519836,520603,+,767
545,NZ_OX366347,1,987789,988787,+,998
545,NZ_OX366363,1,241542,242540,+,998
545,NZ_OX366359,1,556684,557681,-,997
545,NZ_CP090900,1,470353,471351,+,998
545,NZ_OX366352,1,591420,592417,+,997
545,NZ_OX366400,1,581632,582630,+,998
545,NZ_OX366327,1,719764,720749,-,985
545,NZ_CP042444,1,470854,471852,+,998
545,NZ_OX366326,1,764546,765544,-,998
545,NZ_CP037426,1,307184,308181,+,997
545,NZ_OX366339,1,544163,545161,-,998
545,NZ_OX366355,1,687255,688252,+,997
545,NZ_CP046922,1,492181,493179,-,998
545,NZ_OX366399,1,688361,689359,-,998
545,NZ_OX366395,1,661903,662901,-,998
545,NZ_OX366396,1,1124213,1125211,+,998
545,NZ_OX366351,1,586378,587376,-,998
545,NZ_OX366381,1,895672,896669,+,997
545,NZ_OX366369,1,799867,800864,+,997
545,NZ_OX366356,1,712263,713260,+,997
545,NZ_OX366377,1,877333,878315,-,982
545,NZ_OX366388,1,691295,692293,+,998
545,NZ_OX366357,1,864641,865638,+,997
545,NZ_CP072012,1,568968,569966,+,998
545,NZ_OX366398,1,653005,654003,-,998
545,NC_002978,6,470353,471351,+,998
545,NZ_OX366389,1,748616,749614,-,998
545,NZ_OX366397,1,958247,959244,+,997
545,NZ_OX366378,1,1188751,1189740,+,989
545,NZ_CP090903,1,470353,471351,+,998
545,NZ_CP090901,1,470353,471351,+,998
545,NZ_CP046923,1,408429,409427,-,998
545,NZ_CP069055,1,508954,509952,+,998
545,NZ_CP072670,1,470193,471191,+,998
545,NZ_CP090899,1,470353,471351,+,998
545,NZ_CP046924,1,429367,430365,-,998
545,NZ_OX366348,1,454429,455427,-,998
545,NZ_CP046921,1,492181,493179,-,998
545,NZ_OX366338,1,646457,647455,-,998
545,NZ_CP054557,1,37966,38964,-,998
545,NZ_CP072669,1,470201,471199,+,998
545,NC_021089,1,350038,351035,-,997
544,NZ_CP072672,1,443748,444691,+,943
544,NZ_CP072667,1,443730,444673,+,943
544,NZ_CP072671,1,443730,444673,+,943
544,NZ_CP072668,1,443717,444660,+,943
544,NZ_CP072666,1,443730,444673,+,943
544,NZ_CP090902,1,443882,444825,+,943
544,NZ_CP090948,1,443882,444825,+,943
544,NZ_CP076228,1,268890,269968,-,1078
544,NZ_CP042445,1,443882,444825,+,943
544,NZ_CP042446,1,443882,444825,+,943
544,NZ_OX366368,1,789792,790871,-,1079
544,NZ_OX366379,1,745997,747075,-,1078
544,NZ_CP046925,1,443730,444673,+,943
544,NZ_CP090900,1,443882,444825,+,943
544,NZ_OX366327,1,750293,751243,-,950
544,NZ_CP042444,1,444383,445326,+,943
544,NZ_CP046922,1,518578,519650,-,1072
544,NZ_OX366399,1,715580,716659,-,1079
544,NC_002978,6,443882,444825,+,943
544,NZ_CP090903,1,443882,444825,+,943
544,NZ_CP090901,1,443882,444825,+,943
544,NZ_CP046923,1,434826,435898,-,1072
544,NZ_CP069055,1,480759,481709,+,950
544,NZ_CP072670,1,443722,444665,+,943
544,NZ_CP090899,1,443882,444825,+,943
544,NZ_CP046924,1,455764,456836,-,1072
544,NZ_OX366348,1,484274,485245,-,971
544,NZ_CP046921,1,518578,519650,-,1072
544,NZ_CP054557,1,198248,199327,+,1079
544,NZ_CP072669,1,443730,444673,+,943
543,NZ_CP072672,1,436655,437617,+,962
543,NZ_CP069060,1,425300,426265,+,965
543,NZ_CP072667,1,436637,437599,+,962
543,NZ_CP072671,1,436637,437599,+,962
543,NZ_CP072668,1,436624,437586,+,962
543,NZ_CP072666,1,436637,437599,+,962
543,NZ_CP090902,1,436789,437751,+,962
543,NZ_CP090948,1,436789,437751,+,962
543,NZ_CP069052,1,445154,446119,-,965
543,NZ_CP076228,1,275179,276144,-,965
543,NZ_CP042445,1,436789,437751,+,962
543,NZ_CP042904,1,281444,282409,+,965
543,NC_012416,1,284028,284993,+,965
543,NZ_CP069053,1,121012,121977,-,965
543,NZ_CP042446,1,436789,437751,+,962
543,NZ_CP041215,1,1196725,1197685,+,960
543,NZ_OX366353,1,412538,413498,+,960
543,NZ_OX366387,1,1038181,1039146,-,965
543,NZ_OX366368,1,796080,797045,-,965
543,NZ_OX366379,1,753571,754536,-,965
543,NZ_CP091195,1,215531,216496,+,965
543,NZ_OX366375,1,839511,840471,-,960
543,NZ_CP046925,1,436637,437599,+,962
543,NZ_OX366318,1,704148,705108,-,960
543,NZ_OX366319,1,494090,495055,-,965
543,NZ_OX366332,1,826691,827651,+,960
543,NZ_CP110359,1,740544,741509,-,965
543,NZ_OU953855,1,1545296,1546256,+,960
543,NZ_OX366272,1,481265,482230,+,965
543,NZ_OX366347,1,950425,951390,+,965
543,NZ_OU909470,1,1429254,1430219,-,965
543,NZ_OX366363,1,206776,207741,+,965
543,NZ_OX366359,1,591956,592916,-,960
543,NZ_CP090900,1,436789,437751,+,962
543,NZ_OX366352,1,555745,556705,+,960
543,NZ_OX366400,1,541402,542362,+,960
543,NZ_OX366327,1,757743,758708,-,965
543,NZ_CP042444,1,437290,438252,+,962
543,NZ_OX366326,1,798972,799932,-,960
543,NZ_CP037426,1,211660,212620,+,960
543,NZ_OX366339,1,391473,392427,+,954
543,NZ_OX366355,1,473345,474310,+,965
543,NZ_CP046922,1,525780,526743,-,963
543,NZ_OX366399,1,723155,724120,-,965
543,NZ_OX366395,1,858005,858974,+,969
543,NZ_OX366396,1,863259,864213,-,954
543,NZ_OX366351,1,623458,624418,-,960
543,NZ_OX366381,1,651692,652657,-,965
543,NZ_OX366369,1,766044,767009,+,965
543,NZ_OX366356,1,675495,676455,+,960
543,NZ_OX366377,1,916770,917735,-,965
543,NZ_OX366388,1,636705,637670,+,965
543,NZ_OX366357,1,641987,642952,-,965
543,NZ_CP072012,1,535792,536757,+,965
543,NZ_OX366398,1,199187,200152,+,965
543,NC_002978,6,436789,437751,+,962
543,NZ_OX366389,1,822113,823078,-,965
543,NZ_OX366397,1,844386,845346,+,960
543,NZ_OX366378,1,351136,352101,+,965
543,NZ_CP090903,1,436789,437751,+,962
543,NZ_OX366374,1,171886,172851,+,965
543,NZ_CP090901,1,436789,437751,+,962
543,NZ_CP046923,1,442028,442991,-,963
543,NZ_CP069055,1,474586,475551,+,965
543,NZ_CP072670,1,436629,437591,+,962
543,NZ_CP090899,1,436789,437751,+,962
543,NZ_CP046924,1,462966,463929,-,963
543,NZ_OX366348,1,491584,492544,-,960
543,NZ_CP046921,1,525780,526743,-,963
543,NZ_OX366338,1,823410,824357,+,947
543,NZ_CP054557,1,189882,190842,+,960
543,NZ_CP072669,1,436637,437599,+,962
543,NC_021089,1,385648,386608,-,960
542,NZ_CP072672,1,435405,436270,+,865
542,NZ_CP069060,1,424050,424915,+,865
542,NZ_CP072667,1,435387,436252,+,865
542,NZ_CP072671,1,435387,436252,+,865
542,NZ_CP072668,1,435374,436239,+,865
542,NZ_CP072666,1,435387,436252,+,865
542,NZ_CP090902,1,435539,436404,+,865
542,NZ_CP090948,1,435539,436404,+,865
542,NZ_CP069052,1,446503,447369,-,866
542,NZ_CP076228,1,276528,277394,-,866
542,NZ_CP042445,1,435539,436404,+,865
542,NZ_CP042904,1,280194,281062,+,868
542,NC_012416,1,282778,283646,+,868
542,NZ_CP069053,1,122361,123227,-,866
542,NZ_CP042446,1,435539,436404,+,865
542,NZ_CP041215,1,1195475,1196340,+,865
542,NZ_OX366353,1,411288,412153,+,865
542,NZ_OX366387,1,1039528,1040396,-,868
542,NZ_OX366368,1,797429,798295,-,866
542,NZ_OX366379,1,754920,755786,-,866
542,NZ_CP091195,1,214281,215149,+,868
542,NZ_OX366375,1,840853,841721,-,868
542,NZ_CP046925,1,435387,436252,+,865
542,NZ_OX366318,1,705492,706358,-,866
542,NZ_OX366319,1,495437,496305,-,868
542,NZ_OX366332,1,825441,826306,+,865
542,NZ_CP110359,1,741891,742759,-,868
542,NZ_OU953855,1,1544046,1544914,+,868
542,NZ_OX366272,1,480015,480883,+,868
542,NZ_OX366347,1,949175,950043,+,868
542,NZ_OU909470,1,1430601,1431469,-,868
542,NZ_OX366363,1,205526,206394,+,868
542,NZ_OX366359,1,593300,594166,-,866
542,NZ_CP090900,1,435539,436404,+,865
542,NZ_OX366352,1,554495,555360,+,865
542,NZ_OX366400,1,540152,541017,+,865
542,NZ_OX366327,1,759090,759958,-,868
542,NZ_CP042444,1,436040,436905,+,865
542,NZ_OX366326,1,800316,801182,-,866
542,NZ_CP037426,1,210410,211278,+,868
542,NZ_OX366339,1,390223,391091,+,868
542,NZ_OX366355,1,472095,472963,+,868
542,NZ_CP046922,1,527127,527993,-,866
542,NZ_OX366399,1,724504,725370,-,866
542,NZ_OX366395,1,856793,857623,+,830
542,NZ_OX366396,1,864595,865463,-,868
542,NZ_OX366351,1,624802,625668,-,866
542,NZ_OX366381,1,653039,653907,-,868
542,NZ_OX366369,1,764794,765662,+,868
542,NZ_OX366356,1,674245,675113,+,868
542,NZ_OX366377,1,918119,918985,-,866
542,NZ_OX366388,1,635455,636323,+,868
542,NZ_OX366357,1,643334,644202,-,868
542,NZ_CP072012,1,534542,535407,+,865
542,NZ_OX366398,1,197937,198802,+,865
542,NC_002978,6,435539,436404,+,865
542,NZ_OX366389,1,823462,824328,-,866
542,NZ_OX366397,1,843136,844001,+,865
542,NZ_OX366378,1,349886,350754,+,868
542,NZ_CP090903,1,435539,436404,+,865
542,NZ_OX366374,1,169808,170651,+,843
542,NZ_CP090901,1,435539,436404,+,865
542,NZ_CP046923,1,443375,444241,-,866
542,NZ_CP069055,1,473336,474201,+,865
542,NZ_CP072670,1,435379,436244,+,865
542,NZ_CP090899,1,435539,436404,+,865
542,NZ_CP046924,1,464313,465179,-,866
542,NZ_OX366348,1,492928,493794,-,866
542,NZ_CP046921,1,527127,527993,-,866
542,NZ_CP054557,1,188632,189497,+,865
542,NZ_CP072669,1,435387,436252,+,865
542,NC_021089,1,386992,387858,-,866
257,NZ_OX366376,1,756220,757828,+,1608
257,NZ_OX366393,1,172646,174254,-,1608
257,NZ_OX366372,1,802484,804092,-,1608
257,NZ_CP072672,1,514122,515722,+,1600
257,NZ_CP069060,1,1238396,1239996,+,1600
257,NZ_CP072667,1,514104,515704,+,1600
257,NZ_CP072671,1,514104,515704,+,1600
257,NZ_CP072668,1,514091,515691,+,1600
257,NZ_CP072666,1,514104,515704,+,1600
257,NZ_CP090902,1,514256,515856,+,1600
257,NZ_CP090948,1,514256,515856,+,1600
257,NZ_CP069052,1,384567,386167,-,1600
257,NZ_CP076228,1,469866,471466,+,1600
257,NZ_CP042445,1,514256,515856,+,1600
257,NZ_CP042904,1,365665,367265,+,1600
257,NC_012416,1,366755,368355,+,1600
257,NZ_CP069053,1,1193484,1195084,-,1600
257,NZ_CP042446,1,514256,515856,+,1600
257,NZ_CP041215,1,1138774,1140374,-,1600
257,NZ_OX366353,1,53974,55574,-,1600
257,NZ_OX366387,1,1067569,1069169,+,1600
257,NZ_OX366368,1,741760,743360,-,1600
257,NZ_OX366379,1,697965,699565,-,1600
257,NZ_CP091195,1,632958,634558,+,1600
257,NZ_OX366375,1,909507,911107,+,1600
257,NZ_CP046925,1,514104,515704,+,1600
257,NZ_OX366318,1,648884,650484,-,1600
257,NZ_OX366319,1,641251,642851,+,1600
257,NZ_OX366332,1,769456,771056,-,1600
257,NZ_CP110359,1,972399,973999,+,1600
257,NZ_OU953855,1,1425565,1427165,+,1600
257,NZ_OX366272,1,543178,544778,+,1600
257,NZ_OX366347,1,1007908,1009508,+,1600
257,NZ_OU909470,1,279339,280947,-,1608
257,NZ_OX366363,1,264865,266465,+,1600
257,NZ_OX366364,1,897214,898822,+,1608
257,NZ_OX366359,1,536215,537815,-,1600
257,NZ_OX366349,1,1141543,1143151,-,1608
257,NZ_OX366380,1,620355,621963,+,1608
257,NZ_OX366344,1,397961,399569,+,1608
257,NZ_CP090900,1,514256,515856,+,1600
257,NZ_OX366352,1,439088,440688,-,1600
257,NZ_OX366362,1,584217,585824,-,1607
257,NZ_OX366400,1,601868,603468,+,1600
257,NZ_OX366327,1,698960,700568,-,1608
257,NZ_OX366367,1,655363,656971,-,1608
257,NZ_CP042444,1,514757,516357,+,1600
257,NZ_OX366326,1,743708,745308,-,1600
257,NZ_CP037426,1,337667,339267,-,1600
257,NZ_OX366339,1,373939,375539,-,1600
257,NZ_OX366355,1,708377,709977,+,1600
257,NZ_CP046922,1,385781,387381,-,1600
257,NZ_OX366370,1,654125,655733,+,1608
257,NZ_OX366385,1,1302248,1303856,+,1608
257,NZ_OX366399,1,667548,669148,-,1600
257,NZ_OX366395,1,687606,689206,-,1600
257,NZ_OX366396,1,806799,808399,+,1600
257,NZ_OX366351,1,565541,567141,-,1600
257,NZ_OX366381,1,915816,917416,+,1600
257,NZ_OX366342,1,1024700,1026308,+,1608
257,NZ_OX366369,1,819936,821536,+,1600
257,NZ_OX366356,1,731983,733583,+,1600
257,NZ_OX366377,1,855659,857259,-,1600
257,NZ_OX366388,1,715198,716798,+,1600
257,NZ_OX366357,1,791752,793352,+,1600
257,NZ_CP072012,1,589179,590779,+,1600
257,NZ_OX366398,1,632174,633774,-,1600
257,NC_002978,6,514256,515856,+,1600
257,NZ_OX366389,1,726874,728474,-,1600
257,NZ_OX366397,1,787154,788754,-,1600
257,NZ_OX366378,1,288886,290486,+,1600
257,NZ_CP090903,1,514256,515856,+,1600
257,NZ_OX366374,1,852736,854344,+,1608
257,NZ_CP090901,1,514256,515856,+,1600
257,NZ_CP046923,1,385781,387381,-,1600
257,NZ_CP069055,1,531007,532607,+,1600
257,NZ_CP072670,1,514096,515696,+,1600
257,NZ_CP090899,1,514256,515856,+,1600
257,NZ_CP046924,1,385781,387381,-,1600
257,NZ_OX366348,1,431780,433380,-,1600
257,NZ_CP046921,1,385781,387381,-,1600
257,NZ_OX366338,1,945060,946620,-,1560
257,NZ_OX366338,1,1182722,1184276,-,1554
257,NZ_CP054557,1,6746,8346,-,1600
257,NZ_CP054557,1,1274213,1275812,-,1599
257,NZ_CP072669,1,514104,515704,+,1600
257,NC_021089,1,507513,509113,+,1600
256,NZ_OX366376,1,755561,756218,+,657
256,NZ_OX366393,1,174255,174913,-,658
256,NZ_OX366372,1,804093,804751,-,658
256,NZ_CP072672,1,513465,514120,+,655
256,NZ_CP069060,1,1237739,1238394,+,655
256,NZ_CP072667,1,513447,514102,+,655
256,NZ_CP072671,1,513447,514102,+,655
256,NZ_CP072668,1,513434,514089,+,655
256,NZ_CP072666,1,513447,514102,+,655
256,NZ_CP090902,1,513599,514254,+,655
256,NZ_CP090948,1,513599,514254,+,655
256,NZ_CP069052,1,386168,386824,-,656
256,NZ_CP076228,1,469209,469864,+,655
256,NZ_CP042445,1,513599,514254,+,655
256,NZ_CP042904,1,365008,365663,+,655
256,NC_012416,1,366098,366753,+,655
256,NZ_CP069053,1,1195085,1195741,-,656
256,NZ_CP042446,1,513599,514254,+,655
256,NZ_CP041215,1,1140375,1141031,-,656
256,NZ_OX366353,1,55575,56230,-,655
256,NZ_OX366387,1,1066902,1067567,+,665
256,NZ_OX366368,1,743361,744017,-,656
256,NZ_OX366379,1,699566,700222,-,656
256,NZ_CP091195,1,632301,632956,+,655
256,NZ_OX366375,1,908840,909505,+,665
256,NZ_CP046925,1,513447,514102,+,655
256,NZ_OX366318,1,650485,651141,-,656
256,NZ_OX366319,1,640593,641249,+,656
256,NZ_OX366332,1,771057,771713,-,656
256,NZ_CP110359,1,971732,972397,+,665
256,NZ_OU953855,1,1424898,1425563,+,665
256,NZ_OX366272,1,542511,543176,+,665
256,NZ_OX366347,1,1007241,1007906,+,665
256,NZ_OU909470,1,280948,281615,-,667
256,NZ_OX366363,1,264198,264863,+,665
256,NZ_OX366364,1,896545,897212,+,667
256,NZ_OX366359,1,537816,538472,-,656
256,NZ_OX366349,1,1143152,1143740,-,588
256,NZ_OX366380,1,619687,620353,+,666
256,NZ_OX366344,1,397294,397959,+,665
256,NZ_CP090900,1,513599,514254,+,655
256,NZ_OX366352,1,440689,441345,-,656
256,NZ_OX366362,1,585825,586492,-,667
256,NZ_OX366400,1,601211,601866,+,655
256,NZ_OX366327,1,700569,701225,-,656
256,NZ_OX366367,1,656972,657640,-,668
256,NZ_CP042444,1,514100,514755,+,655
256,NZ_OX366326,1,745309,745965,-,656
256,NZ_CP037426,1,339268,339934,-,666
256,NZ_OX366339,1,375540,376196,-,656
256,NZ_OX366355,1,707719,708375,+,656
256,NZ_CP046922,1,387382,388038,-,656
256,NZ_OX366370,1,653457,654123,+,666
256,NZ_OX366385,1,1301580,1302246,+,666
256,NZ_OX366399,1,669149,669805,-,656
256,NZ_OX366395,1,689207,689865,-,658
256,NZ_OX366396,1,806142,806797,+,655
256,NZ_OX366351,1,567142,567798,-,656
256,NZ_OX366381,1,915158,915814,+,656
256,NZ_OX366342,1,1024041,1024698,+,657
256,NZ_OX366369,1,819278,819934,+,656
256,NZ_OX366356,1,731326,731981,+,655
256,NZ_OX366377,1,857260,857926,-,666
256,NZ_OX366388,1,714541,715196,+,655
256,NZ_OX366357,1,791084,791750,+,666
256,NZ_CP072012,1,588525,589177,+,652
256,NZ_OX366398,1,633775,634441,-,666
256,NC_002978,6,513599,514254,+,655
256,NZ_OX366389,1,728475,729141,-,666
256,NZ_OX366397,1,788755,789411,-,656
256,NZ_OX366378,1,288229,288884,+,655
256,NZ_CP090903,1,513599,514254,+,655
256,NZ_OX366374,1,852068,852734,+,666
256,NZ_CP090901,1,513599,514254,+,655
256,NZ_CP046923,1,387382,388038,-,656
256,NZ_CP069055,1,530350,531005,+,655
256,NZ_CP072670,1,513439,514094,+,655
256,NZ_CP090899,1,513599,514254,+,655
256,NZ_CP046924,1,387382,388038,-,656
256,NZ_OX366348,1,433381,434037,-,656
256,NZ_CP046921,1,387382,388038,-,656
256,NZ_OX366338,1,946621,947288,-,667
256,NZ_CP054557,1,8347,9003,-,656
256,NZ_CP054557,1,1275813,1276467,-,654
256,NZ_CP072669,1,513447,514102,+,655
256,NC_021089,1,506856,507511,+,655
255,NZ_OX366376,1,754647,755559,+,912
255,NZ_OX366393,1,174914,175827,-,913
255,NZ_OX366372,1,804752,805665,-,913
255,NZ_CP072672,1,512551,513463,+,912
255,NZ_CP069060,1,1236825,1237737,+,912
255,NZ_CP072667,1,512533,513445,+,912
255,NZ_CP072671,1,512533,513445,+,912
255,NZ_CP072668,1,512520,513432,+,912
255,NZ_CP072666,1,512533,513445,+,912
255,NZ_CP090902,1,512685,513597,+,912
255,NZ_CP090948,1,512685,513597,+,912
255,NZ_CP069052,1,386825,387738,-,913
255,NZ_CP076228,1,468295,469207,+,912
255,NZ_CP042445,1,512685,513597,+,912
255,NZ_CP042904,1,364094,365006,+,912
255,NC_012416,1,365184,366096,+,912
255,NZ_CP069053,1,1195742,1196655,-,913
255,NZ_CP042446,1,512685,513597,+,912
255,NZ_CP041215,1,1141032,1141945,-,913
255,NZ_OX366353,1,56231,57144,-,913
255,NZ_OX366387,1,1065988,1066900,+,912
255,NZ_OX366368,1,744018,744931,-,913
255,NZ_OX366379,1,700223,701136,-,913
255,NZ_CP091195,1,631387,632299,+,912
255,NZ_OX366375,1,907926,908838,+,912
255,NZ_CP046925,1,512533,513445,+,912
255,NZ_OX366318,1,651142,652055,-,913
255,NZ_OX366319,1,639670,640591,+,921
255,NZ_OX366332,1,771714,772627,-,913
255,NZ_CP110359,1,970815,971730,+,915
255,NZ_OU953855,1,1423981,1424896,+,915
255,NZ_OX366272,1,541594,542509,+,915
255,NZ_OX366347,1,1006324,1007239,+,915
255,NZ_OU909470,1,281616,282574,-,958
255,NZ_OX366363,1,263281,264196,+,915
255,NZ_OX366364,1,895640,896543,+,903
255,NZ_OX366359,1,538473,539386,-,913
255,NZ_OX366349,1,458372,459300,-,928
255,NZ_OX366380,1,618728,619685,+,957
255,NZ_OX366344,1,396380,397292,+,912
255,NZ_CP090900,1,512685,513597,+,912
255,NZ_OX366352,1,441346,442259,-,913
255,NZ_OX366362,1,586493,587406,-,913
255,NZ_OX366400,1,600297,601209,+,912
255,NZ_OX366327,1,701226,702139,-,913
255,NZ_OX366367,1,657641,658545,-,904
255,NZ_CP042444,1,513186,514098,+,912
255,NZ_OX366326,1,745966,746879,-,913
255,NZ_CP037426,1,339935,340848,-,913
255,NZ_OX366339,1,376197,377110,-,913
255,NZ_OX366355,1,706796,707717,+,921
255,NZ_CP046922,1,388039,388952,-,913
255,NZ_OX366370,1,652525,653455,+,930
255,NZ_OX366385,1,1300621,1301578,+,957
255,NZ_OX366399,1,669806,670719,-,913
255,NZ_OX366395,1,689866,690779,-,913
255,NZ_OX366396,1,805228,806140,+,912
255,NZ_OX366351,1,567799,568712,-,913
255,NZ_OX366381,1,914235,915156,+,921
255,NZ_OX366342,1,1023127,1024039,+,912
255,NZ_OX366369,1,818355,819276,+,921
255,NZ_OX366356,1,730412,731324,+,912
255,NZ_OX366377,1,857927,858840,-,913
255,NZ_OX366388,1,713627,714539,+,912
255,NZ_OX366357,1,790167,791082,+,915
255,NZ_CP072012,1,587608,588523,+,915
255,NZ_OX366398,1,634442,635355,-,913
255,NC_002978,6,512685,513597,+,912
255,NZ_OX366389,1,729142,730055,-,913
255,NZ_OX366397,1,789412,790325,-,913
255,NZ_OX366378,1,287315,288227,+,912
255,NZ_CP090903,1,512685,513597,+,912
255,NZ_OX366374,1,851142,852066,+,924
255,NZ_CP090901,1,512685,513597,+,912
255,NZ_CP046923,1,388039,388952,-,913
255,NZ_CP069055,1,529436,530348,+,912
255,NZ_CP072670,1,512525,513437,+,912
255,NZ_CP090899,1,512685,513597,+,912
255,NZ_CP046924,1,388039,388952,-,913
255,NZ_OX366348,1,434038,434951,-,913
255,NZ_CP046921,1,388039,388952,-,913
255,NZ_OX366338,1,947289,948202,-,913
255,NZ_CP054557,1,9004,9917,-,913
255,NZ_CP054557,1,1276468,1277379,-,911
255,NZ_CP072669,1,512533,513445,+,912
255,NC_021089,1,505942,506854,+,912
254,NZ_OX366376,1,753343,754484,+,1141
254,NZ_OX366393,1,175990,177131,-,1141
254,NZ_OX366372,1,805828,806969,-,1141
254,NZ_CP072672,1,161368,162509,-,1141
254,NZ_CP069060,1,171607,172748,-,1141
254,NZ_CP072667,1,161350,162491,-,1141
254,NZ_CP072671,1,161350,162491,-,1141
254,NZ_CP072668,1,161350,162491,-,1141
254,NZ_CP072666,1,161350,162491,-,1141
254,NZ_CP090902,1,161502,162643,-,1141
254,NZ_CP090948,1,161502,162643,-,1141
254,NZ_CP069052,1,67378,68519,+,1141
254,NZ_CP076228,1,164615,165756,-,1141
254,NZ_CP042445,1,161502,162643,-,1141
254,NZ_CP042904,1,76042,77183,+,1141
254,NC_012416,1,78623,79764,+,1141
254,NZ_CP069053,1,374529,375670,+,1141
254,NZ_CP042446,1,161502,162643,-,1141
254,NZ_CP041215,1,414125,415266,+,1141
254,NZ_OX366353,1,97826,98967,+,1141
254,NZ_OX366387,1,1279694,1280835,+,1141
254,NZ_OX366368,1,440288,441429,-,1141
254,NZ_OX366379,1,441306,442447,-,1141
254,NZ_CP091195,1,746526,747667,-,1141
254,NZ_OX366375,1,405154,406295,-,1141
254,NZ_CP046925,1,161350,162491,-,1141
254,NZ_OX366318,1,459257,460398,+,1141
254,NZ_OX366319,1,802731,803872,-,1141
254,NZ_OX366332,1,383117,384258,-,1141
254,NZ_CP110359,1,1159189,1160330,-,1141
254,NZ_OU953855,1,732571,733715,+,1144
254,NZ_OX366272,1,791675,792816,+,1141
254,NZ_OX366347,1,467404,468545,+,1141
254,NZ_OU909470,1,311627,312777,+,1150
254,NZ_OX366363,1,568919,570063,-,1144
254,NZ_OX366364,1,894229,895358,+,1129
254,NZ_OX366359,1,396628,397769,+,1141
254,NZ_OX366349,1,460142,461283,-,1141
254,NZ_OX366380,1,583196,584346,-,1150
254,NZ_OX366344,1,395088,396217,+,1129
254,NZ_CP090900,1,161502,162643,-,1141
254,NZ_OX366352,1,359159,360300,-,1141
254,NZ_OX366362,1,587465,588596,-,1131
254,NZ_OX366400,1,328999,330140,+,1141
254,NZ_OX366327,1,506375,507516,+,1141
254,NZ_OX366367,1,658958,660087,-,1129
254,NZ_CP042444,1,161440,162581,-,1141
254,NZ_OX366326,1,434836,435977,-,1141
254,NZ_CP037426,1,520602,521743,-,1141
254,NZ_OX366339,1,162458,163599,+,1141
254,NZ_OX366355,1,948987,950128,-,1141
254,NZ_CP046922,1,161200,162341,-,1141
254,NZ_OX366370,1,650971,652112,+,1141
254,NZ_OX366385,1,322358,323508,+,1150
254,NZ_OX366399,1,439790,440931,-,1141
254,NZ_OX366395,1,584390,585531,-,1141
254,NZ_OX366396,1,1001929,1003070,-,1141
254,NZ_OX366351,1,373114,374255,+,1141
254,NZ_OX366381,1,80541,81682,-,1141
254,NZ_OX366342,1,1021823,1022964,+,1141
254,NZ_OX366369,1,357142,358283,+,1141
254,NZ_OX366356,1,409324,410465,-,1141
254,NZ_OX366377,1,812203,813344,-,1141
254,NZ_OX366388,1,1286371,1287512,+,1141
254,NZ_OX366357,1,909034,910156,+,1122
254,NZ_CP072012,1,362692,363833,-,1141
254,NZ_OX366398,1,1099062,1100203,-,1141
254,NC_002978,6,161502,162643,-,1141
254,NZ_OX366389,1,609221,610362,-,1141
254,NZ_OX366397,1,385752,386893,-,1141
254,NZ_OX366378,1,1072822,1073963,-,1141
254,NZ_CP090903,1,161502,162643,-,1141
254,NZ_OX366374,1,1073507,1074648,+,1141
254,NZ_CP090901,1,161502,162643,-,1141
254,NZ_CP046923,1,161200,162341,-,1141
254,NZ_CP069055,1,63514,64655,+,1141
254,NZ_CP072670,1,161350,162491,-,1141
254,NZ_CP090899,1,161502,162643,-,1141
254,NZ_CP046924,1,161200,162341,-,1141
254,NZ_OX366348,1,895341,896482,-,1141
254,NZ_CP046921,1,161200,162341,-,1141
254,NZ_OX366338,1,138564,139708,-,1144
254,NZ_CP054557,1,482225,483366,+,1141
254,NZ_CP072669,1,161350,162491,-,1141
254,NC_021089,1,101606,102747,-,1141
253,NZ_OX366376,1,751832,752705,+,873
253,NZ_OX366393,1,177747,178620,-,873
253,NZ_OX366372,1,807585,808458,-,873
253,NZ_CP072672,1,163749,164625,-,876
253,NZ_CP069060,1,174093,174969,-,876
253,NZ_CP072667,1,163731,164607,-,876
253,NZ_CP072671,1,163731,164607,-,876
253,NZ_CP072668,1,163731,164607,-,876
253,NZ_CP072666,1,163731,164607,-,876
253,NZ_CP090902,1,163883,164759,-,876
253,NZ_CP090948,1,163883,164759,-,876
253,NZ_CP069052,1,65157,66033,+,876
253,NZ_CP076228,1,167101,167977,-,876
253,NZ_CP042445,1,163883,164759,-,876
253,NZ_CP042904,1,74385,75261,+,876
253,NC_012416,1,76966,77842,+,876
253,NZ_CP069053,1,372308,373184,+,876
253,NZ_CP042446,1,163883,164759,-,876
253,NZ_CP041215,1,410127,411003,+,876
253,NZ_OX366353,1,95544,96420,+,876
253,NZ_OX366387,1,1278227,1279100,+,873
253,NZ_OX366368,1,442774,443650,-,876
253,NZ_OX366379,1,443792,444668,-,876
253,NZ_CP091195,1,748451,749324,-,873
253,NZ_OX366375,1,408744,409620,-,876
253,NZ_CP046925,1,163731,164607,-,876
253,NZ_OX366318,1,455656,456532,+,876
253,NZ_OX366319,1,838792,839668,-,876
253,NZ_OX366332,1,385640,386516,-,876
253,NZ_CP110359,1,1161114,1161987,-,873
253,NZ_OU953855,1,1775916,1776779,+,863
253,NZ_OX366272,1,790018,790891,+,873
253,NZ_OX366347,1,465747,466623,+,876
253,NZ_OU909470,1,310250,311123,+,873
253,NZ_OX366363,1,571454,572327,-,873
253,NZ_OX366364,1,892902,893778,+,876
253,NZ_OX366359,1,394376,395252,+,876
253,NZ_OX366349,1,462591,463464,-,873
253,NZ_OX366380,1,584921,585794,-,873
253,NZ_OX366344,1,393579,394452,+,873
253,NZ_CP090900,1,163883,164759,-,876
253,NZ_OX366352,1,993014,993890,-,876
253,NZ_OX366362,1,165828,166701,+,873
253,NZ_OX366400,1,648605,649481,+,876
253,NZ_OX366327,1,504718,505594,+,876
253,NZ_OX366367,1,661634,662510,-,876
253,NZ_CP042444,1,163821,164697,-,876
253,NZ_OX366326,1,437513,438389,-,876
253,NZ_CP037426,1,524192,525068,-,876
253,NZ_OX366339,1,160811,161677,+,866
253,NZ_OX366355,1,975930,976806,+,876
253,NZ_CP046922,1,163581,164457,-,876
253,NZ_OX366370,1,649574,650447,+,873
253,NZ_OX366385,1,1245260,1246133,-,873
253,NZ_OX366399,1,442276,443152,-,876
253,NZ_OX366395,1,586843,587709,-,866
253,NZ_OX366396,1,595398,596264,-,866
253,NZ_OX366351,1,370702,371578,+,876
253,NZ_OX366381,1,104586,105462,+,876
253,NZ_OX366342,1,1020357,1021230,+,873
253,NZ_OX366369,1,354738,355614,+,876
253,NZ_OX366356,1,410989,411862,-,873
253,NZ_OX366377,1,814872,815748,-,876
253,NZ_OX366388,1,1284714,1285587,+,873
253,NZ_OX366357,1,907709,908575,+,866
253,NZ_CP072012,1,365178,366054,-,876
253,NZ_OX366398,1,1101731,1102607,-,876
253,NC_002978,6,163883,164759,-,876
253,NZ_OX366389,1,612817,613693,-,876
253,NZ_OX366397,1,388275,389151,-,876
253,NZ_OX366378,1,1074747,1075620,-,873
253,NZ_CP090903,1,163883,164759,-,876
253,NZ_OX366374,1,1070962,1071828,+,866
253,NZ_CP090901,1,163883,164759,-,876
253,NZ_CP046923,1,163581,164457,-,876
253,NZ_CP069055,1,61293,62169,+,876
253,NZ_CP072670,1,163731,164607,-,876
253,NZ_CP090899,1,163883,164759,-,876
253,NZ_CP046924,1,163581,164457,-,876
253,NZ_OX366348,1,898026,898902,-,876
253,NZ_CP046921,1,163581,164457,-,876
253,NZ_OX366338,1,140062,140935,-,873
253,NZ_CP054557,1,479805,480681,+,876
253,NZ_CP072669,1,163731,164607,-,876
253,NC_021089,1,105312,106188,-,876
252,NZ_OX366376,1,747358,751113,+,3755
252,NZ_OX366393,1,179357,183112,-,3755
252,NZ_OX366372,1,809199,812954,-,3755
252,NZ_CP072672,1,210967,214770,-,3803
252,NZ_CP069060,1,221581,225377,+,3796
252,NZ_CP072667,1,210949,214752,-,3803
252,NZ_CP072671,1,210949,214752,-,3803
252,NZ_CP072668,1,210949,214752,-,3803
252,NZ_CP072666,1,210949,214752,-,3803
252,NZ_CP090902,1,211101,214904,-,3803
252,NZ_CP090948,1,211101,214904,-,3803
252,NZ_CP069052,1,216246,220042,+,3796
252,NZ_CP076228,1,213422,217219,-,3797
252,NZ_CP042445,1,211101,214904,-,3803
252,NZ_CP042904,1,217369,221158,-,3789
252,NC_012416,1,219951,223740,-,3789
252,NZ_CP069053,1,321899,325696,-,3797
252,NZ_CP042446,1,211101,214904,-,3803
252,NZ_CP041215,1,656304,660092,+,3788
252,NZ_OX366353,1,482345,486134,-,3789
252,NZ_OX366387,1,909295,913091,+,3796
252,NZ_OX366368,1,489185,492982,-,3797
252,NZ_OX366379,1,490203,494000,-,3797
252,NZ_CP091195,1,510456,514253,-,3797
252,NZ_OX366375,1,588594,592391,-,3797
252,NZ_CP046925,1,210949,214752,-,3803
252,NZ_OX366318,1,590110,593907,-,3797
252,NZ_OX366319,1,820762,824559,-,3797
252,NZ_OX366332,1,488174,491963,-,3789
252,NZ_CP110359,1,1028538,1032334,+,3796
252,NZ_OU953855,1,291286,295082,+,3796
252,NZ_OX366272,1,731528,735325,-,3797
252,NZ_OX366347,1,602633,606422,-,3789
252,NZ_OU909470,1,300399,304166,-,3767
252,NZ_OX366363,1,426771,430567,+,3796
252,NZ_OX366364,1,888126,891922,+,3796
252,NZ_OX366359,1,486093,489881,+,3788
252,NZ_OX366349,1,464528,468283,-,3755
252,NZ_OX366380,1,594476,598241,+,3765
252,NZ_OX366344,1,318990,322745,+,3755
252,NZ_CP090900,1,211101,214904,-,3803
252,NZ_OX366352,1,633695,637483,+,3788
252,NZ_OX366362,1,160985,164791,+,3806
252,NZ_OX366400,1,666892,670688,+,3796
252,NZ_OX366327,1,640809,644598,-,3789
252,NZ_OX366367,1,664446,668196,-,3750
252,NZ_CP042444,1,211039,214842,-,3803
252,NZ_OX366326,1,683805,687602,-,3797
252,NZ_CP037426,1,468227,472023,+,3796
252,NZ_OX366339,1,466653,470442,-,3789
252,NZ_OX366355,1,811816,815612,+,3796
252,NZ_CP046922,1,210799,214602,-,3803
252,NZ_OX366370,1,818217,821990,-,3773
252,NZ_OX366385,1,215274,219039,-,3765
252,NZ_OX366399,1,488695,492492,-,3797
252,NZ_OX366395,1,1003602,1007408,-,3806
252,NZ_OX366396,1,1473935,1477724,-,3789
252,NZ_OX366351,1,506732,510529,-,3797
252,NZ_OX366381,1,973285,977081,+,3796
252,NZ_OX366342,1,1015883,1019638,+,3755
252,NZ_OX366369,1,491269,495066,-,3797
252,NZ_OX366356,1,785302,789090,+,3788
252,NZ_OX366377,1,595541,599338,-,3797
252,NZ_OX366388,1,787662,791458,+,3796
252,NZ_OX366357,1,1261776,1265582,-,3806
252,NZ_CP072012,1,411474,415271,-,3797
252,NZ_OX366398,1,1149787,1153584,-,3797
252,NC_002978,6,211101,214904,-,3803
252,NZ_OX366389,1,665262,669058,+,3796
252,NZ_OX366397,1,699482,703271,-,3789
252,NZ_OX366378,1,779475,783272,-,3797
252,NZ_CP090903,1,211101,214904,-,3803
252,NZ_OX366374,1,757162,760968,-,3806
252,NZ_CP090901,1,211101,214904,-,3803
252,NZ_CP046923,1,210799,214602,-,3803
252,NZ_CP069055,1,208456,212252,+,3796
252,NZ_CP072670,1,210949,214752,-,3803
252,NZ_CP090899,1,211101,214904,-,3803
252,NZ_CP046924,1,210799,214602,-,3803
252,NZ_OX366348,1,760831,764627,+,3796
252,NZ_CP046921,1,210799,214602,-,3803
252,NZ_OX366338,1,491592,495389,-,3797
252,NZ_CP054557,1,1214192,1217989,-,3797
252,NZ_CP072669,1,210949,214752,-,3803
252,NC_021089,1,207262,211050,+,3788
251,NZ_OX366376,1,744979,746439,+,1460
251,NZ_OX366393,1,184031,185491,-,1460
251,NZ_OX366372,1,813873,815333,-,1460
251,NZ_CP072672,1,214880,216363,-,1483
251,NZ_CP069060,1,219988,221471,+,1483
251,NZ_CP072667,1,214862,216345,-,1483
251,NZ_CP072671,1,214862,216345,-,1483
251,NZ_CP072668,1,214862,216345,-,1483
251,NZ_CP072666,1,214862,216345,-,1483
251,NZ_CP090902,1,215014,216497,-,1483
251,NZ_CP090948,1,215014,216497,-,1483
251,NZ_CP069052,1,214653,216136,+,1483
251,NZ_CP076228,1,217329,218812,-,1483
251,NZ_CP042445,1,215014,216497,-,1483
251,NZ_CP042904,1,221268,222720,-,1452
251,NC_012416,1,223850,225302,-,1452
251,NZ_CP069053,1,325806,327289,-,1483
251,NZ_CP042446,1,215014,216497,-,1483
251,NZ_CP041215,1,654742,656194,+,1452
251,NZ_OX366353,1,486244,487696,-,1452
251,NZ_OX366387,1,907733,909185,+,1452
251,NZ_OX366368,1,493092,494575,-,1483
251,NZ_OX366379,1,494110,495593,-,1483
251,NZ_CP091195,1,514363,515846,-,1483
251,NZ_OX366375,1,593420,594903,-,1483
251,NZ_CP046925,1,214862,216345,-,1483
251,NZ_OX366318,1,594017,595500,-,1483
251,NZ_OX366319,1,824669,826152,-,1483
251,NZ_OX366332,1,492073,493525,-,1452
251,NZ_CP110359,1,1026945,1028428,+,1483
251,NZ_OU953855,1,289693,291176,+,1483
251,NZ_OX366272,1,735435,736918,-,1483
251,NZ_OX366347,1,606532,608015,-,1483
251,NZ_OU909470,1,304276,305727,-,1451
251,NZ_OX366363,1,425178,426661,+,1483
251,NZ_OX366364,1,886292,887713,+,1421
251,NZ_OX366359,1,484531,485983,+,1452
251,NZ_OX366349,1,469195,470655,-,1460
251,NZ_OX366380,1,592928,594366,+,1438
251,NZ_OX366344,1,316611,318071,+,1460
251,NZ_CP090900,1,215014,216497,-,1483
251,NZ_OX366352,1,632133,633585,+,1452
251,NZ_OX366362,1,858986,860409,-,1423
251,NZ_OX366400,1,665299,666782,+,1483
251,NZ_OX366327,1,644708,646160,-,1452
251,NZ_OX366367,1,668609,670050,-,1441
251,NZ_CP042444,1,214952,216435,-,1483
251,NZ_OX366326,1,687712,689195,-,1483
251,NZ_CP037426,1,465715,467198,+,1483
251,NZ_OX366339,1,470552,472035,-,1483
251,NZ_OX366355,1,810223,811706,+,1483
251,NZ_CP046922,1,214712,216195,-,1483
251,NZ_OX366370,1,822585,824037,-,1452
251,NZ_OX366385,1,219149,220587,-,1438
251,NZ_OX366399,1,492602,494085,-,1483
251,NZ_OX366395,1,1007518,1009001,-,1483
251,NZ_OX366396,1,1477834,1479317,-,1483
251,NZ_OX366351,1,510639,512122,-,1483
251,NZ_OX366381,1,971692,973175,+,1483
251,NZ_OX366342,1,1013504,1014964,+,1460
251,NZ_OX366369,1,495176,496659,-,1483
251,NZ_OX366356,1,783709,785192,+,1483
251,NZ_OX366377,1,599448,600931,-,1483
251,NZ_OX366388,1,766527,768010,-,1483
251,NZ_OX366357,1,1265692,1267175,-,1483
251,NZ_CP072012,1,415381,416864,-,1483
251,NZ_OX366398,1,1153694,1155177,-,1483
251,NC_002978,6,215014,216497,-,1483
251,NZ_OX366389,1,663669,665152,+,1483
251,NZ_OX366397,1,703381,704833,-,1452
251,NZ_OX366378,1,783382,784865,-,1483
251,NZ_CP090903,1,215014,216497,-,1483
251,NZ_OX366374,1,761078,762561,-,1483
251,NZ_CP090901,1,215014,216497,-,1483
251,NZ_CP046923,1,214712,216195,-,1483
251,NZ_CP069055,1,206863,208346,+,1483
251,NZ_CP072670,1,214862,216345,-,1483
251,NZ_CP090899,1,215014,216497,-,1483
251,NZ_CP046924,1,214712,216195,-,1483
251,NZ_OX366348,1,759238,760721,+,1483
251,NZ_CP046921,1,214712,216195,-,1483
251,NZ_OX366338,1,495499,496982,-,1483
251,NZ_CP054557,1,1218099,1219534,-,1435
251,NZ_CP072669,1,214862,216345,-,1483
251,NC_021089,1,205700,207152,+,1452
250,NZ_OX366376,1,741623,743574,+,1951
250,NZ_OX366393,1,186896,188847,-,1951
250,NZ_OX366372,1,816738,818689,-,1951
250,NZ_CP072672,1,217732,219857,-,2125
250,NZ_CP069060,1,216494,218619,+,2125
250,NZ_CP072667,1,217714,219839,-,2125
250,NZ_CP072671,1,217714,219839,-,2125
250,NZ_CP072668,1,217714,219839,-,2125
250,NZ_CP072666,1,217714,219839,-,2125
250,NZ_CP090902,1,217866,219991,-,2125
250,NZ_CP090948,1,217866,219991,-,2125
250,NZ_CP069052,1,211159,213284,+,2125
250,NZ_CP076228,1,221097,223222,-,2125
250,NZ_CP042445,1,217866,219991,-,2125
250,NZ_CP042904,1,224256,226347,-,2091
250,NC_012416,1,226838,228929,-,2091
250,NZ_CP069053,1,328658,330783,-,2125
250,NZ_CP042446,1,217866,219991,-,2125
250,NZ_CP041215,1,651255,653205,+,1950
250,NZ_OX366353,1,489233,491183,-,1950
250,NZ_OX366387,1,904223,906347,+,2124
250,NZ_OX366368,1,495944,498069,-,2125
250,NZ_OX366379,1,496962,499087,-,2125
250,NZ_CP091195,1,517215,519174,-,1959
250,NZ_OX366375,1,596272,598392,-,2120
250,NZ_CP046925,1,217714,219839,-,2125
250,NZ_OX366318,1,596869,598994,-,2125
250,NZ_OX366319,1,827521,829472,-,1951
250,NZ_OX366332,1,495063,497013,-,1950
250,NZ_CP110359,1,1023451,1025576,+,2125
250,NZ_OU953855,1,283195,285320,+,2125
250,NZ_OX366272,1,739239,741343,-,2104
250,NZ_OX366347,1,609384,611509,-,2125
250,NZ_OU909470,1,307122,309160,-,2038
250,NZ_OX366363,1,421666,423809,+,2143
250,NZ_OX366364,1,882908,884828,+,1920
250,NZ_OX366359,1,481044,482994,+,1950
250,NZ_OX366349,1,472060,474011,-,1951
250,NZ_OX366380,1,588541,590666,+,2125
250,NZ_OX366344,1,313255,315206,+,1951
250,NZ_CP090900,1,217866,219991,-,2125
250,NZ_OX366352,1,628646,630596,+,1950
250,NZ_OX366362,1,861942,864045,-,2103
250,NZ_OX366400,1,661763,663930,+,2167
250,NZ_OX366327,1,647696,649853,-,2157
250,NZ_OX366367,1,671597,673640,-,2043
250,NZ_CP042444,1,217804,219929,-,2125
250,NZ_OX366326,1,690564,692773,-,2209
250,NZ_CP037426,1,462226,464346,+,2120
250,NZ_OX366339,1,473392,475517,-,2125
250,NZ_OX366355,1,805586,807537,+,1951
250,NZ_CP046922,1,217564,219689,-,2125
250,NZ_OX366370,1,825451,827393,-,1942
250,NZ_OX366385,1,1251726,1253851,+,2125
250,NZ_OX366399,1,495454,497579,-,2125
250,NZ_OX366395,1,1010532,1012614,-,2082
250,NZ_OX366396,1,1480686,1482790,-,2104
250,NZ_OX366351,1,513491,515658,-,2167
250,NZ_OX366381,1,968372,970323,+,1951
250,NZ_OX366342,1,1010148,1012099,+,1951
250,NZ_OX366369,1,498028,499979,-,1951
250,NZ_OX366356,1,780258,782339,+,2081
250,NZ_OX366377,1,602300,604425,-,2125
250,NZ_OX366388,1,769379,771338,-,1959
250,NZ_OX366357,1,447880,449963,-,2083
250,NZ_CP072012,1,418233,420358,-,2125
250,NZ_OX366398,1,1156546,1158671,-,2125
250,NC_002978,6,217866,219991,-,2125
250,NZ_OX366389,1,660175,662300,+,2125
250,NZ_OX366397,1,706370,708320,-,1950
250,NZ_OX366378,1,786234,788193,-,1959
250,NZ_CP090903,1,217866,219991,-,2125
250,NZ_OX366374,1,767479,769581,-,2102
250,NZ_CP090901,1,217866,219991,-,2125
250,NZ_CP046923,1,217564,219689,-,2125
250,NZ_CP069055,1,203369,205494,+,2125
250,NZ_CP072670,1,217714,219839,-,2125
250,NZ_CP090899,1,217866,219991,-,2125
250,NZ_CP046924,1,217564,219689,-,2125
250,NZ_OX366348,1,755737,757862,+,2125
250,NZ_CP046921,1,217564,219689,-,2125
250,NZ_OX366338,1,498351,500476,-,2125
250,NZ_CP054557,1,1221909,1224034,-,2125
250,NZ_CP072669,1,217714,219839,-,2125
250,NC_021089,1,202213,204163,+,1950
249,NZ_OX366376,1,739467,740624,+,1157
249,NZ_OX366393,1,190699,191856,-,1157
249,NZ_OX366372,1,819866,821023,-,1157
249,NZ_CP072672,1,222416,223566,-,1150
249,NZ_CP069060,1,212785,213935,+,1150
249,NZ_CP072667,1,222398,223548,-,1150
249,NZ_CP072671,1,222398,223548,-,1150
249,NZ_CP072668,1,222398,223548,-,1150
249,NZ_CP072666,1,222398,223548,-,1150
249,NZ_CP090902,1,222550,223700,-,1150
249,NZ_CP090948,1,222550,223700,-,1150
249,NZ_CP069052,1,207450,208600,+,1150
249,NZ_CP076228,1,524416,525566,+,1150
249,NZ_CP042445,1,222550,223700,-,1150
249,NZ_CP042904,1,228648,229774,-,1126
249,NC_012416,1,231230,232356,-,1126
249,NZ_CP069053,1,333342,334492,-,1150
249,NZ_CP042446,1,222550,223700,-,1150
249,NZ_CP041215,1,647668,648825,+,1157
249,NZ_OX366353,1,493611,494768,-,1157
249,NZ_OX366387,1,998849,999999,-,1150
249,NZ_OX366368,1,500628,501778,-,1150
249,NZ_OX366379,1,501673,502823,-,1150
249,NZ_CP091195,1,524079,525229,-,1150
249,NZ_OX366375,1,603034,604184,-,1150
249,NZ_CP046925,1,222398,223548,-,1150
249,NZ_OX366318,1,603351,604501,-,1150
249,NZ_OX366319,1,833253,834403,-,1150
249,NZ_OX366332,1,499442,500599,-,1157
249,NZ_CP110359,1,1019716,1020866,+,1150
249,NZ_OU953855,1,279512,280662,+,1150
249,NZ_OX366272,1,743793,744943,-,1150
249,NZ_OX366347,1,613977,615127,-,1150
249,NZ_OU909470,1,298303,299446,+,1143
249,NZ_OX366363,1,417956,419106,+,1150
249,NZ_OX366364,1,881659,882810,+,1151
249,NZ_OX366359,1,477458,478615,+,1157
249,NZ_OX366349,1,475344,476501,-,1157
249,NZ_OX366380,1,599079,600222,-,1143
249,NZ_OX366344,1,310613,311770,+,1157
249,NZ_CP090900,1,222550,223700,-,1150
249,NZ_OX366352,1,623447,624604,+,1157
249,NZ_OX366362,1,864747,865877,-,1130
249,NZ_OX366400,1,646111,647261,+,1150
249,NZ_OX366327,1,652205,653355,-,1150
249,NZ_OX366367,1,692713,693870,+,1157
249,NZ_CP042444,1,222488,223638,-,1150
249,NZ_OX366326,1,696279,697429,-,1150
249,NZ_CP037426,1,957034,958184,-,1150
249,NZ_OX366339,1,478077,479227,-,1150
249,NZ_OX366355,1,800444,801594,+,1150
249,NZ_CP046922,1,222247,223397,-,1150
249,NZ_OX366370,1,808030,809181,+,1151
249,NZ_OX366385,1,213292,214435,+,1143
249,NZ_OX366399,1,500165,501315,-,1150
249,NZ_OX366395,1,1013540,1014683,-,1143
249,NZ_OX366396,1,1485320,1486470,-,1150
249,NZ_OX366351,1,519164,520314,-,1150
249,NZ_OX366381,1,963229,964379,+,1150
249,NZ_OX366342,1,1007998,1009155,+,1157
249,NZ_OX366369,1,502292,503442,-,1150
249,NZ_OX366356,1,776641,777791,+,1150
249,NZ_OX366377,1,609581,610731,-,1150
249,NZ_OX366388,1,773697,774847,-,1150
249,NZ_OX366357,1,158940,160083,-,1143
249,NZ_CP072012,1,422944,424094,-,1150
249,NZ_OX366398,1,1161258,1162408,-,1150
249,NC_002978,6,222550,223700,-,1150
249,NZ_OX366389,1,656438,657588,+,1150
249,NZ_OX366397,1,710749,711906,-,1157
249,NZ_OX366378,1,481265,482415,+,1150
249,NZ_CP090903,1,222550,223700,-,1150
249,NZ_OX366374,1,612978,614121,-,1143
249,NZ_CP090901,1,222550,223700,-,1150
249,NZ_CP046923,1,222247,223397,-,1150
249,NZ_CP069055,1,199631,200781,+,1150
249,NZ_CP072670,1,222398,223548,-,1150
249,NZ_CP090899,1,222550,223700,-,1150
249,NZ_CP046924,1,222247,223397,-,1150
249,NZ_OX366348,1,752002,753152,+,1150
249,NZ_CP046921,1,222247,223397,-,1150
249,NZ_OX366338,1,502319,503462,-,1143
249,NZ_CP054557,1,1226621,1227771,-,1150
249,NZ_CP072669,1,222398,223548,-,1150
249,NC_021089,1,198613,199770,+,1157
248,NZ_OX366376,1,737411,739177,+,1766
248,NZ_OX366393,1,192146,193912,-,1766
248,NZ_OX366372,1,821313,823079,-,1766
248,NZ_CP072672,1,223856,225622,-,1766
248,NZ_CP069060,1,210729,212495,+,1766
248,NZ_CP072667,1,223838,225604,-,1766
248,NZ_CP072671,1,223838,225604,-,1766
248,NZ_CP072668,1,223838,225604,-,1766
248,NZ_CP072666,1,223838,225604,-,1766
248,NZ_CP090902,1,223990,225756,-,1766
248,NZ_CP090948,1,223990,225756,-,1766
248,NZ_CP069052,1,205394,207160,+,1766
248,NZ_CP076228,1,522360,524126,+,1766
248,NZ_CP042445,1,223990,225756,-,1766
248,NZ_CP042904,1,231851,233607,-,1756
248,NC_012416,1,234433,236189,-,1756
248,NZ_CP069053,1,334782,336548,-,1766
248,NZ_CP042446,1,223990,225756,-,1766
248,NZ_CP041215,1,645624,647390,+,1766
248,NZ_OX366353,1,495046,496812,-,1766
248,NZ_OX366387,1,1000289,1002055,-,1766
248,NZ_OX366368,1,502068,503834,-,1766
248,NZ_OX366379,1,503113,504879,-,1766
248,NZ_CP091195,1,525519,527285,-,1766
248,NZ_OX366375,1,604474,606240,-,1766
248,NZ_CP046925,1,223838,225604,-,1766
248,NZ_OX366318,1,604791,606557,-,1766
248,NZ_OX366319,1,834693,836459,-,1766
248,NZ_OX366332,1,500877,502643,-,1766
248,NZ_CP110359,1,1017660,1019426,+,1766
248,NZ_OU953855,1,277465,279222,+,1757
248,NZ_OX366272,1,745233,746999,-,1766
248,NZ_OX366347,1,615417,617183,-,1766
248,NZ_OU909470,1,296259,298025,+,1766
248,NZ_OX366363,1,415900,417666,+,1766
248,NZ_OX366364,1,879617,881358,+,1741
248,NZ_OX366359,1,475423,477180,+,1757
248,NZ_OX366349,1,476791,478557,-,1766
248,NZ_OX366380,1,600500,602266,-,1766
248,NZ_OX366344,1,308557,310323,+,1766
248,NZ_CP090900,1,223990,225756,-,1766
248,NZ_OX366352,1,621403,623169,+,1766
248,NZ_OX366362,1,866541,868306,-,1765
248,NZ_OX366400,1,644055,645821,+,1766
248,NZ_OX366327,1,653645,655411,-,1766
248,NZ_OX366367,1,690671,692412,+,1741
248,NZ_CP042444,1,223928,225694,-,1766
248,NZ_OX366326,1,697719,699485,-,1766
248,NZ_CP037426,1,958474,960240,-,1766
248,NZ_OX366339,1,479517,481283,-,1766
248,NZ_OX366355,1,798388,800154,+,1766
248,NZ_CP046922,1,223687,225453,-,1766
248,NZ_OX366370,1,805995,807740,+,1745
248,NZ_OX366385,1,211248,213014,+,1766
248,NZ_OX366399,1,501605,503371,-,1766
248,NZ_OX366395,1,1014973,1016739,-,1766
248,NZ_OX366396,1,1486760,1488526,-,1766
248,NZ_OX366351,1,520604,522370,-,1766
248,NZ_OX366381,1,961173,962939,+,1766
248,NZ_OX366342,1,1005942,1007708,+,1766
248,NZ_OX366369,1,503732,505498,-,1766
248,NZ_OX366356,1,774585,776351,+,1766
248,NZ_OX366377,1,611021,612787,-,1766
248,NZ_OX366388,1,775137,776903,-,1766
248,NZ_OX366357,1,160373,162139,-,1766
248,NZ_CP072012,1,424384,426150,-,1766
248,NZ_OX366398,1,1162698,1164464,-,1766
248,NC_002978,6,223990,225756,-,1766
248,NZ_OX366389,1,654382,656148,+,1766
248,NZ_OX366397,1,712184,713950,-,1766
248,NZ_OX366378,1,479209,480975,+,1766
248,NZ_CP090903,1,223990,225756,-,1766
248,NZ_OX366374,1,614399,616165,-,1766
248,NZ_CP090901,1,223990,225756,-,1766
248,NZ_CP046923,1,223687,225453,-,1766
248,NZ_CP069055,1,197575,199341,+,1766
248,NZ_CP072670,1,223838,225604,-,1766
248,NZ_CP090899,1,223990,225756,-,1766
248,NZ_CP046924,1,223687,225453,-,1766
248,NZ_OX366348,1,749946,751712,+,1766
248,NZ_CP046921,1,223687,225453,-,1766
248,NZ_OX366338,1,504854,506628,-,1774
248,NZ_CP054557,1,1228061,1229827,-,1766
248,NZ_CP072669,1,223838,225604,-,1766
248,NC_021089,1,196569,198335,+,1766
247,NZ_OX366376,1,736445,737398,+,953
247,NZ_OX366393,1,193925,194878,-,953
247,NZ_OX366372,1,823092,824045,-,953
247,NZ_CP072672,1,225635,226623,-,988
247,NZ_CP069060,1,209728,210716,+,988
247,NZ_CP072667,1,225617,226605,-,988
247,NZ_CP072671,1,225617,226605,-,988
247,NZ_CP072668,1,225617,226605,-,988
247,NZ_CP072666,1,225617,226605,-,988
247,NZ_CP090902,1,225769,226757,-,988
247,NZ_CP090948,1,225769,226757,-,988
247,NZ_CP069052,1,204393,205381,+,988
247,NZ_CP076228,1,521359,522347,+,988
247,NZ_CP042445,1,225769,226757,-,988
247,NZ_CP042904,1,233620,234608,-,988
247,NC_012416,1,236202,237190,-,988
247,NZ_CP069053,1,336561,337549,-,988
247,NZ_CP042446,1,225769,226757,-,988
247,NZ_CP041215,1,644658,645611,+,953
247,NZ_OX366353,1,496825,497778,-,953
247,NZ_OX366387,1,1002068,1003056,-,988
247,NZ_OX366368,1,503847,504835,-,988
247,NZ_OX366379,1,504892,505880,-,988
247,NZ_CP091195,1,527298,528286,-,988
247,NZ_OX366375,1,606253,607241,-,988
247,NZ_CP046925,1,225617,226605,-,988
247,NZ_OX366318,1,606570,607522,-,952
247,NZ_OX366319,1,836472,837460,-,988
247,NZ_OX366332,1,502656,503609,-,953
247,NZ_CP110359,1,1016659,1017647,+,988
247,NZ_OU953855,1,276464,277452,+,988
247,NZ_OX366272,1,747012,748001,-,989
247,NZ_OX366347,1,617196,618184,-,988
247,NZ_OU909470,1,295295,296246,+,951
247,NZ_OX366363,1,414899,415887,+,988
247,NZ_OX366364,1,878638,879590,+,952
247,NZ_OX366359,1,474457,475410,+,953
247,NZ_OX366349,1,478570,479523,-,953
247,NZ_OX366380,1,602279,603231,-,952
247,NZ_OX366344,1,307556,308544,+,988
247,NZ_CP090900,1,225769,226757,-,988
247,NZ_OX366352,1,620437,621390,+,953
247,NZ_OX366362,1,868319,869307,-,988
247,NZ_OX366400,1,643094,644042,+,948
247,NZ_OX366327,1,655424,656412,-,988
247,NZ_OX366367,1,689700,690644,+,944
247,NZ_CP042444,1,225707,226695,-,988
247,NZ_OX366326,1,699498,700486,-,988
247,NZ_CP037426,1,960253,961241,-,988
247,NZ_OX366339,1,481296,482284,-,988
247,NZ_OX366355,1,797387,798375,+,988
247,NZ_CP046922,1,225466,226454,-,988
247,NZ_OX366370,1,805029,805982,+,953
247,NZ_OX366385,1,210283,211235,+,952
247,NZ_OX366399,1,503384,504372,-,988
247,NZ_OX366395,1,1016752,1017704,-,952
247,NZ_OX366396,1,1488539,1489527,-,988
247,NZ_OX366351,1,522383,523371,-,988
247,NZ_OX366381,1,960172,961160,+,988
247,NZ_OX366342,1,1004976,1005929,+,953
247,NZ_OX366369,1,505511,506499,-,988
247,NZ_OX366356,1,773584,774557,+,973
247,NZ_OX366377,1,612800,613788,-,988
247,NZ_OX366388,1,776916,777904,-,988
247,NZ_OX366357,1,162154,163133,-,979
247,NZ_CP072012,1,426163,427151,-,988
247,NZ_OX366398,1,1164477,1165465,-,988
247,NC_002978,6,225769,226757,-,988
247,NZ_OX366389,1,653381,654369,+,988
247,NZ_OX366397,1,713963,714916,-,953
247,NZ_OX366378,1,478208,479196,+,988
247,NZ_CP090903,1,225769,226757,-,988
247,NZ_OX366374,1,616178,617124,-,946
247,NZ_CP090901,1,225769,226757,-,988
247,NZ_CP046923,1,225466,226454,-,988
247,NZ_CP069055,1,196574,197562,+,988
247,NZ_CP072670,1,225617,226605,-,988
247,NZ_CP090899,1,225769,226757,-,988
247,NZ_CP046924,1,225466,226454,-,988
247,NZ_OX366348,1,748945,749933,+,988
247,NZ_CP046921,1,225466,226454,-,988
247,NZ_OX366338,1,509922,510862,-,940
247,NZ_CP054557,1,1229840,1230828,-,988
247,NZ_CP072669,1,225617,226605,-,988
247,NC_021089,1,195603,196556,+,953
246,NZ_OX366376,1,735139,735724,+,585
246,NZ_OX366393,1,195608,196193,-,585
246,NZ_OX366372,1,824775,825360,-,585
246,NZ_CP072672,1,228659,229231,-,572
246,NZ_CP069060,1,207120,207692,+,572
246,NZ_CP072667,1,228641,229213,-,572
246,NZ_CP072671,1,228641,229213,-,572
246,NZ_CP072668,1,228641,229213,-,572
246,NZ_CP072666,1,228641,229213,-,572
246,NZ_CP090902,1,228793,229365,-,572
246,NZ_CP090948,1,228793,229365,-,572
246,NZ_CP069052,1,201785,202357,+,572
246,NZ_CP076228,1,518751,519323,+,572
246,NZ_CP042445,1,228793,229365,-,572
246,NZ_CP042904,1,237081,237668,-,587
246,NC_012416,1,239663,240250,-,587
246,NZ_CP069053,1,339585,340157,-,572
246,NZ_CP042446,1,228793,229365,-,572
246,NZ_CP041215,1,643324,643911,+,587
246,NZ_OX366353,1,498525,499112,-,587
246,NZ_OX366387,1,1006096,1006683,-,587
246,NZ_OX366368,1,506894,507466,-,572
246,NZ_OX366379,1,507939,508511,-,572
246,NZ_CP091195,1,1472804,1473391,+,587
246,NZ_OX366375,1,610124,610711,-,587
246,NZ_CP046925,1,228641,229213,-,572
246,NZ_OX366318,1,610468,611040,-,572
246,NZ_OX366319,1,683331,683918,+,587
246,NZ_OX366332,1,504356,504943,-,587
246,NZ_CP110359,1,1014771,1015358,+,587
246,NZ_OU953855,1,892720,893307,-,587
246,NZ_OX366272,1,749321,749889,-,568
246,NZ_OX366347,1,619462,620049,-,587
246,NZ_OU909470,1,293728,294279,+,551
246,NZ_OX366363,1,410680,411267,+,587
246,NZ_OX366364,1,877232,877818,+,586
246,NZ_OX366359,1,473121,473708,+,587
246,NZ_OX366349,1,480284,480869,-,585
246,NZ_OX366380,1,605349,605914,-,565
246,NZ_OX366344,1,306876,307397,+,521
246,NZ_CP090900,1,228793,229365,-,572
246,NZ_OX366352,1,619103,619690,+,587
246,NZ_OX366362,1,800278,800850,+,572
246,NZ_OX366400,1,640894,641466,+,572
246,NZ_OX366327,1,658349,658936,-,587
246,NZ_OX366367,1,687958,688531,+,573
246,NZ_CP042444,1,228731,229303,-,572
246,NZ_OX366326,1,703489,704061,-,572
246,NZ_CP037426,1,874346,874933,-,587
246,NZ_OX366339,1,484148,484735,-,587
246,NZ_OX366355,1,794273,794860,+,587
246,NZ_CP046922,1,228490,229062,-,572
246,NZ_OX366370,1,803678,804240,+,562
246,NZ_OX366385,1,207600,208165,+,565
246,NZ_OX366399,1,506431,507003,-,572
246,NZ_OX366395,1,1018666,1019238,-,572
246,NZ_OX366396,1,1490439,1491026,-,587
246,NZ_OX366351,1,525423,525995,-,572
246,NZ_OX366381,1,957058,957645,+,587
246,NZ_OX366342,1,1003661,1004246,+,585
246,NZ_OX366369,1,509034,509621,-,587
246,NZ_OX366356,1,771041,771627,+,586
246,NZ_OX366377,1,615847,616419,-,572
246,NZ_OX366388,1,781812,782399,-,587
246,NZ_OX366357,1,164377,164949,-,572
246,NZ_CP072012,1,429203,429775,-,572
246,NZ_OX366398,1,1167524,1168096,-,572
246,NC_002978,6,228793,229365,-,572
246,NZ_OX366389,1,650758,651330,+,572
246,NZ_OX366397,1,715663,716250,-,587
246,NZ_OX366378,1,475261,475848,+,587
246,NZ_CP090903,1,228793,229365,-,572
246,NZ_OX366374,1,773982,774554,-,572
246,NZ_CP090901,1,228793,229365,-,572
246,NZ_CP046923,1,228490,229062,-,572
246,NZ_CP069055,1,193958,194530,+,572
246,NZ_CP072670,1,228641,229213,-,572
246,NZ_CP090899,1,228793,229365,-,572
246,NZ_CP046924,1,228490,229062,-,572
246,NZ_OX366348,1,744687,745259,+,572
246,NZ_CP046921,1,228490,229062,-,572
246,NZ_OX366338,1,511783,512355,-,572
246,NZ_CP054557,1,1232880,1233452,-,572
246,NZ_CP072669,1,228641,229213,-,572
246,NC_021089,1,194269,194856,+,587
245,NZ_OX366376,1,731981,735059,+,3078
245,NZ_OX366393,1,196273,199351,-,3078
245,NZ_OX366372,1,825440,828518,-,3078
245,NZ_CP072672,1,287046,290101,+,3055
245,NZ_CP069060,1,270531,273605,+,3074
245,NZ_CP072667,1,287028,290083,+,3055
245,NZ_CP072671,1,287028,290083,+,3055
245,NZ_CP072668,1,287028,290083,+,3055
245,NZ_CP072666,1,287028,290083,+,3055
245,NZ_CP090902,1,287180,290235,+,3055
245,NZ_CP090948,1,287180,290235,+,3055
245,NZ_CP069052,1,265196,268270,+,3074
245,NZ_CP076228,1,450432,453489,-,3057
245,NZ_CP042445,1,287180,290235,+,3055
245,NZ_CP042904,1,490958,494032,+,3074
245,NC_012416,1,494277,497351,+,3074
245,NZ_CP069053,1,273672,276746,-,3074
245,NZ_CP042446,1,287180,290235,+,3055
245,NZ_CP041215,1,857254,860324,+,3070
245,NZ_OX366353,1,275308,278367,-,3059
245,NZ_OX366387,1,898482,901556,+,3074
245,NZ_OX366368,1,636655,639710,+,3055
245,NZ_OX366379,1,905326,908381,-,3055
245,NZ_CP091195,1,260960,264034,-,3074
245,NZ_OX366375,1,727672,730746,-,3074
245,NZ_CP046925,1,287028,290083,+,3055
245,NZ_OX366318,1,860542,863616,-,3074
245,NZ_OX366319,1,555768,558821,-,3053
245,NZ_OX366332,1,970614,973684,+,3070
245,NZ_CP110359,1,893653,896727,-,3074
245,NZ_OU953855,1,691995,695045,+,3050
245,NZ_OX366272,1,356583,359657,-,3074
245,NZ_OX366347,1,666770,669844,+,3074
245,NZ_OU909470,1,290658,293608,+,2950
245,NZ_OX366363,1,50390,53464,+,3074
245,NZ_OX366364,1,827855,830926,-,3071
245,NZ_OX366359,1,801322,804390,+,3068
245,NZ_OX366349,1,480949,484027,-,3078
245,NZ_OX366380,1,605987,609038,-,3051
245,NZ_OX366344,1,303718,306796,+,3078
245,NZ_CP090900,1,287180,290235,+,3055
245,NZ_OX366352,1,731718,734788,+,3070
245,NZ_OX366362,1,967898,970970,-,3072
245,NZ_OX366400,1,376579,379653,+,3074
245,NZ_OX366327,1,901318,904392,-,3074
245,NZ_OX366367,1,733678,736749,+,3071
245,NZ_CP042444,1,286762,289817,+,3055
245,NZ_OX366326,1,956494,959566,-,3072
245,NZ_CP037426,1,573454,576528,-,3074
245,NZ_OX366339,1,664977,668051,+,3074
245,NZ_OX366355,1,570294,573347,-,3053
245,NZ_CP046922,1,286878,289933,+,3055
245,NZ_OX366370,1,800540,803600,+,3060
245,NZ_OX366385,1,204476,207527,+,3051
245,NZ_OX366399,1,898390,901445,-,3055
245,NZ_OX366395,1,863285,866359,-,3074
245,NZ_OX366396,1,1175029,1178086,-,3057
245,NZ_OX366351,1,782660,785734,+,3074
245,NZ_OX366381,1,545958,549011,+,3053
245,NZ_OX366342,1,1000503,1003581,+,3078
245,NZ_OX366369,1,613988,617043,+,3055
245,NZ_OX366356,1,526125,529180,+,3055
245,NZ_OX366377,1,470040,473114,-,3074
245,NZ_OX366388,1,474929,478003,+,3074
245,NZ_OX366357,1,1197481,1200535,-,3054
245,NZ_CP072012,1,222418,225473,+,3055
245,NZ_OX366398,1,37676,40750,+,3074
245,NC_002978,6,287180,290235,+,3055
245,NZ_OX366389,1,967735,970809,-,3074
245,NZ_OX366397,1,1052094,1055164,+,3070
245,NZ_OX366378,1,660755,663827,-,3072
245,NZ_CP090903,1,287180,290235,+,3055
245,NZ_OX366374,1,1265629,1268685,+,3056
245,NZ_CP090901,1,287180,290235,+,3055
245,NZ_CP046923,1,286878,289933,+,3055
245,NZ_CP069055,1,318844,321918,+,3074
245,NZ_CP072670,1,287020,290075,+,3055
245,NZ_CP090899,1,287180,290235,+,3055
245,NZ_CP046924,1,286878,289933,+,3055
245,NZ_OX366348,1,574928,577984,-,3056
245,NZ_CP046921,1,286878,289933,+,3055
245,NZ_OX366338,1,369432,372505,+,3073
245,NZ_CP054557,1,240610,243684,-,3074
245,NZ_CP072669,1,287028,290083,+,3055
245,NC_021089,1,619501,622569,+,3068
244,NZ_OX366376,1,729228,730522,+,1294
244,NZ_OX366393,1,200719,202013,-,1294
244,NZ_OX366372,1,829886,831180,-,1294
244,NZ_CP072672,1,310812,312111,-,1299
244,NZ_CP069060,1,299735,301034,-,1299
244,NZ_CP072667,1,310794,312093,-,1299
244,NZ_CP072671,1,310794,312093,-,1299
244,NZ_CP072668,1,310794,312093,-,1299
244,NZ_CP072666,1,310794,312093,-,1299
244,NZ_CP090902,1,310946,312245,-,1299
244,NZ_CP090948,1,310946,312245,-,1299
244,NZ_CP069052,1,294408,295707,-,1299
244,NZ_CP076228,1,423727,425026,+,1299
244,NZ_CP042445,1,310946,312245,-,1299
244,NZ_CP042904,1,485333,486632,+,1299
244,NC_012416,1,488652,489951,+,1299
244,NZ_CP069053,1,246243,247542,+,1299
244,NZ_CP042446,1,310946,312245,-,1299
244,NZ_CP041215,1,853241,854540,+,1299
244,NZ_OX366353,1,281038,282337,-,1299
244,NZ_OX366387,1,1590996,1592295,+,1299
244,NZ_OX366368,1,665887,667186,-,1299
244,NZ_OX366379,1,880001,881300,+,1299
244,NZ_CP091195,1,235819,237118,+,1299
244,NZ_OX366375,1,769278,770577,+,1299
244,NZ_CP046925,1,310794,312093,-,1299
244,NZ_OX366318,1,832868,834167,+,1299
244,NZ_OX366319,1,414459,415758,-,1299
244,NZ_OX366332,1,966601,967900,+,1299
244,NZ_CP110359,1,867140,868439,+,1299
244,NZ_OU953855,1,312811,314110,+,1299
244,NZ_OX366272,1,620715,622014,-,1299
244,NZ_OX366347,1,1084670,1085969,+,1299
244,NZ_OU909470,1,1311653,1312948,+,1295
244,NZ_OX366363,1,78795,80094,-,1299
244,NZ_OX366364,1,833730,834999,-,1269
244,NZ_OX366359,1,797309,798608,+,1299
244,NZ_OX366349,1,485970,487239,-,1269
244,NZ_OX366380,1,696405,697700,-,1295
244,NZ_OX366344,1,301113,302407,+,1294
244,NZ_CP090900,1,310946,312245,-,1299
244,NZ_OX366352,1,727705,729004,+,1299
244,NZ_OX366362,1,972408,973698,-,1290
244,NZ_OX366400,1,390053,391352,+,1299
244,NZ_OX366327,1,875615,876910,+,1295
244,NZ_OX366367,1,729598,730867,+,1269
244,NZ_CP042444,1,311447,312746,-,1299
244,NZ_OX366326,1,928513,929812,+,1299
244,NZ_CP037426,1,154999,156298,+,1299
244,NZ_OX366339,1,645358,646657,+,1299
244,NZ_OX366355,1,542246,543545,+,1299
244,NZ_CP046922,1,310644,311943,-,1299
244,NZ_OX366370,1,797935,799230,+,1295
244,NZ_OX366385,1,1079367,1080662,+,1295
244,NZ_OX366399,1,871042,872341,+,1299
244,NZ_OX366395,1,868021,869316,-,1295
244,NZ_OX366396,1,1078877,1080176,-,1299
244,NZ_OX366351,1,756235,757534,+,1299
244,NZ_OX366381,1,574779,576078,-,1299
244,NZ_OX366342,1,997750,999044,+,1294
244,NZ_OX366369,1,640467,641766,-,1299
244,NZ_OX366356,1,552088,553387,-,1299
244,NZ_OX366377,1,441440,442739,+,1299
244,NZ_OX366388,1,502794,504093,+,1299
244,NZ_OX366357,1,957110,958409,-,1299
244,NZ_CP072012,1,664866,666165,+,1299
244,NZ_OX366398,1,68095,69394,-,1299
244,NC_002978,6,310946,312245,-,1299
244,NZ_OX366389,1,938093,939392,+,1299
244,NZ_OX366397,1,1048081,1049380,+,1299
244,NZ_OX366378,1,633066,634365,+,1299
244,NZ_CP090903,1,310946,312245,-,1299
244,NZ_OX366374,1,604114,605409,-,1295
244,NZ_CP090901,1,310946,312245,-,1299
244,NZ_CP046923,1,310644,311943,-,1299
244,NZ_CP069055,1,347942,349241,-,1299
244,NZ_CP072670,1,310786,312085,-,1299
244,NZ_CP090899,1,310946,312245,-,1299
244,NZ_CP046924,1,310644,311943,-,1299
244,NZ_OX366348,1,405118,406417,+,1299
244,NZ_CP046921,1,310644,311943,-,1299
244,NZ_OX366338,1,760388,761683,+,1295
244,NZ_CP054557,1,53962,55261,-,1299
244,NZ_CP072669,1,310794,312093,-,1299
244,NC_021089,1,615488,616787,+,1299
243,NZ_OX366376,1,723694,725293,+,1599
243,NZ_OX366393,1,205198,206797,-,1599
243,NZ_OX366372,1,835115,836714,-,1599
243,NZ_CP072672,1,970598,972208,-,1610
243,NZ_CP069060,1,815561,817171,-,1610
243,NZ_CP072667,1,970572,972182,-,1610
243,NZ_CP072671,1,970580,972190,-,1610
243,NZ_CP072668,1,970567,972177,-,1610
243,NZ_CP072666,1,970580,972190,-,1610
243,NZ_CP090902,1,970732,972342,-,1610
243,NZ_CP090948,1,970732,972342,-,1610
243,NZ_CP069052,1,838900,840510,+,1610
243,NZ_CP076228,1,1011577,1013187,+,1610
243,NZ_CP042445,1,970720,972330,-,1610
243,NZ_CP042904,1,994483,996093,-,1610
243,NC_012416,1,1033577,1035187,-,1610
243,NZ_CP069053,1,815569,817179,-,1610
243,NZ_CP042446,1,970730,972340,-,1610
243,NZ_CP041215,1,16071,17681,+,1610
243,NZ_OX366353,1,1042954,1044564,+,1610
243,NZ_OX366387,1,1543977,1545576,-,1599
243,NZ_OX366368,1,1416235,1417845,-,1610
243,NZ_OX366379,1,1335680,1337290,-,1610
243,NZ_CP091195,1,1101533,1103143,+,1610
243,NZ_OX366375,1,1239676,1241275,+,1599
243,NZ_CP046925,1,970580,972190,-,1610
243,NZ_OX366318,1,1267005,1268615,-,1610
243,NZ_OX366319,1,1196865,1198475,-,1610
243,NZ_OX366332,1,1350304,1351914,-,1610
243,NZ_CP110359,1,203417,205027,-,1610
243,NZ_OU953855,1,490695,492291,-,1596
243,NZ_OX366272,1,154125,155735,-,1610
243,NZ_OX366347,1,1413572,1415182,-,1610
243,NZ_OU909470,1,1380001,1381597,-,1596
243,NZ_OX366363,1,988399,990009,-,1610
243,NZ_OX366364,1,1274578,1276174,+,1596
243,NZ_OX366359,1,1180023,1181633,-,1610
243,NZ_OX366349,1,1147506,1149105,-,1599
243,NZ_OX366380,1,560920,562516,-,1596
243,NZ_OX366344,1,295823,297422,+,1599
243,NZ_CP090900,1,970732,972342,-,1610
243,NZ_OX366352,1,1674031,1675641,-,1610
243,NZ_OX366362,1,284309,285916,-,1607
243,NZ_OX366400,1,1124026,1125636,-,1610
243,NZ_OX366327,1,1264473,1266083,-,1610
243,NZ_OX366367,1,1516136,1517732,-,1596
243,NZ_CP042444,1,971167,972777,-,1610
243,NZ_OX366326,1,1476255,1477865,-,1610
243,NZ_CP037426,1,666522,668121,+,1599
243,NZ_OX366339,1,114689,116288,-,1599
243,NZ_OX366355,1,1278606,1280216,+,1610
243,NZ_CP046922,1,1032628,1034238,-,1610
243,NZ_OX366370,1,790744,792343,+,1599
243,NZ_OX366385,1,895989,897585,+,1596
243,NZ_OX366399,1,1369296,1370906,-,1610
243,NZ_OX366395,1,1322048,1323647,-,1599
243,NZ_OX366396,1,18930,20526,+,1596
243,NZ_OX366351,1,1420126,1421736,-,1610
243,NZ_OX366381,1,1105812,1107422,-,1610
243,NZ_OX366342,1,992726,994325,+,1599
243,NZ_OX366369,1,1367827,1369437,+,1610
243,NZ_OX366356,1,1132915,1134525,-,1610
243,NZ_OX366377,1,992880,994490,+,1610
243,NZ_OX366388,1,1795955,1797554,-,1599
243,NZ_OX366357,1,189290,190889,-,1599
243,NZ_CP072012,1,1232639,1234249,-,1610
243,NZ_OX366398,1,452319,453929,-,1610
243,NC_002978,6,970732,972342,-,1610
243,NZ_OX366389,1,1348731,1350341,-,1610
243,NZ_OX366397,1,1576660,1578270,-,1610
243,NZ_OX366378,1,1283669,1285279,-,1610
243,NZ_CP090903,1,970732,972342,-,1610
243,NZ_OX366374,1,1214715,1216325,+,1610
243,NZ_CP090901,1,970732,972342,-,1610
243,NZ_CP046923,1,948876,950486,-,1610
243,NZ_CP069055,1,1069898,1071508,+,1610
243,NZ_CP072670,1,970572,972182,-,1610
243,NZ_CP090899,1,970732,972342,-,1610
243,NZ_CP046924,1,969814,971424,-,1610
243,NZ_OX366348,1,1248057,1249667,-,1610
243,NZ_CP046921,1,1032628,1034238,-,1610
243,NZ_OX366338,1,172815,174411,-,1596
243,NZ_CP054557,1,765753,767363,-,1610
243,NZ_CP072669,1,970580,972190,-,1610
243,NC_021089,1,1000118,1001728,-,1610
242,NZ_OX366376,1,720835,723316,+,2481
242,NZ_OX366393,1,207175,209656,-,2481
242,NZ_OX366372,1,837092,839573,-,2481
242,NZ_CP072672,1,972319,974791,-,2472
242,NZ_CP069060,1,817282,819754,-,2472
242,NZ_CP072667,1,972293,974765,-,2472
242,NZ_CP072671,1,972301,974773,-,2472
242,NZ_CP072668,1,972288,974760,-,2472
242,NZ_CP072666,1,972301,974773,-,2472
242,NZ_CP090902,1,972453,974925,-,2472
242,NZ_CP090948,1,972453,974925,-,2472
242,NZ_CP069052,1,836317,838789,+,2472
242,NZ_CP076228,1,1008994,1011466,+,2472
242,NZ_CP042445,1,972441,974913,-,2472
242,NZ_CP042904,1,996612,999084,-,2472
242,NC_012416,1,1035706,1038178,-,2472
242,NZ_CP069053,1,817290,819762,-,2472
242,NZ_CP042446,1,972451,974923,-,2472
242,NZ_CP041215,1,13488,15960,+,2472
242,NZ_OX366353,1,1040371,1042843,+,2472
242,NZ_OX366387,1,1545687,1548159,-,2472
242,NZ_OX366368,1,1417956,1420428,-,2472
242,NZ_OX366379,1,1337401,1339873,-,2472
242,NZ_CP091195,1,1098950,1101422,+,2472
242,NZ_OX366375,1,1237093,1239565,+,2472
242,NZ_CP046925,1,972301,974773,-,2472
242,NZ_OX366318,1,1268726,1271187,-,2461
242,NZ_OX366319,1,1198586,1201058,-,2472
242,NZ_OX366332,1,1352025,1354497,-,2472
242,NZ_CP110359,1,205138,207610,-,2472
242,NZ_OU953855,1,492628,495091,-,2463
242,NZ_OX366272,1,155846,158318,-,2472
242,NZ_OX366347,1,1415293,1417765,-,2472
242,NZ_OU909470,1,1382099,1384562,-,2463
242,NZ_OX366363,1,990120,992601,-,2481
242,NZ_OX366364,1,1337769,1340230,-,2461
242,NZ_OX366359,1,1181744,1184216,-,2472
242,NZ_OX366349,1,1150914,1153395,-,2481
242,NZ_OX366380,1,564098,566561,-,2463
242,NZ_OX366344,1,293018,295489,+,2471
242,NZ_CP090900,1,972453,974925,-,2472
242,NZ_OX366352,1,1675752,1678224,-,2472
242,NZ_OX366362,1,286537,289006,-,2469
242,NZ_OX366400,1,1125747,1128208,-,2461
242,NZ_OX366327,1,1266428,1268900,-,2472
242,NZ_OX366367,1,1518069,1520530,-,2461
242,NZ_CP042444,1,972888,975360,-,2472
242,NZ_OX366326,1,1477976,1480437,-,2461
242,NZ_CP037426,1,663939,666411,+,2472
242,NZ_OX366339,1,116622,119103,-,2481
242,NZ_OX366355,1,1276023,1278495,+,2472
242,NZ_CP046922,1,1034349,1036821,-,2472
242,NZ_OX366370,1,787939,790410,+,2471
242,NZ_OX366385,1,194381,196844,-,2463
242,NZ_OX366399,1,1371017,1373489,-,2472
242,NZ_OX366395,1,1323758,1326230,-,2472
242,NZ_OX366396,1,16112,18593,+,2481
242,NZ_OX366351,1,1421847,1424308,-,2461
242,NZ_OX366381,1,1107533,1110005,-,2472
242,NZ_OX366342,1,989867,992348,+,2481
242,NZ_OX366369,1,1365244,1367716,+,2472
242,NZ_OX366356,1,1134636,1137108,-,2472
242,NZ_OX366377,1,990308,992769,+,2461
242,NZ_OX366388,1,1797665,1800137,-,2472
242,NZ_OX366357,1,191003,193481,-,2478
242,NZ_CP072012,1,1234360,1236832,-,2472
242,NZ_OX366398,1,454040,456501,-,2461
242,NC_002978,6,972453,974925,-,2472
242,NZ_OX366389,1,1350452,1352913,-,2461
242,NZ_OX366397,1,1578381,1580853,-,2472
242,NZ_OX366378,1,1285390,1287862,-,2472
242,NZ_CP090903,1,972453,974925,-,2472
242,NZ_OX366374,1,1212132,1214604,+,2472
242,NZ_CP090901,1,972453,974925,-,2472
242,NZ_CP046923,1,950597,953069,-,2472
242,NZ_CP069055,1,1067315,1069787,+,2472
242,NZ_CP072670,1,972293,974765,-,2472
242,NZ_CP090899,1,972453,974925,-,2472
242,NZ_CP046924,1,971535,974007,-,2472
242,NZ_OX366348,1,1249778,1252250,-,2472
242,NZ_CP046921,1,1034349,1036821,-,2472
242,NZ_OX366338,1,174961,177433,-,2472
242,NZ_CP054557,1,767474,769946,-,2472
242,NZ_CP072669,1,972301,974773,-,2472
242,NC_021089,1,1001839,1004311,-,2472
241,NZ_OX366376,1,720211,720744,+,533
241,NZ_OX366393,1,209747,210280,-,533
241,NZ_OX366372,1,839664,840197,-,533
241,NZ_CP042904,1,999175,999791,-,616
241,NC_012416,1,1040814,1041427,-,613
241,NZ_OX366349,1,1153486,1154019,-,533
241,NZ_OX366344,1,292395,292927,+,532
241,NZ_OX366370,1,787316,787848,+,532
241,NZ_OX366342,1,989235,989776,+,541
241,NZ_OX366357,1,193572,194104,-,532
240,NZ_OX366376,1,716568,717581,+,1013
240,NZ_OX366393,1,212912,213925,-,1013
240,NZ_OX366372,1,842829,843842,-,1013
240,NZ_CP072672,1,977012,978025,-,1013
240,NZ_CP069060,1,821975,822988,-,1013
240,NZ_CP072667,1,976986,977999,-,1013
240,NZ_CP072671,1,976994,978007,-,1013
240,NZ_CP072668,1,976981,977994,-,1013
240,NZ_CP072666,1,976994,978007,-,1013
240,NZ_CP090902,1,977146,978159,-,1013
240,NZ_CP090948,1,977146,978159,-,1013
240,NZ_CP069052,1,833083,834096,+,1013
240,NZ_CP076228,1,1005761,1006774,+,1013
240,NZ_CP042445,1,977134,978147,-,1013
240,NZ_CP042904,1,1002342,1003355,-,1013
240,NC_012416,1,1044899,1045912,-,1013
240,NZ_CP069053,1,821983,822996,-,1013
240,NZ_CP042446,1,977144,978157,-,1013
240,NZ_CP041215,1,10254,11267,+,1013
240,NZ_OX366353,1,1037138,1038151,+,1013
240,NZ_OX366387,1,1554239,1555252,+,1013
240,NZ_OX366368,1,1422649,1423662,-,1013
240,NZ_OX366379,1,1342094,1343107,-,1013
240,NZ_CP091195,1,1096181,1097194,+,1013
240,NZ_OX366375,1,1233859,1234867,+,1008
240,NZ_CP046925,1,976994,978007,-,1013
240,NZ_OX366318,1,1273419,1274432,-,1013
240,NZ_OX366319,1,1204097,1205110,-,1013
240,NZ_OX366332,1,1356718,1357731,-,1013
240,NZ_CP110359,1,209831,210844,-,1013
240,NZ_OU953855,1,70292,71305,-,1013
240,NZ_OX366272,1,1324558,1325571,-,1013
240,NZ_OX366347,1,1419986,1420999,-,1013
240,NZ_OU909470,1,1386011,1387019,-,1008
240,NZ_OX366363,1,994822,995835,-,1013
240,NZ_OX366364,1,1342462,1343736,-,1274
240,NZ_OX366359,1,1186437,1187450,-,1013
240,NZ_OX366349,1,1156658,1157671,-,1013
240,NZ_OX366380,1,569632,570645,-,1013
240,NZ_OX366344,1,288765,289778,+,1013
240,NZ_CP090900,1,977146,978159,-,1013
240,NZ_OX366352,1,1680445,1681458,-,1013
240,NZ_OX366362,1,1475768,1476781,-,1013
240,NZ_OX366400,1,1130440,1131453,-,1013
240,NZ_OX366327,1,1271230,1272238,-,1008
240,NZ_OX366367,1,1522762,1524027,-,1265
240,NZ_CP042444,1,977581,978594,-,1013
240,NZ_OX366326,1,1482669,1483682,-,1013
240,NZ_CP037426,1,660705,661713,+,1008
240,NZ_OX366339,1,120523,121536,-,1013
240,NZ_OX366355,1,1271971,1272984,+,1013
240,NZ_CP046922,1,1039042,1040055,-,1013
240,NZ_OX366370,1,777967,778980,+,1013
240,NZ_OX366385,1,1293242,1294255,+,1013
240,NZ_OX366399,1,1375710,1376723,-,1013
240,NZ_OX366395,1,73028,74041,+,1013
240,NZ_OX366396,1,13679,14692,+,1013
240,NZ_OX366351,1,1427492,1428505,-,1013
240,NZ_OX366381,1,1113044,1114057,-,1013
240,NZ_OX366342,1,985591,986604,+,1013
240,NZ_OX366369,1,1361859,1362872,+,1013
240,NZ_OX366356,1,1138349,1139362,-,1013
240,NZ_OX366377,1,987063,988076,+,1013
240,NZ_OX366388,1,1801558,1802571,-,1013
240,NZ_OX366357,1,98323,99336,-,1013
240,NZ_CP072012,1,1239053,1240066,-,1013
240,NZ_OX366398,1,458733,459746,-,1013
240,NC_002978,6,977146,978159,-,1013
240,NZ_OX366389,1,1355145,1356158,-,1013
240,NZ_OX366397,1,1583074,1584087,-,1013
240,NZ_OX366378,1,1289618,1290631,-,1013
240,NZ_CP090903,1,977146,978159,-,1013
240,NZ_OX366374,1,1208853,1209866,+,1013
240,NZ_CP090901,1,977146,978159,-,1013
240,NZ_CP046923,1,955290,956303,-,1013
240,NZ_CP069055,1,1064082,1065095,+,1013
240,NZ_CP072670,1,976986,977999,-,1013
240,NZ_CP090899,1,977146,978159,-,1013
240,NZ_CP046924,1,976228,977241,-,1013
240,NZ_OX366348,1,1253670,1254683,-,1013
240,NZ_CP046921,1,1039042,1040055,-,1013
240,NZ_OX366338,1,332978,333991,+,1013
240,NZ_CP054557,1,772220,773233,-,1013
240,NZ_CP072669,1,976994,978007,-,1013
240,NC_021089,1,1006532,1007545,-,1013
239,NZ_OX366376,1,715958,716566,+,608
239,NZ_OX366393,1,213926,214513,-,587
239,NZ_OX366372,1,843843,844452,-,609
239,NZ_CP072672,1,978026,978640,-,614
239,NZ_CP069060,1,822989,823603,-,614
239,NZ_CP072667,1,978000,978614,-,614
239,NZ_CP072671,1,978008,978622,-,614
239,NZ_CP072668,1,977995,978609,-,614
239,NZ_CP072666,1,978008,978622,-,614
239,NZ_CP090902,1,978160,978774,-,614
239,NZ_CP090948,1,978160,978774,-,614
239,NZ_CP069052,1,832468,833081,+,613
239,NZ_CP076228,1,1005146,1005759,+,613
239,NZ_CP042445,1,978148,978762,-,614
239,NZ_CP042904,1,1003356,1003935,-,579
239,NC_012416,1,1045913,1046492,-,579
239,NZ_CP069053,1,822997,823611,-,614
239,NZ_CP042446,1,978158,978772,-,614
239,NZ_CP041215,1,9645,10252,+,607
239,NZ_OX366353,1,1036529,1037136,+,607
239,NZ_OX366387,1,1553625,1554237,+,612
239,NZ_OX366368,1,1423663,1424277,-,614
239,NZ_OX366379,1,1343108,1343722,-,614
239,NZ_CP091195,1,1095567,1096179,+,612
239,NZ_OX366375,1,1233244,1233857,+,613
239,NZ_CP046925,1,978008,978622,-,614
239,NZ_OX366319,1,1205111,1205724,-,613
239,NZ_OX366332,1,1357732,1358340,-,608
239,NZ_CP110359,1,210845,211431,-,586
239,NZ_OU953855,1,71306,71885,-,579
239,NZ_OX366272,1,1325572,1326158,-,586
239,NZ_OX366347,1,1421000,1421613,-,613
239,NZ_OU909470,1,1387020,1387607,-,587
239,NZ_OX366363,1,995836,996449,-,613
239,NZ_OX366364,1,1343737,1344316,-,579
239,NZ_OX366359,1,1187451,1188059,-,608
239,NZ_OX366349,1,1157672,1158281,-,609
239,NZ_OX366380,1,570646,571233,-,587
239,NZ_OX366344,1,288155,288763,+,608
239,NZ_CP090900,1,978160,978774,-,614
239,NZ_OX366352,1,1681459,1682067,-,608
239,NZ_OX366362,1,1476782,1477391,-,609
239,NZ_OX366400,1,1131454,1132041,-,587
239,NZ_OX366327,1,1272239,1272852,-,613
239,NZ_OX366367,1,1524028,1524607,-,579
239,NZ_CP042444,1,978595,979209,-,614
239,NZ_OX366326,1,1483683,1484270,-,587
239,NZ_CP037426,1,660090,660703,+,613
239,NZ_OX366339,1,121537,122116,-,579
239,NZ_OX366355,1,1271357,1271969,+,612
239,NZ_CP046922,1,1040056,1040670,-,614
239,NZ_OX366370,1,777357,777965,+,608
239,NZ_OX366385,1,1292649,1293240,+,591
239,NZ_OX366399,1,1376724,1377338,-,614
239,NZ_OX366395,1,72460,73026,+,566
239,NZ_OX366396,1,13099,13677,+,578
239,NZ_OX366351,1,1428506,1429093,-,587
239,NZ_OX366381,1,1114058,1114671,-,613
239,NZ_OX366342,1,985003,985589,+,586
239,NZ_OX366369,1,1361245,1361857,+,612
239,NZ_OX366356,1,1139363,1139976,-,613
239,NZ_OX366377,1,986449,987061,+,612
239,NZ_OX366388,1,1802572,1803185,-,613
239,NZ_OX366357,1,99337,99916,-,579
239,NZ_CP072012,1,1240067,1240681,-,614
239,NZ_OX366398,1,459747,460360,-,613
239,NC_002978,6,978160,978774,-,614
239,NZ_OX366389,1,1356159,1356772,-,613
239,NZ_OX366397,1,1584088,1584696,-,608
239,NZ_OX366378,1,1290632,1291245,-,613
239,NZ_CP090903,1,978160,978774,-,614
239,NZ_OX366374,1,1208285,1208851,+,566
239,NZ_CP090901,1,978160,978774,-,614
239,NZ_CP046923,1,956304,956918,-,614
239,NZ_CP069055,1,1063467,1064080,+,613
239,NZ_CP072670,1,978000,978614,-,614
239,NZ_CP090899,1,978160,978774,-,614
239,NZ_CP046924,1,977242,977856,-,614
239,NZ_OX366348,1,1254684,1255271,-,587
239,NZ_CP046921,1,1040056,1040670,-,614
239,NZ_OX366338,1,332410,332976,+,566
239,NZ_CP054557,1,773234,773848,-,614
239,NZ_CP072669,1,978008,978622,-,614
239,NC_021089,1,1007546,1008154,-,608
238,NZ_OX366376,1,713825,715143,+,1318
238,NZ_OX366393,1,215161,216479,-,1318
238,NZ_OX366372,1,845267,846585,-,1318
238,NZ_CP072672,1,953858,955176,-,1318
238,NZ_CP069060,1,798798,800116,-,1318
238,NZ_CP072667,1,953832,955150,-,1318
238,NZ_CP072671,1,953840,955158,-,1318
238,NZ_CP072668,1,953827,955145,-,1318
238,NZ_CP072666,1,953840,955158,-,1318
238,NZ_CP090902,1,953992,955310,-,1318
238,NZ_CP090948,1,953992,955310,-,1318
238,NZ_CP069052,1,855955,857273,+,1318
238,NZ_CP076228,1,1028620,1029938,+,1318
238,NZ_CP042445,1,953980,955298,-,1318
238,NZ_CP042904,1,977686,979004,-,1318
238,NC_012416,1,1016788,1018106,-,1318
238,NZ_CP069053,1,798806,800124,-,1318
238,NZ_CP042446,1,953990,955308,-,1318
238,NZ_CP041215,1,33109,34427,+,1318
238,NZ_OX366353,1,1199352,1200670,+,1318
238,NZ_OX366387,1,954280,955598,+,1318
238,NZ_OX366368,1,1399480,1400798,-,1318
238,NZ_OX366379,1,1318925,1320243,-,1318
238,NZ_CP091195,1,1119005,1120323,+,1318
238,NZ_OX366375,1,1261022,1262340,+,1318
238,NZ_CP046925,1,953840,955158,-,1318
238,NZ_OX366318,1,1250176,1251494,-,1318
238,NZ_OX366319,1,1180069,1181387,-,1318
238,NZ_OX366332,1,1333563,1334881,-,1318
238,NZ_CP110359,1,186279,187597,-,1318
238,NZ_OU953855,1,423036,424354,+,1318
238,NZ_OX366272,1,1320702,1322020,+,1318
238,NZ_OX366347,1,1396843,1398161,-,1318
238,NZ_OU909470,1,1387989,1389307,-,1318
238,NZ_OX366363,1,971476,972794,-,1318
238,NZ_OX366364,1,1314563,1315881,+,1318
238,NZ_OX366359,1,1163282,1164600,-,1318
238,NZ_OX366349,1,1160519,1161837,-,1318
238,NZ_OX366380,1,573011,574329,-,1318
238,NZ_OX366344,1,286022,287340,+,1318
238,NZ_CP090900,1,953992,955310,-,1318
238,NZ_OX366352,1,1657290,1658608,-,1318
238,NZ_OX366362,1,439730,441048,+,1318
238,NZ_OX366400,1,1107205,1108523,-,1318
238,NZ_OX366327,1,1245883,1247201,-,1318
238,NZ_OX366367,1,1150881,1152199,+,1318
238,NZ_CP042444,1,954427,955745,-,1318
238,NZ_OX366326,1,1459443,1460761,-,1318
238,NZ_CP037426,1,781908,783226,+,1318
238,NZ_OX366339,1,91834,93152,+,1318
238,NZ_OX366355,1,1295694,1297012,+,1318
238,NZ_CP046922,1,1015888,1017206,-,1318
238,NZ_OX366370,1,775503,776821,+,1318
238,NZ_OX366385,1,1289192,1290510,+,1318
238,NZ_OX366399,1,1352541,1353859,-,1318
238,NZ_OX366395,1,1200800,1202118,+,1318
238,NZ_OX366396,1,500811,502129,-,1318
238,NZ_OX366351,1,1403297,1404615,-,1318
238,NZ_OX366381,1,1089016,1090334,-,1318
238,NZ_OX366342,1,1498503,1499821,+,1318
238,NZ_OX366369,1,1384915,1386233,+,1318
238,NZ_OX366356,1,1116703,1118021,-,1318
238,NZ_OX366377,1,1014009,1015327,+,1318
238,NZ_OX366388,1,1650783,1652101,+,1318
238,NZ_OX366357,1,581732,583050,-,1318
238,NZ_CP072012,1,1215884,1217202,-,1318
238,NZ_OX366398,1,434051,435369,-,1318
238,NC_002978,6,953992,955310,-,1318
238,NZ_OX366389,1,1330463,1331781,-,1318
238,NZ_OX366397,1,1559911,1561229,-,1318
238,NZ_OX366378,1,1266489,1267807,-,1318
238,NZ_CP090903,1,953992,955310,-,1318
238,NZ_OX366374,1,347084,348402,-,1318
238,NZ_CP090901,1,953992,955310,-,1318
238,NZ_CP046923,1,932136,933454,-,1318
238,NZ_CP069055,1,1086936,1088254,+,1318
238,NZ_CP072670,1,953832,955150,-,1318
238,NZ_CP090899,1,953992,955310,-,1318
238,NZ_CP046924,1,953074,954392,-,1318
238,NZ_OX366348,1,1230100,1231418,-,1318
238,NZ_CP046921,1,1015888,1017206,-,1318
238,NZ_OX366338,1,684472,685773,+,1301
238,NZ_CP054557,1,748912,750230,-,1318
238,NZ_CP072669,1,953840,955158,-,1318
238,NC_021089,1,983369,984687,-,1318
237,NZ_OX366376,1,706062,711186,+,5124
237,NZ_OX366393,1,219225,224349,-,5124
237,NZ_OX366372,1,1011145,1016269,+,5124
237,NZ_CP072672,1,753006,758011,-,5005
237,NZ_CP069060,1,595964,600969,-,5005
237,NZ_CP072667,1,752988,757993,-,5005
237,NZ_CP072671,1,752988,757993,-,5005
237,NZ_CP072668,1,752975,757980,-,5005
237,NZ_CP072666,1,752988,757993,-,5005
237,NZ_CP090902,1,753140,758145,-,5005
237,NZ_CP090948,1,753140,758145,-,5005
237,NZ_CP069052,1,1146954,1151959,-,5005
237,NZ_CP076228,1,781693,786698,+,5005
237,NZ_CP042445,1,753128,758133,-,5005
237,NZ_CP042904,1,634528,639532,-,5004
237,NC_012416,1,670181,675185,-,5004
237,NZ_CP069053,1,595972,600977,-,5005
237,NZ_CP042446,1,753140,758145,-,5005
237,NZ_CP041215,1,922377,927382,+,5005
237,NZ_OX366353,1,175567,180572,-,5005
237,NZ_OX366387,1,696244,701249,+,5005
237,NZ_OX366368,1,1199034,1204039,-,5005
237,NZ_OX366379,1,1118549,1123554,-,5005
237,NZ_CP091195,1,1497057,1502062,+,5005
237,NZ_OX366375,1,1045282,1050286,-,5004
237,NZ_CP046925,1,752988,757993,-,5005
237,NZ_OX366318,1,1050323,1055328,-,5005
237,NZ_OX366319,1,164382,169386,+,5004
237,NZ_OX366332,1,1136543,1141548,-,5005
237,NZ_CP110359,1,448517,453511,+,4994
237,NZ_OU953855,1,212474,217479,+,5005
237,NZ_OX366272,1,1204011,1209016,-,5005
237,NZ_OX366347,1,184624,189629,-,5005
237,NZ_OU909470,1,315759,320765,+,5006
237,NZ_OX366363,1,1185155,1190160,+,5005
237,NZ_OX366364,1,299600,304725,+,5125
237,NZ_OX366359,1,964351,969356,-,5005
237,NZ_OX366349,1,1162780,1167895,-,5115
237,NZ_OX366380,1,575216,580220,-,5004
237,NZ_OX366344,1,736555,741679,+,5124
237,NZ_CP090900,1,753140,758145,-,5005
237,NZ_OX366352,1,1246586,1251591,+,5005
237,NZ_OX366362,1,251294,256299,+,5005
237,NZ_OX366400,1,913741,918746,-,5005
237,NZ_OX366327,1,1050149,1055154,-,5005
237,NZ_OX366367,1,916691,921816,+,5125
237,NZ_CP042444,1,753575,758580,-,5005
237,NZ_OX366326,1,1257974,1262979,-,5005
237,NZ_CP037426,1,842841,847845,-,5004
237,NZ_OX366339,1,866820,871825,-,5005
237,NZ_OX366355,1,188600,193604,+,5004
237,NZ_CP046922,1,814953,819958,-,5005
237,NZ_OX366370,1,769718,774724,+,5006
237,NZ_OX366385,1,326483,331489,+,5006
237,NZ_OX366399,1,1153177,1158182,-,5005
237,NZ_OX366395,1,141929,146934,+,5005
237,NZ_OX366396,1,1326225,1331230,-,5005
237,NZ_OX366351,1,1204399,1209404,-,5005
237,NZ_OX366381,1,275091,280095,+,5004
237,NZ_OX366342,1,1474857,1479981,-,5124
237,NZ_OX366369,1,1240303,1245307,-,5004
237,NZ_OX366356,1,957889,962894,-,5005
237,NZ_OX366377,1,1172809,1177814,+,5005
237,NZ_OX366388,1,234266,239271,-,5005
237,NZ_OX366357,1,501280,506284,-,5004
237,NZ_CP072012,1,1423700,1428705,+,5005
237,NZ_OX366398,1,231593,236598,-,5005
237,NC_002978,6,753140,758145,-,5005
237,NZ_OX366389,1,1119338,1124343,+,5005
237,NZ_OX366397,1,1358076,1363081,-,5005
237,NZ_OX366378,1,551476,556481,+,5005
237,NZ_CP090903,1,753140,758145,-,5005
237,NZ_OX366374,1,28610,33615,+,5005
237,NZ_CP090901,1,753140,758145,-,5005
237,NZ_CP046923,1,731201,736206,-,5005
237,NZ_CP069055,1,752471,757476,-,5005
237,NZ_CP072670,1,752980,757985,-,5005
237,NZ_CP090899,1,753140,758145,-,5005
237,NZ_CP046924,1,752139,757144,-,5005
237,NZ_OX366348,1,223888,228893,+,5005
237,NZ_CP046921,1,814953,819958,-,5005
237,NZ_OX366338,1,1233478,1238483,+,5005
237,NZ_CP054557,1,1050638,1055643,+,5005
237,NZ_CP072669,1,752988,757993,-,5005
237,NC_021089,1,786804,791809,-,5005
236,NZ_OX366376,1,704507,705851,+,1344
236,NZ_OX366393,1,224560,225904,-,1344
236,NZ_OX366372,1,1009590,1010934,+,1344
236,NZ_CP072672,1,758585,759930,-,1345
236,NZ_CP069060,1,601543,602888,-,1345
236,NZ_CP072667,1,758567,759912,-,1345
236,NZ_CP072671,1,758567,759912,-,1345
236,NZ_CP072668,1,758554,759899,-,1345
236,NZ_CP072666,1,758567,759912,-,1345
236,NZ_CP090902,1,758719,760064,-,1345
236,NZ_CP090948,1,758719,760064,-,1345
236,NZ_CP069052,1,1152533,1153878,-,1345
236,NZ_CP076228,1,780004,781349,+,1345
236,NZ_CP042445,1,758707,760052,-,1345
236,NZ_CP042904,1,639877,641222,-,1345
236,NC_012416,1,675530,676875,-,1345
236,NZ_CP069053,1,601551,602896,-,1345
236,NZ_CP042446,1,758719,760064,-,1345
236,NZ_CP041215,1,920688,922033,+,1345
236,NZ_OX366353,1,180916,182261,-,1345
236,NZ_OX366387,1,694555,695900,+,1345
236,NZ_OX366368,1,1204613,1205958,-,1345
236,NZ_OX366379,1,1124128,1125473,-,1345
236,NZ_CP091195,1,1495368,1496713,+,1345
236,NZ_OX366375,1,1050621,1051965,-,1344
236,NZ_CP046925,1,758567,759912,-,1345
236,NZ_OX366318,1,1055902,1057247,-,1345
236,NZ_OX366319,1,162703,164047,+,1344
236,NZ_OX366332,1,1141892,1143237,-,1345
236,NZ_CP110359,1,446828,448173,+,1345
236,NZ_OU953855,1,210785,212130,+,1345
236,NZ_OX366272,1,1209360,1210705,-,1345
236,NZ_OX366347,1,189973,191318,-,1345
236,NZ_OU909470,1,314228,315572,+,1344
236,NZ_OX366363,1,1183466,1184811,+,1345
236,NZ_OX366364,1,297916,299250,+,1334
236,NZ_OX366359,1,969700,971045,-,1345
236,NZ_OX366349,1,1169202,1170546,-,1344
236,NZ_OX366380,1,580408,581752,-,1344
236,NZ_OX366344,1,735000,736344,+,1344
236,NZ_CP090900,1,758719,760064,-,1345
236,NZ_OX366352,1,1244897,1246242,+,1345
236,NZ_OX366362,1,249375,250707,+,1332
236,NZ_OX366400,1,919320,920665,-,1345
236,NZ_OX366327,1,1055498,1056843,-,1345
236,NZ_OX366367,1,915003,916337,+,1334
236,NZ_CP042444,1,759154,760499,-,1345
236,NZ_OX366326,1,1263553,1264898,-,1345
236,NZ_CP037426,1,848180,849524,-,1344
236,NZ_OX366339,1,872169,873514,-,1345
236,NZ_OX366355,1,186921,188265,+,1344
236,NZ_CP046922,1,820532,821877,-,1345
236,NZ_OX366370,1,767629,768973,+,1344
236,NZ_OX366385,1,324952,326296,+,1344
236,NZ_OX366399,1,1158756,1160101,-,1345
236,NZ_OX366395,1,140241,141586,+,1345
236,NZ_OX366396,1,1331574,1332919,-,1345
236,NZ_OX366351,1,1209978,1211323,-,1345
236,NZ_OX366381,1,273412,274756,+,1344
236,NZ_OX366342,1,1480168,1481512,-,1344
236,NZ_OX366369,1,1245642,1246986,-,1344
236,NZ_OX366356,1,963238,964582,-,1344
236,NZ_OX366377,1,1170890,1172235,+,1345
236,NZ_OX366388,1,239615,240960,-,1345
236,NZ_OX366357,1,506629,507974,-,1345
236,NZ_CP072012,1,1421781,1423126,+,1345
236,NZ_OX366398,1,237172,238517,-,1345
236,NC_002978,6,758719,760064,-,1345
236,NZ_OX366389,1,1117419,1118764,+,1345
236,NZ_OX366397,1,1363425,1364770,-,1345
236,NZ_OX366378,1,549787,551132,+,1345
236,NZ_CP090903,1,758719,760064,-,1345
236,NZ_OX366374,1,26921,28266,+,1345
236,NZ_CP090901,1,758719,760064,-,1345
236,NZ_CP046923,1,736780,738125,-,1345
236,NZ_CP069055,1,757820,759165,-,1345
236,NZ_CP072670,1,758559,759904,-,1345
236,NZ_CP090899,1,758719,760064,-,1345
236,NZ_CP046924,1,757718,759063,-,1345
236,NZ_OX366348,1,221969,223314,+,1345
236,NZ_CP046921,1,820532,821877,-,1345
236,NZ_OX366338,1,1231811,1233156,+,1345
236,NZ_CP054557,1,1048719,1050064,+,1345
236,NZ_CP072669,1,758567,759912,-,1345
236,NC_021089,1,792156,793498,-,1342
235,NZ_OX366376,1,703015,704411,+,1396
235,NZ_OX366393,1,226000,227396,-,1396
235,NZ_OX366372,1,1008098,1009494,+,1396
235,NZ_CP072672,1,759996,761315,-,1319
235,NZ_CP069060,1,602954,604273,-,1319
235,NZ_CP072667,1,759978,761297,-,1319
235,NZ_CP072671,1,759978,761297,-,1319
235,NZ_CP072668,1,759965,761284,-,1319
235,NZ_CP072666,1,759978,761297,-,1319
235,NZ_CP090902,1,760130,761449,-,1319
235,NZ_CP090948,1,760130,761449,-,1319
235,NZ_CP069052,1,1153944,1155263,-,1319
235,NZ_CP076228,1,778619,779938,+,1319
235,NZ_CP042445,1,760118,761437,-,1319
235,NZ_CP042904,1,641288,642593,-,1305
235,NC_012416,1,676941,678246,-,1305
235,NZ_CP069053,1,602962,604281,-,1319
235,NZ_CP042446,1,760130,761449,-,1319
235,NZ_CP041215,1,919279,920622,+,1343
235,NZ_OX366353,1,182327,183670,-,1343
235,NZ_OX366387,1,693184,694489,+,1305
235,NZ_OX366368,1,1206024,1207343,-,1319
235,NZ_OX366379,1,1125539,1126858,-,1319
235,NZ_CP091195,1,1493959,1495302,+,1343
235,NZ_OX366375,1,1052032,1053337,-,1305
235,NZ_CP046925,1,759978,761297,-,1319
235,NZ_OX366318,1,1057313,1058632,-,1319
235,NZ_OX366319,1,161293,162636,+,1343
235,NZ_OX366332,1,1143303,1144646,-,1343
235,NZ_CP110359,1,445443,446762,+,1319
235,NZ_OU953855,1,209376,210719,+,1343
235,NZ_OX366272,1,1210771,1212090,-,1319
235,NZ_OX366347,1,191384,192727,-,1343
235,NZ_OU909470,1,1377805,1379304,+,1499
235,NZ_OX366363,1,1182098,1183400,+,1302
235,NZ_OX366364,1,296514,297823,+,1309
235,NZ_OX366359,1,971111,972454,-,1343
235,NZ_OX366349,1,1170642,1172024,-,1382
235,NZ_OX366380,1,558772,560223,+,1451
235,NZ_OX366344,1,733522,734904,+,1382
235,NZ_CP090900,1,760130,761449,-,1319
235,NZ_OX366352,1,1243488,1244831,+,1343
235,NZ_OX366362,1,247963,249291,+,1328
235,NZ_OX366400,1,920731,922050,-,1319
235,NZ_OX366327,1,1056909,1058228,-,1319
235,NZ_OX366367,1,913601,914910,+,1309
235,NZ_CP042444,1,760565,761884,-,1319
235,NZ_OX366326,1,1264964,1266283,-,1319
235,NZ_CP037426,1,850512,851817,-,1305
235,NZ_OX366339,1,873613,874904,-,1291
235,NZ_OX366355,1,185511,186854,+,1343
235,NZ_CP046922,1,821943,823262,-,1319
235,NZ_OX366370,1,766151,767536,+,1385
235,NZ_OX366385,1,898283,899734,-,1451
235,NZ_OX366399,1,1160167,1161486,-,1319
235,NZ_OX366395,1,138832,140175,+,1343
235,NZ_OX366396,1,1333018,1334309,-,1291
235,NZ_OX366351,1,1211389,1212708,-,1319
235,NZ_OX366381,1,272002,273345,+,1343
235,NZ_OX366342,1,1481608,1483004,-,1396
235,NZ_OX366369,1,1247053,1248396,-,1343
235,NZ_OX366356,1,964649,965968,-,1319
235,NZ_OX366377,1,1169505,1170824,+,1319
235,NZ_OX366388,1,241026,242369,-,1343
235,NZ_OX366357,1,508040,509383,-,1343
235,NZ_CP072012,1,1420396,1421715,+,1319
235,NZ_OX366398,1,238583,239902,-,1319
235,NC_002978,6,760130,761449,-,1319
235,NZ_OX366389,1,1116034,1117353,+,1319
235,NZ_OX366397,1,1364836,1366179,-,1343
235,NZ_OX366378,1,548378,549721,+,1343
235,NZ_CP090903,1,760130,761449,-,1319
235,NZ_OX366374,1,25506,26855,+,1349
235,NZ_CP090901,1,760130,761449,-,1319
235,NZ_CP046923,1,738191,739510,-,1319
235,NZ_CP069055,1,759231,760550,-,1319
235,NZ_CP072670,1,759970,761289,-,1319
235,NZ_CP090899,1,760130,761449,-,1319
235,NZ_CP046924,1,759129,760448,-,1319
235,NZ_OX366348,1,220584,221903,+,1319
235,NZ_CP046921,1,821943,823262,-,1319
235,NZ_OX366338,1,1230402,1231745,+,1343
235,NZ_CP054557,1,1047334,1048653,+,1319
235,NZ_CP072669,1,759978,761297,-,1319
235,NC_021089,1,793564,794907,-,1343
234,NZ_OX366376,1,701802,703013,+,1211
234,NZ_OX366393,1,227397,228609,-,1212
234,NZ_OX366372,1,1006885,1008096,+,1211
234,NZ_CP072672,1,761316,762519,-,1203
234,NZ_CP069060,1,604274,605477,-,1203
234,NZ_CP072667,1,761298,762501,-,1203
234,NZ_CP072671,1,761298,762501,-,1203
234,NZ_CP072668,1,761285,762488,-,1203
234,NZ_CP072666,1,761298,762501,-,1203
234,NZ_CP090902,1,761450,762653,-,1203
234,NZ_CP090948,1,761450,762653,-,1203
234,NZ_CP069052,1,1155264,1156467,-,1203
234,NZ_CP076228,1,777415,778617,+,1202
234,NZ_CP042445,1,761438,762641,-,1203
234,NZ_CP042904,1,642604,643790,-,1186
234,NC_012416,1,678257,679443,-,1186
234,NZ_CP069053,1,604282,605485,-,1203
234,NZ_CP042446,1,761450,762653,-,1203
234,NZ_CP041215,1,918075,919277,+,1202
234,NZ_OX366353,1,183671,184874,-,1203
234,NZ_OX366387,1,691957,693173,+,1216
234,NZ_OX366368,1,1207344,1208547,-,1203
234,NZ_OX366379,1,1126859,1128062,-,1203
234,NZ_CP091195,1,1492755,1493957,+,1202
234,NZ_OX366375,1,1053348,1054555,-,1207
234,NZ_CP046925,1,761298,762501,-,1203
234,NZ_OX366318,1,1058633,1059836,-,1203
234,NZ_OX366319,1,160089,161291,+,1202
234,NZ_OX366332,1,1144647,1145850,-,1203
234,NZ_CP110359,1,444239,445441,+,1202
234,NZ_OU953855,1,208172,209374,+,1202
234,NZ_OX366272,1,1212091,1213294,-,1203
234,NZ_OX366347,1,192728,193931,-,1203
234,NZ_OU909470,1,1376587,1377794,+,1207
234,NZ_OX366363,1,1180877,1182084,+,1207
234,NZ_OX366364,1,295310,296512,+,1202
234,NZ_OX366359,1,972455,973658,-,1203
234,NZ_OX366349,1,1172035,1173251,-,1216
234,NZ_OX366380,1,557554,558761,+,1207
234,NZ_OX366344,1,732295,733511,+,1216
234,NZ_CP090900,1,761450,762653,-,1203
234,NZ_OX366352,1,1242284,1243486,+,1202
234,NZ_OX366362,1,246745,247952,+,1207
234,NZ_OX366400,1,922051,923254,-,1203
234,NZ_OX366327,1,1058229,1059432,-,1203
234,NZ_OX366367,1,912397,913599,+,1202
234,NZ_CP042444,1,761885,763088,-,1203
234,NZ_OX366326,1,1266284,1267487,-,1203
234,NZ_CP037426,1,851828,853035,-,1207
234,NZ_OX366339,1,936388,937568,+,1180
234,NZ_OX366355,1,184307,185509,+,1202
234,NZ_CP046922,1,823263,824466,-,1203
234,NZ_OX366370,1,764924,766140,+,1216
234,NZ_OX366385,1,899745,900952,-,1207
234,NZ_OX366399,1,1161487,1162690,-,1203
234,NZ_OX366395,1,137628,138830,+,1202
234,NZ_OX366396,1,1335982,1337163,-,1181
234,NZ_OX366351,1,1212709,1213912,-,1203
234,NZ_OX366381,1,270798,272000,+,1202
234,NZ_OX366342,1,1483005,1484217,-,1212
234,NZ_OX366369,1,1248397,1249600,-,1203
234,NZ_OX366356,1,965969,967172,-,1203
234,NZ_OX366377,1,1168301,1169503,+,1202
234,NZ_OX366388,1,242370,243573,-,1203
234,NZ_OX366357,1,509384,510587,-,1203
234,NZ_CP072012,1,1419192,1420394,+,1202
234,NZ_OX366398,1,239903,241106,-,1203
234,NC_002978,6,761450,762653,-,1203
234,NZ_OX366389,1,1114830,1116032,+,1202
234,NZ_OX366397,1,1366180,1367383,-,1203
234,NZ_OX366378,1,547174,548376,+,1202
234,NZ_CP090903,1,761450,762653,-,1203
234,NZ_OX366374,1,24302,25504,+,1202
234,NZ_CP090901,1,761450,762653,-,1203
234,NZ_CP046923,1,739511,740714,-,1203
234,NZ_CP069055,1,760551,761754,-,1203
234,NZ_CP072670,1,761290,762493,-,1203
234,NZ_CP090899,1,761450,762653,-,1203
234,NZ_CP046924,1,760449,761652,-,1203
234,NZ_OX366348,1,219380,220582,+,1202
234,NZ_CP046921,1,823263,824466,-,1203
234,NZ_OX366338,1,1229198,1230400,+,1202
234,NZ_CP054557,1,1046130,1047332,+,1202
234,NZ_CP072669,1,761298,762501,-,1203
234,NC_021089,1,794908,796111,-,1203
233,NZ_OX366376,1,699850,701201,+,1351
233,NZ_OX366393,1,229210,230561,-,1351
233,NZ_OX366372,1,1004933,1006284,+,1351
233,NZ_CP072672,1,775411,776790,+,1379
233,NZ_CP069060,1,618375,619754,+,1379
233,NZ_CP072667,1,775393,776772,+,1379
233,NZ_CP072671,1,775393,776772,+,1379
233,NZ_CP072668,1,775380,776759,+,1379
233,NZ_CP072666,1,775393,776772,+,1379
233,NZ_CP090902,1,775545,776924,+,1379
233,NZ_CP090948,1,775545,776924,+,1379
233,NZ_CP069052,1,1169365,1170744,+,1379
233,NZ_CP076228,1,763131,764510,-,1379
233,NZ_CP042445,1,775533,776912,+,1379
233,NZ_CP042904,1,798941,800320,+,1379
233,NC_012416,1,833814,835193,+,1379
233,NZ_CP069053,1,618383,619762,+,1379
233,NZ_CP042446,1,775545,776924,+,1379
233,NZ_CP041215,1,904306,905685,-,1379
233,NZ_OX366353,1,196411,197790,+,1379
233,NZ_OX366387,1,675946,677325,-,1379
233,NZ_OX366368,1,1221446,1222825,+,1379
233,NZ_OX366379,1,1140961,1142340,+,1379
233,NZ_CP091195,1,1479849,1481228,-,1379
233,NZ_OX366375,1,1068344,1069706,+,1362
233,NZ_CP046925,1,775393,776772,+,1379
233,NZ_OX366318,1,1073230,1074609,+,1379
233,NZ_OX366319,1,147183,148562,-,1379
233,NZ_OX366332,1,1157385,1158764,+,1379
233,NZ_CP110359,1,259596,260975,+,1379
233,NZ_OU953855,1,1366203,1367582,-,1379
233,NZ_OX366272,1,1224821,1226200,+,1379
233,NZ_OX366347,1,205562,206941,+,1379
233,NZ_OU909470,1,1373892,1375249,+,1357
233,NZ_OX366363,1,1168001,1169380,-,1379
233,NZ_OX366364,1,374063,375412,+,1349
233,NZ_OX366359,1,985194,986573,+,1379
233,NZ_OX366349,1,1173852,1175203,-,1351
233,NZ_OX366380,1,554393,555739,+,1346
233,NZ_OX366344,1,730333,731684,+,1351
233,NZ_CP090900,1,775545,776924,+,1379
233,NZ_OX366352,1,1229386,1230748,-,1362
233,NZ_OX366362,1,41375,42754,-,1379
233,NZ_OX366400,1,936642,938021,+,1379
233,NZ_OX366327,1,1072368,1073747,+,1379
233,NZ_OX366367,1,1057800,1059148,+,1348
233,NZ_CP042444,1,775980,777359,+,1379
233,NZ_OX366326,1,1280875,1282254,+,1379
233,NZ_CP037426,1,1223200,1224579,+,1379
233,NZ_OX366339,1,920226,921605,-,1379
233,NZ_OX366355,1,171400,172779,-,1379
233,NZ_CP046922,1,837358,838737,+,1379
233,NZ_OX366370,1,762961,764283,+,1322
233,NZ_OX366385,1,903620,904966,-,1346
233,NZ_OX366399,1,1175589,1176968,+,1379
233,NZ_OX366395,1,121820,123199,-,1379
233,NZ_OX366396,1,1208077,1209456,-,1379
233,NZ_OX366351,1,1227300,1228679,+,1379
233,NZ_OX366381,1,257891,259270,-,1379
233,NZ_OX366342,1,1484819,1486170,-,1351
233,NZ_OX366369,1,1261128,1262507,+,1379
233,NZ_OX366356,1,978673,980052,+,1379
233,NZ_OX366377,1,1152820,1154199,-,1379
233,NZ_OX366388,1,256646,258025,+,1379
233,NZ_OX366357,1,1146077,1147456,-,1379
233,NZ_CP072012,1,1403990,1405369,-,1379
233,NZ_OX366398,1,255208,256587,+,1379
233,NC_002978,6,775545,776924,+,1379
233,NZ_OX366389,1,1100600,1101979,-,1379
233,NZ_OX366397,1,1378919,1380298,+,1379
233,NZ_OX366378,1,534268,535647,-,1379
233,NZ_CP090903,1,775545,776924,+,1379
233,NZ_OX366374,1,784727,786106,-,1379
233,NZ_CP090901,1,775545,776924,+,1379
233,NZ_CP046923,1,753606,754985,+,1379
233,NZ_CP069055,1,774651,776030,+,1379
233,NZ_CP072670,1,775385,776764,+,1379
233,NZ_CP090899,1,775545,776924,+,1379
233,NZ_CP046924,1,774544,775923,+,1379
233,NZ_OX366348,1,205168,206530,-,1362
233,NZ_CP046921,1,837358,838737,+,1379
233,NZ_OX366338,1,1214704,1216083,-,1379
233,NZ_CP054557,1,1029532,1030911,-,1379
233,NZ_CP072669,1,775393,776772,+,1379
233,NC_021089,1,807646,809025,+,1379
232,NZ_OX366376,1,695962,697506,+,1544
232,NZ_OX366393,1,232905,234449,-,1544
232,NZ_OX366372,1,876424,877968,-,1544
232,NZ_CP072672,1,1233973,1235504,-,1531
232,NZ_CP069060,1,1374872,1376403,-,1531
232,NZ_CP072667,1,1233947,1235478,-,1531
232,NZ_CP072671,1,1233955,1235486,-,1531
232,NZ_CP072668,1,1233942,1235473,-,1531
232,NZ_CP072666,1,1233955,1235486,-,1531
232,NZ_CP090902,1,1234108,1235639,-,1531
232,NZ_CP090948,1,1234106,1235637,-,1531
232,NZ_CP069052,1,1319172,1320703,-,1531
232,NZ_CP076228,1,1254843,1256374,-,1531
232,NZ_CP042445,1,1233760,1235291,-,1531
232,NZ_CP042904,1,1364869,1366479,-,1610
232,NC_012416,1,1408078,1409688,-,1610
232,NZ_CP069053,1,1360170,1361701,-,1531
232,NZ_CP042446,1,1234105,1235636,-,1531
232,NZ_CP041215,1,614564,616094,+,1530
232,NZ_OX366353,1,604013,605543,+,1530
232,NZ_OX366387,1,607377,608987,+,1610
232,NZ_OX366368,1,247528,249059,-,1531
232,NZ_OX366379,1,248546,250077,-,1531
232,NZ_CP091195,1,888403,889933,+,1530
232,NZ_OX366375,1,266256,267787,-,1531
232,NZ_CP046925,1,1233955,1235486,-,1531
232,NZ_OX366318,1,338236,339780,-,1544
232,NZ_OX366319,1,953764,955374,+,1610
232,NZ_OX366332,1,245509,247040,-,1531
232,NZ_CP110359,1,1273740,1275271,-,1531
232,NZ_OU953855,1,764102,765633,-,1531
232,NZ_OX366272,1,1119141,1120671,+,1530
232,NZ_OX366347,1,356858,358389,-,1531
232,NZ_OU909470,1,667635,669179,+,1544
232,NZ_OX366363,1,690395,692005,+,1610
232,NZ_OX366364,1,1286318,1287928,+,1610
232,NZ_OX366359,1,244266,245857,-,1591
232,NZ_OX366349,1,1631715,1633243,+,1528
232,NZ_OX366380,1,116068,117612,+,1544
232,NZ_OX366344,1,42320,43864,+,1544
232,NZ_CP090900,1,1234110,1235641,-,1531
232,NZ_OX366352,1,1444358,1445888,+,1530
232,NZ_OX366362,1,274242,275768,-,1526
232,NZ_OX366400,1,247217,248761,-,1544
232,NZ_OX366327,1,248762,250372,-,1610
232,NZ_OX366367,1,1435448,1436970,-,1522
232,NZ_CP042444,1,1235461,1236992,-,1531
232,NZ_OX366326,1,545733,547277,+,1544
232,NZ_CP037426,1,1318035,1319566,-,1531
232,NZ_OX366339,1,1287125,1288735,+,1610
232,NZ_OX366355,1,1069519,1071129,+,1610
232,NZ_CP046922,1,1295910,1297441,-,1531
232,NZ_OX366370,1,1109258,1110767,+,1509
232,NZ_OX366385,1,386269,387813,+,1544
232,NZ_OX366399,1,247030,248561,-,1531
232,NZ_OX366395,1,391414,392914,-,1500
232,NZ_OX366396,1,466371,467981,-,1610
232,NZ_OX366351,1,257854,259398,-,1544
232,NZ_OX366381,1,1137420,1139030,+,1610
232,NZ_OX366342,1,1488514,1490058,-,1544
232,NZ_OX366369,1,242393,244003,-,1610
232,NZ_OX366356,1,278319,279831,-,1512
232,NZ_OX366377,1,337102,338632,+,1530
232,NZ_OX366388,1,1531232,1532762,+,1530
232,NZ_OX366357,1,1154665,1156195,+,1530
232,NZ_CP072012,1,1068886,1070398,+,1512
232,NZ_OX366398,1,945625,947155,+,1530
232,NC_002978,6,1234106,1235637,-,1531
232,NZ_OX366389,1,303544,305075,-,1531
232,NZ_OX366397,1,245214,246745,-,1531
232,NZ_OX366378,1,1025816,1027426,-,1610
232,NZ_CP090903,1,1234110,1235641,-,1531
232,NZ_OX366374,1,257275,258776,+,1501
232,NZ_CP090901,1,1234110,1235641,-,1531
232,NZ_CP046923,1,1212158,1213689,-,1531
232,NZ_CP069055,1,1234244,1235775,-,1531
232,NZ_CP072670,1,1233935,1235466,-,1531
232,NZ_CP090899,1,1234110,1235641,-,1531
232,NZ_CP046924,1,1233096,1234627,-,1531
232,NZ_OX366348,1,1003940,1005470,+,1530
232,NZ_CP046921,1,1295910,1297441,-,1531
232,NZ_OX366338,1,1446856,1448385,-,1529
232,NZ_CP054557,1,568924,570454,+,1530
232,NZ_CP072669,1,1233958,1235489,-,1531
232,NC_021089,1,1260666,1262197,-,1531
231,NZ_OX366376,1,694087,695639,+,1552
231,NZ_OX366393,1,234772,236324,-,1552
231,NZ_OX366372,1,878291,879829,-,1538
231,NZ_CP072672,1,1235833,1237541,-,1708
231,NZ_CP069060,1,1376732,1378440,-,1708
231,NZ_CP072667,1,1235807,1237515,-,1708
231,NZ_CP072671,1,1235815,1237523,-,1708
231,NZ_CP072668,1,1235802,1237510,-,1708
231,NZ_CP072666,1,1235815,1237523,-,1708
231,NZ_CP090902,1,1235968,1237676,-,1708
231,NZ_CP090948,1,1235966,1237674,-,1708
231,NZ_CP069052,1,1321032,1322740,-,1708
231,NZ_CP076228,1,1256703,1258411,-,1708
231,NZ_CP042445,1,1235620,1237328,-,1708
231,NZ_CP042904,1,1366808,1368516,-,1708
231,NC_012416,1,1410017,1411725,-,1708
231,NZ_CP069053,1,1362030,1363738,-,1708
231,NZ_CP042446,1,1235965,1237673,-,1708
231,NZ_CP041215,1,612527,614235,+,1708
231,NZ_OX366353,1,601976,603684,+,1708
231,NZ_OX366387,1,605340,607048,+,1708
231,NZ_OX366368,1,249388,251096,-,1708
231,NZ_OX366379,1,250406,252114,-,1708
231,NZ_CP091195,1,886447,888148,+,1701
231,NZ_OX366375,1,268116,269824,-,1708
231,NZ_CP046925,1,1235815,1237523,-,1708
231,NZ_OX366318,1,340109,341817,-,1708
231,NZ_OX366319,1,951727,953435,+,1708
231,NZ_OX366332,1,247369,249077,-,1708
231,NZ_CP110359,1,1275526,1277227,-,1701
231,NZ_OU953855,1,765881,767589,-,1708
231,NZ_OX366272,1,1117185,1118886,+,1701
231,NZ_OX366347,1,358644,360345,-,1701
231,NZ_OU909470,1,665826,667387,+,1561
231,NZ_OX366363,1,688439,690140,+,1701
231,NZ_OX366364,1,1284362,1286070,+,1708
231,NZ_OX366359,1,246186,247894,-,1708
231,NZ_OX366349,1,1629840,1631392,+,1552
231,NZ_OX366380,1,114259,115820,+,1561
231,NZ_OX366344,1,40445,41997,+,1552
231,NZ_CP090900,1,1235970,1237678,-,1708
231,NZ_OX366352,1,1442321,1444029,+,1708
231,NZ_OX366362,1,276097,277658,-,1561
231,NZ_OX366400,1,249090,250798,-,1708
231,NZ_OX366327,1,250701,252409,-,1708
231,NZ_OX366367,1,1437299,1439007,-,1708
231,NZ_CP042444,1,1237321,1239029,-,1708
231,NZ_OX366326,1,543696,545404,+,1708
231,NZ_CP037426,1,1319895,1321603,-,1708
231,NZ_OX366339,1,1285088,1286796,+,1708
231,NZ_OX366355,1,1067482,1069190,+,1708
231,NZ_CP046922,1,1297770,1299478,-,1708
231,NZ_OX366370,1,1107381,1108935,+,1554
231,NZ_OX366385,1,384460,386021,+,1561
231,NZ_OX366399,1,248890,250598,-,1708
231,NZ_OX366395,1,393243,394951,-,1708
231,NZ_OX366396,1,468310,470018,-,1708
231,NZ_OX366351,1,259727,261435,-,1708
231,NZ_OX366381,1,1135383,1137091,+,1708
231,NZ_OX366342,1,1490381,1491933,-,1552
231,NZ_OX366369,1,244332,246040,-,1708
231,NZ_OX366356,1,280079,281640,-,1561
231,NZ_OX366377,1,335065,336773,+,1708
231,NZ_OX366388,1,1529276,1530977,+,1701
231,NZ_OX366357,1,1152628,1154336,+,1708
231,NZ_CP072012,1,1066849,1068557,+,1708
231,NZ_OX366398,1,943588,945296,+,1708
231,NC_002978,6,1235966,1237674,-,1708
231,NZ_OX366389,1,305404,307112,-,1708
231,NZ_OX366397,1,247074,248766,-,1692
231,NZ_OX366378,1,1027681,1029382,-,1701
231,NZ_CP090903,1,1235970,1237678,-,1708
231,NZ_OX366374,1,255238,256946,+,1708
231,NZ_CP090901,1,1235970,1237678,-,1708
231,NZ_CP046923,1,1214018,1215726,-,1708
231,NZ_CP069055,1,1236104,1237812,-,1708
231,NZ_CP072670,1,1235795,1237503,-,1708
231,NZ_CP090899,1,1235970,1237678,-,1708
231,NZ_CP046924,1,1234956,1236664,-,1708
231,NZ_OX366348,1,1001903,1003611,+,1708
231,NZ_CP046921,1,1297770,1299478,-,1708
231,NZ_OX366338,1,1448714,1450422,-,1708
231,NZ_CP054557,1,566887,568595,+,1708
231,NZ_CP072669,1,1235818,1237526,-,1708
231,NC_021089,1,1262526,1264234,-,1708
230,NZ_OX366376,1,690675,692196,+,1521
230,NZ_OX366393,1,238207,239728,-,1521
230,NZ_OX366372,1,881734,883255,-,1521
230,NZ_CP072672,1,964406,965961,-,1555
230,NZ_CP069060,1,809354,810909,-,1555
230,NZ_CP072667,1,964380,965935,-,1555
230,NZ_CP072671,1,964388,965943,-,1555
230,NZ_CP072668,1,964375,965930,-,1555
230,NZ_CP072666,1,964388,965943,-,1555
230,NZ_CP090902,1,964540,966095,-,1555
230,NZ_CP090948,1,964540,966095,-,1555
230,NZ_CP069052,1,845162,846716,+,1554
230,NZ_CP076228,1,1017839,1019393,+,1554
230,NZ_CP042445,1,964528,966083,-,1555
230,NZ_CP042904,1,988262,989833,-,1571
230,NC_012416,1,1027356,1028927,-,1571
230,NZ_CP069053,1,809362,810917,-,1555
230,NZ_CP042446,1,964538,966093,-,1555
230,NZ_CP041215,1,22322,23876,+,1554
230,NZ_OX366353,1,1049205,1050759,+,1554
230,NZ_OX366387,1,1537338,1538893,-,1555
230,NZ_OX366368,1,1410028,1411583,-,1555
230,NZ_OX366379,1,1329473,1331028,-,1555
230,NZ_CP091195,1,1108210,1109750,+,1540
230,NZ_OX366375,1,1246372,1247935,+,1563
230,NZ_CP046925,1,964388,965943,-,1555
230,NZ_OX366318,1,1260869,1262396,-,1527
230,NZ_OX366319,1,1190657,1192228,-,1571
230,NZ_OX366332,1,1344108,1345663,-,1555
230,NZ_CP110359,1,196861,198441,-,1580
230,NZ_OU953855,1,942070,943611,-,1541
230,NZ_OX366272,1,147567,149149,-,1582
230,NZ_OX366347,1,1407363,1408943,-,1580
230,NZ_OU909470,1,754920,756440,-,1520
230,NZ_OX366363,1,982069,983605,-,1536
230,NZ_OX366364,1,1281348,1282878,+,1530
230,NZ_OX366359,1,1173827,1175382,-,1555
230,NZ_OX366349,1,1626439,1627960,+,1521
230,NZ_OX366380,1,110906,112417,+,1511
230,NZ_OX366344,1,37040,38561,+,1521
230,NZ_CP090900,1,964540,966095,-,1555
230,NZ_OX366352,1,1667835,1669390,-,1555
230,NZ_OX366362,1,277840,279361,-,1521
230,NZ_OX366400,1,1117890,1119417,-,1527
230,NZ_OX366327,1,1257613,1259184,-,1571
230,NZ_OX366367,1,1440626,1442170,-,1544
230,NZ_CP042444,1,964975,966530,-,1555
230,NZ_OX366326,1,1470119,1471646,-,1527
230,NZ_CP037426,1,673218,674781,+,1563
230,NZ_OX366339,1,105796,107367,-,1571
230,NZ_OX366355,1,1284853,1286423,+,1570
230,NZ_CP046922,1,1026436,1027991,-,1555
230,NZ_OX366370,1,1103997,1105517,+,1520
230,NZ_OX366385,1,381038,382549,+,1511
230,NZ_OX366399,1,1363089,1364644,-,1555
230,NZ_OX366395,1,1315058,1316608,-,1550
230,NZ_OX366396,1,76896,78467,-,1571
230,NZ_OX366351,1,1413990,1415517,-,1527
230,NZ_OX366381,1,1099604,1101175,-,1571
230,NZ_OX366342,1,1493824,1495345,-,1521
230,NZ_OX366369,1,1374074,1375644,+,1570
230,NZ_OX366356,1,1126615,1128170,-,1555
230,NZ_OX366377,1,999099,1000625,+,1526
230,NZ_OX366388,1,1787703,1789253,-,1550
230,NZ_OX366357,1,182506,184042,-,1536
230,NZ_CP072012,1,1226432,1227987,-,1555
230,NZ_OX366398,1,446183,447710,-,1527
230,NC_002978,6,964540,966095,-,1555
230,NZ_OX366389,1,1342595,1344122,-,1527
230,NZ_OX366397,1,1570464,1572019,-,1555
230,NZ_OX366378,1,1277061,1278602,-,1541
230,NZ_CP090903,1,964540,966095,-,1555
230,NZ_OX366374,1,1221289,1222829,+,1540
230,NZ_CP090901,1,964540,966095,-,1555
230,NZ_CP046923,1,942684,944239,-,1555
230,NZ_CP069055,1,1076160,1077714,+,1554
230,NZ_CP072670,1,964380,965935,-,1555
230,NZ_CP090899,1,964540,966095,-,1555
230,NZ_CP046924,1,963622,965177,-,1555
230,NZ_OX366348,1,1240638,1242165,-,1527
230,NZ_CP046921,1,1026436,1027991,-,1555
230,NZ_OX366338,1,1466021,1467556,+,1535
230,NZ_CP054557,1,759457,760984,-,1527
230,NZ_CP072669,1,964388,965943,-,1555
230,NC_021089,1,993922,995477,-,1555
229,NZ_OX366376,1,684466,686334,+,1868
229,NZ_OX366393,1,244069,245936,-,1867
229,NZ_OX366372,1,887596,889463,-,1867
229,NZ_CP072672,1,541060,542835,-,1775
229,NZ_CP069060,1,1277493,1279268,-,1775
229,NZ_CP072667,1,541042,542817,-,1775
229,NZ_CP072671,1,541042,542817,-,1775
229,NZ_CP072668,1,541029,542804,-,1775
229,NZ_CP072666,1,541042,542817,-,1775
229,NZ_CP090902,1,541194,542969,-,1775
229,NZ_CP090948,1,541194,542969,-,1775
229,NZ_CP069052,1,520847,522622,-,1775
229,NZ_CP076228,1,503588,505363,-,1775
229,NZ_CP042445,1,541182,542957,-,1775
229,NZ_CP042904,1,412413,414169,+,1756
229,NC_012416,1,402970,404725,-,1755
229,NZ_CP069053,1,1154212,1155988,+,1776
229,NZ_CP042446,1,541194,542969,-,1775
229,NZ_CP041215,1,693295,695081,+,1786
229,NZ_OX366353,1,63117,64903,+,1786
229,NZ_OX366387,1,1021517,1023293,+,1776
229,NZ_OX366368,1,520874,522650,+,1776
229,NZ_OX366379,1,521919,523695,+,1776
229,NZ_CP091195,1,658660,660435,-,1775
229,NZ_OX366375,1,669209,670985,+,1776
229,NZ_CP046925,1,541042,542817,-,1775
229,NZ_OX366318,1,624447,626223,+,1776
229,NZ_OX366319,1,665572,667347,-,1775
229,NZ_OX366332,1,885790,887575,-,1785
229,NZ_CP110359,1,997174,998949,-,1775
229,NZ_OU953855,1,702538,704314,+,1776
229,NZ_OX366272,1,700542,702317,-,1775
229,NZ_OX366347,1,635852,637628,+,1776
229,NZ_OU909470,1,756586,758363,-,1777
229,NZ_OX366363,1,289850,291625,-,1775
229,NZ_OX366364,1,1120520,1122376,-,1856
229,NZ_OX366359,1,717551,719336,-,1785
229,NZ_OX366349,1,1623824,1625684,+,1860
229,NZ_OX366380,1,108982,110760,+,1778
229,NZ_OX366344,1,34425,36285,+,1860
229,NZ_CP090900,1,541194,542969,-,1775
229,NZ_OX366352,1,829776,831577,+,1801
229,NZ_OX366362,1,1276735,1278647,+,1912
229,NZ_OX366400,1,624354,626129,-,1775
229,NZ_OX366327,1,673012,674788,+,1776
229,NZ_OX366367,1,183123,184893,+,1770
229,NZ_CP042444,1,541731,543506,-,1775
229,NZ_OX366326,1,717468,719244,+,1776
229,NZ_CP037426,1,247980,249755,-,1775
229,NZ_OX366339,1,348547,350323,+,1776
229,NZ_OX366355,1,777352,779127,-,1775
229,NZ_CP046922,1,602908,604683,-,1775
229,NZ_OX366370,1,75176,77035,+,1859
229,NZ_OX366385,1,379114,380892,+,1778
229,NZ_OX366399,1,520411,522187,+,1776
229,NZ_OX366395,1,712656,714442,+,1786
229,NZ_OX366396,1,1189058,1190833,-,1775
229,NZ_OX366351,1,540253,542029,+,1776
229,NZ_OX366381,1,940137,941912,-,1775
229,NZ_OX366342,1,39538,41405,-,1867
229,NZ_OX366369,1,1113671,1115446,-,1775
229,NZ_OX366356,1,753925,755700,-,1775
229,NZ_OX366377,1,629827,631603,+,1776
229,NZ_OX366388,1,741531,743285,-,1754
229,NZ_OX366357,1,493715,495500,-,1785
229,NZ_CP072012,1,443183,444959,+,1776
229,NZ_OX366398,1,1181504,1183280,+,1776
229,NC_002978,6,541194,542969,-,1775
229,NZ_OX366389,1,697986,699762,+,1776
229,NZ_OX366397,1,735065,736851,+,1786
229,NZ_OX366378,1,749272,751047,-,1775
229,NZ_CP090903,1,541194,542969,-,1775
229,NZ_OX366374,1,11220,13100,-,1880
229,NZ_CP090901,1,541194,542969,-,1775
229,NZ_CP046923,1,519156,520931,-,1775
229,NZ_CP069055,1,240388,242164,+,1776
229,NZ_CP072670,1,541034,542809,-,1775
229,NZ_CP090899,1,541194,542969,-,1775
229,NZ_CP046924,1,540094,541869,-,1775
229,NZ_OX366348,1,729670,731445,-,1775
229,NZ_CP046921,1,602908,604683,-,1775
229,NZ_OX366338,1,1100307,1102092,+,1785
229,NZ_CP054557,1,1247710,1249486,+,1776
229,NZ_CP072669,1,541042,542817,-,1775
229,NC_021089,1,535403,537188,-,1785
228,NZ_OX366376,1,681729,684465,+,2736
228,NZ_OX366393,1,245938,248674,-,2736
228,NZ_OX366372,1,889465,892201,-,2736
228,NZ_CP072672,1,542837,545573,-,2736
228,NZ_CP069060,1,1279270,1282006,-,2736
228,NZ_CP072667,1,542819,545555,-,2736
228,NZ_CP072671,1,542819,545555,-,2736
228,NZ_CP072668,1,542806,545542,-,2736
228,NZ_CP072666,1,542819,545555,-,2736
228,NZ_CP090902,1,542971,545707,-,2736
228,NZ_CP090948,1,542971,545707,-,2736
228,NZ_CP069052,1,522624,525360,-,2736
228,NZ_CP076228,1,505365,508092,-,2727
228,NZ_CP042445,1,542959,545695,-,2736
228,NZ_CP042904,1,409676,412412,+,2736
228,NC_012416,1,404727,407463,-,2736
228,NZ_CP069053,1,1151475,1154211,+,2736
228,NZ_CP042446,1,542971,545707,-,2736
228,NZ_CP041215,1,690558,693294,+,2736
228,NZ_OX366353,1,60380,63116,+,2736
228,NZ_OX366387,1,1018780,1021516,+,2736
228,NZ_OX366368,1,518137,520873,+,2736
228,NZ_OX366379,1,519182,521918,+,2736
228,NZ_CP091195,1,660437,663173,-,2736
228,NZ_OX366375,1,666472,669208,+,2736
228,NZ_CP046925,1,542819,545555,-,2736
228,NZ_OX366318,1,621710,624446,+,2736
228,NZ_OX366319,1,667349,670085,-,2736
228,NZ_OX366332,1,887577,890313,-,2736
228,NZ_CP110359,1,998951,1001687,-,2736
228,NZ_OU953855,1,699801,702537,+,2736
228,NZ_OX366272,1,702319,705055,-,2736
228,NZ_OX366347,1,633115,635851,+,2736
228,NZ_OU909470,1,758365,761101,-,2736
228,NZ_OX366363,1,291627,294363,-,2736
228,NZ_OX366364,1,1122378,1125098,-,2720
228,NZ_OX366359,1,719338,722074,-,2736
228,NZ_OX366349,1,1621087,1623823,+,2736
228,NZ_OX366380,1,106245,108981,+,2736
228,NZ_OX366344,1,31688,34424,+,2736
228,NZ_CP090900,1,542971,545707,-,2736
228,NZ_OX366352,1,950694,953364,-,2670
228,NZ_OX366362,1,1273998,1276734,+,2736
228,NZ_OX366400,1,626131,628867,-,2736
228,NZ_OX366327,1,670275,673011,+,2736
228,NZ_OX366367,1,180402,183122,+,2720
228,NZ_CP042444,1,543508,546244,-,2736
228,NZ_OX366326,1,714731,717467,+,2736
228,NZ_CP037426,1,249757,252493,-,2736
228,NZ_OX366339,1,345810,348546,+,2736
228,NZ_OX366355,1,779129,781865,-,2736
228,NZ_CP046922,1,604685,607421,-,2736
228,NZ_OX366370,1,72464,75175,+,2711
228,NZ_OX366385,1,376374,379113,+,2739
228,NZ_OX366399,1,517674,520410,+,2736
228,NZ_OX366395,1,709919,712655,+,2736
228,NZ_OX366396,1,1190835,1193571,-,2736
228,NZ_OX366351,1,537516,540252,+,2736
228,NZ_OX366381,1,941914,944650,-,2736
228,NZ_OX366342,1,41407,44143,-,2736
228,NZ_OX366369,1,1115448,1118184,-,2736
228,NZ_OX366356,1,755702,758439,-,2737
228,NZ_OX366377,1,627090,629826,+,2736
228,NZ_OX366388,1,743287,746023,-,2736
228,NZ_OX366357,1,495502,498238,-,2736
228,NZ_CP072012,1,440446,443182,+,2736
228,NZ_OX366398,1,1178767,1181503,+,2736
228,NC_002978,6,542971,545707,-,2736
228,NZ_OX366389,1,695249,697985,+,2736
228,NZ_OX366397,1,732328,735064,+,2736
228,NZ_OX366378,1,751049,753785,-,2736
228,NZ_CP090903,1,542971,545707,-,2736
228,NZ_OX366374,1,13102,15839,-,2737
228,NZ_CP090901,1,542971,545707,-,2736
228,NZ_CP046923,1,520933,523669,-,2736
228,NZ_CP069055,1,237660,240387,+,2727
228,NZ_CP072670,1,542811,545547,-,2736
228,NZ_CP090899,1,542971,545707,-,2736
228,NZ_CP046924,1,541871,544607,-,2736
228,NZ_OX366348,1,731447,734183,-,2736
228,NZ_CP046921,1,604685,607421,-,2736
228,NZ_OX366338,1,1097570,1100306,+,2736
228,NZ_CP054557,1,1244973,1247709,+,2736
228,NZ_CP072669,1,542819,545555,-,2736
228,NC_021089,1,537190,539926,-,2736
227,NZ_OX366376,1,680452,681681,+,1229
227,NZ_OX366393,1,248722,249951,-,1229
227,NZ_OX366372,1,892249,893478,-,1229
227,NZ_CP072672,1,545635,546851,-,1216
227,NZ_CP069060,1,1282068,1283284,-,1216
227,NZ_CP072667,1,545617,546833,-,1216
227,NZ_CP072671,1,545617,546833,-,1216
227,NZ_CP072668,1,545604,546820,-,1216
227,NZ_CP072666,1,545617,546833,-,1216
227,NZ_CP090902,1,545769,546985,-,1216
227,NZ_CP090948,1,545769,546985,-,1216
227,NZ_CP069052,1,525422,526638,-,1216
227,NZ_CP076228,1,508163,509379,-,1216
227,NZ_CP042445,1,545757,546973,-,1216
227,NZ_CP042904,1,408398,409614,+,1216
227,NC_012416,1,407525,408741,-,1216
227,NZ_CP069053,1,1150197,1151413,+,1216
227,NZ_CP042446,1,545769,546985,-,1216
227,NZ_CP041215,1,689280,690496,+,1216
227,NZ_OX366353,1,59102,60318,+,1216
227,NZ_OX366387,1,1017502,1018718,+,1216
227,NZ_OX366368,1,516859,518075,+,1216
227,NZ_OX366379,1,517904,519120,+,1216
227,NZ_CP091195,1,663235,664451,-,1216
227,NZ_OX366375,1,665194,666410,+,1216
227,NZ_CP046925,1,545617,546833,-,1216
227,NZ_OX366318,1,620432,621648,+,1216
227,NZ_OX366319,1,670147,671363,-,1216
227,NZ_OX366332,1,890375,891591,-,1216
227,NZ_CP110359,1,1001749,1002965,-,1216
227,NZ_OU953855,1,698523,699739,+,1216
227,NZ_OX366272,1,705117,706333,-,1216
227,NZ_OX366347,1,631837,633053,+,1216
227,NZ_OU909470,1,761149,762378,-,1229
227,NZ_OX366363,1,294425,295641,-,1216
227,NZ_OX366364,1,1311044,1312225,-,1181
227,NZ_OX366359,1,722136,723352,-,1216
227,NZ_OX366349,1,1619810,1621039,+,1229
227,NZ_OX366380,1,104968,106197,+,1229
227,NZ_OX366344,1,30411,31640,+,1229
227,NZ_CP090900,1,545769,546985,-,1216
227,NZ_OX366352,1,953426,954642,-,1216
227,NZ_OX366362,1,1272720,1273949,+,1229
227,NZ_OX366400,1,628929,630145,-,1216
227,NZ_OX366327,1,668997,670213,+,1216
227,NZ_OX366367,1,1146982,1148163,-,1181
227,NZ_CP042444,1,546306,547522,-,1216
227,NZ_OX366326,1,713453,714669,+,1216
227,NZ_CP037426,1,252555,253771,-,1216
227,NZ_OX366339,1,344532,345748,+,1216
227,NZ_OX366355,1,781927,783143,-,1216
227,NZ_CP046922,1,607483,608699,-,1216
227,NZ_OX366370,1,1126456,1127685,+,1229
227,NZ_OX366385,1,375097,376326,+,1229
227,NZ_OX366399,1,516396,517612,+,1216
227,NZ_OX366395,1,708641,709857,+,1216
227,NZ_OX366396,1,1193633,1194849,-,1216
227,NZ_OX366351,1,536238,537454,+,1216
227,NZ_OX366381,1,944712,945928,-,1216
227,NZ_OX366342,1,44191,45420,-,1229
227,NZ_OX366369,1,1118246,1119462,-,1216
227,NZ_OX366356,1,758501,759717,-,1216
227,NZ_OX366377,1,625812,627028,+,1216
227,NZ_OX366388,1,746085,747301,-,1216
227,NZ_OX366357,1,498300,499516,-,1216
227,NZ_CP072012,1,439168,440384,+,1216
227,NZ_OX366398,1,1177489,1178705,+,1216
227,NC_002978,6,545769,546985,-,1216
227,NZ_OX366389,1,693971,695187,+,1216
227,NZ_OX366397,1,731050,732266,+,1216
227,NZ_OX366378,1,753847,755063,-,1216
227,NZ_CP090903,1,545769,546985,-,1216
227,NZ_OX366374,1,15901,17117,-,1216
227,NZ_CP090901,1,545769,546985,-,1216
227,NZ_CP046923,1,523731,524947,-,1216
227,NZ_CP069055,1,236373,237589,+,1216
227,NZ_CP072670,1,545609,546825,-,1216
227,NZ_CP090899,1,545769,546985,-,1216
227,NZ_CP046924,1,544669,545885,-,1216
227,NZ_OX366348,1,734245,735461,-,1216
227,NZ_CP046921,1,607483,608699,-,1216
227,NZ_OX366338,1,1094676,1095892,+,1216
227,NZ_CP054557,1,1243695,1244911,+,1216
227,NZ_CP072669,1,545617,546833,-,1216
227,NC_021089,1,539988,541204,-,1216
226,NZ_OX366376,1,679714,680423,+,709
226,NZ_OX366393,1,249980,250689,-,709
226,NZ_OX366372,1,893507,894216,-,709
226,NZ_CP072672,1,290866,291602,-,736
226,NZ_CP069060,1,274535,275271,-,736
226,NZ_CP072667,1,290848,291584,-,736
226,NZ_CP072671,1,290848,291584,-,736
226,NZ_CP072668,1,290848,291584,-,736
226,NZ_CP072666,1,290848,291584,-,736
226,NZ_CP090902,1,291000,291736,-,736
226,NZ_CP090948,1,291000,291736,-,736
226,NZ_CP069052,1,269200,269936,-,736
226,NZ_CP076228,1,448871,449607,+,736
226,NZ_CP042445,1,291000,291736,-,736
226,NZ_CP042904,1,494900,495636,-,736
226,NC_012416,1,498219,498955,-,736
226,NZ_CP069053,1,272006,272742,+,736
226,NZ_CP042446,1,291000,291736,-,736
226,NZ_CP041215,1,861183,861919,-,736
226,NZ_OX366353,1,327182,327918,-,736
226,NZ_OX366387,1,993520,994256,+,736
226,NZ_OX366368,1,640640,641376,-,736
226,NZ_OX366379,1,903661,904397,+,736
226,NZ_CP091195,1,258322,259058,+,736
226,NZ_OX366375,1,726010,726746,+,736
226,NZ_CP046925,1,290848,291584,-,736
226,NZ_OX366318,1,858961,859697,+,736
226,NZ_OX366319,1,554187,554923,+,736
226,NZ_OX366332,1,974543,975279,-,736
226,NZ_CP110359,1,891023,891759,+,736
226,NZ_OU953855,1,1485318,1486040,+,722
226,NZ_OX366272,1,353953,354689,+,736
226,NZ_OX366347,1,670337,671065,-,728
226,NZ_OU909470,1,762407,763118,-,711
226,NZ_OX366363,1,54309,55045,-,736
226,NZ_OX366364,1,1312254,1312964,-,710
226,NZ_OX366359,1,805087,805823,-,736
226,NZ_OX366349,1,1619072,1619781,+,709
226,NZ_OX366380,1,104228,104939,+,711
226,NZ_OX366344,1,29673,30382,+,709
226,NZ_CP090900,1,291000,291736,-,736
226,NZ_OX366352,1,735567,736303,-,736
226,NZ_OX366362,1,553347,554083,+,736
226,NZ_OX366400,1,414848,415584,+,736
226,NZ_OX366327,1,899737,900473,+,736
226,NZ_OX366367,1,1148545,1149282,-,737
226,NZ_CP042444,1,290582,291318,-,736
226,NZ_OX366326,1,954913,955649,+,736
226,NZ_CP037426,1,571895,572631,+,736
226,NZ_OX366339,1,669994,670722,-,728
226,NZ_OX366355,1,568713,569449,+,736
226,NZ_CP046922,1,290698,291434,-,736
226,NZ_OX366370,1,1125718,1126427,+,709
226,NZ_OX366385,1,374357,375068,+,711
226,NZ_OX366399,1,896724,897460,+,736
226,NZ_OX366395,1,1108750,1109486,-,736
226,NZ_OX366396,1,986133,986861,-,728
226,NZ_OX366396,1,1172366,1173096,+,730
226,NZ_OX366351,1,786579,787315,-,736
226,NZ_OX366381,1,549854,550590,-,736
226,NZ_OX366342,1,45449,46158,-,709
226,NZ_OX366369,1,617991,618727,-,736
226,NZ_OX366356,1,529664,530400,-,736
226,NZ_OX366377,1,468459,469195,+,736
226,NZ_OX366388,1,478488,479226,-,738
226,NZ_OX366357,1,1004670,1005406,+,736
226,NZ_CP072012,1,226318,227054,-,736
226,NZ_OX366398,1,41595,42331,-,736
226,NC_002978,6,291000,291736,-,736
226,NZ_OX366389,1,963927,964663,-,736
226,NZ_OX366397,1,1056023,1056759,-,736
226,NZ_OX366378,1,658117,658853,+,736
226,NZ_CP090903,1,291000,291736,-,736
226,NZ_OX366374,1,949806,950542,-,736
226,NZ_CP090901,1,291000,291736,-,736
226,NZ_CP046923,1,290698,291434,-,736
226,NZ_CP069055,1,322744,323480,-,736
226,NZ_CP072670,1,290840,291576,-,736
226,NZ_CP090899,1,291000,291736,-,736
226,NZ_CP046924,1,290698,291434,-,736
226,NZ_OX366348,1,573329,574065,+,736
226,NZ_CP046921,1,290698,291434,-,736
226,NZ_OX366338,1,789830,790566,-,736
226,NZ_CP054557,1,238175,238911,+,736
226,NZ_CP072669,1,290848,291584,-,736
226,NC_021089,1,623601,624337,-,736
225,NZ_OX366376,1,678624,679712,+,1088
225,NZ_OX366393,1,250690,251782,-,1092
225,NZ_OX366372,1,894217,895309,-,1092
225,NZ_CP072672,1,291603,292732,-,1129
225,NZ_CP069060,1,275272,276401,-,1129
225,NZ_CP072667,1,291585,292714,-,1129
225,NZ_CP072671,1,291585,292714,-,1129
225,NZ_CP072668,1,291585,292714,-,1129
225,NZ_CP072666,1,291585,292714,-,1129
225,NZ_CP090902,1,291737,292866,-,1129
225,NZ_CP090948,1,291737,292866,-,1129
225,NZ_CP069052,1,269937,271066,-,1129
225,NZ_CP076228,1,447741,448869,+,1128
225,NZ_CP042445,1,291737,292866,-,1129
225,NZ_CP042904,1,495637,496765,-,1128
225,NC_012416,1,498956,500084,-,1128
225,NZ_CP069053,1,270876,272004,+,1128
225,NZ_CP042446,1,291737,292866,-,1129
225,NZ_CP041215,1,861920,863049,-,1129
225,NZ_OX366353,1,327919,329048,-,1129
225,NZ_OX366387,1,992390,993518,+,1128
225,NZ_OX366368,1,641377,642506,-,1129
225,NZ_OX366379,1,902531,903659,+,1128
225,NZ_CP091195,1,257192,258320,+,1128
225,NZ_OX366375,1,724880,726008,+,1128
225,NZ_CP046925,1,291585,292714,-,1129
225,NZ_OX366318,1,857831,858959,+,1128
225,NZ_OX366319,1,553057,554185,+,1128
225,NZ_OX366332,1,975280,976409,-,1129
225,NZ_CP110359,1,889893,891021,+,1128
225,NZ_OU953855,1,1484188,1485316,+,1128
225,NZ_OX366272,1,352823,353951,+,1128
225,NZ_OX366347,1,671066,672195,-,1129
225,NZ_OU909470,1,763119,764209,-,1090
225,NZ_OX366363,1,55046,56175,-,1129
225,NZ_OX366364,1,1312965,1314078,-,1113
225,NZ_OX366359,1,805824,806953,-,1129
225,NZ_OX366349,1,1617979,1619070,+,1091
225,NZ_OX366380,1,103137,104226,+,1089
225,NZ_OX366344,1,28580,29671,+,1091
225,NZ_CP090900,1,291737,292866,-,1129
225,NZ_OX366352,1,736304,737433,-,1129
225,NZ_OX366362,1,552232,553345,+,1113
225,NZ_OX366400,1,413718,414846,+,1128
225,NZ_OX366327,1,898619,899735,+,1116
225,NZ_OX366367,1,1149283,1150396,-,1113
225,NZ_CP042444,1,291319,292448,-,1129
225,NZ_OX366326,1,953783,954911,+,1128
225,NZ_CP037426,1,570765,571893,+,1128
225,NZ_OX366339,1,670723,671852,-,1129
225,NZ_OX366355,1,567583,568711,+,1128
225,NZ_CP046922,1,291435,292564,-,1129
225,NZ_OX366370,1,1124640,1125716,+,1076
225,NZ_OX366385,1,373266,374355,+,1089
225,NZ_OX366399,1,895594,896722,+,1128
225,NZ_OX366395,1,1109487,1110616,-,1129
225,NZ_OX366396,1,986862,987991,-,1129
225,NZ_OX366351,1,787316,788445,-,1129
225,NZ_OX366381,1,550591,551720,-,1129
225,NZ_OX366342,1,46159,47251,-,1092
225,NZ_OX366369,1,618728,619857,-,1129
225,NZ_OX366356,1,530401,531530,-,1129
225,NZ_OX366377,1,467329,468457,+,1128
225,NZ_OX366388,1,479227,480354,-,1127
225,NZ_OX366357,1,1003540,1004668,+,1128
225,NZ_CP072012,1,227055,228184,-,1129
225,NZ_OX366398,1,42332,43461,-,1129
225,NC_002978,6,291737,292866,-,1129
225,NZ_OX366389,1,964664,965793,-,1129
225,NZ_OX366397,1,1056760,1057889,-,1129
225,NZ_OX366378,1,656987,658115,+,1128
225,NZ_CP090903,1,291737,292866,-,1129
225,NZ_OX366374,1,950543,951672,-,1129
225,NZ_CP090901,1,291737,292866,-,1129
225,NZ_CP046923,1,291435,292564,-,1129
225,NZ_CP069055,1,323481,324610,-,1129
225,NZ_CP072670,1,291577,292706,-,1129
225,NZ_CP090899,1,291737,292866,-,1129
225,NZ_CP046924,1,291435,292564,-,1129
225,NZ_OX366348,1,572199,573327,+,1128
225,NZ_CP046921,1,291435,292564,-,1129
225,NZ_OX366338,1,790567,791696,-,1129
225,NZ_CP054557,1,237045,238173,+,1128
225,NZ_CP072669,1,291585,292714,-,1129
225,NC_021089,1,624338,625467,-,1129
224,NZ_OX366376,1,676371,677577,+,1206
224,NZ_OX366393,1,252829,254035,-,1206
224,NZ_OX366372,1,896356,897562,-,1206
224,NZ_CP072672,1,919797,921003,-,1206
224,NZ_CP069060,1,724438,725644,-,1206
224,NZ_CP072667,1,919771,920977,-,1206
224,NZ_CP072671,1,919779,920985,-,1206
224,NZ_CP072668,1,919766,920972,-,1206
224,NZ_CP072666,1,919779,920985,-,1206
224,NZ_CP090902,1,919931,921137,-,1206
224,NZ_CP090948,1,919931,921137,-,1206
224,NZ_CP069052,1,909993,911199,-,1206
224,NZ_CP076228,1,962745,963951,-,1206
224,NZ_CP042445,1,919919,921125,-,1206
224,NZ_CP042904,1,940314,941520,-,1206
224,NC_012416,1,975897,977103,-,1206
224,NZ_CP069053,1,744880,746086,+,1206
224,NZ_CP042446,1,919929,921135,-,1206
224,NZ_CP041215,1,135187,136393,-,1206
224,NZ_OX366353,1,1230255,1231461,+,1206
224,NZ_OX366387,1,1721994,1723197,-,1203
224,NZ_OX366368,1,1365319,1366525,-,1206
224,NZ_OX366379,1,1284812,1286018,-,1206
224,NZ_CP091195,1,1149383,1150589,+,1206
224,NZ_OX366375,1,1143015,1144221,-,1206
224,NZ_CP046925,1,919779,920985,-,1206
224,NZ_OX366318,1,1218079,1219285,-,1206
224,NZ_OX366319,1,1147411,1148617,-,1206
224,NZ_OX366332,1,1302782,1303988,-,1206
224,NZ_CP110359,1,172713,173919,+,1206
224,NZ_OU953855,1,650776,651982,+,1206
224,NZ_OX366272,1,123832,125038,-,1206
224,NZ_OX366347,1,1364129,1365335,-,1206
224,NZ_OU909470,1,765177,766383,-,1206
224,NZ_OX366363,1,940626,941832,-,1206
224,NZ_OX366364,1,1103305,1104511,-,1206
224,NZ_OX366359,1,1132589,1133795,-,1206
224,NZ_OX366349,1,1615743,1616949,+,1206
224,NZ_OX366380,1,136170,137376,-,1206
224,NZ_OX366344,1,26336,27542,+,1206
224,NZ_CP090900,1,919931,921137,-,1206
224,NZ_OX366352,1,152303,153509,+,1206
224,NZ_OX366362,1,53298,54504,-,1206
224,NZ_OX366400,1,1074995,1076201,-,1206
224,NZ_OX366327,1,1215607,1216813,-,1206
224,NZ_OX366367,1,200655,201861,+,1206
224,NZ_CP042444,1,920366,921572,-,1206
224,NZ_OX366326,1,1426640,1427846,-,1206
224,NZ_CP037426,1,785295,786501,+,1206
224,NZ_OX366339,1,1146429,1147635,-,1206
224,NZ_OX366339,1,1150259,1151465,+,1206
224,NZ_OX366355,1,138265,139471,+,1206
224,NZ_CP046922,1,981827,983033,-,1206
224,NZ_OX366370,1,1122365,1123571,+,1206
224,NZ_OX366385,1,369276,370482,+,1206
224,NZ_OX366399,1,1318428,1319634,-,1206
224,NZ_OX366395,1,1177489,1178695,-,1206
224,NZ_OX366396,1,158384,159590,-,1206
224,NZ_OX366351,1,1372216,1373422,-,1206
224,NZ_OX366381,1,1055520,1056726,-,1206
224,NZ_OX366342,1,48298,49504,-,1206
224,NZ_OX366369,1,1417660,1418866,+,1206
224,NZ_OX366356,1,1056614,1057820,+,1206
224,NZ_OX366377,1,1046153,1047359,+,1206
224,NZ_OX366388,1,1684361,1685567,+,1206
224,NZ_OX366357,1,1309140,1310346,+,1206
224,NZ_CP072012,1,269756,270962,-,1206
224,NZ_OX366398,1,401983,403189,-,1206
224,NC_002978,6,919931,921137,-,1206
224,NZ_OX366389,1,1297043,1298249,-,1206
224,NZ_OX366397,1,1529114,1530320,-,1206
224,NZ_OX366378,1,1236260,1237466,-,1206
224,NZ_CP090903,1,919931,921137,-,1206
224,NZ_OX366374,1,192331,193537,+,1206
224,NZ_CP090901,1,919931,921137,-,1206
224,NZ_CP046923,1,898075,899281,-,1206
224,NZ_CP069055,1,924031,925237,+,1206
224,NZ_CP072670,1,919771,920977,-,1206
224,NZ_CP090899,1,919931,921137,-,1206
224,NZ_CP046924,1,919013,920219,-,1206
224,NZ_OX366348,1,1198889,1200095,-,1206
224,NZ_CP046921,1,981827,983033,-,1206
224,NZ_OX366338,1,930760,931966,-,1206
224,NZ_CP054557,1,922544,923750,+,1206
224,NZ_CP072669,1,919779,920985,-,1206
224,NC_021089,1,952594,953800,-,1206
223,NZ_OX366376,1,671809,672902,+,1093
223,NZ_OX366393,1,257504,258597,-,1093
223,NZ_OX366372,1,901019,902112,-,1093
223,NZ_OX366349,1,855451,856545,-,1094
223,NZ_OX366362,1,126705,127792,+,1087
223,NZ_OX366342,1,847688,848781,-,1093
222,NZ_OX366376,1,670902,671808,+,906
222,NZ_OX366376,1,1178358,1179261,+,903
222,NZ_OX366393,1,258599,259505,-,906
222,NZ_OX366393,1,805427,806330,-,903
222,NZ_OX366372,1,902114,903020,-,906
222,NZ_OX366349,1,856547,857453,-,906
222,NZ_OX366362,1,125799,126704,+,905
222,NZ_OX366327,1,298510,299421,-,911
222,NZ_OX366370,1,831364,832269,+,905
222,NZ_OX366370,1,952557,953462,+,905
222,NZ_OX366342,1,848783,849689,-,906
221,NZ_OX366376,1,666661,670669,+,4008
221,NZ_OX366393,1,259737,263746,-,4009
221,NZ_OX366372,1,903252,907260,-,4008
221,NZ_OX366349,1,857685,861694,-,4009
221,NZ_OX366342,1,849921,853931,-,4010
220,NZ_OX366376,1,661983,663218,+,1235
220,NZ_OX366393,1,265273,266482,-,1209
220,NZ_OX366349,1,863213,864430,-,1217
219,NZ_OX366376,1,660930,661873,+,943
219,NZ_OX366393,1,1265036,1265970,+,934
219,NZ_OX366342,1,57887,58821,+,934
218,NZ_OX366376,1,656175,659928,+,3753
218,NZ_OX366393,1,1260281,1264034,+,3753
218,NZ_OX366342,1,53137,56885,+,3748
217,NZ_OX366376,1,651253,653065,+,1812
217,NZ_OX366393,1,1158131,1159943,-,1812
217,NZ_OX366372,1,915470,917282,+,1812
217,NZ_CP072672,1,146477,148300,-,1823
217,NZ_CP069060,1,156715,158538,-,1823
217,NZ_CP072667,1,146459,148282,-,1823
217,NZ_CP072671,1,146459,148282,-,1823
217,NZ_CP072668,1,146459,148282,-,1823
217,NZ_CP072666,1,146459,148282,-,1823
217,NZ_CP090902,1,146611,148434,-,1823
217,NZ_CP090948,1,146611,148434,-,1823
217,NZ_CP069052,1,81593,83416,+,1823
217,NZ_CP076228,1,149718,151541,-,1823
217,NZ_CP042445,1,146611,148434,-,1823
217,NZ_CP042904,1,90160,91983,+,1823
217,NC_012416,1,92741,94564,+,1823
217,NZ_CP069053,1,388739,390562,+,1823
217,NZ_CP042446,1,146611,148434,-,1823
217,NZ_CP041215,1,429937,431760,+,1823
217,NZ_OX366353,1,151865,153688,-,1823
217,NZ_OX366387,1,1294477,1296300,+,1823
217,NZ_OX366368,1,425390,427213,-,1823
217,NZ_OX366379,1,426408,428231,-,1823
217,NZ_CP091195,1,731874,733697,-,1823
217,NZ_OX366375,1,389398,391221,-,1823
217,NZ_CP046925,1,146459,148282,-,1823
217,NZ_OX366318,1,474088,475911,+,1823
217,NZ_OX366319,1,787879,789702,-,1823
217,NZ_OX366332,1,367478,369301,-,1823
217,NZ_CP110359,1,1144308,1146131,-,1823
217,NZ_OU953855,1,329042,330865,-,1823
217,NZ_OX366272,1,806832,808655,+,1823
217,NZ_OX366347,1,481635,483458,+,1823
217,NZ_OU909470,1,448763,450586,-,1823
217,NZ_OX366363,1,550846,552669,-,1823
217,NZ_OX366364,1,958919,960742,-,1823
217,NZ_OX366359,1,411585,413408,+,1823
217,NZ_OX366349,1,36521,38333,+,1812
217,NZ_OX366380,1,333093,334916,-,1823
217,NZ_OX366344,1,1027423,1029246,+,1823
217,NZ_CP090900,1,146611,148434,-,1823
217,NZ_OX366352,1,341220,343043,-,1823
217,NZ_OX366362,1,65376,67199,+,1823
217,NZ_OX366400,1,343830,345653,+,1823
217,NZ_OX366327,1,520590,522413,+,1823
217,NZ_OX366367,1,593731,595554,+,1823
217,NZ_CP042444,1,146549,148372,-,1823
217,NZ_OX366326,1,419338,421161,-,1823
217,NZ_CP037426,1,505766,507589,-,1823
217,NZ_OX366339,1,176036,177859,-,1823
217,NZ_OX366355,1,934134,935957,-,1823
217,NZ_CP046922,1,146304,148127,-,1823
217,NZ_OX366370,1,928700,930523,+,1823
217,NZ_OX366385,1,307123,308946,-,1823
217,NZ_OX366399,1,424892,426715,-,1823
217,NZ_OX366395,1,1060352,1062175,-,1823
217,NZ_OX366396,1,939264,941087,-,1823
217,NZ_OX366351,1,387944,389767,+,1823
217,NZ_OX366381,1,65688,67511,-,1823
217,NZ_OX366342,1,201918,203730,+,1812
217,NZ_OX366369,1,371312,373135,+,1823
217,NZ_OX366356,1,395500,397323,-,1823
217,NZ_OX366377,1,796946,798769,-,1823
217,NZ_OX366388,1,1300340,1302163,+,1823
217,NZ_OX366357,1,1186245,1188053,-,1808
217,NZ_CP072012,1,347794,349617,-,1823
217,NZ_OX366398,1,1083805,1085628,-,1823
217,NC_002978,6,146611,148434,-,1823
217,NZ_OX366389,1,593963,595786,-,1823
217,NZ_OX366397,1,370112,371935,-,1823
217,NZ_OX366378,1,1058171,1059994,-,1823
217,NZ_CP090903,1,146611,148434,-,1823
217,NZ_OX366374,1,1055284,1057107,-,1823
217,NZ_CP090901,1,146611,148434,-,1823
217,NZ_CP046923,1,146304,148127,-,1823
217,NZ_CP069055,1,77730,79553,+,1823
217,NZ_CP072670,1,146459,148282,-,1823
217,NZ_CP090899,1,146611,148434,-,1823
217,NZ_CP046924,1,146304,148127,-,1823
217,NZ_OX366348,1,879840,881663,-,1823
217,NZ_CP046921,1,146304,148127,-,1823
217,NZ_OX366338,1,1106624,1108447,+,1823
217,NZ_CP054557,1,497023,498846,+,1823
217,NZ_CP072669,1,146459,148282,-,1823
217,NC_021089,1,86305,88128,-,1823
216,NZ_OX366376,1,648708,651059,+,2351
216,NZ_OX366393,1,1160137,1162488,-,2351
216,NZ_OX366372,1,912925,915276,+,2351
216,NZ_CP072672,1,148494,150856,-,2362
216,NZ_CP069060,1,158732,161093,-,2361
216,NZ_CP072667,1,148476,150838,-,2362
216,NZ_CP072671,1,148476,150838,-,2362
216,NZ_CP072668,1,148476,150838,-,2362
216,NZ_CP072666,1,148476,150838,-,2362
216,NZ_CP090902,1,148628,150990,-,2362
216,NZ_CP090948,1,148628,150990,-,2362
216,NZ_CP069052,1,79038,81399,+,2361
216,NZ_CP076228,1,151735,154097,-,2362
216,NZ_CP042445,1,148628,150990,-,2362
216,NZ_CP042904,1,87604,89962,+,2358
216,NC_012416,1,90185,92543,+,2358
216,NZ_CP069053,1,386184,388545,+,2361
216,NZ_CP042446,1,148628,150990,-,2362
216,NZ_CP041215,1,427381,429743,+,2362
216,NZ_OX366353,1,153882,156244,-,2362
216,NZ_OX366387,1,1291921,1294283,+,2362
216,NZ_OX366368,1,427407,429769,-,2362
216,NZ_OX366379,1,428425,430787,-,2362
216,NZ_CP091195,1,733891,736253,-,2362
216,NZ_OX366375,1,391415,393777,-,2362
216,NZ_CP046925,1,148476,150838,-,2362
216,NZ_OX366318,1,470928,473286,+,2358
216,NZ_OX366319,1,789896,792258,-,2362
216,NZ_OX366332,1,369495,371857,-,2362
216,NZ_CP110359,1,1146325,1148687,-,2362
216,NZ_OU953855,1,331059,333421,-,2362
216,NZ_OX366272,1,804276,806638,+,2362
216,NZ_OX366347,1,479079,481441,+,2362
216,NZ_OU909470,1,450780,453131,-,2351
216,NZ_OX366363,1,552863,555225,-,2362
216,NZ_OX366364,1,960940,963287,-,2347
216,NZ_OX366359,1,409029,411391,+,2362
216,NZ_OX366349,1,33976,36327,+,2351
216,NZ_OX366380,1,335110,337461,-,2351
216,NZ_OX366344,1,1024878,1027229,+,2351
216,NZ_CP090900,1,148628,150990,-,2362
216,NZ_OX366352,1,343237,345599,-,2362
216,NZ_OX366362,1,62820,65182,+,2362
216,NZ_OX366400,1,340670,343028,+,2358
216,NZ_OX366327,1,518034,520396,+,2362
216,NZ_OX366367,1,591186,593533,+,2347
216,NZ_CP042444,1,148566,150928,-,2362
216,NZ_OX366326,1,421944,424302,-,2358
216,NZ_CP037426,1,507783,510145,-,2362
216,NZ_OX366339,1,178053,180415,-,2362
216,NZ_OX366355,1,936151,938513,-,2362
216,NZ_CP046922,1,148321,150683,-,2362
216,NZ_OX366370,1,926155,928506,+,2351
216,NZ_OX366385,1,309140,311491,-,2351
216,NZ_OX366399,1,426909,429271,-,2362
216,NZ_OX366395,1,1062369,1064731,-,2362
216,NZ_OX366396,1,941281,943643,-,2362
216,NZ_OX366351,1,384784,387142,+,2358
216,NZ_OX366381,1,67705,70067,-,2362
216,NZ_OX366342,1,199373,201724,+,2351
216,NZ_OX366369,1,368756,371118,+,2362
216,NZ_OX366356,1,397517,399879,-,2362
216,NZ_OX366377,1,799571,801929,-,2358
216,NZ_OX366388,1,1297784,1300146,+,2362
216,NZ_OX366357,1,1188262,1190624,-,2362
216,NZ_CP072012,1,349811,352173,-,2362
216,NZ_OX366398,1,1086430,1088788,-,2358
216,NC_002978,6,148628,150990,-,2362
216,NZ_OX366389,1,596588,598946,-,2358
216,NZ_OX366397,1,372129,374491,-,2362
216,NZ_OX366378,1,1060188,1062550,-,2362
216,NZ_CP090903,1,148628,150990,-,2362
216,NZ_OX366374,1,1057301,1059663,-,2362
216,NZ_CP090901,1,148628,150990,-,2362
216,NZ_CP046923,1,148321,150683,-,2362
216,NZ_CP069055,1,75174,77536,+,2362
216,NZ_CP072670,1,148476,150838,-,2362
216,NZ_CP090899,1,148628,150990,-,2362
216,NZ_CP046924,1,148321,150683,-,2362
216,NZ_OX366348,1,882465,884823,-,2358
216,NZ_CP046921,1,148321,150683,-,2362
216,NZ_OX366338,1,1104068,1106430,+,2362
216,NZ_CP054557,1,493882,496240,+,2358
216,NZ_CP072669,1,148476,150838,-,2362
216,NC_021089,1,88322,90676,-,2354
215,NZ_OX366376,1,646307,648600,+,2293
215,NZ_OX366393,1,1162596,1164889,-,2293
215,NZ_OX366372,1,910524,912817,+,2293
215,NZ_CP072672,1,51948,54225,+,2277
215,NZ_CP069060,1,54386,56662,-,2276
215,NZ_CP072667,1,51948,54225,+,2277
215,NZ_CP072671,1,51948,54225,+,2277
215,NZ_CP072668,1,51948,54225,+,2277
215,NZ_CP072666,1,51948,54225,+,2277
215,NZ_CP090902,1,52100,54377,+,2277
215,NZ_CP090948,1,52100,54377,+,2277
215,NZ_CP069052,1,53994,56271,+,2277
215,NZ_CP076228,1,52898,55175,+,2277
215,NZ_CP042445,1,52100,54377,+,2277
215,NZ_CP042904,1,49316,51593,+,2277
215,NC_012416,1,49317,51594,+,2277
215,NZ_CP069053,1,54386,56662,-,2276
215,NZ_CP042446,1,52100,54377,+,2277
215,NZ_CP041215,1,468028,470318,-,2290
215,NZ_OX366353,1,350675,352952,+,2277
215,NZ_OX366387,1,1334374,1336650,-,2276
215,NZ_OX366368,1,333172,335449,+,2277
215,NZ_OX366379,1,334190,336467,+,2277
215,NZ_CP091195,1,960254,962525,+,2271
215,NZ_OX366375,1,433992,436282,-,2290
215,NZ_CP046925,1,51948,54225,+,2277
215,NZ_OX366318,1,428258,430535,+,2277
215,NZ_OX366319,1,863965,866241,-,2276
215,NZ_OX366332,1,329890,332167,+,2277
215,NZ_CP110359,1,50515,52792,+,2277
215,NZ_OU953855,1,1337048,1339318,-,2270
215,NZ_OX366272,1,437245,439522,+,2277
215,NZ_OX366347,1,441770,444047,+,2277
215,NZ_OU909470,1,453232,455502,-,2270
215,NZ_OX366363,1,598222,600497,-,2275
215,NZ_OX366364,1,963395,965688,-,2293
215,NZ_OX366359,1,328799,331076,+,2277
215,NZ_OX366349,1,31587,33868,+,2281
215,NZ_OX366380,1,337562,339846,-,2284
215,NZ_OX366344,1,1022489,1024770,+,2281
215,NZ_CP090900,1,52100,54377,+,2277
215,NZ_OX366352,1,1002453,1004729,-,2276
215,NZ_OX366362,1,1316553,1318831,+,2278
215,NZ_OX366400,1,761037,763314,+,2277
215,NZ_OX366327,1,481263,483540,+,2277
215,NZ_OX366367,1,588801,591085,+,2284
215,NZ_CP042444,1,52101,54378,+,2277
215,NZ_OX366326,1,457315,459591,-,2276
215,NZ_CP037426,1,547604,549880,-,2276
215,NZ_OX366339,1,135707,137984,+,2277
215,NZ_OX366355,1,978519,980795,-,2276
215,NZ_CP046922,1,51943,54211,+,2268
215,NZ_OX366370,1,923765,926047,+,2282
215,NZ_OX366385,1,311592,313876,-,2284
215,NZ_OX366399,1,332674,334951,+,2277
215,NZ_OX366395,1,775397,777674,+,2277
215,NZ_OX366396,1,387980,390270,-,2290
215,NZ_OX366351,1,348062,350339,+,2277
215,NZ_OX366381,1,1398580,1400857,+,2277
215,NZ_OX366342,1,196972,199265,+,2293
215,NZ_OX366369,1,328949,331226,+,2277
215,NZ_OX366356,1,361099,363380,+,2281
215,NZ_OX366377,1,207932,210208,-,2276
215,NZ_OX366388,1,1447893,1450169,-,2276
215,NZ_OX366357,1,49753,52029,+,2276
215,NZ_CP072012,1,982511,984787,-,2276
215,NZ_OX366398,1,854271,856547,-,2276
215,NC_002978,6,52100,54377,+,2277
215,NZ_OX366389,1,394362,396639,+,2277
215,NZ_OX366397,1,330178,332446,+,2268
215,NZ_OX366378,1,953221,955491,-,2270
215,NZ_CP090903,1,52100,54377,+,2277
215,NZ_OX366374,1,1097006,1099282,-,2276
215,NZ_CP090901,1,52100,54377,+,2277
215,NZ_CP046923,1,51943,54211,+,2268
215,NZ_CP069055,1,50071,52339,+,2268
215,NZ_CP072670,1,51948,54225,+,2277
215,NZ_CP090899,1,52100,54377,+,2277
215,NZ_CP046924,1,51943,54211,+,2268
215,NZ_OX366348,1,916412,918688,-,2276
215,NZ_CP046921,1,51943,54211,+,2268
215,NZ_OX366338,1,149542,151819,+,2277
215,NZ_CP054557,1,456845,459122,+,2277
215,NZ_CP072669,1,51948,54225,+,2277
215,NC_021089,1,48920,51197,+,2277
214,NZ_OX366376,1,621871,622410,+,539
214,NZ_OX366393,1,917335,917874,-,539
214,NZ_OX366387,1,260917,261448,-,531
214,NZ_OX366387,1,325547,326078,-,531
214,NZ_CP091195,1,390167,390705,+,538
214,NZ_OU953855,1,1087911,1088450,+,539
214,NZ_OX366347,1,1113795,1114335,+,540
214,NZ_OX366364,1,608150,608689,+,539
214,NZ_OX366344,1,111107,111646,+,539
214,NZ_OX366344,1,768310,768849,+,539
214,NZ_OX366352,1,867515,868054,+,539
214,NZ_OX366362,1,685600,686140,+,540
214,NZ_OX366399,1,597567,598106,+,539
214,NZ_OX366342,1,171108,171646,+,538
214,NZ_OX366369,1,1049908,1050447,-,539
214,NZ_OX366356,1,829107,829646,-,539
214,NZ_OX366357,1,935816,936356,-,540
214,NC_021089,1,448643,449174,-,531
213,NZ_OX366376,1,611656,612994,+,1338
213,NZ_OX366393,1,926742,928081,-,1339
213,NZ_CP042904,1,687505,688844,-,1339
213,NC_012416,1,749393,750731,+,1338
213,NZ_CP041215,1,301470,302803,+,1333
213,NZ_OX366353,1,994857,996196,-,1339
213,NZ_OX366353,1,1359197,1360536,-,1339
213,NZ_OX366368,1,1094506,1095844,+,1338
213,NZ_OX366375,1,867888,869226,+,1338
213,NZ_OX366272,1,960335,961668,-,1333
213,NZ_OX366352,1,280203,281541,+,1338
213,NZ_OX366367,1,983663,985002,-,1339
213,NZ_OX366326,1,1153107,1154445,+,1338
213,NZ_OX366395,1,1429544,1430883,-,1339
213,NZ_OX366351,1,1101992,1103330,+,1338
213,NZ_OX366342,1,160892,162230,+,1338
213,NZ_OX366388,1,1026365,1027703,+,1338
213,NZ_CP072012,1,1528091,1529430,-,1339
213,NZ_OX366397,1,899374,900712,+,1338
212,NZ_OX366376,1,610074,611654,+,1580
212,NZ_OX366393,1,928082,929642,-,1560
212,NZ_CP042904,1,688845,690426,-,1581
212,NC_012416,1,747811,749391,+,1580
212,NZ_CP041215,1,1020723,1022307,-,1584
212,NZ_OX366353,1,996197,997778,-,1581
212,NZ_OX366353,1,1360537,1362118,-,1581
212,NZ_OX366368,1,1092924,1094504,+,1580
212,NZ_OX366375,1,866306,867886,+,1580
212,NZ_OX366272,1,963920,965506,-,1586
212,NZ_OX366352,1,278621,280201,+,1580
212,NZ_OX366367,1,985003,986584,-,1581
212,NZ_OX366326,1,1151525,1153105,+,1580
212,NZ_OX366395,1,1430884,1432465,-,1581
212,NZ_OX366351,1,1100410,1101990,+,1580
212,NZ_OX366342,1,159310,160890,+,1580
212,NZ_OX366388,1,1024783,1026363,+,1580
212,NZ_CP072012,1,1529431,1531012,-,1581
212,NZ_OX366397,1,897814,899372,+,1558
211,NZ_OX366376,1,604478,610060,+,5582
211,NZ_OX366393,1,929656,935238,-,5582
211,NZ_CP042904,1,690443,696022,-,5579
211,NC_012416,1,742215,747794,+,5579
211,NZ_CP041215,1,1023180,1028759,-,5579
211,NZ_OX366353,1,997792,1003374,-,5582
211,NZ_OX366353,1,1362132,1367714,-,5582
211,NZ_OX366368,1,1087328,1092907,+,5579
211,NZ_OX366375,1,860710,866292,+,5582
211,NZ_OX366272,1,965520,971102,-,5582
211,NZ_OX366352,1,273025,278607,+,5582
211,NZ_OX366367,1,986598,992180,-,5582
211,NZ_OX366326,1,1145929,1151511,+,5582
211,NZ_OX366395,1,1432479,1438061,-,5582
211,NZ_OX366351,1,1094814,1100396,+,5582
211,NZ_OX366342,1,153714,159296,+,5582
211,NZ_OX366388,1,1019187,1024769,+,5582
211,NZ_CP072012,1,1531026,1536608,-,5582
211,NZ_OX366397,1,892218,897800,+,5582
210,NZ_OX366376,1,602761,603881,+,1120
210,NZ_OX366393,1,935835,936954,-,1119
210,NZ_CP072672,1,592565,593702,-,1137
210,NZ_CP069060,1,1162467,1163605,+,1138
210,NZ_CP072667,1,592547,593684,-,1137
210,NZ_CP072671,1,592547,593684,-,1137
210,NZ_CP072668,1,592534,593671,-,1137
210,NZ_CP072666,1,592547,593684,-,1137
210,NZ_CP090902,1,592699,593836,-,1137
210,NZ_CP090948,1,592699,593836,-,1137
210,NZ_CP069052,1,574179,575316,-,1137
210,NZ_CP042445,1,592687,593824,-,1137
210,NZ_CP042904,1,1076239,1077376,-,1137
210,NC_012416,1,613827,614964,-,1137
210,NC_012416,1,1120286,1121423,-,1137
210,NZ_CP069053,1,1210071,1211208,-,1137
210,NZ_CP042446,1,592699,593836,-,1137
210,NZ_CP041215,1,1029356,1030465,-,1109
210,NZ_OX366353,1,1005145,1006264,-,1119
210,NZ_OX366353,1,1369485,1370604,-,1119
210,NZ_OX366368,1,968923,970060,-,1137
210,NZ_OX366379,1,967457,968594,-,1137
210,NZ_CP091195,1,383225,384363,+,1138
210,NZ_CP091195,1,615487,616625,+,1138
210,NZ_OX366375,1,858994,860113,+,1119
210,NZ_CP046925,1,592547,593684,-,1137
210,NZ_OX366318,1,208421,209558,-,1137
210,NZ_OX366318,1,229042,230179,-,1137
210,NZ_OX366318,1,920876,922014,+,1138
210,NZ_OX366332,1,530227,531365,+,1138
210,NZ_CP110359,1,663815,664952,-,1137
210,NZ_OU953855,1,1299137,1300256,+,1119
210,NZ_OX366347,1,1128565,1129685,+,1120
210,NZ_OU909470,1,1165479,1166617,+,1138
210,NZ_OX366359,1,679705,680842,-,1137
210,NZ_OX366349,1,193179,194297,-,1118
210,NZ_OX366349,1,1106108,1107227,+,1119
210,NZ_CP090900,1,592699,593836,-,1137
210,NZ_OX366362,1,1444675,1445700,-,1025
210,NZ_OX366327,1,342243,343381,+,1138
210,NZ_OX366327,1,420186,421324,+,1138
210,NZ_OX366367,1,993951,994993,-,1042
210,NZ_CP042444,1,593236,594373,-,1137
210,NZ_OX366326,1,255757,256876,+,1119
210,NZ_OX366326,1,615055,616194,+,1139
210,NZ_CP046922,1,654413,655550,-,1137
210,NZ_OX366399,1,960655,961792,-,1137
210,NZ_OX366396,1,286473,287591,-,1118
210,NZ_OX366351,1,819223,820341,-,1118
210,NZ_OX366351,1,987827,988965,+,1138
210,NZ_OX366381,1,497906,499026,+,1120
210,NZ_OX366381,1,780564,781683,-,1119
210,NZ_OX366342,1,20904,22023,-,1119
210,NZ_OX366342,1,1161200,1162320,+,1120
210,NZ_OX366369,1,879118,880237,-,1119
210,NZ_OX366388,1,947461,948581,+,1120
210,NZ_OX366388,1,1017471,1018590,+,1119
210,NZ_OX366388,1,1176706,1177825,-,1119
210,NZ_OX366388,1,1227690,1228808,-,1118
210,NZ_OX366357,1,937661,938702,-,1041
210,NZ_CP072012,1,49,1116,-,1067
210,NZ_CP072012,1,97406,98526,+,1120
210,NC_002978,6,592699,593836,-,1137
210,NZ_OX366389,1,30868,31987,+,1119
210,NZ_OX366397,1,493206,494326,+,1120
210,NZ_OX366397,1,889327,890447,+,1120
210,NZ_OX366397,1,1255054,1256173,+,1119
210,NZ_CP090903,1,592699,593836,-,1137
210,NZ_CP090901,1,592699,593836,-,1137
210,NZ_CP046923,1,570661,571798,-,1137
210,NZ_CP069055,1,646458,647595,-,1137
210,NZ_CP072670,1,592539,593676,-,1137
210,NZ_CP090899,1,592699,593836,-,1137
210,NZ_CP046924,1,591599,592736,-,1137
210,NZ_CP046921,1,654413,655550,-,1137
210,NZ_CP072669,1,592547,593684,-,1137
210,NC_021089,1,249476,250614,+,1138
209,NZ_OX366376,1,601926,602760,+,834
209,NZ_OX366393,1,936956,937790,-,834
209,NZ_CP072672,1,593704,594544,-,840
209,NZ_CP069060,1,1161626,1162466,+,840
209,NZ_CP072667,1,593686,594526,-,840
209,NZ_CP072671,1,593686,594526,-,840
209,NZ_CP072668,1,593673,594513,-,840
209,NZ_CP072666,1,593686,594526,-,840
209,NZ_CP090902,1,593838,594678,-,840
209,NZ_CP090948,1,593838,594678,-,840
209,NZ_CP069052,1,575318,576158,-,840
209,NZ_CP042445,1,593826,594666,-,840
209,NZ_CP042904,1,1077378,1078218,-,840
209,NC_012416,1,614966,615806,-,840
209,NC_012416,1,1121425,1122265,-,840
209,NZ_CP069053,1,1211210,1212050,-,840
209,NZ_CP042446,1,593838,594678,-,840
209,NZ_CP041215,1,1030467,1031301,-,834
209,NZ_OX366353,1,1006266,1007100,-,834
209,NZ_OX366353,1,1370606,1371440,-,834
209,NZ_OX366368,1,970062,970902,-,840
209,NZ_OX366379,1,968596,969436,-,840
209,NZ_CP091195,1,382384,383224,+,840
209,NZ_CP091195,1,614646,615486,+,840
209,NZ_OX366375,1,858159,858993,+,834
209,NZ_CP046925,1,593686,594526,-,840
209,NZ_OX366318,1,209560,210400,-,840
209,NZ_OX366318,1,230181,231021,-,840
209,NZ_OX366318,1,920035,920875,+,840
209,NZ_OX366332,1,529386,530226,+,840
209,NZ_CP110359,1,664954,665794,-,840
209,NZ_OU953855,1,1298302,1299136,+,834
209,NZ_OX366347,1,1127730,1128564,+,834
209,NZ_OU909470,1,1164638,1165478,+,840
209,NZ_OX366359,1,680844,681684,-,840
209,NZ_OX366349,1,194299,195133,-,834
209,NZ_OX366349,1,1105273,1106107,+,834
209,NZ_CP090900,1,593838,594678,-,840
209,NZ_OX366362,1,1445803,1446630,-,827
209,NZ_OX366327,1,341402,342242,+,840
209,NZ_OX366327,1,419345,420185,+,840
209,NZ_OX366367,1,995079,995906,-,827
209,NZ_CP042444,1,594375,595215,-,840
209,NZ_OX366326,1,254922,255756,+,834
209,NZ_OX366326,1,614214,615054,+,840
209,NZ_CP037426,1,238109,238943,+,834
209,NZ_CP046922,1,655552,656392,-,840
209,NZ_OX366399,1,961794,962634,-,840
209,NZ_OX366396,1,287593,288427,-,834
209,NZ_OX366351,1,820343,821177,-,834
209,NZ_OX366351,1,986986,987826,+,840
209,NZ_OX366381,1,497071,497905,+,834
209,NZ_OX366381,1,781685,782519,-,834
209,NZ_OX366342,1,22025,22859,-,834
209,NZ_OX366342,1,1160365,1161199,+,834
209,NZ_OX366369,1,880239,881072,-,833
209,NZ_OX366388,1,946626,947460,+,834
209,NZ_OX366388,1,1016636,1017470,+,834
209,NZ_OX366388,1,1177827,1178661,-,834
209,NZ_OX366388,1,1228810,1229644,-,834
209,NZ_OX366357,1,938788,939615,-,827
209,NZ_CP072012,1,1118,1952,-,834
209,NZ_CP072012,1,96571,97405,+,834
209,NC_002978,6,593838,594678,-,840
209,NZ_OX366389,1,30033,30867,+,834
209,NZ_OX366397,1,492371,493205,+,834
209,NZ_OX366397,1,888492,889326,+,834
209,NZ_OX366397,1,1254219,1255053,+,834
209,NZ_CP090903,1,593838,594678,-,840
209,NZ_CP090901,1,593838,594678,-,840
209,NZ_CP046923,1,571800,572640,-,840
209,NZ_CP069055,1,647597,648437,-,840
209,NZ_CP072670,1,593678,594518,-,840
209,NZ_CP090899,1,593838,594678,-,840
209,NZ_CP046924,1,592738,593578,-,840
209,NZ_CP046921,1,655552,656392,-,840
209,NZ_CP072669,1,593686,594526,-,840
209,NC_021089,1,248635,249475,+,840
208,NZ_OX366376,1,600171,601469,+,1298
208,NZ_OX366393,1,938247,939544,-,1297
208,NZ_CP072672,1,595001,596307,-,1306
208,NZ_CP069060,1,1159862,1161169,+,1307
208,NZ_CP072667,1,594983,596289,-,1306
208,NZ_CP072671,1,594983,596289,-,1306
208,NZ_CP072668,1,594970,596276,-,1306
208,NZ_CP072666,1,594983,596289,-,1306
208,NZ_CP090902,1,595135,596441,-,1306
208,NZ_CP090948,1,595135,596441,-,1306
208,NZ_CP069052,1,576615,577921,-,1306
208,NZ_CP042445,1,595123,596429,-,1306
208,NZ_CP042904,1,1078675,1079981,-,1306
208,NC_012416,1,616263,617569,-,1306
208,NC_012416,1,1122722,1124028,-,1306
208,NZ_CP069053,1,1212507,1213813,-,1306
208,NZ_CP042446,1,595135,596441,-,1306
208,NZ_CP041215,1,1031758,1033055,-,1297
208,NZ_OX366353,1,201,1498,-,1297
208,NZ_OX366353,1,1007557,1008854,-,1297
208,NZ_OX366353,1,1371897,1373194,-,1297
208,NZ_OX366368,1,971359,972665,-,1306
208,NZ_OX366379,1,969893,971199,-,1306
208,NZ_CP091195,1,380620,381927,+,1307
208,NZ_CP091195,1,612882,614189,+,1307
208,NZ_OX366375,1,856404,857702,+,1298
208,NZ_CP046925,1,594983,596289,-,1306
208,NZ_OX366318,1,210857,212163,-,1306
208,NZ_OX366318,1,231478,232784,-,1306
208,NZ_OX366318,1,918271,919578,+,1307
208,NZ_OX366332,1,527622,528929,+,1307
208,NZ_CP110359,1,666251,667557,-,1306
208,NZ_OU953855,1,1296547,1297845,+,1298
208,NZ_OX366347,1,1125975,1127273,+,1298
208,NZ_OU909470,1,1162874,1164181,+,1307
208,NZ_OX366359,1,682141,683438,-,1297
208,NZ_OX366349,1,195590,196887,-,1297
208,NZ_OX366349,1,1103518,1104816,+,1298
208,NZ_CP090900,1,595135,596441,-,1306
208,NZ_OX366362,1,1447087,1448384,-,1297
208,NZ_OX366327,1,339638,340945,+,1307
208,NZ_OX366327,1,417581,418888,+,1307
208,NZ_OX366367,1,996363,997660,-,1297
208,NZ_CP042444,1,595672,596978,-,1306
208,NZ_OX366326,1,253167,254465,+,1298
208,NZ_OX366326,1,612459,613757,+,1298
208,NZ_CP037426,1,236354,237652,+,1298
208,NZ_CP046922,1,656849,658155,-,1306
208,NZ_OX366399,1,963091,964397,-,1306
208,NZ_OX366396,1,288884,290181,-,1297
208,NZ_OX366351,1,821634,822931,-,1297
208,NZ_OX366351,1,985222,986529,+,1307
208,NZ_OX366381,1,495316,496614,+,1298
208,NZ_OX366381,1,782976,784273,-,1297
208,NZ_OX366342,1,23316,24613,-,1297
208,NZ_OX366342,1,1158610,1159908,+,1298
208,NZ_OX366369,1,881530,882843,-,1313
208,NZ_OX366388,1,944871,946169,+,1298
208,NZ_OX366388,1,1014881,1016179,+,1298
208,NZ_OX366388,1,1179118,1180415,-,1297
208,NZ_OX366388,1,1230101,1231398,-,1297
208,NZ_OX366357,1,940072,941369,-,1297
208,NZ_CP072012,1,2410,3708,-,1298
208,NZ_CP072012,1,94816,96114,+,1298
208,NC_002978,6,595135,596441,-,1306
208,NZ_OX366389,1,28278,29576,+,1298
208,NZ_OX366397,1,490616,491919,+,1303
208,NZ_OX366397,1,886737,888040,+,1303
208,NZ_OX366397,1,1252464,1253767,+,1303
208,NZ_CP090903,1,595135,596441,-,1306
208,NZ_CP090901,1,595135,596441,-,1306
208,NZ_CP046923,1,573097,574403,-,1306
208,NZ_CP069055,1,648894,650200,-,1306
208,NZ_CP072670,1,594975,596281,-,1306
208,NZ_CP090899,1,595135,596441,-,1306
208,NZ_CP046924,1,594035,595341,-,1306
208,NZ_CP046921,1,656849,658155,-,1306
208,NZ_CP072669,1,594983,596289,-,1306
208,NC_021089,1,246871,248178,+,1307
207,NZ_OX366376,1,598320,600170,+,1850
207,NZ_OX366393,1,939546,941395,-,1849
207,NZ_CP072672,1,596309,598176,-,1867
207,NZ_CP069060,1,1157993,1159861,+,1868
207,NZ_CP072667,1,596291,598158,-,1867
207,NZ_CP072671,1,596291,598158,-,1867
207,NZ_CP072668,1,596278,598145,-,1867
207,NZ_CP072666,1,596291,598158,-,1867
207,NZ_CP090902,1,596443,598310,-,1867
207,NZ_CP090948,1,596443,598310,-,1867
207,NZ_CP069052,1,577923,579790,-,1867
207,NZ_CP042445,1,596431,598298,-,1867
207,NZ_CP042904,1,1079983,1081850,-,1867
207,NC_012416,1,617571,619438,-,1867
207,NC_012416,1,1124030,1125897,-,1867
207,NZ_CP069053,1,1213815,1215682,-,1867
207,NZ_CP042446,1,596443,598310,-,1867
207,NZ_CP041215,1,1033057,1034906,-,1849
207,NZ_OX366353,1,1500,3349,-,1849
207,NZ_OX366353,1,1008856,1010705,-,1849
207,NZ_OX366353,1,1373196,1375045,-,1849
207,NZ_OX366368,1,972667,974534,-,1867
207,NZ_OX366379,1,971201,973068,-,1867
207,NZ_CP091195,1,378751,380619,+,1868
207,NZ_CP091195,1,611013,612881,+,1868
207,NZ_OX366375,1,854553,856403,+,1850
207,NZ_CP046925,1,596291,598158,-,1867
207,NZ_OX366318,1,212165,214032,-,1867
207,NZ_OX366318,1,232786,234653,-,1867
207,NZ_OX366318,1,916402,918270,+,1868
207,NZ_OX366332,1,525753,527621,+,1868
207,NZ_CP110359,1,667559,669426,-,1867
207,NZ_OU953855,1,1294696,1296546,+,1850
207,NZ_OX366347,1,1124124,1125974,+,1850
207,NZ_OU909470,1,1161005,1162873,+,1868
207,NZ_OX366359,1,683440,685289,-,1849
207,NZ_OX366349,1,196889,198738,-,1849
207,NZ_OX366349,1,1101667,1103517,+,1850
207,NZ_CP090900,1,596443,598310,-,1867
207,NZ_OX366362,1,1448386,1450235,-,1849
207,NZ_OX366327,1,337769,339637,+,1868
207,NZ_OX366327,1,415712,417580,+,1868
207,NZ_OX366367,1,997662,999511,-,1849
207,NZ_CP042444,1,596980,598847,-,1867
207,NZ_OX366326,1,251316,253166,+,1850
207,NZ_OX366326,1,610608,612458,+,1850
207,NZ_CP037426,1,234503,236353,+,1850
207,NZ_CP046922,1,658157,660024,-,1867
207,NZ_OX366399,1,964399,966266,-,1867
207,NZ_OX366396,1,290183,292032,-,1849
207,NZ_OX366351,1,822933,824782,-,1849
207,NZ_OX366351,1,983331,985221,+,1890
207,NZ_OX366381,1,493465,495315,+,1850
207,NZ_OX366381,1,784275,786124,-,1849
207,NZ_OX366342,1,24615,26464,-,1849
207,NZ_OX366342,1,1156759,1158609,+,1850
207,NZ_OX366369,1,884259,886047,-,1788
207,NZ_OX366388,1,943020,944870,+,1850
207,NZ_OX366388,1,1013030,1014880,+,1850
207,NZ_OX366388,1,1180417,1182266,-,1849
207,NZ_OX366388,1,1231400,1233249,-,1849
207,NZ_OX366357,1,941371,943220,-,1849
207,NZ_CP072012,1,3710,5571,-,1861
207,NZ_CP072012,1,92953,94815,+,1862
207,NC_002978,6,596443,598310,-,1867
207,NZ_OX366389,1,26427,28277,+,1850
207,NZ_OX366397,1,488765,490615,+,1850
207,NZ_OX366397,1,884886,886736,+,1850
207,NZ_OX366397,1,1250613,1252463,+,1850
207,NZ_CP090903,1,596443,598310,-,1867
207,NZ_CP090901,1,596443,598310,-,1867
207,NZ_CP046923,1,574405,576272,-,1867
207,NZ_CP069055,1,650202,652069,-,1867
207,NZ_CP072670,1,596283,598150,-,1867
207,NZ_CP090899,1,596443,598310,-,1867
207,NZ_CP046924,1,595343,597210,-,1867
207,NZ_CP046921,1,658157,660024,-,1867
207,NZ_CP072669,1,596291,598158,-,1867
207,NC_021089,1,245002,246870,+,1868
206,NZ_OX366376,1,597506,598027,+,521
206,NZ_OX366393,1,941688,942209,-,521
206,NZ_CP072672,1,598468,598989,-,521
206,NZ_CP069060,1,1157180,1157701,+,521
206,NZ_CP072667,1,598450,598971,-,521
206,NZ_CP072671,1,598450,598971,-,521
206,NZ_CP072668,1,598437,598958,-,521
206,NZ_CP072666,1,598450,598971,-,521
206,NZ_CP090902,1,598602,599123,-,521
206,NZ_CP090948,1,598602,599123,-,521
206,NZ_CP069052,1,580082,580603,-,521
206,NZ_CP042445,1,598590,599111,-,521
206,NZ_CP042904,1,1082142,1082663,-,521
206,NC_012416,1,619730,620251,-,521
206,NC_012416,1,1126189,1126710,-,521
206,NZ_CP069053,1,1215974,1216495,-,521
206,NZ_CP042446,1,598602,599123,-,521
206,NZ_CP041215,1,1035199,1035720,-,521
206,NZ_OX366353,1,4644,5149,-,505
206,NZ_OX366353,1,1012000,1012505,-,505
206,NZ_OX366353,1,1376340,1376845,-,505
206,NZ_OX366368,1,974826,975347,-,521
206,NZ_OX366379,1,973360,973881,-,521
206,NZ_CP091195,1,377938,378459,+,521
206,NZ_CP091195,1,610200,610721,+,521
206,NZ_OX366375,1,853739,854260,+,521
206,NZ_CP046925,1,598450,598971,-,521
206,NZ_OX366318,1,214324,214845,-,521
206,NZ_OX366318,1,234945,235466,-,521
206,NZ_OX366318,1,915589,916110,+,521
206,NZ_OX366332,1,524940,525461,+,521
206,NZ_CP110359,1,669718,670239,-,521
206,NZ_OU953855,1,1293882,1294403,+,521
206,NZ_OX366347,1,1123310,1123842,+,532
206,NZ_OU909470,1,1160192,1160713,+,521
206,NZ_OX366359,1,685582,686103,-,521
206,NZ_OX366349,1,199031,199552,-,521
206,NZ_OX366349,1,1100853,1101374,+,521
206,NZ_CP090900,1,598602,599123,-,521
206,NZ_OX366362,1,1450528,1451049,-,521
206,NZ_OX366327,1,336956,337477,+,521
206,NZ_OX366327,1,414899,415420,+,521
206,NZ_OX366367,1,999804,1000325,-,521
206,NZ_CP042444,1,599139,599660,-,521
206,NZ_OX366326,1,250502,251023,+,521
206,NZ_OX366326,1,609794,610315,+,521
206,NZ_CP037426,1,233689,234210,+,521
206,NZ_CP046922,1,660316,660837,-,521
206,NZ_OX366399,1,966558,967079,-,521
206,NZ_OX366396,1,292325,292846,-,521
206,NZ_OX366351,1,825075,825596,-,521
206,NZ_OX366351,1,981691,982212,+,521
206,NZ_OX366381,1,492651,493172,+,521
206,NZ_OX366381,1,786417,786938,-,521
206,NZ_OX366342,1,26757,27278,-,521
206,NZ_OX366342,1,1155945,1156466,+,521
206,NZ_OX366369,1,886340,886861,-,521
206,NZ_OX366388,1,942206,942727,+,521
206,NZ_OX366388,1,1012216,1012737,+,521
206,NZ_OX366388,1,1182559,1183080,-,521
206,NZ_OX366388,1,1233542,1234063,-,521
206,NZ_OX366357,1,943513,944034,-,521
206,NZ_CP072012,1,5863,6384,-,521
206,NZ_CP072012,1,92139,92661,+,522
206,NC_002978,6,598602,599123,-,521
206,NZ_OX366389,1,25613,26134,+,521
206,NZ_OX366397,1,487951,488472,+,521
206,NZ_OX366397,1,884072,884593,+,521
206,NZ_OX366397,1,1249799,1250320,+,521
206,NZ_CP090903,1,598602,599123,-,521
206,NZ_CP090901,1,598602,599123,-,521
206,NZ_CP046923,1,576564,577085,-,521
206,NZ_CP069055,1,652361,652882,-,521
206,NZ_CP072670,1,598442,598963,-,521
206,NZ_CP090899,1,598602,599123,-,521
206,NZ_CP046924,1,597502,598023,-,521
206,NZ_CP046921,1,660316,660837,-,521
206,NZ_CP072669,1,598450,598971,-,521
206,NC_021089,1,244189,244710,+,521
205,NZ_OX366376,1,596760,597505,+,745
205,NZ_OX366393,1,942211,942956,-,745
205,NZ_CP072672,1,598991,599736,-,745
205,NZ_CP069060,1,1156434,1157179,+,745
205,NZ_CP072667,1,598973,599718,-,745
205,NZ_CP072671,1,598973,599718,-,745
205,NZ_CP072668,1,598960,599705,-,745
205,NZ_CP072666,1,598973,599718,-,745
205,NZ_CP090902,1,599125,599870,-,745
205,NZ_CP090948,1,599125,599870,-,745
205,NZ_CP069052,1,580605,581350,-,745
205,NZ_CP042445,1,599113,599858,-,745
205,NZ_CP042904,1,1082665,1083410,-,745
205,NC_012416,1,620253,620998,-,745
205,NC_012416,1,1126712,1127457,-,745
205,NZ_CP069053,1,1216497,1217242,-,745
205,NZ_CP042446,1,599125,599870,-,745
205,NZ_CP041215,1,1035722,1036467,-,745
205,NZ_OX366353,1,5151,5896,-,745
205,NZ_OX366353,1,1012507,1013252,-,745
205,NZ_OX366353,1,1376847,1377592,-,745
205,NZ_OX366368,1,975349,976094,-,745
205,NZ_OX366379,1,973883,974628,-,745
205,NZ_CP091195,1,377192,377937,+,745
205,NZ_CP091195,1,609454,610199,+,745
205,NZ_OX366375,1,852993,853738,+,745
205,NZ_CP046925,1,598973,599718,-,745
205,NZ_OX366318,1,214847,215592,-,745
205,NZ_OX366318,1,235468,236213,-,745
205,NZ_OX366318,1,914843,915588,+,745
205,NZ_OX366332,1,524194,524939,+,745
205,NZ_CP110359,1,670241,670986,-,745
205,NZ_OU953855,1,1293136,1293881,+,745
205,NZ_OX366347,1,1122564,1123309,+,745
205,NZ_OU909470,1,1159446,1160191,+,745
205,NZ_OX366359,1,686105,686850,-,745
205,NZ_OX366349,1,199554,200299,-,745
205,NZ_OX366349,1,1100107,1100852,+,745
205,NZ_CP090900,1,599125,599870,-,745
205,NZ_OX366362,1,1451051,1451796,-,745
205,NZ_OX366327,1,336210,336955,+,745
205,NZ_OX366327,1,414153,414898,+,745
205,NZ_OX366367,1,1000327,1001072,-,745
205,NZ_CP042444,1,599662,600407,-,745
205,NZ_OX366326,1,249756,250501,+,745
205,NZ_OX366326,1,609048,609793,+,745
205,NZ_CP037426,1,232943,233688,+,745
205,NZ_CP046922,1,660839,661584,-,745
205,NZ_OX366399,1,967081,967826,-,745
205,NZ_OX366396,1,292848,293593,-,745
205,NZ_OX366351,1,825598,826343,-,745
205,NZ_OX366351,1,980945,981690,+,745
205,NZ_OX366381,1,491905,492650,+,745
205,NZ_OX366381,1,786940,787685,-,745
205,NZ_OX366342,1,27280,28025,-,745
205,NZ_OX366342,1,1155199,1155944,+,745
205,NZ_OX366369,1,886863,887608,-,745
205,NZ_OX366356,1,703760,704470,-,710
205,NZ_OX366388,1,941460,942205,+,745
205,NZ_OX366388,1,1011470,1012215,+,745
205,NZ_OX366388,1,1183082,1183827,-,745
205,NZ_OX366388,1,1234065,1234810,-,745
205,NZ_OX366357,1,944036,944781,-,745
205,NZ_CP072012,1,6386,7131,-,745
205,NZ_CP072012,1,91393,92138,+,745
205,NC_002978,6,599125,599870,-,745
205,NZ_OX366389,1,24867,25612,+,745
205,NZ_OX366397,1,487205,487950,+,745
205,NZ_OX366397,1,883326,884071,+,745
205,NZ_OX366397,1,1249053,1249798,+,745
205,NZ_CP090903,1,599125,599870,-,745
205,NZ_CP090901,1,599125,599870,-,745
205,NZ_CP046923,1,577087,577832,-,745
205,NZ_CP069055,1,652884,653629,-,745
205,NZ_CP072670,1,598965,599710,-,745
205,NZ_CP090899,1,599125,599870,-,745
205,NZ_CP046924,1,598025,598770,-,745
205,NZ_CP046921,1,660839,661584,-,745
205,NZ_CP072669,1,598973,599718,-,745
205,NC_021089,1,243443,244188,+,745
204,NZ_OX366376,1,595489,596438,+,949
204,NZ_OX366393,1,943278,944230,-,952
204,NZ_CP072672,1,600058,601010,-,952
204,NZ_CP069060,1,1155160,1156112,+,952
204,NZ_CP072667,1,600040,600992,-,952
204,NZ_CP072671,1,600040,600992,-,952
204,NZ_CP072668,1,600027,600979,-,952
204,NZ_CP072666,1,600040,600992,-,952
204,NZ_CP090902,1,600192,601144,-,952
204,NZ_CP090948,1,600192,601144,-,952
204,NZ_CP069052,1,581672,582624,-,952
204,NZ_CP042445,1,600180,601132,-,952
204,NZ_CP042904,1,1083732,1084684,-,952
204,NC_012416,1,621320,622272,-,952
204,NC_012416,1,1127779,1128731,-,952
204,NZ_CP069053,1,1217564,1218516,-,952
204,NZ_CP042446,1,600192,601144,-,952
204,NZ_CP041215,1,1036789,1037741,-,952
204,NZ_OX366353,1,6218,7170,-,952
204,NZ_OX366353,1,1013574,1014526,-,952
204,NZ_OX366353,1,1377914,1378866,-,952
204,NZ_OX366368,1,976416,977368,-,952
204,NZ_OX366379,1,974950,975902,-,952
204,NZ_CP091195,1,375918,376870,+,952
204,NZ_CP091195,1,608180,609132,+,952
204,NZ_OX366375,1,851719,852671,+,952
204,NZ_CP046925,1,600040,600992,-,952
204,NZ_OX366318,1,215914,216866,-,952
204,NZ_OX366318,1,236535,237487,-,952
204,NZ_OX366318,1,913569,914521,+,952
204,NZ_OX366332,1,522920,523872,+,952
204,NZ_CP110359,1,671308,672260,-,952
204,NZ_OU953855,1,1291862,1292814,+,952
204,NZ_OX366347,1,1121290,1122242,+,952
204,NZ_OU909470,1,1158172,1159124,+,952
204,NZ_OX366359,1,687197,688124,-,927
204,NZ_OX366349,1,200621,201573,-,952
204,NZ_OX366349,1,1098833,1099785,+,952
204,NZ_CP090900,1,600192,601144,-,952
204,NZ_OX366362,1,1452118,1453070,-,952
204,NZ_OX366327,1,334936,335888,+,952
204,NZ_OX366327,1,412879,413831,+,952
204,NZ_OX366367,1,1001394,1002346,-,952
204,NZ_CP042444,1,600729,601681,-,952
204,NZ_OX366326,1,248482,249434,+,952
204,NZ_OX366326,1,607774,608726,+,952
204,NZ_CP037426,1,231669,232621,+,952
204,NZ_CP046922,1,661906,662858,-,952
204,NZ_OX366399,1,968148,969100,-,952
204,NZ_OX366396,1,293915,294867,-,952
204,NZ_OX366351,1,826665,827617,-,952
204,NZ_OX366351,1,979671,980623,+,952
204,NZ_OX366381,1,490631,491583,+,952
204,NZ_OX366381,1,788007,788959,-,952
204,NZ_OX366342,1,28347,29299,-,952
204,NZ_OX366342,1,1153925,1154877,+,952
204,NZ_OX366369,1,887930,888882,-,952
204,NZ_OX366356,1,484378,485434,+,1056
204,NZ_OX366388,1,940186,941138,+,952
204,NZ_OX366388,1,1010196,1011148,+,952
204,NZ_OX366388,1,1184149,1185101,-,952
204,NZ_OX366388,1,1235132,1236084,-,952
204,NZ_OX366357,1,945103,946055,-,952
204,NZ_CP072012,1,7453,8405,-,952
204,NZ_CP072012,1,90119,91071,+,952
204,NC_002978,6,600192,601144,-,952
204,NZ_OX366389,1,23593,24545,+,952
204,NZ_OX366389,1,523810,524762,+,952
204,NZ_OX366397,1,485931,486883,+,952
204,NZ_OX366397,1,882052,883004,+,952
204,NZ_OX366397,1,1247779,1248731,+,952
204,NZ_CP090903,1,600192,601144,-,952
204,NZ_CP090901,1,600192,601144,-,952
204,NZ_CP046923,1,578154,579106,-,952
204,NZ_CP069055,1,653951,654903,-,952
204,NZ_CP072670,1,600032,600984,-,952
204,NZ_CP090899,1,600192,601144,-,952
204,NZ_CP046924,1,599092,600044,-,952
204,NZ_CP046921,1,661906,662858,-,952
204,NZ_CP072669,1,600040,600992,-,952
204,NC_021089,1,242169,243121,+,952
203,NZ_OX366376,1,593520,594563,+,1043
203,NZ_OX366393,1,945153,946196,-,1043
203,NZ_CP072672,1,601933,602976,-,1043
203,NZ_CP069060,1,1153194,1154237,+,1043
203,NZ_CP072667,1,601915,602958,-,1043
203,NZ_CP072671,1,601915,602958,-,1043
203,NZ_CP072668,1,601902,602945,-,1043
203,NZ_CP072666,1,601915,602958,-,1043
203,NZ_CP090902,1,602067,603110,-,1043
203,NZ_CP090948,1,602067,603110,-,1043
203,NZ_CP069052,1,583547,584590,-,1043
203,NZ_CP042445,1,602055,603098,-,1043
203,NZ_CP042904,1,1085607,1086650,-,1043
203,NC_012416,1,623195,624238,-,1043
203,NC_012416,1,1129654,1130697,-,1043
203,NZ_CP069053,1,1219439,1220482,-,1043
203,NZ_CP042446,1,602067,603110,-,1043
203,NZ_CP041215,1,1038664,1039707,-,1043
203,NZ_OX366353,1,8093,9136,-,1043
203,NZ_OX366353,1,1015449,1016492,-,1043
203,NZ_OX366353,1,1379789,1380832,-,1043
203,NZ_OX366387,1,354890,355933,-,1043
203,NZ_OX366368,1,978291,979334,-,1043
203,NZ_OX366379,1,976825,977868,-,1043
203,NZ_CP091195,1,373952,374995,+,1043
203,NZ_CP091195,1,605295,606338,+,1043
203,NZ_OX366375,1,849753,850796,+,1043
203,NZ_CP046925,1,601915,602958,-,1043
203,NZ_OX366318,1,238410,239453,-,1043
203,NZ_OX366332,1,520954,521997,+,1043
203,NZ_CP110359,1,673183,674226,-,1043
203,NZ_OU953855,1,1289896,1290939,+,1043
203,NZ_OX366347,1,1119324,1120367,+,1043
203,NZ_OU909470,1,1156206,1157249,+,1043
203,NZ_OX366359,1,689047,690090,-,1043
203,NZ_OX366349,1,1096867,1097910,+,1043
203,NZ_OX366349,1,1218353,1219396,+,1043
203,NZ_CP090900,1,602067,603110,-,1043
203,NZ_OX366362,1,1453993,1455036,-,1043
203,NZ_OX366327,1,332970,334013,+,1043
203,NZ_OX366327,1,410913,411956,+,1043
203,NZ_OX366367,1,1003269,1004312,-,1043
203,NZ_CP042444,1,602604,603647,-,1043
203,NZ_OX366326,1,245665,246708,+,1043
203,NZ_OX366326,1,605808,606851,+,1043
203,NZ_CP037426,1,229703,230746,+,1043
203,NZ_CP046922,1,663781,664824,-,1043
203,NZ_OX366399,1,970023,971066,-,1043
203,NZ_OX366395,1,839946,840989,-,1043
203,NZ_OX366396,1,295790,296833,-,1043
203,NZ_OX366351,1,828540,829583,-,1043
203,NZ_OX366351,1,976854,977897,+,1043
203,NZ_OX366381,1,488665,489708,+,1043
203,NZ_OX366381,1,789882,790925,-,1043
203,NZ_OX366342,1,30222,31265,-,1043
203,NZ_OX366342,1,1151959,1153002,+,1043
203,NZ_OX366369,1,889805,890848,-,1043
203,NZ_OX366356,1,482311,483354,+,1043
203,NZ_OX366388,1,938222,939263,+,1041
203,NZ_OX366388,1,1008230,1009273,+,1043
203,NZ_OX366388,1,1186024,1187065,-,1041
203,NZ_OX366388,1,1237007,1238050,-,1043
203,NZ_OX366357,1,946978,948021,-,1043
203,NZ_CP072012,1,9328,10370,-,1042
203,NZ_CP072012,1,88153,89196,+,1043
203,NC_002978,6,602067,603110,-,1043
203,NZ_OX366389,1,21627,22670,+,1043
203,NZ_OX366389,1,521844,522887,+,1043
203,NZ_OX366397,1,483997,485008,+,1011
203,NZ_OX366397,1,880086,881129,+,1043
203,NZ_OX366397,1,1245813,1246856,+,1043
203,NZ_CP090903,1,602067,603110,-,1043
203,NZ_CP090901,1,602067,603110,-,1043
203,NZ_CP046923,1,580029,581072,-,1043
203,NZ_CP069055,1,655826,656869,-,1043
203,NZ_CP072670,1,601907,602950,-,1043
203,NZ_CP090899,1,602067,603110,-,1043
203,NZ_CP046924,1,600967,602010,-,1043
203,NZ_OX366348,1,369793,370836,+,1043
203,NZ_CP046921,1,663781,664824,-,1043
203,NZ_CP072669,1,601915,602958,-,1043
203,NC_021089,1,240203,241246,+,1043
202,NZ_OX366376,1,592140,593518,+,1378
202,NZ_OX366393,1,946197,947575,-,1378
202,NZ_CP072672,1,602977,604352,-,1375
202,NZ_CP069060,1,1151818,1153192,+,1374
202,NZ_CP072667,1,602959,604334,-,1375
202,NZ_CP072671,1,602959,604334,-,1375
202,NZ_CP072668,1,602946,604321,-,1375
202,NZ_CP072666,1,602959,604334,-,1375
202,NZ_CP090902,1,603111,604486,-,1375
202,NZ_CP090948,1,603111,604486,-,1375
202,NZ_CP069052,1,584591,585966,-,1375
202,NZ_CP042445,1,603099,604474,-,1375
202,NZ_CP042904,1,1086651,1088026,-,1375
202,NC_012416,1,624239,625614,-,1375
202,NC_012416,1,1130698,1132073,-,1375
202,NZ_CP069053,1,1220483,1221858,-,1375
202,NZ_CP042446,1,603111,604486,-,1375
202,NZ_CP041215,1,1039708,1041065,-,1357
202,NZ_OX366353,1,9137,10516,-,1379
202,NZ_OX366353,1,1016493,1017872,-,1379
202,NZ_OX366353,1,1380833,1382212,-,1379
202,NZ_OX366387,1,355934,357534,-,1600
202,NZ_OX366368,1,979335,980710,-,1375
202,NZ_OX366379,1,977869,979244,-,1375
202,NZ_CP091195,1,372576,373950,+,1374
202,NZ_CP091195,1,603919,605293,+,1374
202,NZ_OX366375,1,848377,849751,+,1374
202,NZ_CP046925,1,602959,604334,-,1375
202,NZ_OX366318,1,239454,240850,-,1396
202,NZ_OX366332,1,519579,520952,+,1373
202,NZ_CP110359,1,674227,675623,-,1396
202,NZ_OU953855,1,1288520,1289894,+,1374
202,NZ_OX366347,1,1117944,1119322,+,1378
202,NZ_OU909470,1,1154831,1156204,+,1373
202,NZ_OX366359,1,690091,691470,-,1379
202,NZ_OX366349,1,1095491,1096865,+,1374
202,NZ_OX366349,1,1216977,1218351,+,1374
202,NZ_CP090900,1,603111,604486,-,1375
202,NZ_OX366362,1,1455037,1456416,-,1379
202,NZ_OX366327,1,331595,332968,+,1373
202,NZ_OX366327,1,409538,410911,+,1373
202,NZ_OX366367,1,1004313,1005688,-,1375
202,NZ_CP042444,1,603648,605023,-,1375
202,NZ_OX366326,1,244289,245663,+,1374
202,NZ_OX366326,1,604411,605806,+,1395
202,NZ_CP037426,1,228327,229701,+,1374
202,NZ_CP046922,1,664825,666200,-,1375
202,NZ_OX366399,1,971067,972442,-,1375
202,NZ_OX366395,1,840990,842365,-,1375
202,NZ_OX366396,1,296834,298230,-,1396
202,NZ_OX366351,1,829584,830980,-,1396
202,NZ_OX366351,1,975478,976852,+,1374
202,NZ_OX366381,1,487285,488663,+,1378
202,NZ_OX366381,1,790926,792305,-,1379
202,NZ_OX366342,1,31266,32645,-,1379
202,NZ_OX366342,1,1150579,1151957,+,1378
202,NZ_OX366369,1,890849,892228,-,1379
202,NZ_OX366356,1,480763,482309,+,1546
202,NZ_OX366388,1,936840,938220,+,1380
202,NZ_OX366388,1,1006850,1008228,+,1378
202,NZ_OX366388,1,1187067,1188447,-,1380
202,NZ_OX366388,1,1238051,1239430,-,1379
202,NZ_OX366357,1,948022,949401,-,1379
202,NZ_CP072012,1,10371,11736,-,1365
202,NZ_CP072012,1,86786,88151,+,1365
202,NC_002978,6,603111,604486,-,1375
202,NZ_OX366389,1,20251,21625,+,1374
202,NZ_OX366389,1,520468,521842,+,1374
202,NZ_OX366397,1,481750,483142,+,1392
202,NZ_OX366397,1,878710,880084,+,1374
202,NZ_OX366397,1,1244437,1245811,+,1374
202,NZ_CP090903,1,603111,604486,-,1375
202,NZ_CP090901,1,603111,604486,-,1375
202,NZ_CP046923,1,581073,582448,-,1375
202,NZ_CP069055,1,656870,658245,-,1375
202,NZ_CP072670,1,602951,604326,-,1375
202,NZ_CP090899,1,603111,604486,-,1375
202,NZ_CP046924,1,602011,603386,-,1375
202,NZ_OX366348,1,368396,369791,+,1395
202,NZ_CP046921,1,664825,666200,-,1375
202,NZ_CP072669,1,602959,604334,-,1375
202,NC_021089,1,238827,240201,+,1374
201,NZ_OX366376,1,590880,591771,+,891
201,NZ_OX366393,1,947944,948858,-,914
201,NZ_CP072672,1,604721,605635,-,914
201,NZ_CP069060,1,1150535,1151449,+,914
201,NZ_CP072667,1,604703,605617,-,914
201,NZ_CP072671,1,604703,605617,-,914
201,NZ_CP072668,1,604690,605604,-,914
201,NZ_CP072666,1,604703,605617,-,914
201,NZ_CP090902,1,604855,605769,-,914
201,NZ_CP090948,1,604855,605769,-,914
201,NZ_CP069052,1,586335,587249,-,914
201,NZ_CP042445,1,604843,605757,-,914
201,NZ_CP042904,1,1088395,1089309,-,914
201,NC_012416,1,625983,626897,-,914
201,NC_012416,1,1132442,1133356,-,914
201,NZ_CP069053,1,1222227,1223141,-,914
201,NZ_CP042446,1,604855,605769,-,914
201,NZ_CP041215,1,1041456,1042370,-,914
201,NZ_OX366353,1,10885,11799,-,914
201,NZ_OX366353,1,1018241,1019155,-,914
201,NZ_OX366353,1,1382581,1383495,-,914
201,NZ_OX366387,1,357903,358817,-,914
201,NZ_OX366368,1,981079,981993,-,914
201,NZ_OX366379,1,979613,980527,-,914
201,NZ_CP091195,1,371293,372207,+,914
201,NZ_CP091195,1,602636,603550,+,914
201,NZ_OX366375,1,538053,538967,-,914
201,NZ_CP046925,1,604703,605617,-,914
201,NZ_OX366318,1,241242,242132,-,890
201,NZ_OX366332,1,518271,519161,+,890
201,NZ_CP110359,1,676015,676905,-,890
201,NZ_OU953855,1,1287237,1288151,+,914
201,NZ_OX366347,1,1116661,1117575,+,914
201,NZ_OU909470,1,1152033,1152923,+,890
201,NZ_OX366359,1,691839,692753,-,914
201,NZ_OX366349,1,1094208,1095122,+,914
201,NZ_OX366349,1,1215694,1216608,+,914
201,NZ_CP090900,1,604855,605769,-,914
201,NZ_OX366362,1,1456790,1457699,-,909
201,NZ_OX366327,1,330287,331177,+,890
201,NZ_OX366327,1,408230,409120,+,890
201,NZ_OX366367,1,1006057,1006971,-,914
201,NZ_CP042444,1,605392,606306,-,914
201,NZ_OX366326,1,243006,243920,+,914
201,NZ_OX366326,1,603128,604042,+,914
201,NZ_CP037426,1,227044,227958,+,914
201,NZ_CP046922,1,666569,667483,-,914
201,NZ_OX366399,1,972811,973725,-,914
201,NZ_OX366395,1,842734,843615,-,881
201,NZ_OX366396,1,298598,299512,-,914
201,NZ_OX366351,1,831372,832262,-,890
201,NZ_OX366351,1,974194,975108,+,914
201,NZ_OX366381,1,486002,486916,+,914
201,NZ_OX366381,1,792674,793588,-,914
201,NZ_OX366342,1,33014,33928,-,914
201,NZ_OX366342,1,1149296,1150210,+,914
201,NZ_OX366369,1,892597,893511,-,914
201,NZ_OX366356,1,479481,480394,+,913
201,NZ_OX366388,1,457241,458126,+,885
201,NZ_OX366388,1,935557,936471,+,914
201,NZ_OX366388,1,1005568,1006482,+,914
201,NZ_OX366388,1,1188816,1189730,-,914
201,NZ_OX366388,1,1239798,1240712,-,914
201,NZ_OX366357,1,949771,950685,-,914
201,NZ_CP072012,1,12104,13018,-,914
201,NZ_CP072012,1,85504,86418,+,914
201,NC_002978,6,604855,605769,-,914
201,NZ_OX366389,1,18967,19881,+,914
201,NZ_OX366389,1,519184,520098,+,914
201,NZ_OX366397,1,480467,481381,+,914
201,NZ_OX366397,1,877427,878341,+,914
201,NZ_OX366397,1,1243154,1244068,+,914
201,NZ_CP090903,1,604855,605769,-,914
201,NZ_CP090901,1,604855,605769,-,914
201,NZ_CP046923,1,582817,583731,-,914
201,NZ_CP069055,1,658613,659527,-,914
201,NZ_CP072670,1,604695,605609,-,914
201,NZ_CP090899,1,604855,605769,-,914
201,NZ_CP046924,1,603755,604669,-,914
201,NZ_OX366348,1,367114,367979,+,865
201,NZ_CP046921,1,666569,667483,-,914
201,NZ_CP072669,1,604703,605617,-,914
201,NC_021089,1,237544,238458,+,914
200,NZ_OX366376,1,584492,588426,+,3934
200,NZ_OX366393,1,1153533,1157467,+,3934
200,NZ_OX366372,1,917946,921880,-,3934
200,NZ_CP072672,1,142430,146364,+,3934
200,NZ_CP069060,1,152668,156602,+,3934
200,NZ_CP072667,1,142412,146346,+,3934
200,NZ_CP072671,1,142412,146346,+,3934
200,NZ_CP072668,1,142412,146346,+,3934
200,NZ_CP072666,1,142412,146346,+,3934
200,NZ_CP090902,1,142564,146498,+,3934
200,NZ_CP090948,1,142564,146498,+,3934
200,NZ_CP069052,1,83529,87463,-,3934
200,NZ_CP076228,1,145671,149605,+,3934
200,NZ_CP042445,1,142564,146498,+,3934
200,NZ_CP042904,1,92096,96030,-,3934
200,NC_012416,1,94677,98611,-,3934
200,NZ_CP069053,1,390675,394609,-,3934
200,NZ_CP042446,1,142564,146498,+,3934
200,NZ_CP041215,1,431873,435807,-,3934
200,NZ_OX366353,1,147817,151752,+,3935
200,NZ_OX366387,1,1296413,1300347,-,3934
200,NZ_OX366368,1,421343,425277,+,3934
200,NZ_OX366379,1,422361,426295,+,3934
200,NZ_CP091195,1,727827,731761,+,3934
200,NZ_OX366375,1,385350,389285,+,3935
200,NZ_CP046925,1,142412,146346,+,3934
200,NZ_OX366318,1,476024,479958,-,3934
200,NZ_OX366319,1,783832,787766,+,3934
200,NZ_OX366332,1,363431,367365,+,3934
200,NZ_CP110359,1,1140261,1144195,+,3934
200,NZ_OU953855,1,324995,328929,+,3934
200,NZ_OX366272,1,808768,812702,-,3934
200,NZ_OX366347,1,483571,487505,-,3934
200,NZ_OU909470,1,444716,448650,+,3934
200,NZ_OX366363,1,546799,550733,+,3934
200,NZ_OX366364,1,954872,958806,+,3934
200,NZ_OX366359,1,413521,417455,-,3934
200,NZ_OX366349,1,38997,42931,-,3934
200,NZ_OX366380,1,329059,332980,+,3921
200,NZ_OX366344,1,1029359,1033293,-,3934
200,NZ_CP090900,1,142564,146498,+,3934
200,NZ_OX366352,1,337173,341107,+,3934
200,NZ_OX366362,1,67312,71246,-,3934
200,NZ_OX366400,1,345766,349700,-,3934
200,NZ_OX366327,1,522526,526461,-,3935
200,NZ_OX366367,1,595667,599601,-,3934
200,NZ_CP042444,1,142502,146436,+,3934
200,NZ_OX366326,1,415291,419225,+,3934
200,NZ_CP037426,1,501718,505653,+,3935
200,NZ_OX366339,1,171989,175923,+,3934
200,NZ_OX366355,1,930087,934021,+,3934
200,NZ_CP046922,1,142257,146191,+,3934
200,NZ_OX366370,1,930636,934570,-,3934
200,NZ_OX366385,1,303089,307010,+,3921
200,NZ_OX366399,1,420845,424779,+,3934
200,NZ_OX366395,1,1056306,1060239,+,3933
200,NZ_OX366396,1,935217,939151,+,3934
200,NZ_OX366351,1,389880,393814,-,3934
200,NZ_OX366381,1,61641,65575,+,3934
200,NZ_OX366342,1,204394,208328,-,3934
200,NZ_OX366369,1,373248,377181,-,3933
200,NZ_OX366356,1,391453,395387,+,3934
200,NZ_OX366377,1,792899,796833,+,3934
200,NZ_OX366388,1,1302276,1306210,-,3934
200,NZ_OX366357,1,1182198,1186132,+,3934
200,NZ_CP072012,1,343747,347681,+,3934
200,NZ_OX366398,1,1079758,1083692,+,3934
200,NC_002978,6,142564,146498,+,3934
200,NZ_OX366389,1,589916,593850,+,3934
200,NZ_OX366397,1,366065,369999,+,3934
200,NZ_OX366378,1,1054124,1058058,+,3934
200,NZ_CP090903,1,142564,146498,+,3934
200,NZ_OX366374,1,1049856,1053789,+,3933
200,NZ_CP090901,1,142564,146498,+,3934
200,NZ_CP046923,1,142257,146191,+,3934
200,NZ_CP069055,1,79666,83600,-,3934
200,NZ_CP072670,1,142412,146346,+,3934
200,NZ_CP090899,1,142564,146498,+,3934
200,NZ_CP046924,1,142257,146191,+,3934
200,NZ_OX366348,1,875793,879727,+,3934
200,NZ_CP046921,1,142257,146191,+,3934
200,NZ_OX366338,1,1108560,1112494,-,3934
200,NZ_CP054557,1,498959,502893,-,3934
200,NZ_CP072669,1,142412,146346,+,3934
200,NC_021089,1,82258,86192,+,3934
199,NZ_OX366376,1,583506,584021,+,515
199,NZ_OX366393,1,1152547,1153062,+,515
199,NZ_OX366372,1,922350,922866,-,516
199,NZ_CP072672,1,141444,141959,+,515
199,NZ_CP069060,1,151682,152197,+,515
199,NZ_CP072667,1,141426,141941,+,515
199,NZ_CP072671,1,141426,141941,+,515
199,NZ_CP072668,1,141426,141941,+,515
199,NZ_CP072666,1,141426,141941,+,515
199,NZ_CP090902,1,141578,142093,+,515
199,NZ_CP090948,1,141578,142093,+,515
199,NZ_CP069052,1,87933,88449,-,516
199,NZ_CP076228,1,144685,145200,+,515
199,NZ_CP042445,1,141578,142093,+,515
199,NZ_CP042904,1,96500,97016,-,516
199,NC_012416,1,99081,99597,-,516
199,NZ_CP069053,1,395079,395595,-,516
199,NZ_CP042446,1,141578,142093,+,515
199,NZ_CP041215,1,436277,436793,-,516
199,NZ_OX366353,1,146831,147346,+,515
199,NZ_OX366387,1,1300817,1301333,-,516
199,NZ_OX366368,1,420357,420872,+,515
199,NZ_OX366379,1,421375,421890,+,515
199,NZ_CP091195,1,726841,727356,+,515
199,NZ_OX366375,1,384364,384879,+,515
199,NZ_CP046925,1,141426,141941,+,515
199,NZ_OX366318,1,480428,480944,-,516
199,NZ_OX366319,1,782846,783361,+,515
199,NZ_OX366332,1,362445,362960,+,515
199,NZ_CP110359,1,1139275,1139790,+,515
199,NZ_OU953855,1,324009,324524,+,515
199,NZ_OX366272,1,813172,813688,-,516
199,NZ_OX366347,1,487975,488491,-,516
199,NZ_OU909470,1,739695,740210,+,515
199,NZ_OX366363,1,545813,546328,+,515
199,NZ_OX366364,1,953886,954401,+,515
199,NZ_OX366359,1,417925,418441,-,516
199,NZ_OX366349,1,43401,43917,-,516
199,NZ_OX366380,1,328060,328575,+,515
199,NZ_OX366344,1,1033763,1034279,-,516
199,NZ_CP090900,1,141578,142093,+,515
199,NZ_OX366352,1,336187,336702,+,515
199,NZ_OX366362,1,71716,72217,-,501
199,NZ_OX366400,1,350170,350686,-,516
199,NZ_OX366327,1,526931,527447,-,516
199,NZ_OX366367,1,600071,600587,-,516
199,NZ_CP042444,1,141516,142031,+,515
199,NZ_OX366326,1,414305,414820,+,515
199,NZ_CP037426,1,500732,501247,+,515
199,NZ_OX366355,1,929101,929616,+,515
199,NZ_CP046922,1,141271,141786,+,515
199,NZ_OX366370,1,935040,935556,-,516
199,NZ_OX366385,1,302090,302605,+,515
199,NZ_OX366399,1,419859,420374,+,515
199,NZ_OX366395,1,1055320,1055835,+,515
199,NZ_OX366396,1,934231,934746,+,515
199,NZ_OX366351,1,394284,394800,-,516
199,NZ_OX366381,1,60655,61170,+,515
199,NZ_OX366342,1,208798,209314,-,516
199,NZ_OX366369,1,377651,378167,-,516
199,NZ_OX366356,1,390467,390982,+,515
199,NZ_OX366377,1,791913,792428,+,515
199,NZ_OX366388,1,1306680,1307196,-,516
199,NZ_OX366357,1,1181212,1181727,+,515
199,NZ_CP072012,1,342761,343276,+,515
199,NZ_OX366398,1,1078772,1079287,+,515
199,NC_002978,6,141578,142093,+,515
199,NZ_OX366389,1,588930,589445,+,515
199,NZ_OX366397,1,365079,365594,+,515
199,NZ_OX366378,1,1053138,1053653,+,515
199,NZ_CP090903,1,141578,142093,+,515
199,NZ_OX366374,1,1048884,1049385,+,501
199,NZ_CP090901,1,141578,142093,+,515
199,NZ_CP046923,1,141271,141786,+,515
199,NZ_CP069055,1,84070,84586,-,516
199,NZ_CP072670,1,141426,141941,+,515
199,NZ_CP090899,1,141578,142093,+,515
199,NZ_CP046924,1,141271,141786,+,515
199,NZ_OX366348,1,874807,875322,+,515
199,NZ_CP046921,1,141271,141786,+,515
199,NZ_OX366338,1,1112964,1113480,-,516
199,NZ_CP054557,1,503363,503879,-,516
199,NZ_CP072669,1,141426,141941,+,515
199,NC_021089,1,81272,81787,+,515
198,NZ_OX366376,1,582827,583504,+,677
198,NZ_OX366393,1,1151868,1152545,+,677
198,NZ_OX366372,1,922867,923544,-,677
198,NZ_CP072672,1,140763,141442,+,679
198,NZ_CP069060,1,151001,151680,+,679
198,NZ_CP072667,1,140745,141424,+,679
198,NZ_CP072671,1,140745,141424,+,679
198,NZ_CP072668,1,140745,141424,+,679
198,NZ_CP072666,1,140745,141424,+,679
198,NZ_CP090902,1,140897,141576,+,679
198,NZ_CP090948,1,140897,141576,+,679
198,NZ_CP069052,1,88450,89130,-,680
198,NZ_CP076228,1,144004,144683,+,679
198,NZ_CP042445,1,140897,141576,+,679
198,NZ_CP042904,1,97017,97697,-,680
198,NC_012416,1,99598,100278,-,680
198,NZ_CP069053,1,395596,396276,-,680
198,NZ_CP042446,1,140897,141576,+,679
198,NZ_CP041215,1,436794,437474,-,680
198,NZ_OX366353,1,146150,146829,+,679
198,NZ_OX366387,1,1301334,1302014,-,680
198,NZ_OX366368,1,419676,420355,+,679
198,NZ_OX366379,1,420694,421373,+,679
198,NZ_CP091195,1,726160,726839,+,679
198,NZ_OX366375,1,383683,384362,+,679
198,NZ_CP046925,1,140745,141424,+,679
198,NZ_OX366318,1,480945,481625,-,680
198,NZ_OX366319,1,782165,782844,+,679
198,NZ_OX366332,1,361764,362443,+,679
198,NZ_CP110359,1,1138594,1139273,+,679
198,NZ_OU953855,1,323328,324007,+,679
198,NZ_OX366272,1,813689,814369,-,680
198,NZ_OX366347,1,488492,489172,-,680
198,NZ_OU909470,1,739016,739693,+,677
198,NZ_OX366363,1,545132,545811,+,679
198,NZ_OX366364,1,953205,953884,+,679
198,NZ_OX366359,1,418442,419122,-,680
198,NZ_OX366349,1,43918,44595,-,677
198,NZ_OX366380,1,327381,328058,+,677
198,NZ_OX366344,1,1034280,1034957,-,677
198,NZ_CP090900,1,140897,141576,+,679
198,NZ_OX366352,1,335506,336185,+,679
198,NZ_OX366362,1,72234,72913,-,679
198,NZ_OX366400,1,350687,351367,-,680
198,NZ_OX366327,1,527448,528128,-,680
198,NZ_OX366367,1,600588,601268,-,680
198,NZ_CP042444,1,140835,141514,+,679
198,NZ_OX366326,1,413624,414303,+,679
198,NZ_CP037426,1,500051,500730,+,679
198,NZ_OX366355,1,928420,929099,+,679
198,NZ_CP046922,1,140590,141269,+,679
198,NZ_OX366370,1,935557,936234,-,677
198,NZ_OX366385,1,301411,302088,+,677
198,NZ_OX366399,1,419178,419857,+,679
198,NZ_OX366395,1,1054639,1055318,+,679
198,NZ_OX366396,1,933550,934229,+,679
198,NZ_OX366351,1,394801,395481,-,680
198,NZ_OX366381,1,59974,60653,+,679
198,NZ_OX366342,1,209315,209992,-,677
198,NZ_OX366369,1,378168,378848,-,680
198,NZ_OX366356,1,389786,390465,+,679
198,NZ_OX366377,1,791232,791911,+,679
198,NZ_OX366388,1,1307197,1307877,-,680
198,NZ_OX366357,1,1180531,1181210,+,679
198,NZ_CP072012,1,342080,342759,+,679
198,NZ_OX366398,1,1078091,1078770,+,679
198,NC_002978,6,140897,141576,+,679
198,NZ_OX366389,1,588249,588928,+,679
198,NZ_OX366397,1,364398,365077,+,679
198,NZ_OX366378,1,1052457,1053136,+,679
198,NZ_CP090903,1,140897,141576,+,679
198,NZ_OX366374,1,1047336,1048025,+,689
198,NZ_CP090901,1,140897,141576,+,679
198,NZ_CP046923,1,140590,141269,+,679
198,NZ_CP069055,1,84587,85267,-,680
198,NZ_CP072670,1,140745,141424,+,679
198,NZ_CP090899,1,140897,141576,+,679
198,NZ_CP046924,1,140590,141269,+,679
198,NZ_OX366348,1,874126,874805,+,679
198,NZ_CP046921,1,140590,141269,+,679
198,NZ_OX366338,1,1113481,1114161,-,680
198,NZ_CP054557,1,503880,504560,-,680
198,NZ_CP072669,1,140745,141424,+,679
198,NC_021089,1,80591,81270,+,679
197,NZ_OX366376,1,582000,582826,+,826
197,NZ_OX366393,1,1151042,1151867,+,825
197,NZ_OX366372,1,923546,924372,-,826
197,NZ_CP072672,1,117303,118115,-,812
197,NZ_CP069060,1,127551,128363,-,812
197,NZ_CP072667,1,117285,118097,-,812
197,NZ_CP072671,1,117285,118097,-,812
197,NZ_CP072668,1,117285,118097,-,812
197,NZ_CP072666,1,117285,118097,-,812
197,NZ_CP090902,1,117437,118249,-,812
197,NZ_CP090948,1,117437,118249,-,812
197,NZ_CP069052,1,111768,112580,+,812
197,NZ_CP076228,1,121067,121879,-,812
197,NZ_CP042445,1,117437,118249,-,812
197,NZ_CP042904,1,122900,123712,+,812
197,NC_012416,1,125482,126294,+,812
197,NZ_CP069053,1,418914,419726,+,812
197,NZ_CP042446,1,117437,118249,-,812
197,NZ_CP041215,1,395553,396365,-,812
197,NZ_OX366353,1,540917,541729,-,812
197,NZ_OX366387,1,642145,642957,+,812
197,NZ_OX366368,1,397135,397947,-,812
197,NZ_OX366379,1,398153,398965,-,812
197,NZ_CP091195,1,703669,704481,-,812
197,NZ_OX366375,1,361142,361954,-,812
197,NZ_CP046925,1,117285,118097,-,812
197,NZ_OX366318,1,504213,505025,+,812
197,NZ_OX366319,1,758997,759809,-,812
197,NZ_OX366332,1,400666,401478,+,812
197,NZ_CP110359,1,1115734,1116546,-,812
197,NZ_OU953855,1,1027791,1028603,-,812
197,NZ_OX366272,1,567225,568037,+,812
197,NZ_OX366347,1,517879,518691,+,812
197,NZ_OU909470,1,738189,739015,+,826
197,NZ_OX366363,1,515237,516049,+,812
197,NZ_OX366364,1,361760,362570,-,810
197,NZ_OX366359,1,379687,380499,-,812
197,NZ_OX366349,1,44597,45423,-,826
197,NZ_OX366380,1,326554,327380,+,826
197,NZ_OX366344,1,1034959,1035785,-,826
197,NZ_CP090900,1,117437,118249,-,812
197,NZ_OX366352,1,298541,299353,-,812
197,NZ_OX366362,1,23445,24255,+,810
197,NZ_OX366400,1,757908,758720,-,812
197,NZ_OX366327,1,550653,551465,+,812
197,NZ_OX366367,1,1045666,1046476,-,810
197,NZ_CP042444,1,117375,118187,-,812
197,NZ_OX366326,1,388274,389086,-,812
197,NZ_CP037426,1,47195,48007,-,812
197,NZ_OX366339,1,200138,200950,-,812
197,NZ_OX366355,1,904272,905084,-,812
197,NZ_CP046922,1,117130,117942,-,812
197,NZ_OX366370,1,936236,937062,-,826
197,NZ_OX366385,1,300584,301410,+,826
197,NZ_OX366399,1,396637,397449,-,812
197,NZ_OX366395,1,597761,598573,+,812
197,NZ_OX366396,1,1086002,1086811,+,809
197,NZ_OX366351,1,418765,419577,+,812
197,NZ_OX366381,1,145547,146359,-,812
197,NZ_OX366342,1,209994,210820,-,826
197,NZ_OX366369,1,401204,402016,+,812
197,NZ_OX366356,1,422175,422987,-,812
197,NZ_OX366377,1,506342,507151,+,809
197,NZ_OX366388,1,1332569,1333381,+,812
197,NZ_OX366357,1,178719,179531,+,812
197,NZ_CP072012,1,317670,318482,-,812
197,NZ_OX366398,1,1053321,1054130,-,809
197,NC_002978,6,117437,118249,-,812
197,NZ_OX366389,1,561351,562163,-,812
197,NZ_OX366397,1,451886,452698,-,812
197,NZ_OX366378,1,219192,220004,+,812
197,NZ_CP090903,1,117437,118249,-,812
197,NZ_OX366374,1,1015118,1015930,+,812
197,NZ_CP090901,1,117437,118249,-,812
197,NZ_CP046923,1,117130,117942,-,812
197,NZ_CP069055,1,107915,108727,+,812
197,NZ_CP072670,1,117285,118097,-,812
197,NZ_CP090899,1,117437,118249,-,812
197,NZ_CP046924,1,117130,117942,-,812
197,NZ_OX366348,1,849363,850175,-,812
197,NZ_CP046921,1,117130,117942,-,812
197,NZ_OX366338,1,1146303,1147115,-,812
197,NZ_CP054557,1,1126618,1127430,+,812
197,NZ_CP072669,1,117285,118097,-,812
197,NC_021089,1,120151,120963,+,812
196,NZ_OX366376,1,580495,581104,+,609
196,NZ_OX366393,1,1149537,1150146,+,609
196,NZ_OX366372,1,925268,925877,-,609
196,NZ_CP072672,1,118952,119552,-,600
196,NZ_CP069060,1,129200,129800,-,600
196,NZ_CP072667,1,118934,119534,-,600
196,NZ_CP072671,1,118934,119534,-,600
196,NZ_CP072668,1,118934,119534,-,600
196,NZ_CP072666,1,118934,119534,-,600
196,NZ_CP090902,1,119086,119686,-,600
196,NZ_CP090948,1,119086,119686,-,600
196,NZ_CP069052,1,110331,110931,+,600
196,NZ_CP076228,1,122716,123314,-,598
196,NZ_CP042445,1,119086,119686,-,600
196,NZ_CP042904,1,121463,122063,+,600
196,NC_012416,1,124045,124645,+,600
196,NZ_CP069053,1,417477,418077,+,600
196,NZ_CP042446,1,119086,119686,-,600
196,NZ_CP041215,1,397202,397802,-,600
196,NZ_OX366353,1,542566,543166,-,600
196,NZ_OX366387,1,640837,641437,+,600
196,NZ_OX366368,1,398784,399384,-,600
196,NZ_OX366379,1,399802,400402,-,600
196,NZ_CP091195,1,705318,705918,-,600
196,NZ_OX366375,1,362791,363391,-,600
196,NZ_CP046925,1,118934,119534,-,600
196,NZ_OX366318,1,502776,503376,+,600
196,NZ_OX366319,1,760526,761117,-,591
196,NZ_OX366332,1,399229,399829,+,600
196,NZ_CP110359,1,1117398,1117998,-,600
196,NZ_OU953855,1,1029455,1030055,-,600
196,NZ_OX366272,1,565773,566373,+,600
196,NZ_OX366347,1,516299,516890,+,591
196,NZ_OU909470,1,736891,737475,+,584
196,NZ_OX366363,1,513785,514385,+,600
196,NZ_OX366364,1,742637,743228,+,591
196,NZ_OX366359,1,381336,381936,-,600
196,NZ_OX366349,1,46319,46919,-,600
196,NZ_OX366380,1,325256,325840,+,584
196,NZ_OX366344,1,1036681,1037289,-,608
196,NZ_CP090900,1,119086,119686,-,600
196,NZ_OX366352,1,300190,300790,-,600
196,NZ_OX366362,1,21573,22164,+,591
196,NZ_OX366327,1,549216,549816,+,600
196,NZ_OX366367,1,817378,817978,-,600
196,NZ_CP042444,1,119024,119624,-,600
196,NZ_OX366326,1,389923,390523,-,600
196,NZ_CP037426,1,48844,49444,-,600
196,NZ_OX366339,1,201795,202395,-,600
196,NZ_OX366355,1,905801,906392,-,591
196,NZ_CP046922,1,118779,119379,-,600
196,NZ_OX366385,1,299286,299870,+,584
196,NZ_OX366399,1,398286,398886,-,600
196,NZ_OX366395,1,596306,596909,+,603
196,NZ_OX366351,1,417328,417928,+,600
196,NZ_OX366381,1,147076,147667,-,591
196,NZ_OX366342,1,211716,212325,-,609
196,NZ_OX366369,1,399896,400496,+,600
196,NZ_OX366356,1,423695,424294,-,599
196,NZ_OX366377,1,504906,505505,+,599
196,NZ_OX366388,1,1331124,1331724,+,600
196,NZ_CP072012,1,319319,319919,-,600
196,NZ_OX366398,1,1054967,1055566,-,599
196,NC_002978,6,119086,119686,-,600
196,NZ_OX366389,1,563000,563599,-,599
196,NZ_OX366397,1,453535,454135,-,600
196,NZ_OX366378,1,217755,218355,+,600
196,NZ_CP090903,1,119086,119686,-,600
196,NZ_OX366374,1,1013725,1014273,+,548
196,NZ_CP090901,1,119086,119686,-,600
196,NZ_CP046923,1,118779,119379,-,600
196,NZ_CP069055,1,106478,107078,+,600
196,NZ_CP072670,1,118934,119534,-,600
196,NZ_CP090899,1,119086,119686,-,600
196,NZ_CP046924,1,118779,119379,-,600
196,NZ_OX366348,1,851012,851612,-,600
196,NZ_CP046921,1,118779,119379,-,600
196,NZ_OX366338,1,1147960,1148563,-,603
196,NZ_CP054557,1,1124277,1124853,+,576
196,NZ_CP072669,1,118934,119534,-,600
196,NC_021089,1,118714,119314,+,600
195,NZ_OX366376,1,576995,579526,+,2531
195,NZ_OX366393,1,1146035,1148566,+,2531
195,NZ_OX366372,1,926848,929379,-,2531
195,NZ_CP072672,1,120475,123007,-,2532
195,NZ_CP069060,1,130723,133255,-,2532
195,NZ_CP072667,1,120457,122989,-,2532
195,NZ_CP072671,1,120457,122989,-,2532
195,NZ_CP072668,1,120457,122989,-,2532
195,NZ_CP072666,1,120457,122989,-,2532
195,NZ_CP090902,1,120609,123141,-,2532
195,NZ_CP090948,1,120609,123141,-,2532
195,NZ_CP069052,1,106876,109408,+,2532
195,NZ_CP076228,1,124237,126769,-,2532
195,NZ_CP042445,1,120609,123141,-,2532
195,NZ_CP042904,1,118008,120540,+,2532
195,NC_012416,1,120590,123122,+,2532
195,NZ_CP069053,1,414022,416554,+,2532
195,NZ_CP042446,1,120609,123141,-,2532
195,NZ_CP041215,1,398722,401254,-,2532
195,NZ_OX366353,1,544086,546618,-,2532
195,NZ_OX366387,1,637397,639929,+,2532
195,NZ_OX366368,1,400307,402839,-,2532
195,NZ_OX366379,1,401325,403857,-,2532
195,NZ_CP091195,1,706826,709358,-,2532
195,NZ_OX366375,1,364299,366831,-,2532
195,NZ_CP046925,1,120457,122989,-,2532
195,NZ_OX366318,1,499321,501853,+,2532
195,NZ_OX366319,1,762025,764557,-,2532
195,NZ_OX366332,1,395777,398309,+,2532
195,NZ_CP110359,1,1118946,1121478,-,2532
195,NZ_OU953855,1,1030990,1033522,-,2532
195,NZ_OX366272,1,562306,564838,+,2532
195,NZ_OX366347,1,512859,515391,+,2532
195,NZ_OU909470,1,733407,735941,+,2534
195,NZ_OX366363,1,510328,512850,+,2522
195,NZ_OX366364,1,739177,741708,+,2531
195,NZ_OX366359,1,382856,385388,-,2532
195,NZ_OX366349,1,48225,50756,-,2531
195,NZ_OX366380,1,321772,324306,+,2534
195,NZ_OX366344,1,1038259,1040790,-,2531
195,NZ_CP090900,1,120609,123141,-,2532
195,NZ_OX366352,1,301710,304242,-,2532
195,NZ_OX366362,1,18079,20611,+,2532
195,NZ_OX366400,1,651041,653573,-,2532
195,NZ_OX366327,1,545761,548293,+,2532
195,NZ_OX366367,1,818907,821420,-,2513
195,NZ_CP042444,1,120547,123079,-,2532
195,NZ_OX366326,1,391446,393978,-,2532
195,NZ_CP037426,1,50352,52884,-,2532
195,NZ_OX366339,1,204318,206850,-,2532
195,NZ_OX366355,1,907300,909832,-,2532
195,NZ_CP046922,1,120302,122834,-,2532
195,NZ_OX366370,1,939897,942428,-,2531
195,NZ_OX366385,1,294949,297483,+,2534
195,NZ_OX366399,1,399809,402341,-,2532
195,NZ_OX366395,1,592853,595385,+,2532
195,NZ_OX366396,1,114067,116599,+,2532
195,NZ_OX366351,1,413873,416405,+,2532
195,NZ_OX366381,1,148575,151107,-,2532
195,NZ_OX366342,1,213303,215827,-,2524
195,NZ_OX366369,1,396456,398988,+,2532
195,NZ_OX366356,1,425202,427734,-,2532
195,NZ_OX366377,1,501451,503983,+,2532
195,NZ_OX366388,1,1327286,1329818,+,2532
195,NZ_OX366357,1,632027,634483,-,2456
195,NZ_CP072012,1,320842,323374,-,2532
195,NZ_OX366398,1,1056489,1059021,-,2532
195,NC_002978,6,120609,123141,-,2532
195,NZ_OX366389,1,564522,567054,-,2532
195,NZ_OX366397,1,455055,457587,-,2532
195,NZ_OX366378,1,214315,216847,+,2532
195,NZ_CP090903,1,120609,123141,-,2532
195,NZ_OX366374,1,900377,902909,+,2532
195,NZ_CP090901,1,120609,123141,-,2532
195,NZ_CP046923,1,120302,122834,-,2532
195,NZ_CP069055,1,103023,105555,+,2532
195,NZ_CP072670,1,120457,122989,-,2532
195,NZ_CP090899,1,120609,123141,-,2532
195,NZ_CP046924,1,120302,122834,-,2532
195,NZ_OX366348,1,852535,855067,-,2532
195,NZ_CP046921,1,120302,122834,-,2532
195,NZ_OX366338,1,1134170,1136702,+,2532
195,NZ_CP054557,1,1120821,1123353,+,2532
195,NZ_CP072669,1,120457,122989,-,2532
195,NC_021089,1,115262,117794,+,2532
194,NZ_OX366376,1,576274,576885,+,611
194,NZ_OX366393,1,1145314,1145925,+,611
194,NZ_OX366372,1,929489,930100,-,611
194,NZ_OX366364,1,738459,739068,+,609
194,NZ_OX366349,1,50866,51477,-,611
194,NZ_OX366344,1,1040900,1041493,-,593
194,NZ_OX366367,1,821550,822158,-,608
194,NZ_OX366370,1,1048374,1048974,+,600
194,NZ_OX366342,1,215937,216548,-,611
193,NZ_OX366376,1,575433,576272,+,839
193,NZ_OX366393,1,1144473,1145312,+,839
193,NZ_OX366372,1,930102,930941,-,839
193,NZ_CP072672,1,123863,124720,-,857
193,NZ_CP069060,1,134111,134968,-,857
193,NZ_CP072667,1,123845,124702,-,857
193,NZ_CP072671,1,123845,124702,-,857
193,NZ_CP072668,1,123845,124702,-,857
193,NZ_CP072666,1,123845,124702,-,857
193,NZ_CP090902,1,123997,124854,-,857
193,NZ_CP090948,1,123997,124854,-,857
193,NZ_CP069052,1,105163,106020,+,857
193,NZ_CP076228,1,127763,128620,-,857
193,NZ_CP042445,1,123997,124854,-,857
193,NZ_CP042904,1,116102,116959,+,857
193,NC_012416,1,118684,119541,+,857
193,NZ_CP069053,1,412309,413166,+,857
193,NZ_CP042446,1,123997,124854,-,857
193,NZ_CP041215,1,453837,454690,+,853
193,NZ_OX366353,1,585378,586231,-,853
193,NZ_OX366387,1,1267607,1268460,-,853
193,NZ_OX366368,1,403695,404552,-,857
193,NZ_OX366379,1,404713,405570,-,857
193,NZ_CP091195,1,710248,711105,-,857
193,NZ_OX366375,1,367701,368554,-,853
193,NZ_CP046925,1,123845,124702,-,857
193,NZ_OX366318,1,497608,498465,+,857
193,NZ_OX366319,1,765630,766487,-,857
193,NZ_OX366332,1,345505,346358,-,853
193,NZ_CP110359,1,1122334,1123191,-,857
193,NZ_OU953855,1,1034658,1035511,-,853
193,NZ_OX366272,1,560611,561468,+,857
193,NZ_OX366347,1,508416,509207,+,791
193,NZ_OU909470,1,208286,209143,+,857
193,NZ_OX366363,1,525515,526372,-,857
193,NZ_OX366364,1,737616,738458,+,842
193,NZ_OX366359,1,434381,435234,+,853
193,NZ_OX366349,1,51479,52300,-,821
193,NZ_OX366380,1,750094,750951,+,857
193,NZ_OX366344,1,1041495,1042316,-,821
193,NZ_CP090900,1,123997,124854,-,857
193,NZ_OX366352,1,319646,320499,-,853
193,NZ_OX366362,1,429713,430477,+,764
193,NZ_OX366400,1,654429,655286,-,857
193,NZ_OX366327,1,543949,544802,+,853
193,NZ_OX366367,1,822160,823002,-,842
193,NZ_CP042444,1,123935,124792,-,857
193,NZ_OX366326,1,394834,395691,-,857
193,NZ_CP037426,1,53754,54607,-,853
193,NZ_OX366339,1,207787,208640,-,853
193,NZ_OX366355,1,910905,911762,-,857
193,NZ_CP046922,1,123690,124547,-,857
193,NZ_OX366370,1,1047533,1048372,+,839
193,NZ_OX366385,1,33511,34368,-,857
193,NZ_OX366399,1,403197,404054,-,857
193,NZ_OX366395,1,591289,592146,+,857
193,NZ_OX366396,1,110837,111690,+,853
193,NZ_OX366351,1,412160,413017,+,857
193,NZ_OX366381,1,152180,153037,-,857
193,NZ_OX366342,1,216550,217389,-,839
193,NZ_OX366369,1,394526,395383,+,857
193,NZ_OX366356,1,428699,429538,-,839
193,NZ_OX366377,1,770927,771784,-,857
193,NZ_OX366388,1,1324826,1325679,+,853
193,NZ_OX366357,1,635216,636073,-,857
193,NZ_CP072012,1,324230,325068,-,838
193,NZ_OX366398,1,1059888,1060745,-,857
193,NC_002978,6,123997,124854,-,857
193,NZ_OX366389,1,567921,568778,-,857
193,NZ_OX366397,1,345784,346637,-,853
193,NZ_OX366378,1,212567,213424,+,857
193,NZ_CP090903,1,123997,124854,-,857
193,NZ_OX366374,1,1009899,1010756,+,857
193,NZ_CP090901,1,123997,124854,-,857
193,NZ_CP046923,1,123690,124547,-,857
193,NZ_CP069055,1,101310,102167,+,857
193,NZ_CP072670,1,123845,124702,-,857
193,NZ_CP090899,1,123997,124854,-,857
193,NZ_CP046924,1,123690,124547,-,857
193,NZ_OX366348,1,855923,856780,-,857
193,NZ_CP046921,1,123690,124547,-,857
193,NZ_OX366338,1,1132581,1133438,+,857
193,NZ_CP054557,1,1119108,1119965,+,857
193,NZ_CP072669,1,123845,124702,-,857
193,NC_021089,1,64534,65387,-,853
192,NZ_OX366376,1,574206,574836,+,630
192,NZ_OX366393,1,1143246,1143876,+,630
192,NZ_OX366372,1,931538,932168,-,630
192,NZ_CP072672,1,125311,125941,-,630
192,NZ_CP069060,1,135559,136189,-,630
192,NZ_CP072667,1,125293,125923,-,630
192,NZ_CP072671,1,125293,125923,-,630
192,NZ_CP072668,1,125293,125923,-,630
192,NZ_CP072666,1,125293,125923,-,630
192,NZ_CP090902,1,125445,126075,-,630
192,NZ_CP090948,1,125445,126075,-,630
192,NZ_CP069052,1,103942,104572,+,630
192,NZ_CP076228,1,129211,129841,-,630
192,NZ_CP042445,1,125445,126075,-,630
192,NZ_CP042904,1,114881,115511,+,630
192,NC_012416,1,117463,118093,+,630
192,NZ_CP069053,1,411088,411718,+,630
192,NZ_CP042446,1,125445,126075,-,630
192,NZ_CP041215,1,452616,453246,+,630
192,NZ_OX366353,1,586822,587452,-,630
192,NZ_OX366387,1,1269051,1269644,-,593
192,NZ_OX366368,1,405143,405773,-,630
192,NZ_OX366379,1,406161,406791,-,630
192,NZ_CP091195,1,711696,712326,-,630
192,NZ_OX366375,1,369145,369775,-,630
192,NZ_CP046925,1,125293,125923,-,630
192,NZ_OX366318,1,496387,497017,+,630
192,NZ_OX366319,1,767078,767708,-,630
192,NZ_OX366332,1,346949,347579,-,630
192,NZ_CP110359,1,1123782,1124412,-,630
192,NZ_OU953855,1,1036327,1036957,-,630
192,NZ_OX366272,1,559390,560020,+,630
192,NZ_OX366347,1,507195,507825,+,630
192,NZ_OU909470,1,207065,207688,+,623
192,NZ_OX366363,1,526970,527600,-,630
192,NZ_OX366364,1,736388,737018,+,630
192,NZ_OX366359,1,433160,433790,+,630
192,NZ_OX366349,1,58184,58814,-,630
192,NZ_OX366380,1,748873,749503,+,630
192,NZ_OX366344,1,1048200,1048830,-,630
192,NZ_CP090900,1,125445,126075,-,630
192,NZ_OX366352,1,321090,321720,-,630
192,NZ_OX366362,1,428458,429088,+,630
192,NZ_OX366400,1,655877,656507,-,630
192,NZ_OX366327,1,542729,543359,+,630
192,NZ_OX366367,1,823600,824230,-,630
192,NZ_CP042444,1,125383,126013,-,630
192,NZ_OX366326,1,396282,396912,-,630
192,NZ_CP037426,1,55198,55828,-,630
192,NZ_OX366339,1,209231,209861,-,630
192,NZ_OX366355,1,912353,912983,-,630
192,NZ_CP046922,1,125138,125768,-,630
192,NZ_OX366370,1,1046305,1046935,+,630
192,NZ_OX366385,1,34959,35589,-,630
192,NZ_OX366399,1,404645,405275,-,630
192,NZ_OX366395,1,1490772,1491367,-,595
192,NZ_OX366396,1,109616,110246,+,630
192,NZ_OX366351,1,410939,411569,+,630
192,NZ_OX366381,1,153628,154258,-,630
192,NZ_OX366342,1,217986,218616,-,630
192,NZ_OX366369,1,393305,393935,+,630
192,NZ_OX366356,1,430129,430759,-,630
192,NZ_OX366377,1,772375,773005,-,630
192,NZ_OX366388,1,1323606,1324235,+,629
192,NZ_OX366357,1,636664,637294,-,630
192,NZ_CP072012,1,325678,326308,-,630
192,NZ_OX366398,1,1061336,1061966,-,630
192,NC_002978,6,125445,126075,-,630
192,NZ_OX366389,1,569369,569999,-,630
192,NZ_OX366397,1,347228,347858,-,630
192,NZ_OX366378,1,211346,211976,+,630
192,NZ_CP090903,1,125445,126075,-,630
192,NZ_OX366374,1,1008678,1009308,+,630
192,NZ_CP090901,1,125445,126075,-,630
192,NZ_CP046923,1,125138,125768,-,630
192,NZ_CP069055,1,100089,100719,+,630
192,NZ_CP072670,1,125293,125923,-,630
192,NZ_CP090899,1,125445,126075,-,630
192,NZ_CP046924,1,125138,125768,-,630
192,NZ_OX366348,1,857371,858001,-,630
192,NZ_CP046921,1,125138,125768,-,630
192,NZ_OX366338,1,1131360,1131990,+,630
192,NZ_CP054557,1,1117887,1118517,+,630
192,NZ_CP072669,1,125293,125923,-,630
192,NC_021089,1,65978,66608,-,630
191,NZ_OX366376,1,573501,574026,+,525
191,NZ_OX366393,1,1142541,1143066,+,525
191,NZ_OX366372,1,932348,932872,-,524
191,NZ_OU909470,1,206353,206878,+,525
191,NZ_OX366380,1,748167,748692,+,525
191,NZ_OX366385,1,35770,36295,-,525
191,NZ_OX366395,1,1491550,1492075,-,525
191,NZ_OX366342,1,218796,219321,-,525
191,NZ_OX366388,1,1322917,1323420,+,503
191,NZ_OX366357,1,637478,638003,-,525
191,NZ_OX366338,1,1130655,1131180,+,525
190,NZ_OX366376,1,572891,573499,+,608
190,NZ_OX366393,1,1141931,1142539,+,608
190,NZ_OX366372,1,932873,933481,-,608
190,NZ_OU909470,1,205743,206351,+,608
190,NZ_OX366380,1,747557,748165,+,608
190,NZ_OX366385,1,36296,36904,-,608
190,NZ_OX366395,1,1492076,1492682,-,606
190,NZ_OX366342,1,219322,219930,-,608
190,NZ_OX366357,1,638004,638610,-,606
190,NZ_OX366338,1,1130045,1130653,+,608
189,NZ_OX366376,1,571061,572724,+,1663
189,NZ_OX366393,1,1140101,1141764,+,1663
189,NZ_OX366372,1,933649,935311,-,1662
189,NZ_CP072672,1,128356,130018,-,1662
189,NZ_CP069060,1,138604,140266,-,1662
189,NZ_CP072667,1,128338,130000,-,1662
189,NZ_CP072671,1,128338,130000,-,1662
189,NZ_CP072668,1,128338,130000,-,1662
189,NZ_CP072666,1,128338,130000,-,1662
189,NZ_CP090902,1,128490,130152,-,1662
189,NZ_CP090948,1,128490,130152,-,1662
189,NZ_CP069052,1,99864,101527,+,1663
189,NZ_CP076228,1,132252,133914,-,1662
189,NZ_CP042445,1,128490,130152,-,1662
189,NZ_CP042904,1,111722,113385,+,1663
189,NC_012416,1,114304,115967,+,1663
189,NZ_CP069053,1,407010,408673,+,1663
189,NZ_CP042446,1,128490,130152,-,1662
189,NZ_CP041215,1,449457,451120,+,1663
189,NZ_OX366353,1,588947,590609,-,1662
189,NZ_OX366387,1,1271770,1273432,-,1662
189,NZ_OX366368,1,407269,408931,-,1662
189,NZ_OX366379,1,408287,409949,-,1662
189,NZ_CP091195,1,714741,716403,-,1662
189,NZ_OX366375,1,371271,372933,-,1662
189,NZ_CP046925,1,128338,130000,-,1662
189,NZ_OX366318,1,493228,494891,+,1663
189,NZ_OX366319,1,769204,770866,-,1662
189,NZ_OX366332,1,349075,350737,-,1662
189,NZ_CP110359,1,1125908,1127570,-,1662
189,NZ_OU953855,1,1686113,1687776,+,1663
189,NZ_OX366272,1,1057293,1058956,+,1663
189,NZ_OX366347,1,502418,504081,+,1663
189,NZ_OU909470,1,203914,205561,+,1647
189,NZ_OX366363,1,530045,531707,-,1662
189,NZ_OX366364,1,733241,734904,+,1663
189,NZ_OX366359,1,430001,431664,+,1663
189,NZ_OX366349,1,60299,61961,-,1662
189,NZ_OX366380,1,745727,747375,+,1648
189,NZ_OX366344,1,1050315,1051977,-,1662
189,NZ_CP090900,1,128490,130152,-,1662
189,NZ_OX366352,1,323216,324878,-,1662
189,NZ_OX366362,1,425300,426963,+,1663
189,NZ_OX366400,1,361735,363398,+,1663
189,NZ_OX366327,1,539570,541233,+,1663
189,NZ_OX366367,1,825715,827377,-,1662
189,NZ_CP042444,1,128428,130090,-,1662
189,NZ_OX366326,1,398408,400070,-,1662
189,NZ_CP037426,1,487638,489300,-,1662
189,NZ_OX366339,1,211357,213018,-,1661
189,NZ_OX366355,1,914479,916141,-,1662
189,NZ_CP046922,1,128183,129845,-,1662
189,NZ_OX366370,1,1043157,1044820,+,1663
189,NZ_OX366385,1,37087,38734,-,1647
189,NZ_OX366399,1,406771,408433,-,1662
189,NZ_OX366395,1,1492852,1494514,-,1662
189,NZ_OX366396,1,104587,106249,+,1662
189,NZ_OX366351,1,407780,409443,+,1663
189,NZ_OX366381,1,155754,157416,-,1662
189,NZ_OX366342,1,220098,221760,-,1662
189,NZ_OX366369,1,390146,391809,+,1663
189,NZ_OX366356,1,378585,380247,-,1662
189,NZ_OX366377,1,776271,777933,-,1662
189,NZ_OX366388,1,1320447,1322110,+,1663
189,NZ_OX366357,1,638780,640442,-,1662
189,NZ_CP072012,1,328723,330385,-,1662
189,NZ_OX366398,1,1064381,1066043,-,1662
189,NC_002978,6,128490,130152,-,1662
189,NZ_OX366389,1,573332,574994,-,1662
189,NZ_OX366397,1,349354,351016,-,1662
189,NZ_OX366378,1,1041037,1042699,-,1662
189,NZ_CP090903,1,128490,130152,-,1662
189,NZ_OX366374,1,1005519,1007182,+,1663
189,NZ_CP090901,1,128490,130152,-,1662
189,NZ_CP046923,1,128183,129845,-,1662
189,NZ_CP069055,1,96011,97674,+,1663
189,NZ_CP072670,1,128338,130000,-,1662
189,NZ_CP090899,1,128490,130152,-,1662
189,NZ_CP046924,1,128183,129845,-,1662
189,NZ_OX366348,1,860416,862078,-,1662
189,NZ_CP046921,1,128183,129845,-,1662
189,NZ_OX366338,1,1128215,1129878,+,1663
189,NZ_CP054557,1,395604,397266,-,1662
189,NZ_CP054557,1,520351,522029,+,1678
189,NZ_CP072669,1,128338,130000,-,1662
189,NC_021089,1,68104,69766,-,1662
188,NZ_OX366376,1,569066,570120,+,1054
188,NZ_OX366393,1,1138106,1139160,+,1054
188,NZ_OX366372,1,936253,937307,-,1054
188,NZ_CP072672,1,131769,132823,-,1054
188,NZ_CP069060,1,142017,143071,-,1054
188,NZ_CP072667,1,131751,132805,-,1054
188,NZ_CP072671,1,131751,132805,-,1054
188,NZ_CP072668,1,131751,132805,-,1054
188,NZ_CP072666,1,131751,132805,-,1054
188,NZ_CP090902,1,131903,132957,-,1054
188,NZ_CP090948,1,131903,132957,-,1054
188,NZ_CP069052,1,97060,98114,+,1054
188,NZ_CP076228,1,135667,136721,-,1054
188,NZ_CP042445,1,131903,132957,-,1054
188,NZ_CP042904,1,105863,106917,+,1054
188,NC_012416,1,108444,109498,+,1054
188,NZ_CP069053,1,404206,405260,+,1054
188,NZ_CP042446,1,131903,132957,-,1054
188,NZ_CP041215,1,446318,447372,+,1054
188,NZ_OX366353,1,137957,139011,-,1054
188,NZ_OX366387,1,1309785,1310831,+,1046
188,NZ_OX366368,1,410682,411736,-,1054
188,NZ_OX366379,1,411700,412754,-,1054
188,NZ_CP091195,1,719089,720143,-,1054
188,NZ_OX366375,1,374684,375738,-,1054
188,NZ_CP046925,1,131751,132805,-,1054
188,NZ_OX366318,1,490425,491479,+,1054
188,NZ_OX366319,1,772952,774006,-,1054
188,NZ_OX366332,1,352823,353877,-,1054
188,NZ_CP110359,1,1129321,1130367,-,1046
188,NZ_OU953855,1,1681110,1682156,+,1046
188,NZ_OX366272,1,822596,823642,+,1046
188,NZ_OX366347,1,498722,499768,+,1046
188,NZ_OU909470,1,194918,195972,+,1054
188,NZ_OX366363,1,533458,534512,-,1054
188,NZ_OX366364,1,682881,683927,-,1046
188,NZ_OX366359,1,427009,428063,+,1054
188,NZ_OX366349,1,62903,63957,-,1054
188,NZ_OX366380,1,1202928,1203982,+,1054
188,NZ_OX366344,1,1052919,1053973,-,1054
188,NZ_CP090900,1,131903,132957,-,1054
188,NZ_OX366352,1,326964,328018,-,1054
188,NZ_OX366362,1,81273,82319,-,1046
188,NZ_OX366400,1,358932,359986,+,1054
188,NZ_OX366327,1,536929,537983,+,1054
188,NZ_OX366367,1,875952,876998,+,1046
188,NZ_CP042444,1,131841,132895,-,1054
188,NZ_OX366326,1,402671,403725,-,1054
188,NZ_CP037426,1,491051,492105,-,1054
188,NZ_OX366339,1,215102,216156,-,1054
188,NZ_OX366355,1,919207,920261,-,1054
188,NZ_CP046922,1,131596,132650,-,1054
188,NZ_OX366370,1,1041178,1042216,+,1038
188,NZ_OX366385,1,623087,624141,+,1054
188,NZ_OX366399,1,410184,411238,-,1054
188,NZ_OX366395,1,1496260,1497314,-,1054
188,NZ_OX366396,1,799698,800752,-,1054
188,NZ_OX366351,1,404977,406031,+,1054
188,NZ_OX366381,1,159502,160556,-,1054
188,NZ_OX366342,1,222702,223756,-,1054
188,NZ_OX366369,1,387007,388061,+,1054
188,NZ_OX366356,1,382451,383505,-,1054
188,NZ_OX366377,1,780935,781989,-,1054
188,NZ_OX366388,1,1315875,1316929,+,1054
188,NZ_OX366357,1,1060028,1061082,-,1054
188,NZ_CP072012,1,333086,334140,-,1054
188,NZ_OX366398,1,1067794,1068848,-,1054
188,NC_002978,6,131903,132957,-,1054
188,NZ_OX366389,1,576745,577799,-,1054
188,NZ_OX366397,1,353102,354156,-,1054
188,NZ_OX366378,1,1045386,1046440,-,1054
188,NZ_CP090903,1,131903,132957,-,1054
188,NZ_OX366374,1,991937,992991,-,1054
188,NZ_CP090901,1,131903,132957,-,1054
188,NZ_CP046923,1,131596,132650,-,1054
188,NZ_CP069055,1,93207,94261,+,1054
188,NZ_CP072670,1,131751,132805,-,1054
188,NZ_CP090899,1,131903,132957,-,1054
188,NZ_CP046924,1,131596,132650,-,1054
188,NZ_OX366348,1,863829,864883,-,1054
188,NZ_CP046921,1,131596,132650,-,1054
188,NZ_OX366338,1,1125430,1126466,+,1036
188,NZ_CP054557,1,515610,516664,+,1054
188,NZ_CP054557,1,716309,717363,-,1054
188,NZ_CP054557,1,916774,917828,+,1054
188,NZ_CP072669,1,131751,132805,-,1054
188,NC_021089,1,71650,72704,-,1054
187,NZ_OX366376,1,562554,563671,+,1117
187,NZ_OX366393,1,775972,777090,-,1118
187,NZ_OX366372,1,1021061,1022179,-,1118
187,NZ_CP072672,1,1192742,1193860,-,1118
187,NZ_CP069060,1,1333579,1334697,-,1118
187,NZ_CP072667,1,1192716,1193834,-,1118
187,NZ_CP072671,1,1192724,1193842,-,1118
187,NZ_CP072668,1,1192711,1193829,-,1118
187,NZ_CP072666,1,1192724,1193842,-,1118
187,NZ_CP090902,1,1192877,1193995,-,1118
187,NZ_CP090948,1,1192875,1193993,-,1118
187,NZ_CP069052,1,1277879,1278997,-,1118
187,NZ_CP076228,1,1213264,1214382,-,1118
187,NZ_CP042445,1,1192864,1193982,-,1118
187,NZ_CP042904,1,1268331,1269449,-,1118
187,NC_012416,1,1313547,1314665,-,1118
187,NZ_CP069053,1,1318877,1319995,-,1118
187,NZ_CP042446,1,1192874,1193992,-,1118
187,NZ_CP041215,1,217157,218275,-,1118
187,NZ_OX366353,1,620426,621543,+,1117
187,NZ_OX366387,1,384166,385283,+,1117
187,NZ_OX366368,1,205923,207041,-,1118
187,NZ_OX366379,1,206941,208059,-,1118
187,NZ_CP091195,1,930237,931369,+,1132
187,NZ_OX366375,1,224691,225808,+,1117
187,NZ_CP046925,1,1192724,1193842,-,1118
187,NZ_OX366318,1,294949,296067,-,1118
187,NZ_OX366319,1,997281,998398,+,1117
187,NZ_OX366332,1,203030,204148,-,1118
187,NZ_CP110359,1,1230694,1231812,-,1118
187,NZ_OU953855,1,963430,964548,-,1118
187,NZ_OX366272,1,427992,429109,+,1117
187,NZ_OX366347,1,315370,316488,-,1118
187,NZ_OU909470,1,1244547,1245668,+,1121
187,NZ_OX366363,1,733390,734507,+,1117
187,NZ_OX366364,1,571952,573070,-,1118
187,NZ_OX366359,1,202029,203147,-,1118
187,NZ_OX366349,1,695988,697088,-,1100
187,NZ_OX366380,1,943967,945088,-,1121
187,NZ_OX366344,1,257790,258907,+,1117
187,NZ_CP090900,1,1192879,1193997,-,1118
187,NZ_OX366352,1,1487250,1488367,+,1117
187,NZ_OX366362,1,418461,419594,-,1133
187,NZ_OX366400,1,204282,205400,-,1118
187,NZ_OX366327,1,205356,206474,-,1118
187,NZ_OX366367,1,32826,33959,-,1133
187,NZ_CP042444,1,1194230,1195348,-,1118
187,NZ_OX366326,1,204760,205878,-,1118
187,NZ_CP037426,1,1095794,1096912,-,1118
187,NZ_OX366339,1,1232078,1233196,-,1118
187,NZ_OX366355,1,1114057,1115174,+,1117
187,NZ_CP046922,1,1254679,1255797,-,1118
187,NZ_OX366370,1,360334,361438,+,1104
187,NZ_OX366385,1,868325,869446,+,1121
187,NZ_OX366399,1,205425,206543,-,1118
187,NZ_OX366395,1,345564,346682,-,1118
187,NZ_OX366396,1,205092,206210,-,1118
187,NZ_OX366351,1,203585,204702,+,1117
187,NZ_OX366381,1,1180937,1182054,+,1117
187,NZ_OX366342,1,655472,656589,+,1117
187,NZ_OX366369,1,199369,200487,-,1118
187,NZ_OX366356,1,234509,235627,-,1118
187,NZ_OX366377,1,378510,379627,+,1117
187,NZ_OX366388,1,1579139,1580271,+,1132
187,NZ_OX366357,1,1337026,1338159,-,1133
187,NZ_CP072012,1,1111008,1112125,+,1117
187,NZ_OX366398,1,987045,988162,+,1117
187,NC_002978,6,1192875,1193993,-,1118
187,NZ_OX366389,1,262750,263868,-,1118
187,NZ_OX366397,1,202736,203854,-,1118
187,NZ_OX366378,1,984376,985509,-,1133
187,NZ_CP090903,1,1192879,1193997,-,1118
187,NZ_OX366374,1,1257181,1258323,-,1142
187,NZ_CP090901,1,1192879,1193997,-,1118
187,NZ_CP046923,1,1170927,1172045,-,1118
187,NZ_CP069055,1,1192814,1193932,-,1118
187,NZ_CP072670,1,1192704,1193822,-,1118
187,NZ_CP090899,1,1192879,1193997,-,1118
187,NZ_CP046924,1,1191865,1192983,-,1118
187,NZ_OX366348,1,1046054,1047171,+,1117
187,NZ_CP046921,1,1254679,1255797,-,1118
187,NZ_OX366338,1,281258,282391,-,1133
187,NZ_CP054557,1,612628,613745,+,1117
187,NZ_CP072669,1,1192724,1193842,-,1118
187,NC_021089,1,1219264,1220382,-,1118
186,NZ_OX366376,1,559404,562552,+,3148
186,NZ_OX366393,1,777091,780240,-,3149
186,NZ_OX366372,1,1022180,1025329,-,3149
186,NZ_CP072672,1,1193861,1196956,-,3095
186,NZ_CP069060,1,1334698,1337793,-,3095
186,NZ_CP072667,1,1193835,1196930,-,3095
186,NZ_CP072671,1,1193843,1196938,-,3095
186,NZ_CP072668,1,1193830,1196925,-,3095
186,NZ_CP072666,1,1193843,1196938,-,3095
186,NZ_CP090902,1,1193996,1197091,-,3095
186,NZ_CP090948,1,1193994,1197089,-,3095
186,NZ_CP069052,1,1278998,1282093,-,3095
186,NZ_CP076228,1,1214383,1217478,-,3095
186,NZ_CP042445,1,1193983,1197078,-,3095
186,NZ_CP042904,1,1269450,1272545,-,3095
186,NC_012416,1,1314666,1317761,-,3095
186,NZ_CP069053,1,1319996,1323091,-,3095
186,NZ_CP042446,1,1193993,1197088,-,3095
186,NZ_CP041215,1,218276,221371,-,3095
186,NZ_OX366353,1,617330,620424,+,3094
186,NZ_OX366387,1,381070,384164,+,3094
186,NZ_OX366368,1,207042,210137,-,3095
186,NZ_OX366379,1,208060,211155,-,3095
186,NZ_CP091195,1,926657,929752,+,3095
186,NZ_OX366375,1,221595,224689,+,3094
186,NZ_CP046925,1,1193843,1196938,-,3095
186,NZ_OX366318,1,296068,299163,-,3095
186,NZ_OX366319,1,994185,997276,+,3091
186,NZ_OX366332,1,204149,207244,-,3095
186,NZ_CP110359,1,1231813,1234908,-,3095
186,NZ_OU953855,1,964549,967644,-,3095
186,NZ_OX366272,1,424896,427990,+,3094
186,NZ_OX366347,1,316489,319578,-,3089
186,NZ_OU909470,1,1241522,1244545,+,3023
186,NZ_OX366363,1,730294,733388,+,3094
186,NZ_OX366364,1,573071,576054,-,2983
186,NZ_OX366359,1,203148,206243,-,3095
186,NZ_OX366349,1,697119,700256,-,3137
186,NZ_OX366380,1,945089,948178,-,3089
186,NZ_OX366344,1,254640,257788,+,3148
186,NZ_CP090900,1,1193998,1197093,-,3095
186,NZ_OX366352,1,1484154,1487248,+,3094
186,NZ_OX366362,1,419835,422930,-,3095
186,NZ_OX366400,1,205401,208496,-,3095
186,NZ_OX366327,1,206475,209570,-,3095
186,NZ_OX366367,1,34192,37175,-,2983
186,NZ_CP042444,1,1195349,1198444,-,3095
186,NZ_OX366326,1,205879,208974,-,3095
186,NZ_CP037426,1,1096913,1100008,-,3095
186,NZ_OX366339,1,1233197,1236292,-,3095
186,NZ_OX366355,1,1110961,1114055,+,3094
186,NZ_CP046922,1,1255798,1258893,-,3095
186,NZ_OX366370,1,357177,360320,+,3143
186,NZ_OX366385,1,865235,868323,+,3088
186,NZ_OX366399,1,206544,209639,-,3095
186,NZ_OX366395,1,346683,349770,-,3087
186,NZ_OX366396,1,206211,209306,-,3095
186,NZ_OX366351,1,200489,203583,+,3094
186,NZ_OX366381,1,1177841,1180935,+,3094
186,NZ_OX366342,1,652322,655470,+,3148
186,NZ_OX366369,1,200488,203583,-,3095
186,NZ_OX366356,1,235628,238710,-,3082
186,NZ_OX366377,1,375414,378508,+,3094
186,NZ_OX366388,1,1573930,1577025,+,3095
186,NZ_OX366357,1,1338392,1341487,-,3095
186,NZ_CP072012,1,1107912,1111006,+,3094
186,NZ_OX366398,1,983949,987043,+,3094
186,NC_002978,6,1193994,1197089,-,3095
186,NZ_OX366389,1,263869,266964,-,3095
186,NZ_OX366397,1,203855,206950,-,3095
186,NZ_OX366378,1,986077,989172,-,3095
186,NZ_CP090903,1,1193998,1197093,-,3095
186,NZ_OX366374,1,1258556,1261585,-,3029
186,NZ_CP090901,1,1193998,1197093,-,3095
186,NZ_CP046923,1,1172046,1175141,-,3095
186,NZ_CP069055,1,1193933,1197028,-,3095
186,NZ_CP072670,1,1193823,1196918,-,3095
186,NZ_CP090899,1,1193998,1197093,-,3095
186,NZ_CP046924,1,1192984,1196079,-,3095
186,NZ_OX366348,1,1042958,1046052,+,3094
186,NZ_CP046921,1,1255798,1258893,-,3095
186,NZ_OX366338,1,282624,285719,-,3095
186,NZ_CP054557,1,609532,612626,+,3094
186,NZ_CP072669,1,1193843,1196938,-,3095
186,NC_021089,1,1220383,1223478,-,3095
185,NZ_OX366376,1,557574,558568,+,994
185,NZ_OX366393,1,781076,782070,-,994
185,NZ_OX366372,1,1026165,1027159,-,994
185,NZ_CP072672,1,1197792,1198789,-,997
185,NZ_CP069060,1,1338630,1339627,-,997
185,NZ_CP072667,1,1197766,1198763,-,997
185,NZ_CP072671,1,1197774,1198771,-,997
185,NZ_CP072668,1,1197761,1198758,-,997
185,NZ_CP072666,1,1197774,1198771,-,997
185,NZ_CP090902,1,1197927,1198924,-,997
185,NZ_CP090948,1,1197925,1198922,-,997
185,NZ_CP069052,1,1282930,1283927,-,997
185,NZ_CP076228,1,1218315,1219312,-,997
185,NZ_CP042445,1,1197914,1198911,-,997
185,NZ_CP042904,1,1273382,1274367,-,985
185,NC_012416,1,1318598,1319583,-,985
185,NZ_CP069053,1,1323928,1324925,-,997
185,NZ_CP042446,1,1197924,1198921,-,997
185,NZ_CP041215,1,222208,223193,-,985
185,NZ_OX366353,1,615517,616503,+,986
185,NZ_OX366387,1,379247,380233,+,986
185,NZ_OX366368,1,210974,211971,-,997
185,NZ_OX366379,1,211992,212989,-,997
185,NZ_CP091195,1,924833,925819,+,986
185,NZ_OX366375,1,219772,220758,+,986
185,NZ_CP046925,1,1197774,1198771,-,997
185,NZ_OX366318,1,300000,300997,-,997
185,NZ_OX366319,1,992362,993348,+,986
185,NZ_OX366332,1,208081,209066,-,985
185,NZ_CP110359,1,1235745,1236730,-,985
185,NZ_OU953855,1,968481,969466,-,985
185,NZ_OX366272,1,423073,424059,+,986
185,NZ_OX366347,1,320415,321400,-,985
185,NZ_OU909470,1,1315468,1316462,-,994
185,NZ_OX366363,1,728471,729457,+,986
185,NZ_OX366364,1,577285,578270,-,985
185,NZ_OX366359,1,207079,208064,-,985
185,NZ_OX366349,1,701092,702086,-,994
185,NZ_OX366380,1,949892,950886,-,994
185,NZ_OX366344,1,252810,253804,+,994
185,NZ_CP090900,1,1197929,1198926,-,997
185,NZ_OX366352,1,1482331,1483317,+,986
185,NZ_OX366362,1,404503,405488,-,985
185,NZ_OX366400,1,209333,210330,-,997
185,NZ_OX366327,1,210408,211393,-,985
185,NZ_OX366367,1,38517,39499,-,982
185,NZ_CP042444,1,1199280,1200277,-,997
185,NZ_OX366326,1,209811,210808,-,997
185,NZ_CP037426,1,1100845,1101830,-,985
185,NZ_OX366339,1,1237129,1238114,-,985
185,NZ_OX366355,1,1109138,1110124,+,986
185,NZ_CP046922,1,1259729,1260726,-,997
185,NZ_OX366370,1,355350,356344,+,994
185,NZ_OX366385,1,862546,863540,+,994
185,NZ_OX366399,1,210476,211473,-,997
185,NZ_OX366395,1,388122,389108,+,986
185,NZ_OX366396,1,211095,212080,-,985
185,NZ_OX366351,1,198655,199652,+,997
185,NZ_OX366381,1,1176018,1177004,+,986
185,NZ_OX366342,1,650492,651486,+,994
185,NZ_OX366369,1,204420,205405,-,985
185,NZ_OX366356,1,239618,240603,-,985
185,NZ_OX366377,1,373580,374577,+,997
185,NZ_OX366388,1,1572106,1573092,+,986
185,NZ_OX366357,1,342808,343793,-,985
185,NZ_CP072012,1,1106078,1107075,+,997
185,NZ_OX366398,1,982115,983112,+,997
185,NC_002978,6,1197925,1198922,-,997
185,NZ_OX366389,1,267801,268798,-,997
185,NZ_OX366397,1,207787,208772,-,985
185,NZ_OX366378,1,990010,990995,-,985
185,NZ_CP090903,1,1197929,1198926,-,997
185,NZ_OX366374,1,1283563,1284549,+,986
185,NZ_CP090901,1,1197929,1198926,-,997
185,NZ_CP046923,1,1175977,1176974,-,997
185,NZ_CP069055,1,1197864,1198861,-,997
185,NZ_CP072670,1,1197754,1198751,-,997
185,NZ_CP090899,1,1197929,1198926,-,997
185,NZ_CP046924,1,1196915,1197912,-,997
185,NZ_OX366348,1,1041124,1042121,+,997
185,NZ_CP046921,1,1259729,1260726,-,997
185,NZ_OX366338,1,287509,288494,-,985
185,NZ_CP054557,1,606794,607791,+,997
185,NZ_CP072669,1,1197774,1198771,-,997
185,NC_021089,1,1224315,1225300,-,985
184,NZ_OX366376,1,556683,557437,+,754
184,NZ_OX366393,1,782207,782961,-,754
184,NZ_OX366372,1,1027296,1028050,-,754
184,NZ_CP072672,1,1198926,1199680,-,754
184,NZ_CP069060,1,1339764,1340518,-,754
184,NZ_CP072667,1,1198900,1199654,-,754
184,NZ_CP072671,1,1198908,1199662,-,754
184,NZ_CP072668,1,1198895,1199649,-,754
184,NZ_CP072666,1,1198908,1199662,-,754
184,NZ_CP090902,1,1199061,1199815,-,754
184,NZ_CP090948,1,1199059,1199813,-,754
184,NZ_CP069052,1,1284064,1284818,-,754
184,NZ_CP076228,1,1219449,1220203,-,754
184,NZ_CP042445,1,1199048,1199802,-,754
184,NZ_CP042904,1,1274528,1275267,-,739
184,NC_012416,1,1319744,1320483,-,739
184,NZ_CP069053,1,1325062,1325816,-,754
184,NZ_CP042446,1,1199058,1199812,-,754
184,NZ_CP041215,1,223354,224093,-,739
184,NZ_OX366353,1,614618,615356,+,738
184,NZ_OX366387,1,378348,379086,+,738
184,NZ_OX366368,1,212108,212862,-,754
184,NZ_OX366379,1,213126,213880,-,754
184,NZ_CP091195,1,923934,924672,+,738
184,NZ_OX366375,1,218873,219611,+,738
184,NZ_CP046925,1,1198908,1199662,-,754
184,NZ_OX366318,1,301134,301888,-,754
184,NZ_OX366319,1,991463,992201,+,738
184,NZ_OX366332,1,209227,209966,-,739
184,NZ_CP110359,1,1236891,1237630,-,739
184,NZ_OU953855,1,969627,970366,-,739
184,NZ_OX366272,1,422174,422912,+,738
184,NZ_OX366347,1,321561,322300,-,739
184,NZ_OU909470,1,1316599,1317353,-,754
184,NZ_OX366363,1,727572,728310,+,738
184,NZ_OX366364,1,578431,579170,-,739
184,NZ_OX366359,1,208225,208964,-,739
184,NZ_OX366349,1,702223,702977,-,754
184,NZ_OX366380,1,951023,951777,-,754
184,NZ_OX366344,1,251919,252673,+,754
184,NZ_CP090900,1,1199063,1199817,-,754
184,NZ_OX366352,1,1481432,1482170,+,738
184,NZ_OX366362,1,405649,406388,-,739
184,NZ_OX366400,1,210467,211221,-,754
184,NZ_OX366327,1,211554,212293,-,739
184,NZ_OX366367,1,39660,40399,-,739
184,NZ_CP042444,1,1200414,1201168,-,754
184,NZ_OX366326,1,210945,211699,-,754
184,NZ_CP037426,1,1101991,1102730,-,739
184,NZ_OX366339,1,1238275,1239014,-,739
184,NZ_OX366355,1,1108239,1108977,+,738
184,NZ_CP046922,1,1260863,1261617,-,754
184,NZ_OX366370,1,354459,355213,+,754
184,NZ_OX366385,1,861655,862409,+,754
184,NZ_OX366399,1,211610,212364,-,754
184,NZ_OX366395,1,387223,387961,+,738
184,NZ_OX366396,1,212241,212980,-,739
184,NZ_OX366351,1,197764,198518,+,754
184,NZ_OX366381,1,1175119,1175857,+,738
184,NZ_OX366342,1,649601,650355,+,754
184,NZ_OX366369,1,205566,206305,-,739
184,NZ_OX366356,1,240764,241503,-,739
184,NZ_OX366377,1,372689,373443,+,754
184,NZ_OX366388,1,1571207,1571945,+,738
184,NZ_OX366357,1,343954,344693,-,739
184,NZ_CP072012,1,1105187,1105941,+,754
184,NZ_OX366398,1,981224,981978,+,754
184,NC_002978,6,1199059,1199813,-,754
184,NZ_OX366389,1,268935,269689,-,754
184,NZ_OX366397,1,208933,209672,-,739
184,NZ_OX366378,1,991156,991895,-,739
184,NZ_CP090903,1,1199063,1199817,-,754
184,NZ_OX366374,1,1282664,1283402,+,738
184,NZ_CP090901,1,1199063,1199817,-,754
184,NZ_CP046923,1,1177111,1177865,-,754
184,NZ_CP069055,1,1198998,1199752,-,754
184,NZ_CP072670,1,1198888,1199642,-,754
184,NZ_CP090899,1,1199063,1199817,-,754
184,NZ_CP046924,1,1198049,1198803,-,754
184,NZ_OX366348,1,1040233,1040987,+,754
184,NZ_CP046921,1,1260863,1261617,-,754
184,NZ_OX366338,1,288655,289394,-,739
184,NZ_CP054557,1,605903,606657,+,754
184,NZ_CP072669,1,1198908,1199662,-,754
184,NC_021089,1,1225461,1226200,-,739
183,NZ_OX366376,1,555282,556681,+,1399
183,NZ_OX366393,1,782962,784366,-,1404
183,NZ_OX366372,1,1028051,1029454,-,1403
183,NZ_OX366342,1,648196,649599,+,1403
182,NZ_OX366376,1,553939,555237,+,1298
182,NZ_OX366393,1,784411,785709,-,1298
182,NZ_OX366372,1,1029499,1030797,-,1298
182,NZ_CP072672,1,1199715,1201058,-,1343
182,NZ_CP069060,1,1340553,1341896,-,1343
182,NZ_CP072667,1,1199689,1201032,-,1343
182,NZ_CP072671,1,1199697,1201040,-,1343
182,NZ_CP072668,1,1199684,1201027,-,1343
182,NZ_CP072666,1,1199697,1201040,-,1343
182,NZ_CP090902,1,1199850,1201193,-,1343
182,NZ_CP090948,1,1199848,1201191,-,1343
182,NZ_CP069052,1,1284853,1286196,-,1343
182,NZ_CP076228,1,1220238,1221581,-,1343
182,NZ_CP042445,1,1199837,1201180,-,1343
182,NZ_CP042904,1,1275302,1276645,-,1343
182,NC_012416,1,1320518,1321861,-,1343
182,NZ_CP069053,1,1325851,1327194,-,1343
182,NZ_CP042446,1,1199847,1201190,-,1343
182,NZ_CP041215,1,224128,225464,-,1336
182,NZ_OX366353,1,613247,614583,+,1336
182,NZ_OX366387,1,376970,378313,+,1343
182,NZ_OX366368,1,212897,214240,-,1343
182,NZ_OX366379,1,213915,215258,-,1343
182,NZ_CP091195,1,922556,923899,+,1343
182,NZ_OX366375,1,217496,218838,+,1342
182,NZ_CP046925,1,1199697,1201040,-,1343
182,NZ_OX366318,1,301923,303266,-,1343
182,NZ_OX366319,1,990085,991428,+,1343
182,NZ_OX366332,1,210001,211337,-,1336
182,NZ_CP110359,1,1237665,1239006,-,1341
182,NZ_OU953855,1,970401,971742,-,1341
182,NZ_OX366272,1,420847,422139,+,1292
182,NZ_OX366347,1,322335,323676,-,1341
182,NZ_OU909470,1,1317388,1318721,-,1333
182,NZ_OX366363,1,726196,727537,+,1341
182,NZ_OX366364,1,579205,580530,-,1325
182,NZ_OX366359,1,208999,210335,-,1336
182,NZ_OX366349,1,703012,704310,-,1298
182,NZ_OX366380,1,951812,953153,-,1341
182,NZ_OX366344,1,249038,250336,+,1298
182,NZ_CP090900,1,1199852,1201195,-,1343
182,NZ_OX366352,1,1480061,1481397,+,1336
182,NZ_OX366362,1,406431,407766,-,1335
182,NZ_OX366400,1,211256,212599,-,1343
182,NZ_OX366327,1,212328,213671,-,1343
182,NZ_OX366367,1,40434,41759,-,1325
182,NZ_CP042444,1,1201203,1202546,-,1343
182,NZ_OX366326,1,211734,213077,-,1343
182,NZ_CP037426,1,1102765,1104107,-,1342
182,NZ_OX366339,1,1239049,1240392,-,1343
182,NZ_OX366355,1,1106863,1108204,+,1341
182,NZ_CP046922,1,1261652,1262995,-,1343
182,NZ_OX366370,1,353126,354424,+,1298
182,NZ_OX366385,1,860279,861620,+,1341
182,NZ_OX366399,1,212399,213742,-,1343
182,NZ_OX366395,1,385860,387188,+,1328
182,NZ_OX366396,1,213015,214358,-,1343
182,NZ_OX366351,1,196386,197729,+,1343
182,NZ_OX366381,1,1173741,1175084,+,1343
182,NZ_OX366342,1,646853,648151,+,1298
182,NZ_OX366369,1,206340,207683,-,1343
182,NZ_OX366356,1,241538,242881,-,1343
182,NZ_OX366377,1,371311,372654,+,1343
182,NZ_OX366388,1,1569829,1571172,+,1343
182,NZ_OX366357,1,344728,346069,-,1341
182,NZ_CP072012,1,1103809,1105152,+,1343
182,NZ_OX366398,1,979846,981189,+,1343
182,NC_002978,6,1199848,1201191,-,1343
182,NZ_OX366389,1,269724,271067,-,1343
182,NZ_OX366397,1,209707,211043,-,1336
182,NZ_OX366378,1,991930,993273,-,1343
182,NZ_CP090903,1,1199852,1201195,-,1343
182,NZ_OX366374,1,1281301,1282629,+,1328
182,NZ_CP090901,1,1199852,1201195,-,1343
182,NZ_CP046923,1,1177900,1179243,-,1343
182,NZ_CP069055,1,1199787,1201130,-,1343
182,NZ_CP072670,1,1199677,1201020,-,1343
182,NZ_CP090899,1,1199852,1201195,-,1343
182,NZ_CP046924,1,1198838,1200181,-,1343
182,NZ_OX366348,1,1038855,1040198,+,1343
182,NZ_CP046921,1,1261652,1262995,-,1343
182,NZ_OX366338,1,289429,290770,-,1341
182,NZ_CP054557,1,604525,605868,+,1343
182,NZ_CP072669,1,1199697,1201040,-,1343
182,NC_021089,1,1226235,1227571,-,1336
181,NZ_OX366376,1,550723,553937,+,3214
181,NZ_OX366393,1,785710,788925,-,3215
181,NZ_OX366372,1,1030798,1034006,-,3208
181,NZ_CP072672,1,1201059,1204281,-,3222
181,NZ_CP069060,1,1341897,1345119,-,3222
181,NZ_CP072667,1,1201033,1204255,-,3222
181,NZ_CP072671,1,1201041,1204263,-,3222
181,NZ_CP072668,1,1201028,1204250,-,3222
181,NZ_CP072666,1,1201041,1204263,-,3222
181,NZ_CP090902,1,1201194,1204416,-,3222
181,NZ_CP090948,1,1201192,1204414,-,3222
181,NZ_CP069052,1,1286197,1289419,-,3222
181,NZ_CP076228,1,1221582,1224804,-,3222
181,NZ_CP042445,1,1201181,1204403,-,3222
181,NZ_CP042904,1,1276646,1279868,-,3222
181,NC_012416,1,1321862,1325084,-,3222
181,NZ_CP069053,1,1327195,1330417,-,3222
181,NZ_CP042446,1,1201191,1204413,-,3222
181,NZ_CP041215,1,225465,228687,-,3222
181,NZ_OX366353,1,610024,613245,+,3221
181,NZ_OX366387,1,373741,376968,+,3227
181,NZ_OX366368,1,214241,217463,-,3222
181,NZ_OX366379,1,215259,218481,-,3222
181,NZ_CP091195,1,919333,922554,+,3221
181,NZ_OX366375,1,214273,217494,+,3221
181,NZ_CP046925,1,1201041,1204263,-,3222
181,NZ_OX366318,1,303267,306495,-,3228
181,NZ_OX366319,1,986862,990083,+,3221
181,NZ_OX366332,1,211338,214560,-,3222
181,NZ_CP110359,1,1239007,1242226,-,3219
181,NZ_OU953855,1,971743,974965,-,3222
181,NZ_OX366272,1,417243,420477,+,3234
181,NZ_OX366347,1,323677,326896,-,3219
181,NZ_OU909470,1,1318722,1321942,-,3220
181,NZ_OX366363,1,722967,726194,+,3227
181,NZ_OX366364,1,580531,583750,-,3219
181,NZ_OX366359,1,210336,213558,-,3222
181,NZ_OX366349,1,704311,707527,-,3216
181,NZ_OX366380,1,953154,956367,-,3213
181,NZ_OX366344,1,245821,249036,+,3215
181,NZ_CP090900,1,1201196,1204418,-,3222
181,NZ_OX366352,1,1476838,1480059,+,3221
181,NZ_OX366362,1,407767,410980,-,3213
181,NZ_OX366400,1,212600,215828,-,3228
181,NZ_OX366327,1,213672,216894,-,3222
181,NZ_OX366367,1,41760,44979,-,3219
181,NZ_CP042444,1,1202547,1205769,-,3222
181,NZ_OX366326,1,213078,216306,-,3228
181,NZ_CP037426,1,1104108,1107330,-,3222
181,NZ_OX366339,1,1240393,1243615,-,3222
181,NZ_OX366355,1,1103638,1106861,+,3223
181,NZ_CP046922,1,1262996,1266218,-,3222
181,NZ_OX366370,1,349909,353124,+,3215
181,NZ_OX366385,1,857065,860277,+,3212
181,NZ_OX366399,1,213743,216965,-,3222
181,NZ_OX366395,1,382646,385858,+,3212
181,NZ_OX366396,1,214359,217581,-,3222
181,NZ_OX366351,1,193157,196384,+,3227
181,NZ_OX366381,1,1170518,1173739,+,3221
181,NZ_OX366342,1,643637,646851,+,3214
181,NZ_OX366369,1,207684,210906,-,3222
181,NZ_OX366356,1,242882,246101,-,3219
181,NZ_OX366377,1,368082,371309,+,3227
181,NZ_OX366388,1,1566606,1569827,+,3221
181,NZ_OX366357,1,346070,349292,-,3222
181,NZ_CP072012,1,1100586,1103807,+,3221
181,NZ_OX366398,1,976617,979844,+,3227
181,NC_002978,6,1201192,1204414,-,3222
181,NZ_OX366389,1,271068,274296,-,3228
181,NZ_OX366397,1,211044,214266,-,3222
181,NZ_OX366378,1,993274,996496,-,3222
181,NZ_CP090903,1,1201196,1204418,-,3222
181,NZ_OX366374,1,1278087,1281299,+,3212
181,NZ_CP090901,1,1201196,1204418,-,3222
181,NZ_CP046923,1,1179244,1182466,-,3222
181,NZ_CP069055,1,1201131,1204353,-,3222
181,NZ_CP072670,1,1201021,1204243,-,3222
181,NZ_CP090899,1,1201196,1204418,-,3222
181,NZ_CP046924,1,1200182,1203404,-,3222
181,NZ_OX366348,1,1035626,1038853,+,3227
181,NZ_CP046921,1,1262996,1266218,-,3222
181,NZ_OX366338,1,290771,293984,-,3213
181,NZ_CP054557,1,601296,604523,+,3227
181,NZ_CP072669,1,1201041,1204263,-,3222
181,NC_021089,1,1227572,1230794,-,3222
180,NZ_OX366376,1,549219,550366,+,1147
180,NZ_OX366393,1,789282,790429,-,1147
180,NZ_OX366372,1,1034363,1035510,-,1147
180,NZ_CP072672,1,1204523,1205684,-,1161
180,NZ_CP069060,1,1345361,1346522,-,1161
180,NZ_CP072667,1,1204497,1205658,-,1161
180,NZ_CP072671,1,1204505,1205666,-,1161
180,NZ_CP072668,1,1204492,1205653,-,1161
180,NZ_CP072666,1,1204505,1205666,-,1161
180,NZ_CP090902,1,1204658,1205819,-,1161
180,NZ_CP090948,1,1204656,1205817,-,1161
180,NZ_CP069052,1,1289661,1290822,-,1161
180,NZ_CP076228,1,1225046,1226207,-,1161
180,NZ_CP042445,1,1204645,1205806,-,1161
180,NZ_CP042904,1,1280224,1281385,-,1161
180,NC_012416,1,1325440,1326601,-,1161
180,NZ_CP069053,1,1330659,1331820,-,1161
180,NZ_CP042446,1,1204655,1205816,-,1161
180,NZ_CP041215,1,228929,230081,-,1152
180,NZ_OX366353,1,608630,609782,+,1152
180,NZ_OX366387,1,372224,373385,+,1161
180,NZ_OX366368,1,217705,218866,-,1161
180,NZ_OX366379,1,218723,219884,-,1161
180,NZ_CP091195,1,917832,918977,+,1145
180,NZ_OX366375,1,212756,213917,+,1161
180,NZ_CP046925,1,1204505,1205666,-,1161
180,NZ_OX366318,1,306737,307898,-,1161
180,NZ_OX366319,1,985345,986506,+,1161
180,NZ_OX366332,1,214802,215954,-,1152
180,NZ_CP110359,1,1242582,1243743,-,1161
180,NZ_OU953855,1,975321,976482,-,1161
180,NZ_OX366272,1,415726,416887,+,1161
180,NZ_OX366347,1,327138,328299,-,1161
180,NZ_OU909470,1,1322184,1323339,-,1155
180,NZ_OX366363,1,721564,722725,+,1161
180,NZ_OX366364,1,584035,585187,-,1152
180,NZ_OX366359,1,213800,214952,-,1152
180,NZ_OX366349,1,707884,709031,-,1147
180,NZ_OX366380,1,956609,957770,-,1161
180,NZ_OX366344,1,244317,245464,+,1147
180,NZ_CP090900,1,1204660,1205821,-,1161
180,NZ_OX366352,1,1475444,1476596,+,1152
180,NZ_OX366362,1,1362204,1363348,-,1144
180,NZ_OX366400,1,216070,217231,-,1161
180,NZ_OX366327,1,217250,218411,-,1161
180,NZ_OX366367,1,45284,46407,-,1123
180,NZ_CP042444,1,1206011,1207172,-,1161
180,NZ_OX366326,1,216548,217709,-,1161
180,NZ_CP037426,1,1107686,1108830,-,1144
180,NZ_OX366339,1,1243971,1245132,-,1161
180,NZ_OX366355,1,1102121,1103282,+,1161
180,NZ_CP046922,1,1266460,1267621,-,1161
180,NZ_OX366370,1,348486,349552,+,1066
180,NZ_OX366385,1,855662,856823,+,1161
180,NZ_OX366399,1,217207,218368,-,1161
180,NZ_OX366395,1,381129,382290,+,1161
180,NZ_OX366396,1,217937,219098,-,1161
180,NZ_OX366351,1,191754,192915,+,1161
180,NZ_OX366381,1,1169001,1170162,+,1161
180,NZ_OX366342,1,642133,643280,+,1147
180,NZ_OX366369,1,211262,212423,-,1161
180,NZ_OX366356,1,246457,247618,-,1161
180,NZ_OX366377,1,366679,367840,+,1161
180,NZ_OX366388,1,1565105,1566250,+,1145
180,NZ_OX366357,1,349648,350714,-,1066
180,NZ_CP072012,1,1099183,1100344,+,1161
180,NZ_OX366398,1,975214,976375,+,1161
180,NC_002978,6,1204656,1205817,-,1161
180,NZ_OX366389,1,274538,275699,-,1161
180,NZ_OX366397,1,214508,215660,-,1152
180,NZ_OX366378,1,996852,997918,-,1066
180,NZ_CP090903,1,1204660,1205821,-,1161
180,NZ_OX366374,1,1275812,1276871,+,1059
180,NZ_CP090901,1,1204660,1205821,-,1161
180,NZ_CP046923,1,1182708,1183869,-,1161
180,NZ_CP069055,1,1204595,1205756,-,1161
180,NZ_CP072670,1,1204485,1205646,-,1161
180,NZ_CP090899,1,1204660,1205821,-,1161
180,NZ_CP046924,1,1203646,1204807,-,1161
180,NZ_OX366348,1,1034223,1035384,+,1161
180,NZ_CP046921,1,1266460,1267621,-,1161
180,NZ_OX366338,1,294340,295406,-,1066
180,NZ_CP054557,1,599893,601054,+,1161
180,NZ_CP072669,1,1204505,1205666,-,1161
180,NC_021089,1,1231036,1232188,-,1152
179,NZ_OX366376,1,547337,548181,+,844
179,NZ_OX366393,1,791467,792310,-,843
179,NZ_OX366372,1,1036548,1037391,-,843
179,NZ_CP072672,1,1207541,1208382,-,841
179,NZ_CP069060,1,1348438,1349279,-,841
179,NZ_CP072667,1,1207515,1208356,-,841
179,NZ_CP072671,1,1207523,1208364,-,841
179,NZ_CP072668,1,1207510,1208351,-,841
179,NZ_CP072666,1,1207523,1208364,-,841
179,NZ_CP090902,1,1207676,1208517,-,841
179,NZ_CP090948,1,1207674,1208515,-,841
179,NZ_CP069052,1,1292738,1293579,-,841
179,NZ_CP076228,1,1228196,1229037,-,841
179,NZ_CP042445,1,1207663,1208504,-,841
179,NZ_CP042904,1,1283245,1284105,-,860
179,NC_012416,1,1328461,1329321,-,860
179,NZ_CP069053,1,1333736,1334577,-,841
179,NZ_CP042446,1,1207673,1208514,-,841
179,NZ_CP041215,1,231720,232573,-,853
179,NZ_OX366353,1,562989,563842,-,853
179,NZ_OX366387,1,369602,370445,+,843
179,NZ_OX366368,1,220855,221696,-,841
179,NZ_OX366379,1,221873,222714,-,841
179,NZ_CP091195,1,915430,916298,+,868
179,NZ_OX366375,1,209015,209857,+,842
179,NZ_CP046925,1,1207523,1208364,-,841
179,NZ_OX366318,1,310007,310858,-,851
179,NZ_OX366319,1,982716,983560,+,844
179,NZ_OX366332,1,217748,218601,-,853
179,NZ_CP110359,1,1245439,1246280,-,841
179,NZ_OU953855,1,199781,200586,+,805
179,NZ_OX366272,1,413187,414029,+,842
179,NZ_OX366347,1,329981,330822,-,841
179,NZ_OU909470,1,1324393,1325244,-,851
179,NZ_OX366363,1,718655,719497,+,842
179,NZ_OX366364,1,563559,564393,+,834
179,NZ_OX366359,1,216574,217427,-,853
179,NZ_OX366349,1,710066,710900,-,834
179,NZ_OX366380,1,77148,78000,+,852
179,NZ_OX366344,1,242439,243273,+,834
179,NZ_CP090900,1,1207678,1208519,-,841
179,NZ_OX366352,1,1472796,1473650,+,854
179,NZ_OX366362,1,1365149,1365992,-,843
179,NZ_OX366400,1,220191,221042,-,851
179,NZ_OX366327,1,220271,221122,-,851
179,NZ_OX366367,1,48718,49571,-,853
179,NZ_CP042444,1,1209029,1209870,-,841
179,NZ_OX366326,1,219814,220665,-,851
179,NZ_CP037426,1,221125,221967,+,842
179,NZ_OX366339,1,1246868,1247729,-,861
179,NZ_OX366355,1,1099492,1100336,+,844
179,NZ_CP046922,1,1269478,1270319,-,841
179,NZ_OX366370,1,346457,347291,+,834
179,NZ_OX366385,1,1239509,1240360,-,851
179,NZ_OX366399,1,220357,221198,-,841
179,NZ_OX366395,1,378483,379285,+,802
179,NZ_OX366396,1,220742,221603,-,861
179,NZ_OX366351,1,188793,189645,+,852
179,NZ_OX366381,1,1166372,1167216,+,844
179,NZ_OX366342,1,640251,641095,+,844
179,NZ_OX366369,1,214208,215051,-,843
179,NZ_OX366356,1,249555,250396,-,841
179,NZ_OX366377,1,363997,364839,+,842
179,NZ_OX366388,1,1562152,1562987,+,835
179,NZ_OX366357,1,351893,352725,-,832
179,NZ_CP072012,1,1096352,1097194,+,842
179,NZ_OX366398,1,972532,973374,+,842
179,NC_002978,6,1207674,1208515,-,841
179,NZ_OX366389,1,277366,278207,-,841
179,NZ_OX366397,1,217454,218307,-,853
179,NZ_OX366378,1,999531,1000399,-,868
179,NZ_CP090903,1,1207678,1208519,-,841
179,NZ_OX366374,1,1273857,1274699,+,842
179,NZ_CP090901,1,1207678,1208519,-,841
179,NZ_CP046923,1,1185726,1186567,-,841
179,NZ_CP069055,1,1207575,1208415,-,840
179,NZ_CP072670,1,1207503,1208344,-,841
179,NZ_CP090899,1,1207678,1208519,-,841
179,NZ_CP046924,1,1206664,1207505,-,841
179,NZ_OX366348,1,1031362,1032214,+,852
179,NZ_CP046921,1,1269478,1270319,-,841
179,NZ_OX366338,1,296528,297325,-,797
179,NZ_CP054557,1,596955,597807,+,852
179,NZ_CP072669,1,1207523,1208364,-,841
179,NC_021089,1,1233894,1234747,-,853
178,NZ_OX366376,1,544419,546902,+,2483
178,NZ_OX366393,1,792746,795229,-,2483
178,NZ_OX366372,1,1037827,1040310,-,2483
178,NZ_CP072672,1,1208603,1211103,-,2500
178,NZ_CP069060,1,1349500,1352000,-,2500
178,NZ_CP072667,1,1208577,1211077,-,2500
178,NZ_CP072671,1,1208585,1211085,-,2500
178,NZ_CP072668,1,1208572,1211072,-,2500
178,NZ_CP072666,1,1208585,1211085,-,2500
178,NZ_CP090902,1,1208738,1211238,-,2500
178,NZ_CP090948,1,1208736,1211236,-,2500
178,NZ_CP069052,1,1293800,1296300,-,2500
178,NZ_CP076228,1,1229359,1231859,-,2500
178,NZ_CP042445,1,1208725,1211225,-,2500
178,NZ_CP042904,1,1284418,1286916,-,2498
178,NC_012416,1,1329634,1332132,-,2498
178,NZ_CP069053,1,1334798,1337298,-,2500
178,NZ_CP042446,1,1208735,1211235,-,2500
178,NZ_CP041215,1,232885,235391,-,2506
178,NZ_OX366353,1,564154,566660,-,2506
178,NZ_OX366387,1,366803,369281,+,2478
178,NZ_OX366368,1,222018,224518,-,2500
178,NZ_OX366379,1,223036,225536,-,2500
178,NZ_CP091195,1,912291,914799,+,2508
178,NZ_OX366375,1,206205,208694,+,2489
178,NZ_CP046925,1,1208585,1211085,-,2500
178,NZ_OX366318,1,311180,313688,-,2508
178,NZ_OX366319,1,979991,982505,+,2514
178,NZ_OX366332,1,218913,221419,-,2506
178,NZ_CP110359,1,1246937,1249445,-,2508
178,NZ_OU953855,1,737111,739625,-,2514
178,NZ_OX366272,1,1146095,1148603,+,2508
178,NZ_OX366347,1,331144,333652,-,2508
178,NZ_OU909470,1,1325745,1328165,-,2420
178,NZ_OX366363,1,715834,718334,+,2500
178,NZ_OX366364,1,559525,562026,+,2501
178,NZ_OX366359,1,217739,220245,-,2506
178,NZ_OX366349,1,710960,713450,-,2490
178,NZ_OX366380,1,818548,821041,-,2493
178,NZ_OX366344,1,239886,242375,+,2489
178,NZ_CP090900,1,1208740,1211240,-,2500
178,NZ_OX366352,1,1469979,1472485,+,2506
178,NZ_OX366362,1,1366328,1368825,-,2497
178,NZ_OX366400,1,221364,223872,-,2508
178,NZ_OX366327,1,221343,223816,-,2473
178,NZ_OX366367,1,50075,52576,-,2501
178,NZ_CP042444,1,1210091,1212591,-,2500
178,NZ_OX366326,1,220987,223495,-,2508
178,NZ_CP037426,1,218315,220804,+,2489
178,NZ_OX366339,1,1249115,1251613,-,2498
178,NZ_OX366355,1,1096767,1099281,+,2514
178,NZ_CP046922,1,1270540,1273040,-,2500
178,NZ_OX366370,1,343896,346393,+,2497
178,NZ_OX366385,1,537241,539734,+,2493
178,NZ_OX366399,1,221520,224020,-,2500
178,NZ_OX366395,1,375447,377945,+,2498
178,NZ_OX366396,1,222989,225487,-,2498
178,NZ_OX366351,1,185964,188472,+,2508
178,NZ_OX366381,1,1163647,1166161,+,2514
178,NZ_OX366342,1,637333,639816,+,2483
178,NZ_OX366369,1,215263,217777,-,2514
178,NZ_OX366356,1,250728,253235,-,2507
178,NZ_OX366377,1,361176,363676,+,2500
178,NZ_OX366388,1,1559580,1562088,+,2508
178,NZ_OX366357,1,353232,355705,-,2473
178,NZ_CP072012,1,1093531,1096031,+,2500
178,NZ_OX366398,1,969711,972211,+,2500
178,NC_002978,6,1208736,1211236,-,2500
178,NZ_OX366389,1,278529,281029,-,2500
178,NZ_OX366397,1,218619,221125,-,2506
178,NZ_OX366378,1,1001030,1003538,-,2508
178,NZ_CP090903,1,1208740,1211240,-,2500
178,NZ_OX366374,1,1271034,1273532,+,2498
178,NZ_CP090901,1,1208740,1211240,-,2500
178,NZ_CP046923,1,1186788,1189288,-,2500
178,NZ_CP069055,1,1208737,1211237,-,2500
178,NZ_CP072670,1,1208565,1211065,-,2500
178,NZ_CP090899,1,1208740,1211240,-,2500
178,NZ_CP046924,1,1207726,1210226,-,2500
178,NZ_OX366348,1,1028662,1031151,+,2489
178,NZ_CP046921,1,1270540,1273040,-,2500
178,NZ_OX366338,1,297877,300366,-,2489
178,NZ_CP054557,1,594256,596744,+,2488
178,NZ_CP072669,1,1208585,1211085,-,2500
178,NC_021089,1,1235059,1237565,-,2506
177,NZ_OX366376,1,542274,543005,+,731
177,NZ_OX366393,1,796642,797379,-,737
177,NZ_OX366372,1,1041724,1042461,-,737
177,NZ_CP072672,1,1212498,1213235,-,737
177,NZ_CP069060,1,1353397,1354134,-,737
177,NZ_CP072667,1,1212472,1213209,-,737
177,NZ_CP072671,1,1212480,1213217,-,737
177,NZ_CP072668,1,1212467,1213204,-,737
177,NZ_CP072666,1,1212480,1213217,-,737
177,NZ_CP090902,1,1212633,1213370,-,737
177,NZ_CP090948,1,1212631,1213368,-,737
177,NZ_CP069052,1,1297697,1298434,-,737
177,NZ_CP076228,1,1233256,1233966,-,710
177,NZ_CP042445,1,1212620,1213357,-,737
177,NZ_CP042904,1,1288324,1289061,-,737
177,NC_012416,1,1333540,1334277,-,737
177,NZ_CP069053,1,1338695,1339432,-,737
177,NZ_CP042446,1,1212630,1213367,-,737
177,NZ_CP041215,1,236796,237533,-,737
177,NZ_OX366353,1,568065,568802,-,737
177,NZ_OX366387,1,365015,365752,+,737
177,NZ_OX366368,1,225915,226652,-,737
177,NZ_OX366379,1,226933,227670,-,737
177,NZ_CP091195,1,910158,910895,+,737
177,NZ_OX366375,1,243195,243932,-,737
177,NZ_CP046925,1,1212480,1213217,-,737
177,NZ_OX366318,1,315093,315830,-,737
177,NZ_OX366319,1,977879,978616,+,737
177,NZ_OX366332,1,222824,223561,-,737
177,NZ_CP110359,1,1250842,1251579,-,737
177,NZ_OU953855,1,741255,741992,-,737
177,NZ_OX366272,1,1143961,1144698,+,737
177,NZ_OX366347,1,335057,335794,-,737
177,NZ_OU909470,1,1331406,1332143,-,737
177,NZ_OX366363,1,713700,714437,+,737
177,NZ_OX366364,1,429898,430635,+,737
177,NZ_OX366359,1,221650,222387,-,737
177,NZ_OX366349,1,714850,715587,-,737
177,NZ_OX366380,1,822437,823174,-,737
177,NZ_OX366344,1,237680,238417,+,737
177,NZ_CP090900,1,1212635,1213372,-,737
177,NZ_OX366352,1,1467837,1468574,+,737
177,NZ_OX366362,1,1436666,1437403,+,737
177,NZ_OX366400,1,225277,226014,-,737
177,NZ_OX366327,1,225224,225961,-,737
177,NZ_OX366367,1,1069303,1070040,+,737
177,NZ_CP042444,1,1213986,1214723,-,737
177,NZ_OX366326,1,224900,225637,-,737
177,NZ_CP037426,1,871179,871916,+,737
177,NZ_OX366339,1,1253957,1254694,-,737
177,NZ_OX366355,1,1092699,1093436,+,737
177,NZ_CP046922,1,1274435,1275172,-,737
177,NZ_OX366370,1,243397,244134,+,737
177,NZ_OX366385,1,1060621,1061325,-,704
177,NZ_OX366399,1,225417,226154,-,737
177,NZ_OX366395,1,371974,372709,+,735
177,NZ_OX366396,1,226879,227616,-,737
177,NZ_OX366351,1,183822,184559,+,737
177,NZ_OX366381,1,1161535,1162272,+,737
177,NZ_OX366342,1,635182,635919,+,737
177,NZ_OX366369,1,219152,219889,-,737
177,NZ_OX366356,1,254862,255589,-,727
177,NZ_OX366377,1,359046,359771,+,725
177,NZ_OX366388,1,1557447,1558184,+,737
177,NZ_OX366357,1,649010,649747,-,737
177,NZ_CP072012,1,1091397,1092134,+,737
177,NZ_OX366398,1,967569,968306,+,737
177,NC_002978,6,1212631,1213368,-,737
177,NZ_OX366389,1,282434,283171,-,737
177,NZ_OX366397,1,222530,223267,-,737
177,NZ_OX366378,1,1004934,1005671,-,737
177,NZ_CP090903,1,1212635,1213372,-,737
177,NZ_OX366374,1,338650,339387,+,737
177,NZ_CP090901,1,1212635,1213372,-,737
177,NZ_CP046923,1,1190683,1191420,-,737
177,NZ_CP069055,1,1212634,1213371,-,737
177,NZ_CP072670,1,1212460,1213197,-,737
177,NZ_CP090899,1,1212635,1213372,-,737
177,NZ_CP046924,1,1211621,1212358,-,737
177,NZ_OX366348,1,1026528,1027265,+,737
177,NZ_CP046921,1,1274435,1275172,-,737
177,NZ_OX366338,1,429427,430131,+,704
177,NZ_CP054557,1,592122,592859,+,737
177,NZ_CP072669,1,1212480,1213217,-,737
177,NC_021089,1,1238970,1239707,-,737
176,NZ_OX366376,1,540769,542073,+,1304
176,NZ_OX366393,1,797580,798884,-,1304
176,NZ_OX366372,1,1042662,1043966,-,1304
176,NZ_CP072672,1,1213434,1214737,-,1303
176,NZ_CP069060,1,1354333,1355636,-,1303
176,NZ_CP072667,1,1213408,1214711,-,1303
176,NZ_CP072671,1,1213416,1214719,-,1303
176,NZ_CP072668,1,1213403,1214706,-,1303
176,NZ_CP072666,1,1213416,1214719,-,1303
176,NZ_CP090902,1,1213569,1214872,-,1303
176,NZ_CP090948,1,1213567,1214870,-,1303
176,NZ_CP069052,1,1298633,1299936,-,1303
176,NZ_CP076228,1,1234180,1235483,-,1303
176,NZ_CP042445,1,1213556,1214859,-,1303
176,NZ_CP042904,1,1289260,1290563,-,1303
176,NC_012416,1,1334476,1335779,-,1303
176,NZ_CP069053,1,1339631,1340934,-,1303
176,NZ_CP042446,1,1213566,1214869,-,1303
176,NZ_CP041215,1,237732,239035,-,1303
176,NZ_OX366353,1,569001,570304,-,1303
176,NZ_OX366387,1,363513,364816,+,1303
176,NZ_OX366368,1,226851,228154,-,1303
176,NZ_OX366379,1,227869,229172,-,1303
176,NZ_CP091195,1,908656,909959,+,1303
176,NZ_OX366375,1,244101,245405,-,1304
176,NZ_CP046925,1,1213416,1214719,-,1303
176,NZ_OX366318,1,317232,318535,-,1303
176,NZ_OX366319,1,976377,977680,+,1303
176,NZ_OX366332,1,223760,225063,-,1303
176,NZ_CP110359,1,1251748,1253052,-,1304
176,NZ_OU953855,1,743394,744697,-,1303
176,NZ_OX366272,1,1142488,1143792,+,1304
176,NZ_OX366347,1,335963,337267,-,1304
176,NZ_OU909470,1,1332342,1333645,-,1303
176,NZ_OX366363,1,712195,713499,+,1304
176,NZ_OX366364,1,428392,429696,+,1304
176,NZ_OX366359,1,222586,223889,-,1303
176,NZ_OX366349,1,715788,717092,-,1304
176,NZ_OX366380,1,824728,826032,-,1304
176,NZ_OX366344,1,236175,237479,+,1304
176,NZ_CP090900,1,1213571,1214874,-,1303
176,NZ_OX366352,1,1466335,1467638,+,1303
176,NZ_OX366362,1,1435183,1436488,+,1305
176,NZ_OX366400,1,226213,227516,-,1303
176,NZ_OX366327,1,226160,227463,-,1303
176,NZ_OX366367,1,1067797,1069101,+,1304
176,NZ_CP042444,1,1214922,1216225,-,1303
176,NZ_OX366326,1,225836,227139,-,1303
176,NZ_CP037426,1,869706,871010,+,1304
176,NZ_OX366339,1,1254863,1256167,-,1304
176,NZ_OX366355,1,1091197,1092500,+,1303
176,NZ_CP046922,1,1275371,1276674,-,1303
176,NZ_OX366370,1,241892,243196,+,1304
176,NZ_OX366385,1,1267998,1269302,+,1304
176,NZ_OX366399,1,226353,227656,-,1303
176,NZ_OX366395,1,370467,371771,+,1304
176,NZ_OX366396,1,227785,229089,-,1304
176,NZ_OX366351,1,182320,183623,+,1303
176,NZ_OX366381,1,1160033,1161336,+,1303
176,NZ_OX366342,1,633677,634981,+,1304
176,NZ_OX366369,1,220088,221391,-,1303
176,NZ_OX366356,1,255864,257168,-,1304
176,NZ_OX366377,1,357544,358847,+,1303
176,NZ_OX366388,1,1555945,1557248,+,1303
176,NZ_OX366357,1,649946,651249,-,1303
176,NZ_CP072012,1,1089895,1091198,+,1303
176,NZ_OX366398,1,966067,967370,+,1303
176,NC_002978,6,1213567,1214870,-,1303
176,NZ_OX366389,1,283370,284673,-,1303
176,NZ_OX366397,1,223466,224769,-,1303
176,NZ_OX366378,1,1005870,1007173,-,1303
176,NZ_CP090903,1,1213571,1214874,-,1303
176,NZ_OX366374,1,337177,338481,+,1304
176,NZ_CP090901,1,1213571,1214874,-,1303
176,NZ_CP046923,1,1191619,1192922,-,1303
176,NZ_CP069055,1,1213570,1214873,-,1303
176,NZ_CP072670,1,1213396,1214699,-,1303
176,NZ_CP090899,1,1213571,1214874,-,1303
176,NZ_CP046924,1,1212557,1213860,-,1303
176,NZ_OX366348,1,1025026,1026329,+,1303
176,NZ_CP046921,1,1275371,1276674,-,1303
176,NZ_OX366338,1,427926,429229,+,1303
176,NZ_CP054557,1,590620,591923,+,1303
176,NZ_CP072669,1,1213416,1214719,-,1303
176,NC_021089,1,1239906,1241209,-,1303
175,NZ_OX366376,1,539161,540667,+,1506
175,NZ_OX366393,1,798986,800492,-,1506
175,NZ_OX366372,1,1044068,1045574,-,1506
175,NZ_CP072672,1,1214761,1216267,-,1506
175,NZ_CP069060,1,1355660,1357166,-,1506
175,NZ_CP072667,1,1214735,1216241,-,1506
175,NZ_CP072671,1,1214743,1216249,-,1506
175,NZ_CP072668,1,1214730,1216236,-,1506
175,NZ_CP072666,1,1214743,1216249,-,1506
175,NZ_CP090902,1,1214896,1216402,-,1506
175,NZ_CP090948,1,1214894,1216400,-,1506
175,NZ_CP069052,1,1299960,1301466,-,1506
175,NZ_CP076228,1,1235507,1237013,-,1506
175,NZ_CP042445,1,1214883,1216389,-,1506
175,NZ_CP042904,1,1290588,1292093,-,1505
175,NC_012416,1,1335804,1337309,-,1505
175,NZ_CP069053,1,1340958,1342464,-,1506
175,NZ_CP042446,1,1214893,1216399,-,1506
175,NZ_CP041215,1,239347,240853,-,1506
175,NZ_OX366353,1,570616,572122,-,1506
175,NZ_OX366387,1,361983,363489,+,1506
175,NZ_OX366368,1,228178,229684,-,1506
175,NZ_OX366379,1,229196,230702,-,1506
175,NZ_CP091195,1,906829,908335,+,1506
175,NZ_OX366375,1,245430,246935,-,1505
175,NZ_CP046925,1,1214743,1216249,-,1506
175,NZ_OX366318,1,318560,320065,-,1505
175,NZ_OX366319,1,974847,976353,+,1506
175,NZ_OX366332,1,225375,226881,-,1506
175,NZ_CP110359,1,1253077,1254582,-,1505
175,NZ_OU953855,1,745018,746524,-,1506
175,NZ_OX366272,1,1140958,1142463,+,1505
175,NZ_OX366347,1,337588,339094,-,1506
175,NZ_OU909470,1,1333755,1335251,-,1496
175,NZ_OX366363,1,710368,711874,+,1506
175,NZ_OX366364,1,426547,428037,+,1490
175,NZ_OX366359,1,224201,225707,-,1506
175,NZ_OX366349,1,717194,718700,-,1506
175,NZ_OX366380,1,826134,827638,-,1504
175,NZ_OX366344,1,234567,236073,+,1506
175,NZ_CP090900,1,1214898,1216404,-,1506
175,NZ_OX366352,1,1464517,1466023,+,1506
175,NZ_OX366362,1,1433366,1434871,+,1505
175,NZ_OX366400,1,227541,229046,-,1505
175,NZ_OX366327,1,227487,228977,-,1490
175,NZ_OX366367,1,1066267,1067773,+,1506
175,NZ_CP042444,1,1216249,1217755,-,1506
175,NZ_OX366326,1,227164,228669,-,1505
175,NZ_CP037426,1,868176,869681,+,1505
175,NZ_OX366339,1,1256191,1257697,-,1506
175,NZ_OX366355,1,1089667,1091173,+,1506
175,NZ_CP046922,1,1276698,1278204,-,1506
175,NZ_OX366370,1,240364,241868,+,1504
175,NZ_OX366385,1,1266392,1267896,+,1504
175,NZ_OX366399,1,227680,229186,-,1506
175,NZ_OX366395,1,368644,370146,+,1502
175,NZ_OX366396,1,229113,230619,-,1506
175,NZ_OX366351,1,180790,182295,+,1505
175,NZ_OX366381,1,1158503,1160009,+,1506
175,NZ_OX366342,1,632069,633575,+,1506
175,NZ_OX366369,1,221431,222921,-,1490
175,NZ_OX366356,1,257193,258698,-,1505
175,NZ_OX366377,1,356014,357520,+,1506
175,NZ_OX366388,1,1554118,1555624,+,1506
175,NZ_OX366357,1,651561,653067,-,1506
175,NZ_CP072012,1,1088365,1089871,+,1506
175,NZ_OX366398,1,964537,966043,+,1506
175,NC_002978,6,1214894,1216400,-,1506
175,NZ_OX366389,1,284697,286203,-,1506
175,NZ_OX366397,1,225081,226587,-,1506
175,NZ_OX366378,1,1007494,1009000,-,1506
175,NZ_CP090903,1,1214898,1216404,-,1506
175,NZ_OX366374,1,335363,336865,+,1502
175,NZ_CP090901,1,1214898,1216404,-,1506
175,NZ_CP046923,1,1192946,1194452,-,1506
175,NZ_CP069055,1,1214897,1216403,-,1506
175,NZ_CP072670,1,1214723,1216229,-,1506
175,NZ_CP090899,1,1214898,1216404,-,1506
175,NZ_CP046924,1,1213884,1215390,-,1506
175,NZ_OX366348,1,1023496,1025001,+,1505
175,NZ_CP046921,1,1276698,1278204,-,1506
175,NZ_OX366338,1,426117,427623,+,1506
175,NZ_CP054557,1,589090,590595,+,1505
175,NZ_CP072669,1,1214743,1216249,-,1506
175,NC_021089,1,1241521,1243027,-,1506
174,NZ_OX366376,1,536884,537983,+,1099
174,NZ_OX366393,1,360647,361746,+,1099
174,NZ_OX366372,1,1046752,1047851,-,1099
174,NZ_CP072672,1,908729,909828,-,1099
174,NZ_CP069060,1,713340,714439,-,1099
174,NZ_CP072667,1,908703,909802,-,1099
174,NZ_CP072671,1,908711,909810,-,1099
174,NZ_CP072668,1,908698,909797,-,1099
174,NZ_CP072666,1,908711,909810,-,1099
174,NZ_CP090902,1,908863,909962,-,1099
174,NZ_CP090948,1,908863,909962,-,1099
174,NZ_CP069052,1,898895,899994,-,1099
174,NZ_CP076228,1,949776,950875,-,1099
174,NZ_CP042445,1,908851,909950,-,1099
174,NZ_CP042904,1,928279,929346,-,1067
174,NC_012416,1,963862,964929,-,1067
174,NZ_CP069053,1,756085,757184,+,1099
174,NZ_CP042446,1,908861,909960,-,1099
174,NZ_CP041215,1,123416,124483,-,1067
174,NZ_OX366353,1,1242095,1243162,+,1067
174,NZ_OX366387,1,1710978,1712077,-,1099
174,NZ_OX366368,1,1354181,1355280,-,1099
174,NZ_OX366379,1,1273674,1274773,-,1099
174,NZ_CP091195,1,1299130,1300230,-,1100
174,NZ_OX366375,1,1131271,1132370,-,1099
174,NZ_CP046925,1,908711,909810,-,1099
174,NZ_OX366318,1,1206941,1208040,-,1099
174,NZ_OX366319,1,1222424,1223490,+,1066
174,NZ_OX366332,1,1291038,1292105,-,1067
174,NZ_CP110359,1,93383,94483,+,1100
174,NZ_OU953855,1,191740,192840,+,1100
174,NZ_OX366272,1,44171,45271,+,1100
174,NZ_OX366347,1,1351924,1353024,-,1100
174,NZ_OU909470,1,1335414,1336515,-,1101
174,NZ_OX366363,1,1064290,1065390,-,1100
174,NZ_OX366364,1,380246,381344,+,1098
174,NZ_OX366359,1,1120969,1122036,-,1067
174,NZ_OX366349,1,720179,721248,-,1069
174,NZ_OX366380,1,827801,828902,-,1101
174,NZ_OX366344,1,232308,233377,+,1069
174,NZ_CP090900,1,908863,909962,-,1099
174,NZ_OX366352,1,164212,165279,+,1067
174,NZ_OX366362,1,1431941,1433008,+,1067
174,NZ_OX366400,1,1063857,1064956,-,1099
174,NZ_OX366327,1,1203660,1204726,-,1066
174,NZ_OX366367,1,1063971,1065069,+,1098
174,NZ_CP042444,1,909298,910397,-,1099
174,NZ_OX366326,1,1415502,1416601,-,1099
174,NZ_CP037426,1,1122012,1123111,+,1099
174,NZ_OX366339,1,76763,77863,-,1100
174,NZ_OX366355,1,151197,152263,+,1066
174,NZ_CP046922,1,970759,971858,-,1099
174,NZ_OX366370,1,239103,240202,+,1099
174,NZ_OX366385,1,1265128,1266229,+,1101
174,NZ_OX366399,1,1307290,1308389,-,1099
174,NZ_OX366395,1,614861,615960,-,1099
174,NZ_OX366395,1,1507562,1508661,+,1099
174,NZ_OX366396,1,1460608,1461708,-,1100
174,NZ_OX366351,1,1361078,1362177,-,1099
174,NZ_OX366381,1,123514,124580,-,1066
174,NZ_OX366342,1,629792,630891,+,1099
174,NZ_OX366369,1,1430593,1431659,+,1066
174,NZ_OX366356,1,1067290,1068389,+,1099
174,NZ_OX366377,1,1057390,1058489,+,1099
174,NZ_OX366388,1,1698564,1699664,+,1100
174,NZ_OX366357,1,76770,77869,+,1099
174,NZ_CP072012,1,258627,259726,-,1099
174,NZ_OX366398,1,390853,391952,-,1099
174,NC_002978,6,908863,909962,-,1099
174,NZ_OX366389,1,1283744,1284843,-,1099
174,NZ_OX366397,1,1515735,1516802,-,1067
174,NZ_OX366378,1,172031,173131,+,1100
174,NZ_CP090903,1,908863,909962,-,1099
174,NZ_OX366374,1,202358,203458,+,1100
174,NZ_CP090901,1,908863,909962,-,1099
174,NZ_CP046923,1,887007,888106,-,1099
174,NZ_CP069055,1,935205,936304,+,1099
174,NZ_CP072670,1,908703,909802,-,1099
174,NZ_CP090899,1,908863,909962,-,1099
174,NZ_CP046924,1,907945,909044,-,1099
174,NZ_OX366348,1,71388,72487,+,1099
174,NZ_CP046921,1,970759,971858,-,1099
174,NZ_OX366338,1,347946,349044,+,1098
174,NZ_CP054557,1,933795,934894,+,1099
174,NZ_CP072669,1,908711,909810,-,1099
174,NC_021089,1,940823,941890,-,1067
173,NZ_OX366376,1,533958,535262,+,1304
173,NZ_OX366393,1,357721,359025,+,1304
173,NZ_OX366372,1,1049473,1050776,-,1303
173,NZ_CP072672,1,911063,912365,-,1302
173,NZ_CP069060,1,715674,716976,-,1302
173,NZ_CP072667,1,911037,912339,-,1302
173,NZ_CP072671,1,911045,912347,-,1302
173,NZ_CP072668,1,911032,912334,-,1302
173,NZ_CP072666,1,911045,912347,-,1302
173,NZ_CP090902,1,911197,912499,-,1302
173,NZ_CP090948,1,911197,912499,-,1302
173,NZ_CP069052,1,901229,902531,-,1302
173,NZ_CP076228,1,952110,953412,-,1302
173,NZ_CP042445,1,911185,912487,-,1302
173,NZ_CP042904,1,931530,932832,-,1302
173,NC_012416,1,967113,968415,-,1302
173,NZ_CP069053,1,753548,754850,+,1302
173,NZ_CP042446,1,911195,912497,-,1302
173,NZ_CP041215,1,126651,127953,-,1302
173,NZ_OX366353,1,1238627,1239929,+,1302
173,NZ_OX366387,1,1713302,1714605,-,1303
173,NZ_OX366368,1,1356515,1357817,-,1302
173,NZ_OX366379,1,1276008,1277310,-,1302
173,NZ_CP091195,1,1301465,1302767,-,1302
173,NZ_OX366375,1,1133605,1134907,-,1302
173,NZ_CP046925,1,911045,912347,-,1302
173,NZ_OX366318,1,1209275,1210577,-,1302
173,NZ_OX366319,1,1218955,1220257,+,1302
173,NZ_OX366332,1,1294273,1295575,-,1302
173,NZ_CP110359,1,90870,92148,+,1278
173,NZ_OU953855,1,189203,190505,+,1302
173,NZ_OX366272,1,41634,42936,+,1302
173,NZ_OX366347,1,1354258,1355561,-,1303
173,NZ_OU909470,1,1337839,1339142,-,1303
173,NZ_OX366363,1,1066625,1067927,-,1302
173,NZ_OX366364,1,376232,377526,+,1294
173,NZ_OX366359,1,1124126,1125427,-,1301
173,NZ_OX366349,1,723515,724803,-,1288
173,NZ_OX366380,1,831183,832493,-,1310
173,NZ_OX366344,1,228764,230068,+,1304
173,NZ_CP090900,1,911197,912499,-,1302
173,NZ_OX366352,1,160742,162044,+,1302
173,NZ_OX366362,1,1428639,1429938,+,1299
173,NZ_OX366400,1,1066191,1067493,-,1302
173,NZ_OX366327,1,1206894,1208196,-,1302
173,NZ_OX366367,1,1059958,1061261,+,1303
173,NZ_CP042444,1,911632,912934,-,1302
173,NZ_OX366326,1,1417836,1419138,-,1302
173,NZ_CP037426,1,1119475,1120777,+,1302
173,NZ_OX366339,1,79098,80400,-,1302
173,NZ_OX366355,1,147728,149030,+,1302
173,NZ_CP046922,1,973093,974395,-,1302
173,NZ_OX366370,1,236460,237777,+,1317
173,NZ_OX366385,1,1261538,1262848,+,1310
173,NZ_OX366399,1,1309624,1310926,-,1302
173,NZ_OX366395,1,617295,618597,-,1302
173,NZ_OX366395,1,1504925,1506227,+,1302
173,NZ_OX366396,1,1462943,1464245,-,1302
173,NZ_OX366351,1,1363412,1364714,-,1302
173,NZ_OX366381,1,126747,128049,-,1302
173,NZ_OX366342,1,626866,628170,+,1304
173,NZ_OX366369,1,1427123,1428425,+,1302
173,NZ_OX366356,1,1064753,1066037,+,1284
173,NZ_OX366377,1,1054853,1056155,+,1302
173,NZ_OX366388,1,1696027,1697329,+,1302
173,NZ_OX366357,1,74232,75520,+,1288
173,NZ_CP072012,1,260961,262263,-,1302
173,NZ_OX366398,1,393187,394489,-,1302
173,NC_002978,6,911197,912499,-,1302
173,NZ_OX366389,1,1286078,1287380,-,1302
173,NZ_OX366397,1,1518970,1520272,-,1302
173,NZ_OX366378,1,169494,170796,+,1302
173,NZ_CP090903,1,911197,912499,-,1302
173,NZ_OX366374,1,199820,201123,+,1303
173,NZ_CP090901,1,911197,912499,-,1302
173,NZ_CP046923,1,889341,890643,-,1302
173,NZ_CP069055,1,932668,933970,+,1302
173,NZ_CP072670,1,911037,912339,-,1302
173,NZ_CP090899,1,911197,912499,-,1302
173,NZ_CP046924,1,910279,911581,-,1302
173,NZ_OX366348,1,68851,70153,+,1302
173,NZ_CP046921,1,973093,974395,-,1302
173,NZ_OX366338,1,345309,346611,+,1302
173,NZ_CP054557,1,931258,932560,+,1302
173,NZ_CP072669,1,911045,912347,-,1302
173,NC_021089,1,944058,945360,-,1302
172,NZ_OX366376,1,530508,532830,+,2322
172,NZ_OX366393,1,354271,356593,+,2322
172,NZ_OX366372,1,1051881,1054203,-,2322
172,NZ_CP072672,1,943677,946015,-,2338
172,NZ_CP069060,1,788630,790968,-,2338
172,NZ_CP072667,1,943651,945989,-,2338
172,NZ_CP072671,1,943659,945997,-,2338
172,NZ_CP072668,1,943646,945984,-,2338
172,NZ_CP072666,1,943659,945997,-,2338
172,NZ_CP090902,1,943811,946149,-,2338
172,NZ_CP090948,1,943811,946149,-,2338
172,NZ_CP069052,1,865103,867441,+,2338
172,NZ_CP076228,1,1059201,1061539,+,2338
172,NZ_CP042445,1,943799,946137,-,2338
172,NZ_CP042904,1,965701,968022,-,2321
172,NC_012416,1,1004803,1007124,-,2321
172,NZ_CP069053,1,788638,790976,-,2338
172,NZ_CP042446,1,943809,946147,-,2338
172,NZ_CP041215,1,40308,42630,+,2322
172,NZ_OX366353,1,1205674,1207996,+,2322
172,NZ_OX366387,1,961126,963518,+,2392
172,NZ_OX366368,1,1389283,1391621,-,2338
172,NZ_OX366379,1,1308728,1311066,-,2338
172,NZ_CP091195,1,1125369,1127691,+,2322
172,NZ_OX366375,1,1267279,1269601,+,2322
172,NZ_CP046925,1,943659,945997,-,2338
172,NZ_OX366318,1,1242196,1244588,-,2392
172,NZ_OX366319,1,1172725,1175101,-,2376
172,NZ_OX366332,1,1326244,1328566,-,2322
172,NZ_CP110359,1,178452,180844,-,2392
172,NZ_OU953855,1,1702455,1704847,-,2392
172,NZ_OX366272,1,1331981,1334373,+,2392
172,NZ_OX366347,1,1387252,1389644,-,2392
172,NZ_OU909470,1,34161,36475,-,2314
172,NZ_OX366363,1,964021,966359,-,2338
172,NZ_OX366364,1,81947,84233,+,2286
172,NZ_OX366359,1,1156050,1158372,-,2322
172,NZ_OX366349,1,725931,728252,-,2321
172,NZ_OX366380,1,834079,836393,-,2314
172,NZ_OX366344,1,225451,227773,+,2322
172,NZ_CP090900,1,943811,946149,-,2338
172,NZ_OX366352,1,127725,130047,+,2322
172,NZ_OX366362,1,297344,299630,+,2286
172,NZ_OX366400,1,1099225,1101617,-,2392
172,NZ_OX366327,1,1238575,1240897,-,2322
172,NZ_OX366367,1,1472408,1474698,-,2290
172,NZ_CP042444,1,944246,946584,-,2338
172,NZ_OX366326,1,1451463,1453855,-,2392
172,NZ_CP037426,1,796469,798791,+,2322
172,NZ_OX366339,1,98303,100695,+,2392
172,NZ_OX366355,1,1301980,1304356,+,2376
172,NZ_CP046922,1,1005707,1008045,-,2338
172,NZ_OX366370,1,377314,379636,-,2322
172,NZ_OX366385,1,1257636,1259950,+,2314
172,NZ_OX366399,1,1342344,1344682,-,2338
172,NZ_OX366395,1,1205777,1208178,+,2401
172,NZ_OX366396,1,493349,495741,-,2392
172,NZ_OX366351,1,1395317,1397709,-,2392
172,NZ_OX366381,1,1081672,1084048,-,2376
172,NZ_OX366342,1,623415,625737,+,2322
172,NZ_OX366369,1,1391201,1393577,+,2376
172,NZ_OX366356,1,1109394,1111716,-,2322
172,NZ_OX366377,1,1020615,1022953,+,2338
172,NZ_OX366388,1,1657382,1659774,+,2392
172,NZ_OX366357,1,574607,576954,-,2347
172,NZ_CP072012,1,293696,296034,-,2338
172,NZ_OX366398,1,426389,428727,-,2338
172,NC_002978,6,943811,946149,-,2338
172,NZ_OX366389,1,1320597,1322935,-,2338
172,NZ_OX366397,1,1552586,1554908,-,2322
172,NZ_OX366378,1,1259157,1261479,-,2322
172,NZ_CP090903,1,943811,946149,-,2338
172,NZ_OX366374,1,504104,506442,+,2338
172,NZ_CP090901,1,943811,946149,-,2338
172,NZ_CP046923,1,921955,924293,-,2338
172,NZ_CP069055,1,898984,901322,+,2338
172,NZ_CP072670,1,943651,945989,-,2338
172,NZ_CP090899,1,943811,946149,-,2338
172,NZ_CP046924,1,942893,945231,-,2338
172,NZ_OX366348,1,1222504,1224842,-,2338
172,NZ_CP046921,1,1005707,1008045,-,2338
172,NZ_OX366338,1,694367,696746,+,2379
172,NZ_CP054557,1,741328,743666,-,2338
172,NZ_CP072669,1,943659,945997,-,2338
172,NC_021089,1,976056,978378,-,2322
171,NZ_OX366376,1,528965,530453,+,1488
171,NZ_OX366393,1,352728,354216,+,1488
171,NZ_OX366372,1,1054258,1055746,-,1488
171,NZ_CP072672,1,946650,948121,-,1471
171,NZ_CP069060,1,791603,793074,-,1471
171,NZ_CP072667,1,946624,948095,-,1471
171,NZ_CP072671,1,946632,948103,-,1471
171,NZ_CP072668,1,946619,948090,-,1471
171,NZ_CP072666,1,946632,948103,-,1471
171,NZ_CP090902,1,946784,948255,-,1471
171,NZ_CP090948,1,946784,948255,-,1471
171,NZ_CP069052,1,862997,864468,+,1471
171,NZ_CP076228,1,1057095,1058566,+,1471
171,NZ_CP042445,1,946772,948243,-,1471
171,NZ_CP042904,1,968096,969573,-,1477
171,NC_012416,1,1007198,1008675,-,1477
171,NZ_CP069053,1,791611,793082,-,1471
171,NZ_CP042446,1,946782,948253,-,1471
171,NZ_CP041215,1,38757,40245,+,1488
171,NZ_OX366353,1,1204123,1205611,+,1488
171,NZ_OX366387,1,959012,960485,+,1473
171,NZ_OX366368,1,1392256,1393727,-,1471
171,NZ_OX366379,1,1311701,1313172,-,1471
171,NZ_CP091195,1,1123825,1125306,+,1481
171,NZ_OX366375,1,1265735,1267216,+,1481
171,NZ_CP046925,1,946632,948103,-,1471
171,NZ_OX366318,1,1245230,1246703,-,1473
171,NZ_OX366319,1,1175164,1176645,-,1481
171,NZ_OX366332,1,1328629,1330117,-,1488
171,NZ_CP110359,1,181485,182958,-,1473
171,NZ_OU953855,1,1706251,1707724,-,1473
171,NZ_OX366272,1,1329867,1331340,+,1473
171,NZ_OX366347,1,1389706,1391179,-,1473
171,NZ_OU909470,1,949560,951024,+,1464
171,NZ_OX366363,1,966639,968130,-,1491
171,NZ_OX366364,1,79142,80572,+,1430
171,NZ_OX366359,1,1158435,1159923,-,1488
171,NZ_OX366349,1,728307,729795,-,1488
171,NZ_OX366380,1,127353,128817,+,1464
171,NZ_OX366344,1,223908,225396,+,1488
171,NZ_CP090900,1,946784,948255,-,1471
171,NZ_OX366352,1,126174,127662,+,1488
171,NZ_OX366362,1,549599,551029,+,1430
171,NZ_OX366400,1,1102259,1103732,-,1473
171,NZ_OX366327,1,1240960,1242448,-,1488
171,NZ_OX366367,1,1474747,1476177,-,1430
171,NZ_CP042444,1,947219,948690,-,1471
171,NZ_OX366326,1,1454497,1455970,-,1473
171,NZ_CP037426,1,794925,796406,+,1481
171,NZ_OX366339,1,96524,98023,+,1499
171,NZ_OX366355,1,1300436,1301917,+,1481
171,NZ_CP046922,1,1008680,1010151,-,1471
171,NZ_OX366370,1,379691,381187,-,1496
171,NZ_OX366385,1,1102234,1103506,+,1272
171,NZ_OX366399,1,1345317,1346788,-,1471
171,NZ_OX366395,1,1204242,1205697,+,1455
171,NZ_OX366396,1,496021,497520,-,1499
171,NZ_OX366351,1,1398351,1399824,-,1473
171,NZ_OX366381,1,1084111,1085592,-,1481
171,NZ_OX366342,1,621872,623360,+,1488
171,NZ_OX366369,1,1389657,1391138,+,1481
171,NZ_OX366356,1,1111779,1113260,-,1481
171,NZ_OX366377,1,1018836,1020335,+,1499
171,NZ_OX366388,1,1655603,1657102,+,1499
171,NZ_OX366357,1,577033,578489,-,1456
171,NZ_CP072012,1,296669,298140,-,1471
171,NZ_OX366398,1,429007,430506,-,1499
171,NC_002978,6,946784,948255,-,1471
171,NZ_OX366389,1,1323215,1324714,-,1499
171,NZ_OX366397,1,1554971,1556459,-,1488
171,NZ_OX366378,1,1261542,1263023,-,1481
171,NZ_CP090903,1,946784,948255,-,1471
171,NZ_OX366374,1,502309,503808,+,1499
171,NZ_CP090901,1,946784,948255,-,1471
171,NZ_CP046923,1,924928,926399,-,1471
171,NZ_CP069055,1,896878,898349,+,1471
171,NZ_CP072670,1,946624,948095,-,1471
171,NZ_CP090899,1,946784,948255,-,1471
171,NZ_CP046924,1,945866,947337,-,1471
171,NZ_OX366348,1,1225122,1226621,-,1499
171,NZ_CP046921,1,1008680,1010151,-,1471
171,NZ_OX366338,1,691621,693120,+,1499
171,NZ_CP054557,1,743946,745445,-,1499
171,NZ_CP072669,1,946632,948103,-,1471
171,NC_021089,1,978441,979929,-,1488
170,NZ_OX366376,1,526826,528656,+,1830
170,NZ_OX366393,1,350589,352419,+,1830
170,NZ_OX366372,1,1056054,1057885,-,1831
170,NZ_CP072672,1,948480,950301,-,1821
170,NZ_CP069060,1,793429,795250,-,1821
170,NZ_CP072667,1,948454,950275,-,1821
170,NZ_CP072671,1,948462,950283,-,1821
170,NZ_CP072668,1,948449,950270,-,1821
170,NZ_CP072666,1,948462,950283,-,1821
170,NZ_CP090902,1,948614,950435,-,1821
170,NZ_CP090948,1,948614,950435,-,1821
170,NZ_CP069052,1,860821,862641,+,1820
170,NZ_CP076228,1,1054915,1056735,+,1820
170,NZ_CP042445,1,948602,950423,-,1821
170,NZ_CP042904,1,972304,974135,-,1831
170,NC_012416,1,1011406,1013237,-,1831
170,NZ_CP069053,1,793437,795258,-,1821
170,NZ_CP042446,1,948612,950433,-,1821
170,NZ_CP041215,1,36567,38397,+,1830
170,NZ_OX366353,1,1201933,1203763,+,1830
170,NZ_OX366387,1,956832,958652,+,1820
170,NZ_OX366368,1,1394086,1395907,-,1821
170,NZ_OX366379,1,1313531,1315352,-,1821
170,NZ_CP091195,1,1121635,1123465,+,1830
170,NZ_OX366375,1,1263555,1265375,+,1820
170,NZ_CP046925,1,948462,950283,-,1821
170,NZ_OX366318,1,1247062,1248893,-,1831
170,NZ_OX366319,1,1177004,1178835,-,1831
170,NZ_OX366332,1,1330476,1332307,-,1831
170,NZ_CP110359,1,183317,185138,-,1821
170,NZ_OU953855,1,1707982,1709798,-,1816
170,NZ_OX366272,1,1327687,1329507,+,1820
170,NZ_OX366347,1,1391538,1393352,-,1814
170,NZ_OU909470,1,944178,945989,+,1811
170,NZ_OX366363,1,968388,970204,-,1816
170,NZ_OX366364,1,77076,78881,+,1805
170,NZ_OX366359,1,1160282,1162113,-,1831
170,NZ_OX366349,1,730103,731925,-,1822
170,NZ_OX366380,1,122839,124650,+,1811
170,NZ_OX366344,1,221718,223539,+,1821
170,NZ_CP090900,1,948614,950435,-,1821
170,NZ_OX366352,1,123984,125814,+,1830
170,NZ_OX366362,1,545032,546880,+,1848
170,NZ_OX366400,1,1104091,1105922,-,1831
170,NZ_OX366327,1,1242807,1244628,-,1821
170,NZ_OX366367,1,1476438,1478243,-,1805
170,NZ_CP042444,1,949049,950870,-,1821
170,NZ_OX366326,1,1456329,1458160,-,1831
170,NZ_CP037426,1,792745,794565,+,1820
170,NZ_OX366339,1,94450,96266,+,1816
170,NZ_OX366355,1,1298246,1300076,+,1830
170,NZ_CP046922,1,1010510,1012331,-,1821
170,NZ_OX366370,1,385068,386866,-,1798
170,NZ_OX366385,1,1095993,1097804,+,1811
170,NZ_OX366399,1,1347147,1348968,-,1821
170,NZ_OX366395,1,1202183,1203988,+,1805
170,NZ_OX366396,1,497778,499594,-,1816
170,NZ_OX366351,1,1400183,1402014,-,1831
170,NZ_OX366381,1,1085951,1087782,-,1831
170,NZ_OX366342,1,619733,621563,+,1830
170,NZ_OX366369,1,1387467,1389297,+,1830
170,NZ_OX366356,1,1113736,1115529,-,1793
170,NZ_OX366377,1,1016646,1018476,+,1830
170,NZ_OX366388,1,1653413,1655243,+,1830
170,NZ_OX366357,1,578747,580554,-,1807
170,NZ_CP072012,1,298499,300320,-,1821
170,NZ_OX366398,1,430865,432696,-,1831
170,NC_002978,6,948614,950435,-,1821
170,NZ_OX366389,1,1325073,1326904,-,1831
170,NZ_OX366397,1,1556818,1558649,-,1831
170,NZ_OX366378,1,1263382,1265213,-,1831
170,NZ_CP090903,1,948614,950435,-,1821
170,NZ_OX366374,1,500233,502051,+,1818
170,NZ_CP090901,1,948614,950435,-,1821
170,NZ_CP046923,1,926758,928579,-,1821
170,NZ_CP069055,1,894698,896518,+,1820
170,NZ_CP072670,1,948454,950275,-,1821
170,NZ_CP090899,1,948614,950435,-,1821
170,NZ_CP046924,1,947696,949517,-,1821
170,NZ_OX366348,1,1226980,1228801,-,1821
170,NZ_CP046921,1,1010510,1012331,-,1821
170,NZ_OX366338,1,689439,691252,+,1813
170,NZ_CP054557,1,745804,747625,-,1821
170,NZ_CP072669,1,948462,950283,-,1821
170,NC_021089,1,980288,982119,-,1831
169,NZ_OX366376,1,522704,524163,+,1459
169,NZ_OX366393,1,346313,347772,+,1459
169,NZ_OX366372,1,1060763,1062222,-,1459
169,NZ_CP072672,1,166723,168187,-,1464
169,NZ_CP069060,1,177084,178548,-,1464
169,NZ_CP072667,1,166705,168169,-,1464
169,NZ_CP072671,1,166705,168169,-,1464
169,NZ_CP072668,1,166705,168169,-,1464
169,NZ_CP072666,1,166705,168169,-,1464
169,NZ_CP090902,1,166857,168321,-,1464
169,NZ_CP090948,1,166857,168321,-,1464
169,NZ_CP069052,1,171749,173213,-,1464
169,NZ_CP076228,1,170085,171549,-,1464
169,NZ_CP042445,1,166857,168321,-,1464
169,NZ_CP042904,1,169536,171000,-,1464
169,NC_012416,1,172118,173582,-,1464
169,NZ_CP069053,1,368729,370193,+,1464
169,NZ_CP042446,1,166857,168321,-,1464
169,NZ_CP041215,1,522684,524148,-,1464
169,NZ_OX366353,1,528629,530093,+,1464
169,NZ_OX366387,1,1352854,1354318,+,1464
169,NZ_OX366368,1,445756,447220,-,1464
169,NZ_OX366379,1,446774,448238,-,1464
169,NZ_CP091195,1,1439628,1441092,-,1464
169,NZ_OX366375,1,484053,485517,+,1464
169,NZ_CP046925,1,166705,168169,-,1464
169,NZ_OX366318,1,545202,546666,-,1464
169,NZ_OX366319,1,714056,715520,+,1464
169,NZ_OX366332,1,443781,445245,-,1464
169,NZ_CP110359,1,1073582,1075046,+,1464
169,NZ_OU953855,1,1472141,1473605,-,1464
169,NZ_OX366272,1,310148,311612,-,1464
169,NZ_OX366347,1,559164,560628,-,1464
169,NZ_OU909470,1,1397546,1399005,+,1459
169,NZ_OX366363,1,472833,474297,+,1464
169,NZ_OX366364,1,54690,56151,+,1461
169,NZ_OX366359,1,442056,443520,-,1464
169,NZ_OX366349,1,896591,898050,-,1459
169,NZ_OX366380,1,215839,217298,-,1459
169,NZ_OX366344,1,217382,218841,+,1459
169,NZ_CP090900,1,166857,168321,-,1464
169,NZ_OX366352,1,684991,686455,+,1464
169,NZ_OX366362,1,58677,60141,-,1464
169,NZ_OX366400,1,713880,715344,+,1464
169,NZ_OX366327,1,593654,595118,-,1464
169,NZ_OX366367,1,1339550,1341014,+,1464
169,NZ_CP042444,1,166795,168259,-,1464
169,NZ_OX366326,1,637004,638468,-,1464
169,NZ_CP037426,1,707770,709234,+,1464
169,NZ_OX366339,1,260359,261823,-,1464
169,NZ_OX366355,1,860230,861694,+,1464
169,NZ_CP046922,1,166555,168019,-,1464
169,NZ_OX366370,1,205525,206984,+,1459
169,NZ_OX366385,1,1019801,1021260,+,1459
169,NZ_OX366399,1,445267,446731,-,1464
169,NZ_OX366395,1,1049048,1050512,+,1464
169,NZ_OX366396,1,825116,826576,-,1460
169,NZ_OX366351,1,461698,463162,-,1464
169,NZ_OX366381,1,1021699,1023163,+,1464
169,NZ_OX366342,1,615459,616918,+,1459
169,NZ_OX366369,1,445362,446826,-,1464
169,NZ_OX366356,1,465406,466870,-,1464
169,NZ_OX366377,1,550468,551932,-,1464
169,NZ_OX366388,1,1251913,1253377,+,1464
169,NZ_OX366357,1,281382,282846,-,1464
169,NZ_CP072012,1,368152,369616,-,1464
169,NZ_OX366398,1,1104714,1106178,-,1464
169,NC_002978,6,166857,168321,-,1464
169,NZ_OX366389,1,615800,617264,-,1464
169,NZ_OX366397,1,391250,392714,-,1464
169,NZ_OX366378,1,253224,254688,-,1464
169,NZ_CP090903,1,166857,168321,-,1464
169,NZ_OX366374,1,978938,980402,+,1464
169,NZ_CP090901,1,166857,168321,-,1464
169,NZ_CP046923,1,166555,168019,-,1464
169,NZ_CP069055,1,164010,165474,-,1464
169,NZ_CP072670,1,166705,168169,-,1464
169,NZ_CP090899,1,166857,168321,-,1464
169,NZ_CP046924,1,166555,168019,-,1464
169,NZ_OX366348,1,808023,809487,+,1464
169,NZ_CP046921,1,166555,168019,-,1464
169,NZ_OX366338,1,163234,164697,+,1463
169,NZ_CP054557,1,1170869,1172333,-,1464
169,NZ_CP072669,1,166705,168169,-,1464
169,NC_021089,1,163124,164588,-,1464
168,NZ_OX366376,1,522058,522576,+,518
168,NZ_OX366393,1,345667,346185,+,518
168,NZ_OX366372,1,1062350,1062868,-,518
168,NZ_CP072672,1,168509,169027,+,518
168,NZ_CP069060,1,178870,179388,+,518
168,NZ_CP072667,1,168491,169009,+,518
168,NZ_CP072671,1,168491,169009,+,518
168,NZ_CP072668,1,168491,169009,+,518
168,NZ_CP072666,1,168491,169009,+,518
168,NZ_CP090902,1,168643,169161,+,518
168,NZ_CP090948,1,168643,169161,+,518
168,NZ_CP069052,1,173535,174053,+,518
168,NZ_CP076228,1,171867,172385,+,518
168,NZ_CP042445,1,168643,169161,+,518
168,NZ_CP042904,1,171320,171838,+,518
168,NC_012416,1,173902,174420,+,518
168,NZ_CP069053,1,367889,368407,-,518
168,NZ_CP042446,1,168643,169161,+,518
168,NZ_CP041215,1,524803,525321,+,518
168,NZ_OX366353,1,527454,527972,-,518
168,NZ_OX366387,1,1352016,1352534,-,518
168,NZ_OX366368,1,447542,448060,+,518
168,NZ_OX366379,1,448560,449078,+,518
168,NZ_CP091195,1,1441412,1441930,+,518
168,NZ_OX366375,1,483312,483830,-,518
168,NZ_CP046925,1,168491,169009,+,518
168,NZ_OX366318,1,546986,547504,+,518
168,NZ_OX366319,1,713315,713833,-,518
168,NZ_OX366332,1,445900,446418,+,518
168,NZ_CP110359,1,1072409,1072927,-,518
168,NZ_OU953855,1,1475023,1475541,+,518
168,NZ_OX366272,1,780104,780622,-,518
168,NZ_OX366347,1,560948,561466,+,518
168,NZ_OU909470,1,1396900,1397418,+,518
168,NZ_OX366363,1,471993,472511,-,518
168,NZ_OX366364,1,554580,555098,-,518
168,NZ_OX366359,1,444175,444693,+,518
168,NZ_OX366349,1,898178,898688,-,510
168,NZ_OX366380,1,217618,218136,+,518
168,NZ_OX366344,1,216736,217254,+,518
168,NZ_CP090900,1,168643,169161,+,518
168,NZ_OX366352,1,683842,684360,-,518
168,NZ_OX366362,1,60269,60787,-,518
168,NZ_OX366400,1,713042,713560,-,518
168,NZ_OX366327,1,595438,595956,+,518
168,NZ_OX366367,1,71829,72347,-,518
168,NZ_CP042444,1,168581,169099,+,518
168,NZ_OX366326,1,638788,639306,+,518
168,NZ_CP037426,1,707029,707547,-,518
168,NZ_OX366339,1,262046,262564,+,518
168,NZ_OX366355,1,859489,860007,-,518
168,NZ_CP046922,1,168341,168859,+,518
168,NZ_OX366370,1,204879,205397,+,518
168,NZ_OX366385,1,1018963,1019481,-,518
168,NZ_OX366399,1,447053,447571,+,518
168,NZ_OX366395,1,1048402,1048920,+,518
168,NZ_OX366396,1,828419,828937,+,518
168,NZ_OX366351,1,463482,464000,+,518
168,NZ_OX366381,1,1020958,1021476,-,518
168,NZ_OX366342,1,614813,615331,+,518
168,NZ_OX366369,1,447049,447567,+,518
168,NZ_OX366356,1,467189,467707,+,518
168,NZ_OX366377,1,552252,552770,+,518
168,NZ_OX366388,1,1250740,1251258,-,518
168,NZ_OX366357,1,283231,283749,-,518
168,NZ_CP072012,1,369938,370456,+,518
168,NZ_OX366398,1,1106498,1107016,+,518
168,NC_002978,6,168643,169161,+,518
168,NZ_OX366389,1,617584,618102,+,518
168,NZ_OX366397,1,393369,393887,+,518
168,NZ_OX366378,1,255008,255526,+,518
168,NZ_CP090903,1,168643,169161,+,518
168,NZ_OX366374,1,978292,978810,+,518
168,NZ_CP090901,1,168643,169161,+,518
168,NZ_CP046923,1,168341,168859,+,518
168,NZ_CP069055,1,165796,166314,+,518
168,NZ_CP072670,1,168491,169009,+,518
168,NZ_CP090899,1,168643,169161,+,518
168,NZ_CP046924,1,168341,168859,+,518
168,NZ_OX366348,1,807185,807703,-,518
168,NZ_CP046921,1,168341,168859,+,518
168,NZ_OX366338,1,1201250,1201768,-,518
168,NZ_CP054557,1,1172653,1173171,+,518
168,NZ_CP072669,1,168491,169009,+,518
168,NC_021089,1,165243,165761,+,518
167,NZ_OX366376,1,520550,521621,+,1071
167,NZ_OX366393,1,344159,345230,+,1071
167,NZ_OX366372,1,1063220,1064291,-,1071
167,NZ_CP072672,1,169397,170468,-,1071
167,NZ_CP069060,1,179758,180829,-,1071
167,NZ_CP072667,1,169379,170450,-,1071
167,NZ_CP072671,1,169379,170450,-,1071
167,NZ_CP072668,1,169379,170450,-,1071
167,NZ_CP072666,1,169379,170450,-,1071
167,NZ_CP090902,1,169531,170602,-,1071
167,NZ_CP090948,1,169531,170602,-,1071
167,NZ_CP069052,1,174423,175494,-,1071
167,NZ_CP076228,1,172755,173825,-,1070
167,NZ_CP042445,1,169531,170602,-,1071
167,NZ_CP042904,1,172224,173295,-,1071
167,NC_012416,1,174806,175877,-,1071
167,NZ_CP069053,1,366448,367519,+,1071
167,NZ_CP042446,1,169531,170602,-,1071
167,NZ_CP041215,1,525705,526776,-,1071
167,NZ_OX366353,1,525997,527068,+,1071
167,NZ_OX366387,1,1350575,1351646,+,1071
167,NZ_OX366368,1,448430,449501,-,1071
167,NZ_OX366379,1,449448,450519,-,1071
167,NZ_CP091195,1,1442316,1443387,-,1071
167,NZ_OX366375,1,481856,482927,+,1071
167,NZ_CP046925,1,169379,170450,-,1071
167,NZ_OX366318,1,547891,548962,-,1071
167,NZ_OX366319,1,711874,712945,+,1071
167,NZ_OX366332,1,446804,447875,-,1071
167,NZ_CP110359,1,1070952,1072023,+,1071
167,NZ_OU953855,1,1475938,1476994,-,1056
167,NZ_OX366272,1,778647,779718,+,1071
167,NZ_OX366347,1,562950,564021,-,1071
167,NZ_OU909470,1,1395667,1396738,+,1071
167,NZ_OX366363,1,470536,471607,+,1071
167,NZ_OX366364,1,555185,556256,-,1071
167,NZ_OX366359,1,445079,446150,-,1071
167,NZ_OX366349,1,899002,900073,-,1071
167,NZ_OX366380,1,218522,219593,-,1071
167,NZ_OX366344,1,215300,216371,+,1071
167,NZ_CP090900,1,169531,170602,-,1071
167,NZ_OX366352,1,682385,683456,+,1071
167,NZ_OX366362,1,61153,62224,-,1071
167,NZ_OX366400,1,711584,712655,+,1071
167,NZ_OX366327,1,596373,597444,-,1071
167,NZ_OX366367,1,72434,73505,-,1071
167,NZ_CP042444,1,169469,170540,-,1071
167,NZ_OX366326,1,639693,640764,-,1071
167,NZ_CP037426,1,705573,706644,+,1071
167,NZ_OX366339,1,262950,264021,-,1071
167,NZ_OX366355,1,857841,858912,+,1071
167,NZ_CP046922,1,169229,170300,-,1071
167,NZ_OX366370,1,203569,204640,+,1071
167,NZ_OX366385,1,1017506,1018577,+,1071
167,NZ_OX366399,1,447941,449012,-,1071
167,NZ_OX366395,1,1046778,1047849,+,1071
167,NZ_OX366396,1,829323,830394,-,1071
167,NZ_OX366351,1,464387,465458,-,1071
167,NZ_OX366381,1,1019310,1020381,+,1071
167,NZ_OX366342,1,613305,614376,+,1071
167,NZ_OX366369,1,447937,449008,-,1071
167,NZ_OX366356,1,468092,469163,-,1071
167,NZ_OX366377,1,553155,554226,-,1071
167,NZ_OX366388,1,1248947,1250018,+,1071
167,NZ_OX366357,1,284311,285382,-,1071
167,NZ_CP072012,1,370826,371897,-,1071
167,NZ_OX366398,1,1107401,1108472,-,1071
167,NC_002978,6,169531,170602,-,1071
167,NZ_OX366389,1,618487,619558,-,1071
167,NZ_OX366397,1,394273,395344,-,1071
167,NZ_OX366378,1,255912,256983,-,1071
167,NZ_CP090903,1,169531,170602,-,1071
167,NZ_OX366374,1,976660,977731,+,1071
167,NZ_CP090901,1,169531,170602,-,1071
167,NZ_CP046923,1,169229,170300,-,1071
167,NZ_CP069055,1,166684,167755,-,1071
167,NZ_CP072670,1,169379,170450,-,1071
167,NZ_CP090899,1,169531,170602,-,1071
167,NZ_CP046924,1,169229,170300,-,1071
167,NZ_OX366348,1,805744,806815,+,1071
167,NZ_CP046921,1,169229,170300,-,1071
167,NZ_OX366338,1,1198213,1199284,+,1071
167,NZ_CP054557,1,1173541,1174612,-,1071
167,NZ_CP072669,1,169379,170450,-,1071
167,NC_021089,1,166147,167218,-,1071
166,NZ_OX366376,1,518315,519227,+,912
166,NZ_OX366393,1,341924,342836,+,912
166,NZ_OX366372,1,1065614,1066526,-,912
166,NZ_CP072672,1,190978,191890,-,912
166,NZ_CP069060,1,243536,244448,+,912
166,NZ_CP072667,1,190960,191872,-,912
166,NZ_CP072671,1,190960,191872,-,912
166,NZ_CP072668,1,190960,191872,-,912
166,NZ_CP072666,1,190960,191872,-,912
166,NZ_CP090902,1,191112,192024,-,912
166,NZ_CP090948,1,191112,192024,-,912
166,NZ_CP069052,1,238201,239113,+,912
166,NZ_CP076228,1,194343,195255,-,912
166,NZ_CP042445,1,191112,192024,-,912
166,NZ_CP042904,1,198778,199657,-,879
166,NC_012416,1,201360,202239,-,879
166,NZ_CP069053,1,302829,303741,-,912
166,NZ_CP042446,1,191112,192024,-,912
166,NZ_CP041215,1,679859,680738,+,879
166,NZ_OX366353,1,463426,464305,-,879
166,NZ_OX366387,1,761839,762751,+,912
166,NZ_OX366368,1,470115,471027,-,912
166,NZ_OX366379,1,471133,472045,-,912
166,NZ_CP091195,1,668061,668973,-,912
166,NZ_OX366375,1,573145,574057,+,912
166,NZ_CP046925,1,190960,191872,-,912
166,NZ_OX366318,1,571146,572058,-,912
166,NZ_OX366319,1,689548,690460,+,912
166,NZ_OX366332,1,469237,470116,-,879
166,NZ_CP110359,1,1049699,1050611,+,912
166,NZ_OU953855,1,1592706,1593618,+,912
166,NZ_OX366272,1,712302,713213,-,911
166,NZ_OX366347,1,584366,585278,-,912
166,NZ_OU909470,1,253499,254403,-,904
166,NZ_OX366363,1,448028,448940,+,912
166,NZ_OX366364,1,1182537,1183451,-,914
166,NZ_OX366359,1,507918,508797,+,879
166,NZ_OX366349,1,901396,902308,-,912
166,NZ_OX366380,1,644911,645815,+,904
166,NZ_OX366344,1,213066,213978,+,912
166,NZ_CP090900,1,191112,192024,-,912
166,NZ_OX366352,1,660144,661023,+,879
166,NZ_OX366362,1,827617,828522,+,905
166,NZ_OX366400,1,688832,689744,+,912
166,NZ_OX366327,1,620015,620927,-,912
166,NZ_OX366367,1,121551,122465,+,914
166,NZ_CP042444,1,191050,191962,-,912
166,NZ_OX366326,1,662947,663859,-,912
166,NZ_CP037426,1,777310,778222,+,912
166,NZ_OX366339,1,446975,447854,-,879
166,NZ_OX366355,1,835410,836322,+,912
166,NZ_CP046922,1,190810,191722,-,912
166,NZ_OX366370,1,569473,570385,-,912
166,NZ_OX366385,1,913509,914413,-,904
166,NZ_OX366399,1,469625,470537,-,912
166,NZ_OX366396,1,1170594,1171473,+,879
166,NZ_OX366351,1,487641,488553,-,912
166,NZ_OX366381,1,996879,997791,+,912
166,NZ_OX366342,1,611069,611982,+,913
166,NZ_OX366369,1,470552,471464,-,912
166,NZ_OX366356,1,808271,809183,+,912
166,NZ_OX366377,1,576773,577685,-,912
166,NZ_OX366388,1,812856,813768,+,912
166,NZ_OX366357,1,436819,437759,-,940
166,NZ_CP072012,1,392404,393316,-,912
166,NZ_OX366398,1,1131019,1131931,-,912
166,NC_002978,6,191112,192024,-,912
166,NZ_OX366389,1,686915,687827,+,912
166,NZ_OX366397,1,680523,681402,-,879
166,NZ_OX366378,1,758673,759585,-,912
166,NZ_CP090903,1,191112,192024,-,912
166,NZ_OX366374,1,740022,740962,-,940
166,NZ_CP090901,1,191112,192024,-,912
166,NZ_CP046923,1,190810,191722,-,912
166,NZ_CP069055,1,230410,231322,+,912
166,NZ_CP072670,1,190960,191872,-,912
166,NZ_CP090899,1,191112,192024,-,912
166,NZ_CP046924,1,190810,191722,-,912
166,NZ_OX366348,1,782786,783698,+,912
166,NZ_CP046921,1,190810,191722,-,912
166,NZ_OX366338,1,1159297,1160202,+,905
166,NZ_CP054557,1,1195122,1196034,-,912
166,NZ_CP072669,1,190960,191872,-,912
166,NC_021089,1,229109,229988,+,879
165,NZ_OX366376,1,514139,517576,+,3437
165,NZ_OX366393,1,337748,341185,+,3437
165,NZ_OX366372,1,1067265,1070702,-,3437
165,NZ_CP072672,1,192629,195905,-,3276
165,NZ_CP069060,1,239521,242797,+,3276
165,NZ_CP072667,1,192611,195887,-,3276
165,NZ_CP072671,1,192611,195887,-,3276
165,NZ_CP072668,1,192611,195887,-,3276
165,NZ_CP072666,1,192611,195887,-,3276
165,NZ_CP090902,1,192763,196039,-,3276
165,NZ_CP090948,1,192763,196039,-,3276
165,NZ_CP069052,1,234186,237462,+,3276
165,NZ_CP076228,1,195994,199263,-,3269
165,NZ_CP042445,1,192763,196039,-,3276
165,NZ_CP042904,1,200396,203672,-,3276
165,NC_012416,1,202978,206254,-,3276
165,NZ_CP069053,1,304480,307756,-,3276
165,NZ_CP042446,1,192763,196039,-,3276
165,NZ_CP041215,1,674971,678266,+,3295
165,NZ_OX366353,1,465044,468339,-,3295
165,NZ_OX366387,1,757805,761100,+,3295
165,NZ_OX366368,1,471766,475042,-,3276
165,NZ_OX366379,1,472784,476060,-,3276
165,NZ_CP091195,1,492224,495519,-,3295
165,NZ_OX366375,1,569111,572406,+,3295
165,NZ_CP046925,1,192611,195887,-,3276
165,NZ_OX366318,1,572797,576073,-,3276
165,NZ_OX366319,1,685514,688809,+,3295
165,NZ_OX366332,1,470855,474150,-,3295
165,NZ_CP110359,1,1045665,1048960,+,3295
165,NZ_OU953855,1,1588672,1591967,+,3295
165,NZ_OX366272,1,713952,717247,-,3295
165,NZ_OX366347,1,586017,589312,-,3295
165,NZ_OU909470,1,256040,259334,-,3294
165,NZ_OX366363,1,443994,447289,+,3295
165,NZ_OX366364,1,1184176,1187564,-,3388
165,NZ_OX366359,1,503884,507179,+,3295
165,NZ_OX366349,1,903047,906484,-,3437
165,NZ_OX366380,1,640877,644171,+,3294
165,NZ_OX366344,1,208890,212327,+,3437
165,NZ_CP090900,1,192763,196039,-,3276
165,NZ_OX366352,1,656110,659405,+,3295
165,NZ_OX366362,1,823573,826877,+,3304
165,NZ_OX366400,1,684817,688093,+,3276
165,NZ_OX366327,1,621666,624942,-,3276
165,NZ_OX366367,1,116519,119907,+,3388
165,NZ_CP042444,1,192701,195977,-,3276
165,NZ_OX366326,1,665449,668725,-,3276
165,NZ_CP037426,1,773276,776571,+,3295
165,NZ_OX366339,1,448593,451878,-,3285
165,NZ_OX366355,1,831376,834671,+,3295
165,NZ_CP046922,1,192461,195737,-,3276
165,NZ_OX366370,1,388923,392361,-,3438
165,NZ_OX366385,1,915153,918447,-,3294
165,NZ_OX366399,1,471276,474552,-,3276
165,NZ_OX366395,1,983785,987080,-,3295
165,NZ_OX366396,1,1166570,1169855,+,3285
165,NZ_OX366351,1,489328,492604,-,3276
165,NZ_OX366381,1,992845,996140,+,3295
165,NZ_OX366342,1,606893,610330,+,3437
165,NZ_OX366369,1,472203,475498,-,3295
165,NZ_OX366356,1,804257,807532,+,3275
165,NZ_OX366377,1,578424,581700,-,3276
165,NZ_OX366388,1,807275,810570,+,3295
165,NZ_OX366357,1,438499,441794,-,3295
165,NZ_CP072012,1,394055,397331,-,3276
165,NZ_OX366398,1,1132670,1135946,-,3276
165,NC_002978,6,192763,196039,-,3276
165,NZ_OX366389,1,682900,686176,+,3276
165,NZ_OX366397,1,682141,685436,-,3295
165,NZ_OX366378,1,761243,764538,-,3295
165,NZ_CP090903,1,192763,196039,-,3276
165,NZ_OX366374,1,741702,744997,-,3295
165,NZ_CP090901,1,192763,196039,-,3276
165,NZ_CP046923,1,192461,195737,-,3276
165,NZ_CP069055,1,226395,229671,+,3276
165,NZ_CP072670,1,192611,195887,-,3276
165,NZ_CP090899,1,192763,196039,-,3276
165,NZ_CP046924,1,192461,195737,-,3276
165,NZ_OX366348,1,778771,782047,+,3276
165,NZ_CP046921,1,192461,195737,-,3276
165,NZ_OX366338,1,1155263,1158558,+,3295
165,NZ_CP054557,1,1196773,1200049,-,3276
165,NZ_CP072669,1,192611,195887,-,3276
165,NC_021089,1,225075,228370,+,3295
164,NZ_OX366376,1,513237,513879,+,642
164,NZ_OX366393,1,336846,337488,+,642
164,NZ_OX366372,1,1070962,1071604,-,642
164,NZ_CP072672,1,196625,197281,-,656
164,NZ_CP069060,1,238159,238801,+,642
164,NZ_CP072667,1,196607,197263,-,656
164,NZ_CP072671,1,196607,197263,-,656
164,NZ_CP072668,1,196607,197263,-,656
164,NZ_CP072666,1,196607,197263,-,656
164,NZ_CP090902,1,196759,197415,-,656
164,NZ_CP090948,1,196759,197415,-,656
164,NZ_CP069052,1,232824,233466,+,642
164,NZ_CP076228,1,199990,200632,-,642
164,NZ_CP042445,1,196759,197415,-,656
164,NZ_CP042904,1,204057,204699,-,642
164,NC_012416,1,206639,207281,-,642
164,NZ_CP069053,1,308476,309118,-,642
164,NZ_CP042446,1,196759,197415,-,656
164,NZ_CP041215,1,674102,674744,+,642
164,NZ_OX366353,1,468566,469208,-,642
164,NZ_OX366387,1,925820,926462,+,642
164,NZ_OX366368,1,475762,476404,-,642
164,NZ_OX366379,1,476780,477422,-,642
164,NZ_CP091195,1,497208,497850,-,642
164,NZ_OX366375,1,565909,566551,+,642
164,NZ_CP046925,1,196607,197263,-,656
164,NZ_OX366318,1,576793,577435,-,642
164,NZ_OX366319,1,806466,807108,-,642
164,NZ_OX366332,1,474377,475019,-,642
164,NZ_CP110359,1,1044816,1045458,+,642
164,NZ_OU953855,1,1128044,1128686,-,642
164,NZ_OX366272,1,717454,718096,-,642
164,NZ_OX366347,1,589519,590161,-,642
164,NZ_OU909470,1,259593,260235,-,642
164,NZ_OX366363,1,443145,443787,+,642
164,NZ_OX366364,1,1189397,1190048,-,651
164,NZ_OX366359,1,503015,503657,+,642
164,NZ_OX366349,1,907079,907721,-,642
164,NZ_OX366380,1,639976,640618,+,642
164,NZ_OX366344,1,207988,208630,+,642
164,NZ_CP090900,1,196759,197415,-,656
164,NZ_OX366352,1,655241,655883,+,642
164,NZ_OX366362,1,822284,822926,+,642
164,NZ_OX366400,1,683455,684097,+,642
164,NZ_OX366327,1,625327,625969,-,642
164,NZ_OX366367,1,115468,116119,+,651
164,NZ_CP042444,1,196697,197353,-,656
164,NZ_OX366326,1,669445,670087,-,642
164,NZ_CP037426,1,771914,772556,+,642
164,NZ_OX366339,1,452598,453240,-,642
164,NZ_OX366355,1,829267,829909,+,642
164,NZ_CP046922,1,196457,197113,-,656
164,NZ_OX366370,1,392488,393130,-,642
164,NZ_OX366385,1,918706,919348,-,642
164,NZ_OX366399,1,475272,475914,-,642
164,NZ_OX366395,1,987465,988107,-,642
164,NZ_OX366396,1,1165208,1165850,+,642
164,NZ_OX366351,1,493324,493966,-,642
164,NZ_OX366381,1,990736,991378,+,642
164,NZ_OX366342,1,605991,606633,+,642
164,NZ_OX366369,1,476973,477615,-,642
164,NZ_OX366356,1,802044,802686,+,642
164,NZ_OX366377,1,582420,583062,-,642
164,NZ_OX366388,1,806426,807068,+,642
164,NZ_OX366357,1,442122,442764,-,642
164,NZ_CP072012,1,398051,398693,-,642
164,NZ_OX366398,1,1136666,1137308,-,642
164,NC_002978,6,196759,197415,-,656
164,NZ_OX366389,1,681538,682180,+,642
164,NZ_OX366397,1,685663,686305,-,642
164,NZ_OX366378,1,766227,766869,-,642
164,NZ_CP090903,1,196759,197415,-,656
164,NZ_OX366374,1,745682,746324,-,642
164,NZ_CP090901,1,196759,197415,-,656
164,NZ_CP046923,1,196457,197113,-,656
164,NZ_CP069055,1,225033,225675,+,642
164,NZ_CP072670,1,196607,197263,-,656
164,NZ_CP090899,1,196759,197415,-,656
164,NZ_CP046924,1,196457,197113,-,656
164,NZ_OX366348,1,777409,778051,+,642
164,NZ_CP046921,1,196457,197113,-,656
164,NZ_OX366338,1,1153936,1154578,+,642
164,NZ_CP054557,1,1200769,1201411,-,642
164,NZ_CP072669,1,196607,197263,-,656
164,NC_021089,1,224206,224848,+,642
163,NZ_OX366376,1,512409,513159,+,750
163,NZ_OX366393,1,336015,336768,+,753
163,NZ_OX366372,1,1071682,1072426,-,744
163,NZ_CP072672,1,199498,200276,-,778
163,NZ_CP069060,1,236069,236847,+,778
163,NZ_CP072667,1,199480,200258,-,778
163,NZ_CP072671,1,199480,200258,-,778
163,NZ_CP072668,1,199480,200258,-,778
163,NZ_CP072666,1,199480,200258,-,778
163,NZ_CP090902,1,199632,200410,-,778
163,NZ_CP090948,1,199632,200410,-,778
163,NZ_CP069052,1,230734,231512,+,778
163,NZ_CP076228,1,201944,202722,-,778
163,NZ_CP042445,1,199632,200410,-,778
163,NZ_CP042904,1,206003,206781,-,778
163,NC_012416,1,208585,209363,-,778
163,NZ_CP069053,1,310430,311208,-,778
163,NZ_CP042446,1,199632,200410,-,778
163,NZ_CP041215,1,672021,672799,+,778
163,NZ_OX366353,1,470511,471289,-,778
163,NZ_OX366387,1,923730,924508,+,778
163,NZ_OX366368,1,477716,478494,-,778
163,NZ_OX366379,1,478734,479512,-,778
163,NZ_CP091195,1,499161,499940,-,779
163,NZ_OX366375,1,575297,576076,-,779
163,NZ_CP046925,1,199480,200258,-,778
163,NZ_OX366318,1,578739,579518,-,779
163,NZ_OX366319,1,808412,809190,-,778
163,NZ_OX366332,1,476322,477100,-,778
163,NZ_CP110359,1,1042738,1043517,+,779
163,NZ_OU953855,1,305486,306265,+,779
163,NZ_OX366272,1,719394,720173,-,779
163,NZ_OX366347,1,591460,592239,-,779
163,NZ_OU909470,1,261432,262211,-,779
163,NZ_OX366363,1,441067,441846,+,779
163,NZ_OX366364,1,1191352,1192089,-,737
163,NZ_OX366359,1,500934,501712,+,778
163,NZ_OX366349,1,907799,908551,-,752
163,NZ_OX366380,1,639147,639899,+,752
163,NZ_OX366344,1,207157,207910,+,753
163,NZ_CP090900,1,199632,200410,-,778
163,NZ_OX366352,1,648558,649336,+,778
163,NZ_OX366362,1,820200,820979,+,779
163,NZ_OX366400,1,681372,682151,+,779
163,NZ_OX366327,1,627377,628155,-,778
163,NZ_OX366367,1,113378,114156,+,778
163,NZ_CP042444,1,199570,200348,-,778
163,NZ_OX366326,1,671391,672170,-,779
163,NZ_CP037426,1,768942,769721,+,779
163,NZ_OX366339,1,454528,455307,-,779
163,NZ_OX366355,1,827185,827963,+,778
163,NZ_CP046922,1,199330,200108,-,778
163,NZ_OX366370,1,394448,395227,-,779
163,NZ_OX366385,1,919425,920177,-,752
163,NZ_OX366399,1,477226,478004,-,778
163,NZ_OX366395,1,989407,990186,-,779
163,NZ_OX366396,1,1163141,1163920,+,779
163,NZ_OX366351,1,495270,496049,-,779
163,NZ_OX366381,1,988654,989432,+,778
163,NZ_OX366342,1,605160,605913,+,753
163,NZ_OX366369,1,478919,479697,-,778
163,NZ_OX366356,1,799970,800748,+,778
163,NZ_OX366377,1,584368,585147,-,779
163,NZ_OX366388,1,804336,805115,+,779
163,NZ_OX366357,1,444063,444842,-,779
163,NZ_CP072012,1,400005,400783,-,778
163,NZ_OX366398,1,1138614,1139393,-,779
163,NC_002978,6,199632,200410,-,778
163,NZ_OX366389,1,679453,680232,+,779
163,NZ_OX366397,1,687608,688386,-,778
163,NZ_OX366378,1,768180,768959,-,779
163,NZ_CP090903,1,199632,200410,-,778
163,NZ_CP090901,1,199632,200410,-,778
163,NZ_CP046923,1,199330,200108,-,778
163,NZ_CP069055,1,222943,223721,+,778
163,NZ_CP072670,1,199480,200258,-,778
163,NZ_CP090899,1,199632,200410,-,778
163,NZ_CP046924,1,199330,200108,-,778
163,NZ_OX366348,1,775319,776097,+,778
163,NZ_CP046921,1,199330,200108,-,778
163,NZ_OX366338,1,480345,481099,-,754
163,NZ_CP054557,1,1202723,1203501,-,778
163,NZ_CP072669,1,199480,200258,-,778
163,NC_021089,1,222125,222903,+,778
162,NZ_OX366376,1,505543,512246,+,6703
162,NZ_OX366393,1,329149,335852,+,6703
162,NZ_OX366372,1,1072588,1079292,-,6704
162,NZ_CP072672,1,200753,207475,-,6722
162,NZ_CP069060,1,228870,235591,+,6721
162,NZ_CP072667,1,200735,207457,-,6722
162,NZ_CP072671,1,200735,207457,-,6722
162,NZ_CP072668,1,200735,207457,-,6722
162,NZ_CP072666,1,200735,207457,-,6722
162,NZ_CP090902,1,200887,207609,-,6722
162,NZ_CP090948,1,200887,207609,-,6722
162,NZ_CP069052,1,223535,230256,+,6721
162,NZ_CP076228,1,203199,209921,-,6722
162,NZ_CP042445,1,200887,207609,-,6722
162,NZ_CP042904,1,207144,213877,-,6733
162,NC_012416,1,209726,216459,-,6733
162,NZ_CP069053,1,311685,318407,-,6722
162,NZ_CP042446,1,200887,207609,-,6722
162,NZ_CP041215,1,664439,671187,+,6748
162,NZ_OX366353,1,472104,478853,-,6749
162,NZ_OX366387,1,916584,923323,+,6739
162,NZ_OX366368,1,478971,485693,-,6722
162,NZ_OX366379,1,479989,486711,-,6722
162,NZ_CP091195,1,500086,506850,-,6764
162,NZ_OX366375,1,576523,583263,-,6740
162,NZ_CP046925,1,200735,207457,-,6722
162,NZ_OX366318,1,579880,586618,-,6738
162,NZ_OX366319,1,810548,817270,-,6722
162,NZ_OX366332,1,477933,484682,-,6749
162,NZ_CP110359,1,1035827,1042592,+,6765
162,NZ_OU953855,1,298575,305340,+,6765
162,NZ_OX366272,1,720319,727084,-,6765
162,NZ_OX366347,1,592385,599141,-,6756
162,NZ_OU909470,1,262363,269097,-,6734
162,NZ_OX366363,1,434174,440921,+,6747
162,NZ_OX366364,1,1192186,1198927,-,6741
162,NZ_OX366359,1,493374,500122,+,6748
162,NZ_OX366349,1,908713,915417,-,6704
162,NZ_OX366380,1,632272,638994,+,6722
162,NZ_OX366344,1,200291,206994,+,6703
162,NZ_CP090900,1,200887,207609,-,6722
162,NZ_OX366352,1,640976,647724,+,6748
162,NZ_OX366362,1,1029519,1036265,-,6746
162,NZ_OX366400,1,674181,680919,+,6738
162,NZ_OX366327,1,628561,635292,-,6731
162,NZ_OX366367,1,106466,113215,+,6749
162,NZ_CP042444,1,200825,207547,-,6722
162,NZ_OX366326,1,672623,679361,-,6738
162,NZ_CP037426,1,761755,768494,+,6739
162,NZ_OX366339,1,455469,462209,-,6740
162,NZ_OX366355,1,819105,825826,+,6721
162,NZ_CP046922,1,200585,207307,-,6722
162,NZ_OX366370,1,395389,402091,-,6702
162,NZ_OX366385,1,920329,927052,-,6723
162,NZ_OX366399,1,478481,485203,-,6722
162,NZ_OX366395,1,990289,997054,-,6765
162,NZ_OX366396,1,1156230,1162978,+,6748
162,NZ_OX366351,1,496502,503240,-,6738
162,NZ_OX366381,1,980574,987295,+,6721
162,NZ_OX366342,1,598294,604997,+,6703
162,NZ_OX366369,1,481055,487777,-,6722
162,NZ_OX366356,1,792711,799459,+,6748
162,NZ_OX366377,1,585309,592049,-,6740
162,NZ_OX366388,1,797426,804190,+,6764
162,NZ_OX366357,1,1251153,1257892,-,6739
162,NZ_CP072012,1,401260,407982,-,6722
162,NZ_OX366398,1,1139555,1146295,-,6740
162,NC_002978,6,200887,207609,-,6722
162,NZ_OX366389,1,672551,679290,+,6739
162,NZ_OX366397,1,689241,695990,-,6749
162,NZ_OX366378,1,769105,775869,-,6764
162,NZ_CP090903,1,200887,207609,-,6722
162,NZ_OX366374,1,748066,754815,-,6749
162,NZ_CP090901,1,200887,207609,-,6722
162,NZ_CP046923,1,200585,207307,-,6722
162,NZ_CP069055,1,215745,222466,+,6721
162,NZ_CP072670,1,200735,207457,-,6722
162,NZ_CP090899,1,200887,207609,-,6722
162,NZ_CP046924,1,200585,207307,-,6722
162,NZ_OX366348,1,768120,774841,+,6721
162,NZ_CP046921,1,200585,207307,-,6722
162,NZ_OX366338,1,481261,488010,-,6749
162,NZ_CP054557,1,1203978,1210700,-,6722
162,NZ_CP072669,1,200735,207457,-,6722
162,NC_021089,1,214543,221291,+,6748
161,NZ_OX366376,1,503160,505087,+,1927
161,NZ_OX366393,1,326766,328693,+,1927
161,NZ_OX366372,1,1079748,1081675,-,1927
161,NZ_CP072672,1,207829,209756,-,1927
161,NZ_CP069060,1,226589,228516,+,1927
161,NZ_CP072667,1,207811,209738,-,1927
161,NZ_CP072671,1,207811,209738,-,1927
161,NZ_CP072668,1,207811,209738,-,1927
161,NZ_CP072666,1,207811,209738,-,1927
161,NZ_CP090902,1,207963,209890,-,1927
161,NZ_CP090948,1,207963,209890,-,1927
161,NZ_CP069052,1,221254,223181,+,1927
161,NZ_CP076228,1,210275,212202,-,1927
161,NZ_CP042445,1,207963,209890,-,1927
161,NZ_CP042904,1,214231,216158,-,1927
161,NC_012416,1,216813,218740,-,1927
161,NZ_CP069053,1,318761,320688,-,1927
161,NZ_CP042446,1,207963,209890,-,1927
161,NZ_CP041215,1,662158,664085,+,1927
161,NZ_OX366353,1,479207,481134,-,1927
161,NZ_OX366387,1,914303,916230,+,1927
161,NZ_OX366368,1,486047,487974,-,1927
161,NZ_OX366379,1,487065,488992,-,1927
161,NZ_CP091195,1,507318,509245,-,1927
161,NZ_OX366375,1,583617,585539,-,1922
161,NZ_CP046925,1,207811,209738,-,1927
161,NZ_OX366318,1,586972,588899,-,1927
161,NZ_OX366319,1,817624,819551,-,1927
161,NZ_OX366332,1,485036,486963,-,1927
161,NZ_CP110359,1,1033546,1035473,+,1927
161,NZ_OU953855,1,296294,298221,+,1927
161,NZ_OX366272,1,727438,729365,-,1927
161,NZ_OX366347,1,599495,601422,-,1927
161,NZ_OU909470,1,269553,271480,-,1927
161,NZ_OX366363,1,431779,433706,+,1927
161,NZ_OX366364,1,1199280,1201207,-,1927
161,NZ_OX366359,1,491093,493020,+,1927
161,NZ_OX366349,1,915873,917800,-,1927
161,NZ_OX366380,1,629889,631816,+,1927
161,NZ_OX366344,1,197911,199835,+,1924
161,NZ_CP090900,1,207963,209890,-,1927
161,NZ_OX366352,1,638695,640622,+,1927
161,NZ_OX366362,1,1036715,1038642,-,1927
161,NZ_OX366400,1,671900,673827,+,1927
161,NZ_OX366327,1,635646,637573,-,1927
161,NZ_OX366367,1,104089,106016,+,1927
161,NZ_CP042444,1,207901,209828,-,1927
161,NZ_OX366326,1,679715,681609,-,1894
161,NZ_CP037426,1,759479,761401,+,1922
161,NZ_OX366339,1,462563,464490,-,1927
161,NZ_OX366355,1,816824,818751,+,1927
161,NZ_CP046922,1,207661,209588,-,1927
161,NZ_OX366370,1,402547,404474,-,1927
161,NZ_OX366385,1,927508,929435,-,1927
161,NZ_OX366399,1,485557,487484,-,1927
161,NZ_OX366395,1,997408,999335,-,1927
161,NZ_OX366396,1,1153949,1155876,+,1927
161,NZ_OX366351,1,503594,505521,-,1927
161,NZ_OX366381,1,978293,980220,+,1927
161,NZ_OX366342,1,595911,597838,+,1927
161,NZ_OX366369,1,488131,490058,-,1927
161,NZ_OX366356,1,790334,792261,+,1927
161,NZ_OX366377,1,592403,594330,-,1927
161,NZ_OX366388,1,794695,796622,+,1927
161,NZ_OX366357,1,1258384,1260275,-,1891
161,NZ_CP072012,1,408336,410263,-,1927
161,NZ_OX366398,1,1146649,1148576,-,1927
161,NC_002978,6,207963,209890,-,1927
161,NZ_OX366389,1,670270,672197,+,1927
161,NZ_OX366397,1,696344,698271,-,1927
161,NZ_OX366378,1,776337,778264,-,1927
161,NZ_CP090903,1,207963,209890,-,1927
161,NZ_OX366374,1,755169,757096,-,1927
161,NZ_CP090901,1,207963,209890,-,1927
161,NZ_CP046923,1,207661,209588,-,1927
161,NZ_CP069055,1,213464,215391,+,1927
161,NZ_CP072670,1,207811,209738,-,1927
161,NZ_CP090899,1,207963,209890,-,1927
161,NZ_CP046924,1,207661,209588,-,1927
161,NZ_OX366348,1,765839,767766,+,1927
161,NZ_CP046921,1,207661,209588,-,1927
161,NZ_OX366338,1,488454,490381,-,1927
161,NZ_CP054557,1,1211054,1212981,-,1927
161,NZ_CP072669,1,207811,209738,-,1927
161,NC_021089,1,212262,214189,+,1927
160,NZ_OX366376,1,501073,501620,+,547
160,NZ_OX366393,1,324680,325227,+,547
160,NZ_OX366372,1,1083102,1083650,-,548
160,NZ_CP072672,1,1079703,1080250,+,547
160,NZ_CP069060,1,925648,926195,+,547
160,NZ_CP072667,1,1079677,1080224,+,547
160,NZ_CP072671,1,1079685,1080232,+,547
160,NZ_CP072668,1,1079672,1080219,+,547
160,NZ_CP072666,1,1079685,1080232,+,547
160,NZ_CP090902,1,1079837,1080384,+,547
160,NZ_CP090948,1,1079835,1080382,+,547
160,NZ_CP069052,1,728432,728980,-,548
160,NZ_CP076228,1,925187,925735,-,548
160,NZ_CP042445,1,1079825,1080372,+,547
160,NZ_CP042904,1,1343248,1343795,+,547
160,NC_012416,1,1387946,1388493,+,547
160,NZ_CP069053,1,925656,926203,+,547
160,NZ_CP042446,1,1079835,1080382,+,547
160,NZ_CP041215,1,98717,99265,-,548
160,NZ_OX366353,1,124838,125385,+,547
160,NZ_OX366387,1,1577334,1577882,-,548
160,NZ_OX366368,1,92137,92684,+,547
160,NZ_OX366379,1,92155,92702,+,547
160,NZ_CP091195,1,1027811,1028359,-,548
160,NZ_OX366375,1,89595,90143,-,548
160,NZ_CP046925,1,1079685,1080232,+,547
160,NZ_OX366318,1,90046,90593,+,547
160,NZ_OX366319,1,1113197,1113744,+,547
160,NZ_OX366332,1,85533,86081,-,548
160,NZ_CP110359,1,368545,369092,+,547
160,NZ_OU953855,1,1764547,1765095,-,548
160,NZ_OX366272,1,199825,200373,-,548
160,NZ_OX366347,1,22169,22716,+,547
160,NZ_OU909470,1,905828,906376,-,548
160,NZ_OX366363,1,911663,912211,-,548
160,NZ_OX366364,1,400844,401392,-,548
160,NZ_OX366359,1,84606,85154,-,548
160,NZ_OX366349,1,920529,921077,-,548
160,NZ_OX366380,1,93933,94481,-,548
160,NZ_OX366344,1,196077,196624,+,547
160,NZ_CP090900,1,1079837,1080384,+,547
160,NZ_OX366352,1,1605332,1605879,+,547
160,NZ_OX366362,1,468280,468827,+,547
160,NZ_OX366400,1,83880,84428,-,548
160,NZ_OX366327,1,84814,85362,-,548
160,NZ_OX366367,1,1090661,1091209,-,548
160,NZ_CP042444,1,1081191,1081738,+,547
160,NZ_OX366326,1,93375,93922,+,547
160,NZ_CP037426,1,1057696,1058223,+,527
160,NZ_OX366339,1,940948,941496,-,548
160,NZ_OX366355,1,1230305,1230852,+,547
160,NZ_CP046922,1,1141754,1142301,+,547
160,NZ_OX366370,1,191124,191687,+,563
160,NZ_OX366385,1,1119845,1120392,+,547
160,NZ_OX366399,1,91646,92193,+,547
160,NZ_OX366395,1,1516179,1516727,-,548
160,NZ_OX366396,1,415854,416402,-,548
160,NZ_OX366351,1,100766,101313,+,547
160,NZ_OX366381,1,1295233,1295780,+,547
160,NZ_OX366342,1,593911,594458,+,547
160,NZ_OX366369,1,91381,91928,+,547
160,NZ_OX366356,1,89875,90422,+,547
160,NZ_OX366377,1,90772,91319,+,547
160,NZ_OX366388,1,70854,71401,+,547
160,NZ_OX366357,1,114804,115353,-,549
160,NZ_CP072012,1,913688,914236,-,548
160,NZ_OX366398,1,562131,562678,+,547
160,NC_002978,6,1079835,1080382,+,547
160,NZ_OX366389,1,160197,160745,-,548
160,NZ_OX366397,1,92479,93026,+,547
160,NZ_OX366378,1,201154,201701,+,547
160,NZ_CP090903,1,1079837,1080384,+,547
160,NZ_OX366374,1,668471,669019,-,548
160,NZ_CP090901,1,1079837,1080384,+,547
160,NZ_CP046923,1,1058002,1058549,+,547
160,NZ_CP069055,1,882805,883352,+,547
160,NZ_CP072670,1,1079665,1080212,+,547
160,NZ_CP090899,1,1079837,1080384,+,547
160,NZ_CP046924,1,1078940,1079487,+,547
160,NZ_OX366348,1,1132226,1132773,+,547
160,NZ_CP046921,1,1141754,1142301,+,547
160,NZ_OX366338,1,1434287,1434834,+,547
160,NZ_CP054557,1,875221,875768,+,547
160,NZ_CP072669,1,1079685,1080232,+,547
160,NC_021089,1,1108924,1109471,+,547
159,NZ_OX366376,1,498824,500717,+,1893
159,NZ_OX366393,1,322431,324324,+,1893
159,NZ_OX366372,1,1084005,1085899,-,1894
159,NZ_CP072672,1,1077450,1079347,+,1897
159,NZ_CP069060,1,923395,925292,+,1897
159,NZ_CP072667,1,1077424,1079321,+,1897
159,NZ_CP072671,1,1077432,1079329,+,1897
159,NZ_CP072668,1,1077419,1079316,+,1897
159,NZ_CP072666,1,1077432,1079329,+,1897
159,NZ_CP090902,1,1077584,1079481,+,1897
159,NZ_CP090948,1,1077582,1079479,+,1897
159,NZ_CP069052,1,729335,731233,-,1898
159,NZ_CP076228,1,926090,927988,-,1898
159,NZ_CP042445,1,1077572,1079469,+,1897
159,NZ_CP042904,1,1340995,1342892,+,1897
159,NC_012416,1,1385693,1387590,+,1897
159,NZ_CP069053,1,923403,925300,+,1897
159,NZ_CP042446,1,1077582,1079479,+,1897
159,NZ_CP041215,1,99620,101518,-,1898
159,NZ_OX366353,1,122585,124482,+,1897
159,NZ_OX366387,1,1578237,1579984,-,1747
159,NZ_OX366368,1,89884,91781,+,1897
159,NZ_OX366379,1,89902,91799,+,1897
159,NZ_CP091195,1,1028714,1030612,-,1898
159,NZ_OX366375,1,90498,92396,-,1898
159,NZ_CP046925,1,1077432,1079329,+,1897
159,NZ_OX366318,1,87793,89690,+,1897
159,NZ_OX366319,1,1111095,1112841,+,1746
159,NZ_OX366332,1,86436,88334,-,1898
159,NZ_CP110359,1,366299,368189,+,1890
159,NZ_OU953855,1,1765450,1767348,-,1898
159,NZ_OX366272,1,200728,202626,-,1898
159,NZ_OX366347,1,1272207,1274120,+,1913
159,NZ_OU909470,1,906731,908631,-,1900
159,NZ_OX366363,1,912566,914464,-,1898
159,NZ_OX366364,1,1238472,1240210,-,1738
159,NZ_OX366359,1,85509,87407,-,1898
159,NZ_OX366349,1,921432,923326,-,1894
159,NZ_OX366380,1,94836,96583,-,1747
159,NZ_OX366344,1,193981,195721,+,1740
159,NZ_CP090900,1,1077584,1079481,+,1897
159,NZ_OX366352,1,1603079,1604976,+,1897
159,NZ_OX366362,1,466027,467924,+,1897
159,NZ_OX366400,1,84783,86681,-,1898
159,NZ_OX366327,1,85717,87615,-,1898
159,NZ_OX366367,1,1091564,1093449,-,1885
159,NZ_CP042444,1,1078938,1080835,+,1897
159,NZ_OX366326,1,91122,93019,+,1897
159,NZ_CP037426,1,1054502,1056399,+,1897
159,NZ_OX366339,1,941851,943749,-,1898
159,NZ_OX366355,1,1228203,1229949,+,1746
159,NZ_CP046922,1,1139501,1141398,+,1897
159,NZ_OX366370,1,189022,190768,+,1746
159,NZ_OX366385,1,1117743,1119489,+,1746
159,NZ_OX366399,1,89393,91290,+,1897
159,NZ_OX366395,1,1517082,1518980,-,1898
159,NZ_OX366396,1,416757,418655,-,1898
159,NZ_OX366351,1,98513,100410,+,1897
159,NZ_OX366381,1,1293131,1294877,+,1746
159,NZ_OX366342,1,591662,593555,+,1893
159,NZ_OX366369,1,89279,91025,+,1746
159,NZ_OX366356,1,87622,89519,+,1897
159,NZ_OX366377,1,88519,90416,+,1897
159,NZ_OX366388,1,68580,70498,+,1918
159,NZ_OX366357,1,115708,117607,-,1899
159,NZ_CP072012,1,914591,916489,-,1898
159,NZ_OX366398,1,559878,561775,+,1897
159,NC_002978,6,1077582,1079479,+,1897
159,NZ_OX366389,1,161100,162998,-,1898
159,NZ_OX366397,1,90226,92123,+,1897
159,NZ_OX366378,1,198901,200798,+,1897
159,NZ_CP090903,1,1077584,1079481,+,1897
159,NZ_OX366374,1,669374,671272,-,1898
159,NZ_CP090901,1,1077584,1079481,+,1897
159,NZ_CP046923,1,1055749,1057646,+,1897
159,NZ_CP069055,1,880552,882449,+,1897
159,NZ_CP072670,1,1077412,1079309,+,1897
159,NZ_CP090899,1,1077584,1079481,+,1897
159,NZ_CP046924,1,1076687,1078584,+,1897
159,NZ_OX366348,1,1129973,1131870,+,1897
159,NZ_CP046921,1,1139501,1141398,+,1897
159,NZ_OX366338,1,1432034,1433931,+,1897
159,NZ_CP054557,1,872968,874865,+,1897
159,NZ_CP072669,1,1077432,1079329,+,1897
159,NC_021089,1,1106671,1108568,+,1897
158,NZ_OX366376,1,495152,497903,+,2751
158,NZ_OX366393,1,318753,321504,+,2751
158,NZ_OX366372,1,1086826,1089577,-,2751
158,NZ_CP072672,1,1073683,1076432,+,2749
158,NZ_CP069060,1,919628,922377,+,2749
158,NZ_CP072667,1,1073657,1076406,+,2749
158,NZ_CP072671,1,1073665,1076414,+,2749
158,NZ_CP072668,1,1073652,1076401,+,2749
158,NZ_CP072666,1,1073665,1076414,+,2749
158,NZ_CP090902,1,1073817,1076566,+,2749
158,NZ_CP090948,1,1073815,1076564,+,2749
158,NZ_CP069052,1,732251,735000,-,2749
158,NZ_CP076228,1,929006,931755,-,2749
158,NZ_CP042445,1,1073805,1076554,+,2749
158,NZ_CP042904,1,1337222,1339971,+,2749
158,NC_012416,1,1381920,1384669,+,2749
158,NZ_CP069053,1,919636,922385,+,2749
158,NZ_CP042446,1,1073815,1076564,+,2749
158,NZ_CP041215,1,102548,105297,-,2749
158,NZ_OX366353,1,118806,121555,+,2749
158,NZ_OX366387,1,1581017,1583766,-,2749
158,NZ_OX366368,1,86117,88866,+,2749
158,NZ_OX366379,1,86135,88884,+,2749
158,NZ_CP091195,1,1031630,1034379,-,2749
158,NZ_OX366375,1,93429,96178,-,2749
158,NZ_CP046925,1,1073665,1076414,+,2749
158,NZ_OX366318,1,84026,86775,+,2749
158,NZ_OX366319,1,1107313,1110062,+,2749
158,NZ_OX366332,1,89364,92113,-,2749
158,NZ_CP110359,1,362492,365241,+,2749
158,NZ_OU953855,1,1768381,1771130,-,2749
158,NZ_OX366272,1,203677,206426,-,2749
158,NZ_OX366347,1,1268407,1271156,+,2749
158,NZ_OU909470,1,909703,912445,-,2742
158,NZ_OX366363,1,915488,918237,-,2749
158,NZ_OX366364,1,1241316,1244074,-,2758
158,NZ_OX366359,1,88437,91186,-,2749
158,NZ_OX366349,1,924256,927007,-,2751
158,NZ_OX366380,1,97655,100397,-,2742
158,NZ_OX366344,1,190300,193051,+,2751
158,NZ_CP090900,1,1073817,1076566,+,2749
158,NZ_OX366352,1,1599300,1602049,+,2749
158,NZ_OX366362,1,462261,465019,+,2758
158,NZ_OX366400,1,87699,90448,-,2749
158,NZ_OX366327,1,88666,91415,-,2749
158,NZ_OX366367,1,1094470,1097228,-,2758
158,NZ_CP042444,1,1075171,1077920,+,2749
158,NZ_OX366326,1,87355,90104,+,2749
158,NZ_CP037426,1,1050720,1053469,+,2749
158,NZ_OX366339,1,944776,947525,-,2749
158,NZ_OX366355,1,1224421,1227170,+,2749
158,NZ_CP046922,1,1135734,1138483,+,2749
158,NZ_OX366370,1,185347,188098,+,2751
158,NZ_OX366385,1,1113923,1116671,+,2748
158,NZ_OX366399,1,85626,88375,+,2749
158,NZ_OX366395,1,1520025,1522774,-,2749
158,NZ_OX366396,1,419682,422431,-,2749
158,NZ_OX366351,1,94746,97495,+,2749
158,NZ_OX366381,1,1289349,1292098,+,2749
158,NZ_OX366342,1,587984,590735,+,2751
158,NZ_OX366369,1,85497,88246,+,2749
158,NZ_OX366356,1,83834,86583,+,2749
158,NZ_OX366377,1,84761,87510,+,2749
158,NZ_OX366388,1,64789,67538,+,2749
158,NZ_OX366357,1,118652,121401,-,2749
158,NZ_CP072012,1,917507,920256,-,2749
158,NZ_OX366398,1,556120,558869,+,2749
158,NC_002978,6,1073815,1076564,+,2749
158,NZ_OX366389,1,164007,166756,-,2749
158,NZ_OX366397,1,86447,89196,+,2749
158,NZ_OX366378,1,195134,197883,+,2749
158,NZ_CP090903,1,1073817,1076566,+,2749
158,NZ_OX366374,1,672305,675054,-,2749
158,NZ_CP090901,1,1073817,1076566,+,2749
158,NZ_CP046923,1,1051982,1054731,+,2749
158,NZ_CP069055,1,876785,879534,+,2749
158,NZ_CP072670,1,1073645,1076394,+,2749
158,NZ_CP090899,1,1073817,1076566,+,2749
158,NZ_CP046924,1,1072920,1075669,+,2749
158,NZ_OX366348,1,1126206,1128955,+,2749
158,NZ_CP046921,1,1135734,1138483,+,2749
158,NZ_OX366338,1,1428231,1430989,+,2758
158,NZ_CP054557,1,869201,871950,+,2749
158,NZ_CP072669,1,1073665,1076414,+,2749
158,NC_021089,1,1102892,1105641,+,2749
157,NZ_OX366376,1,493089,495017,+,1928
157,NZ_OX366393,1,316690,318618,+,1928
157,NZ_OX366372,1,1089712,1091640,-,1928
157,NZ_CP072672,1,1071645,1073556,+,1911
157,NZ_CP069060,1,917590,919501,+,1911
157,NZ_CP072667,1,1071619,1073530,+,1911
157,NZ_CP072671,1,1071627,1073538,+,1911
157,NZ_CP072668,1,1071614,1073525,+,1911
157,NZ_CP072666,1,1071627,1073538,+,1911
157,NZ_CP090902,1,1071779,1073690,+,1911
157,NZ_CP090948,1,1071777,1073688,+,1911
157,NZ_CP069052,1,735127,737038,-,1911
157,NZ_CP076228,1,931882,933793,-,1911
157,NZ_CP042445,1,1071767,1073678,+,1911
157,NZ_CP042904,1,1335184,1337095,+,1911
157,NC_012416,1,1379882,1381793,+,1911
157,NZ_CP069053,1,917598,919509,+,1911
157,NZ_CP042446,1,1071777,1073688,+,1911
157,NZ_CP041215,1,105424,107336,-,1912
157,NZ_OX366353,1,116767,118679,+,1912
157,NZ_OX366387,1,1583893,1585804,-,1911
157,NZ_OX366368,1,84079,85990,+,1911
157,NZ_OX366379,1,84097,86008,+,1911
157,NZ_CP091195,1,1034506,1036417,-,1911
157,NZ_OX366375,1,96305,98216,-,1911
157,NZ_CP046925,1,1071627,1073538,+,1911
157,NZ_OX366318,1,81988,83899,+,1911
157,NZ_OX366319,1,1105275,1107186,+,1911
157,NZ_OX366332,1,92240,94152,-,1912
157,NZ_CP110359,1,360454,362363,+,1909
157,NZ_OU953855,1,1771257,1773168,-,1911
157,NZ_OX366272,1,206553,208464,-,1911
157,NZ_OX366347,1,1266369,1268280,+,1911
157,NZ_OU909470,1,915543,917455,-,1912
157,NZ_OX366363,1,918364,920275,-,1911
157,NZ_OX366364,1,1244209,1246120,-,1911
157,NZ_OX366359,1,91313,93225,-,1912
157,NZ_OX366349,1,927142,929070,-,1928
157,NZ_OX366380,1,349905,351808,+,1903
157,NZ_OX366344,1,188237,190165,+,1928
157,NZ_CP090900,1,1071779,1073690,+,1911
157,NZ_OX366352,1,1597261,1599173,+,1912
157,NZ_OX366362,1,459893,461805,+,1912
157,NZ_OX366400,1,90575,92486,-,1911
157,NZ_OX366327,1,91542,93453,-,1911
157,NZ_OX366367,1,1097363,1099274,-,1911
157,NZ_CP042444,1,1073133,1075044,+,1911
157,NZ_OX366326,1,85317,87228,+,1911
157,NZ_CP037426,1,1048682,1050593,+,1911
157,NZ_OX366339,1,947652,949563,-,1911
157,NZ_OX366355,1,1222383,1224294,+,1911
157,NZ_CP046922,1,1133696,1135607,+,1911
157,NZ_OX366370,1,183283,185212,+,1929
157,NZ_OX366385,1,935549,937452,+,1903
157,NZ_OX366399,1,83588,85499,+,1911
157,NZ_OX366395,1,1523230,1525141,-,1911
157,NZ_OX366396,1,422558,424469,-,1911
157,NZ_OX366351,1,92708,94619,+,1911
157,NZ_OX366381,1,1287311,1289222,+,1911
157,NZ_OX366342,1,585921,587849,+,1928
157,NZ_OX366369,1,83459,85370,+,1911
157,NZ_OX366356,1,81796,83707,+,1911
157,NZ_OX366377,1,82723,84634,+,1911
157,NZ_OX366388,1,62751,64662,+,1911
157,NZ_OX366357,1,121857,123768,-,1911
157,NZ_CP072012,1,920383,922294,-,1911
157,NZ_OX366398,1,554082,555993,+,1911
157,NC_002978,6,1071777,1073688,+,1911
157,NZ_OX366389,1,166883,168794,-,1911
157,NZ_OX366397,1,84408,86320,+,1912
157,NZ_OX366378,1,193096,195007,+,1911
157,NZ_CP090903,1,1071779,1073690,+,1911
157,NZ_OX366374,1,675510,677366,-,1856
157,NZ_CP090901,1,1071779,1073690,+,1911
157,NZ_CP046923,1,1049944,1051855,+,1911
157,NZ_CP069055,1,874747,876658,+,1911
157,NZ_CP072670,1,1071607,1073518,+,1911
157,NZ_CP090899,1,1071779,1073690,+,1911
157,NZ_CP046924,1,1070882,1072793,+,1911
157,NZ_OX366348,1,1124168,1126079,+,1911
157,NZ_CP046921,1,1133696,1135607,+,1911
157,NZ_OX366338,1,1426193,1428104,+,1911
157,NZ_CP054557,1,867163,869074,+,1911
157,NZ_CP072669,1,1071627,1073538,+,1911
157,NC_021089,1,1100853,1102765,+,1912
156,NZ_OX366376,1,491173,492446,+,1273
156,NZ_OX366393,1,314774,316047,+,1273
156,NZ_OX366372,1,1092283,1093556,-,1273
156,NZ_CP072672,1,1069755,1071053,+,1298
156,NZ_CP069060,1,915700,916998,+,1298
156,NZ_CP072667,1,1069729,1071027,+,1298
156,NZ_CP072671,1,1069737,1071035,+,1298
156,NZ_CP072668,1,1069724,1071022,+,1298
156,NZ_CP072666,1,1069737,1071035,+,1298
156,NZ_CP090902,1,1069889,1071187,+,1298
156,NZ_CP090948,1,1069887,1071185,+,1298
156,NZ_CP069052,1,737630,738928,-,1298
156,NZ_CP076228,1,934384,935682,-,1298
156,NZ_CP042445,1,1069877,1071175,+,1298
156,NZ_CP042904,1,1333294,1334592,+,1298
156,NC_012416,1,1377992,1379290,+,1298
156,NZ_CP069053,1,915708,917006,+,1298
156,NZ_CP042446,1,1069887,1071185,+,1298
156,NZ_CP041215,1,107921,109219,-,1298
156,NZ_OX366353,1,114884,116182,+,1298
156,NZ_OX366387,1,1586395,1587693,-,1298
156,NZ_OX366368,1,82189,83487,+,1298
156,NZ_OX366379,1,82207,83505,+,1298
156,NZ_CP091195,1,1037009,1038307,-,1298
156,NZ_OX366375,1,98808,100106,-,1298
156,NZ_CP046925,1,1069737,1071035,+,1298
156,NZ_OX366318,1,80098,81396,+,1298
156,NZ_OX366319,1,1103385,1104671,+,1286
156,NZ_OX366332,1,94737,96035,-,1298
156,NZ_CP110359,1,358564,359862,+,1298
156,NZ_OU953855,1,997205,998503,+,1298
156,NZ_OX366272,1,209056,210354,-,1298
156,NZ_OX366347,1,1263373,1264678,+,1305
156,NZ_OU909470,1,1048137,1049356,+,1219
156,NZ_OX366363,1,920867,922165,-,1298
156,NZ_OX366364,1,351479,352657,+,1178
156,NZ_OX366359,1,93810,95108,-,1298
156,NZ_OX366349,1,930045,931318,-,1273
156,NZ_OX366380,1,10016,11235,-,1219
156,NZ_OX366344,1,186324,187597,+,1273
156,NZ_CP090900,1,1069889,1071187,+,1298
156,NZ_OX366352,1,1595378,1596676,+,1298
156,NZ_OX366362,1,457988,459267,+,1279
156,NZ_OX366400,1,93078,94376,-,1298
156,NZ_OX366327,1,94045,95343,-,1298
156,NZ_OX366367,1,1035276,1036469,+,1193
156,NZ_CP042444,1,1071243,1072541,+,1298
156,NZ_OX366326,1,83427,84725,+,1298
156,NZ_CP037426,1,1046792,1048090,+,1298
156,NZ_OX366339,1,950155,951453,-,1298
156,NZ_OX366355,1,1220493,1221791,+,1298
156,NZ_CP046922,1,1131806,1133104,+,1298
156,NZ_OX366370,1,181371,182675,+,1304
156,NZ_OX366385,1,1136660,1137879,-,1219
156,NZ_OX366399,1,81698,82996,+,1298
156,NZ_OX366395,1,1525733,1527031,-,1298
156,NZ_OX366396,1,425061,426359,-,1298
156,NZ_OX366351,1,90818,92116,+,1298
156,NZ_OX366381,1,1285421,1286719,+,1298
156,NZ_OX366342,1,584005,585278,+,1273
156,NZ_OX366369,1,81569,82867,+,1298
156,NZ_OX366356,1,79907,81189,+,1282
156,NZ_OX366377,1,80833,82131,+,1298
156,NZ_OX366388,1,60861,62159,+,1298
156,NZ_OX366357,1,124360,125658,-,1298
156,NZ_CP072012,1,922886,924184,-,1298
156,NZ_OX366398,1,552192,553490,+,1298
156,NC_002978,6,1069887,1071185,+,1298
156,NZ_OX366389,1,169386,170684,-,1298
156,NZ_OX366397,1,82525,83823,+,1298
156,NZ_OX366378,1,191206,192504,+,1298
156,NZ_CP090903,1,1069889,1071187,+,1298
156,NZ_OX366374,1,692852,694045,+,1193
156,NZ_CP090901,1,1069889,1071187,+,1298
156,NZ_CP046923,1,1048054,1049352,+,1298
156,NZ_CP069055,1,872857,874155,+,1298
156,NZ_CP072670,1,1069717,1071015,+,1298
156,NZ_CP090899,1,1069889,1071187,+,1298
156,NZ_CP046924,1,1068992,1070290,+,1298
156,NZ_OX366348,1,1122278,1123576,+,1298
156,NZ_CP046921,1,1131806,1133104,+,1298
156,NZ_OX366338,1,1424303,1425601,+,1298
156,NZ_CP054557,1,865273,866571,+,1298
156,NZ_CP072669,1,1069737,1071035,+,1298
156,NC_021089,1,1098970,1100268,+,1298
155,NZ_OX366376,1,490584,491171,+,587
155,NZ_OX366393,1,314185,314772,+,587
155,NZ_OX366372,1,1093557,1094144,-,587
155,NZ_OX366349,1,931319,931906,-,587
155,NZ_OX366344,1,185735,186322,+,587
155,NZ_OX366342,1,583416,584003,+,587
154,NZ_OX366376,1,486001,488838,+,2837
154,NZ_OX366393,1,309604,312442,+,2838
154,NZ_OX366372,1,1095889,1098727,-,2838
154,NZ_CP072672,1,731405,734229,-,2824
154,NZ_CP069060,1,572858,575682,-,2824
154,NZ_CP072667,1,731387,734211,-,2824
154,NZ_CP072671,1,731387,734211,-,2824
154,NZ_CP072668,1,731374,734198,-,2824
154,NZ_CP072666,1,731387,734211,-,2824
154,NZ_CP090902,1,731539,734363,-,2824
154,NZ_CP090948,1,731539,734363,-,2824
154,NZ_CP069052,1,1123848,1126672,-,2824
154,NZ_CP076228,1,727233,730054,-,2821
154,NZ_CP042445,1,731527,734351,-,2824
154,NZ_CP042904,1,610981,613807,-,2826
154,NC_012416,1,646636,649462,-,2826
154,NZ_CP069053,1,572866,575690,-,2824
154,NZ_CP042446,1,731539,734363,-,2824
154,NZ_CP041215,1,947719,950537,+,2818
154,NZ_OX366353,1,109805,112696,+,2891
154,NZ_OX366387,1,1513297,1516123,-,2826
154,NZ_OX366368,1,1175728,1178552,-,2824
154,NZ_OX366379,1,1096194,1099018,-,2824
154,NZ_CP091195,1,1521351,1524177,+,2826
154,NZ_OX366375,1,1022983,1025782,-,2799
154,NZ_CP046925,1,731387,734211,-,2824
154,NZ_OX366318,1,1026519,1029343,-,2824
154,NZ_OX366319,1,187963,190756,+,2793
154,NZ_OX366332,1,1113790,1116608,-,2818
154,NZ_CP110359,1,472639,475465,+,2826
154,NZ_OU953855,1,236905,239731,+,2826
154,NZ_OX366272,1,1353485,1356311,-,2826
154,NZ_OX366347,1,162343,165168,-,2825
154,NZ_OU909470,1,1041387,1044231,+,2844
154,NZ_OX366363,1,1209512,1212336,+,2824
154,NZ_OX366364,1,184549,187431,-,2882
154,NZ_OX366359,1,942731,945549,-,2818
154,NZ_OX366349,1,933895,936733,-,2838
154,NZ_OX366380,1,65005,67849,-,2844
154,NZ_OX366344,1,1341064,1343902,+,2838
154,NZ_CP090900,1,731539,734363,-,2824
154,NZ_OX366352,1,1270999,1273890,+,2891
154,NZ_OX366362,1,1062183,1064994,+,2811
154,NZ_OX366400,1,888915,891739,-,2824
154,NZ_OX366327,1,1027783,1030609,-,2826
154,NZ_OX366367,1,1362499,1365308,-,2809
154,NZ_CP042444,1,732076,734900,-,2824
154,NZ_OX366326,1,1233151,1235975,-,2824
154,NZ_CP037426,1,821170,823969,-,2799
154,NZ_OX366339,1,844018,846862,-,2844
154,NZ_OX366355,1,212234,215027,+,2793
154,NZ_CP046922,1,793253,796077,-,2824
154,NZ_OX366370,1,177235,180072,+,2837
154,NZ_OX366385,1,55495,58339,+,2844
154,NZ_OX366399,1,1130822,1133646,-,2824
154,NZ_OX366395,1,1347229,1350022,+,2793
154,NZ_OX366396,1,1354945,1357789,+,2844
154,NZ_OX366351,1,1180400,1183224,-,2824
154,NZ_OX366381,1,298824,301617,+,2793
154,NZ_OX366342,1,578834,581672,+,2838
154,NZ_OX366369,1,1217985,1220778,-,2793
154,NZ_OX366356,1,935230,938053,-,2823
154,NZ_OX366377,1,1198349,1201173,+,2824
154,NZ_OX366388,1,119206,122032,+,2826
154,NZ_OX366357,1,1015476,1018302,-,2826
154,NZ_CP072012,1,1448069,1450893,+,2824
154,NZ_OX366398,1,682791,685615,+,2824
154,NC_002978,6,731539,734363,-,2824
154,NZ_OX366389,1,1143671,1146495,+,2824
154,NZ_OX366397,1,1334901,1337719,-,2818
154,NZ_OX366378,1,575671,578497,+,2826
154,NZ_CP090903,1,731539,734363,-,2824
154,NZ_OX366374,1,58631,61424,-,2793
154,NZ_CP090901,1,731539,734363,-,2824
154,NZ_CP046923,1,709501,712325,-,2824
154,NZ_CP069055,1,730494,733318,-,2824
154,NZ_CP072670,1,731379,734203,-,2824
154,NZ_CP090899,1,731539,734363,-,2824
154,NZ_CP046924,1,730439,733263,-,2824
154,NZ_OX366348,1,248629,251453,+,2824
154,NZ_CP046921,1,793253,796077,-,2824
154,NZ_OX366338,1,312487,315331,-,2844
154,NZ_CP054557,1,1074867,1077688,+,2821
154,NZ_CP072669,1,731387,734211,-,2824
154,NC_021089,1,764323,767141,-,2818
153,NZ_OX366376,1,485247,485808,+,561
153,NZ_OX366393,1,308850,309411,+,561
153,NZ_OX366372,1,1098920,1099481,-,561
153,NZ_CP072672,1,734422,734983,-,561
153,NZ_CP069060,1,575875,576436,-,561
153,NZ_CP072667,1,734404,734965,-,561
153,NZ_CP072671,1,734404,734965,-,561
153,NZ_CP072668,1,734391,734952,-,561
153,NZ_CP072666,1,734404,734965,-,561
153,NZ_CP090902,1,734556,735117,-,561
153,NZ_CP090948,1,734556,735117,-,561
153,NZ_CP069052,1,1126865,1127426,-,561
153,NZ_CP076228,1,730247,730808,-,561
153,NZ_CP042445,1,734544,735105,-,561
153,NZ_CP042904,1,614000,614561,-,561
153,NC_012416,1,649655,650216,-,561
153,NZ_CP069053,1,575883,576444,-,561
153,NZ_CP042446,1,734556,735117,-,561
153,NZ_CP041215,1,946965,947526,+,561
153,NZ_OX366353,1,109040,109601,+,561
153,NZ_OX366387,1,1516316,1516877,-,561
153,NZ_OX366368,1,1178745,1179306,-,561
153,NZ_OX366379,1,1099211,1099772,-,561
153,NZ_CP091195,1,1520597,1521158,+,561
153,NZ_OX366375,1,1025975,1026536,-,561
153,NZ_CP046925,1,734404,734965,-,561
153,NZ_OX366318,1,1029536,1030097,-,561
153,NZ_OX366319,1,187209,187770,+,561
153,NZ_OX366332,1,1116885,1117446,-,561
153,NZ_CP110359,1,471885,472446,+,561
153,NZ_OU953855,1,236151,236712,+,561
153,NZ_OU953855,1,1453941,1454480,-,539
153,NZ_OX366272,1,1356504,1357065,-,561
153,NZ_OX366347,1,165361,165922,-,561
153,NZ_OU909470,1,1040633,1041182,+,549
153,NZ_OX366363,1,1208758,1209319,+,561
153,NZ_OX366364,1,187636,188197,-,561
153,NZ_OX366359,1,945742,946303,-,561
153,NZ_OX366349,1,936926,937487,-,561
153,NZ_OX366380,1,68054,68603,-,549
153,NZ_OX366344,1,1340310,1340871,+,561
153,NZ_CP090900,1,734556,735117,-,561
153,NZ_OX366352,1,1270234,1270795,+,561
153,NZ_OX366362,1,1061429,1061990,+,561
153,NZ_OX366400,1,891932,892493,-,561
153,NZ_OX366327,1,1030802,1031357,-,555
153,NZ_OX366367,1,1365586,1366147,-,561
153,NZ_CP042444,1,735093,735654,-,561
153,NZ_OX366326,1,1236168,1236729,-,561
153,NZ_CP037426,1,824162,824723,-,561
153,NZ_OX366339,1,847055,847616,-,561
153,NZ_OX366355,1,211480,212041,+,561
153,NZ_CP046922,1,796270,796831,-,561
153,NZ_OX366370,1,176481,177042,+,561
153,NZ_OX366385,1,54741,55290,+,549
153,NZ_OX366399,1,1133839,1134400,-,561
153,NZ_OX366395,1,1346475,1347036,+,561
153,NZ_OX366396,1,1354191,1354752,+,561
153,NZ_OX366351,1,1183417,1183978,-,561
153,NZ_OX366381,1,298070,298631,+,561
153,NZ_OX366342,1,578077,578641,+,564
153,NZ_OX366369,1,1220971,1221532,-,561
153,NZ_OX366356,1,938246,938807,-,561
153,NZ_OX366377,1,1197595,1198156,+,561
153,NZ_OX366388,1,118452,119013,+,561
153,NZ_OX366357,1,1018495,1019056,-,561
153,NZ_CP072012,1,1447315,1447876,+,561
153,NZ_OX366398,1,682037,682598,+,561
153,NC_002978,6,734556,735117,-,561
153,NZ_OX366389,1,1142917,1143478,+,561
153,NZ_OX366397,1,1337996,1338557,-,561
153,NZ_OX366378,1,574917,575478,+,561
153,NZ_CP090903,1,734556,735117,-,561
153,NZ_OX366374,1,61617,62172,-,555
153,NZ_CP090901,1,734556,735117,-,561
153,NZ_CP046923,1,712518,713079,-,561
153,NZ_CP069055,1,733511,734072,-,561
153,NZ_CP072670,1,734396,734957,-,561
153,NZ_CP090899,1,734556,735117,-,561
153,NZ_CP046924,1,733456,734017,-,561
153,NZ_OX366348,1,247881,248436,+,555
153,NZ_CP046921,1,796270,796831,-,561
153,NZ_OX366338,1,315524,316085,-,561
153,NZ_CP054557,1,1074119,1074674,+,555
153,NZ_CP072669,1,734404,734965,-,561
153,NC_021089,1,767417,767978,-,561
152,NZ_OX366376,1,483927,484744,+,817
152,NZ_OX366393,1,307530,308347,+,817
152,NZ_OX366372,1,1099984,1100801,-,817
152,NZ_CP072672,1,735489,736303,-,814
152,NZ_CP069060,1,576942,577756,-,814
152,NZ_CP072667,1,735471,736285,-,814
152,NZ_CP072671,1,735471,736285,-,814
152,NZ_CP072668,1,735458,736272,-,814
152,NZ_CP072666,1,735471,736285,-,814
152,NZ_CP090902,1,735623,736437,-,814
152,NZ_CP090948,1,735623,736437,-,814
152,NZ_CP069052,1,1127932,1128746,-,814
152,NZ_CP076228,1,731314,732128,-,814
152,NZ_CP042445,1,735611,736425,-,814
152,NZ_CP042904,1,615067,615881,-,814
152,NC_012416,1,650722,651536,-,814
152,NZ_CP069053,1,576950,577764,-,814
152,NZ_CP042446,1,735623,736437,-,814
152,NZ_CP041215,1,945645,946459,+,814
152,NZ_OX366353,1,107720,108534,+,814
152,NZ_OX366387,1,718341,719155,+,814
152,NZ_OX366368,1,1179812,1180626,-,814
152,NZ_OX366379,1,1100278,1101092,-,814
152,NZ_CP091195,1,1519277,1520091,+,814
152,NZ_OX366375,1,1027042,1027856,-,814
152,NZ_CP046925,1,735471,736285,-,814
152,NZ_OX366318,1,1030603,1031417,-,814
152,NZ_OX366319,1,185889,186703,+,814
152,NZ_OX366332,1,1117952,1118766,-,814
152,NZ_CP110359,1,470565,471379,+,814
152,NZ_OU953855,1,234831,235645,+,814
152,NZ_OU953855,1,1455047,1455874,-,827
152,NZ_OX366272,1,1357571,1358385,-,814
152,NZ_OX366347,1,166428,167242,-,814
152,NZ_OU909470,1,1039313,1040127,+,814
152,NZ_OX366363,1,1207438,1208252,+,814
152,NZ_OX366364,1,188703,189517,-,814
152,NZ_OX366359,1,946809,947623,-,814
152,NZ_OX366349,1,937990,938807,-,817
152,NZ_OX366380,1,69109,69923,-,814
152,NZ_OX366344,1,1338990,1339807,+,817
152,NZ_CP090900,1,735623,736437,-,814
152,NZ_OX366352,1,1268914,1269728,+,814
152,NZ_OX366362,1,1060109,1060923,+,814
152,NZ_OX366400,1,892999,893813,-,814
152,NZ_OX366327,1,1031869,1032683,-,814
152,NZ_OX366367,1,1366653,1367467,-,814
152,NZ_CP042444,1,736160,736974,-,814
152,NZ_OX366326,1,1237235,1238049,-,814
152,NZ_CP037426,1,825229,826043,-,814
152,NZ_OX366339,1,848122,848936,-,814
152,NZ_OX366355,1,210160,210974,+,814
152,NZ_CP046922,1,797337,798151,-,814
152,NZ_OX366370,1,175161,175978,+,817
152,NZ_OX366385,1,53421,54235,+,814
152,NZ_OX366399,1,1134906,1135720,-,814
152,NZ_OX366395,1,1345155,1345969,+,814
152,NZ_OX366396,1,1352871,1353685,+,814
152,NZ_OX366351,1,1184484,1185298,-,814
152,NZ_OX366381,1,296750,297564,+,814
152,NZ_OX366342,1,576757,577574,+,817
152,NZ_OX366369,1,1222038,1222852,-,814
152,NZ_OX366356,1,939313,940127,-,814
152,NZ_OX366377,1,1196275,1197089,+,814
152,NZ_OX366388,1,117132,117946,+,814
152,NZ_OX366357,1,1019562,1020376,-,814
152,NZ_CP072012,1,1445995,1446809,+,814
152,NZ_OX366398,1,680717,681531,+,814
152,NC_002978,6,735623,736437,-,814
152,NZ_OX366389,1,1141597,1142411,+,814
152,NZ_OX366397,1,1339063,1339877,-,814
152,NZ_OX366378,1,573597,574411,+,814
152,NZ_CP090903,1,735623,736437,-,814
152,NZ_OX366374,1,62684,63498,-,814
152,NZ_CP090901,1,735623,736437,-,814
152,NZ_CP046923,1,713585,714399,-,814
152,NZ_CP069055,1,734578,735392,-,814
152,NZ_CP072670,1,735463,736277,-,814
152,NZ_CP090899,1,735623,736437,-,814
152,NZ_CP046924,1,734523,735337,-,814
152,NZ_OX366348,1,246555,247369,+,814
152,NZ_CP046921,1,797337,798151,-,814
152,NZ_OX366338,1,316591,317405,-,814
152,NZ_CP054557,1,1072793,1073607,+,814
152,NZ_CP072669,1,735471,736285,-,814
152,NC_021089,1,768484,769298,-,814
151,NZ_OX366376,1,480896,481688,+,792
151,NZ_OX366376,1,771651,772443,+,792
151,NZ_OX366376,1,1336701,1337493,+,792
151,NZ_OX366393,1,298934,299726,-,792
151,NZ_OX366393,1,304499,305291,+,792
151,NZ_OX366393,1,730108,730900,+,792
151,NZ_OX366393,1,879528,880320,-,792
151,NZ_OX366372,1,392445,393237,+,792
151,NZ_OX366372,1,787872,788664,-,792
151,NZ_OX366372,1,1103040,1103832,-,792
151,NZ_OX366368,1,545360,546152,+,792
151,NZ_OX366379,1,546405,547197,+,792
151,NZ_OX366367,1,294893,295685,+,792
151,NZ_OX366367,1,534571,535363,-,792
151,NZ_OX366367,1,676083,676875,-,792
151,NZ_OX366367,1,695476,696268,+,792
151,NZ_OX366367,1,797979,798771,+,792
151,NZ_OX366367,1,1177995,1178787,+,792
151,NZ_OX366367,1,1463676,1464468,+,792
151,NZ_OX366367,1,1484408,1485200,+,792
151,NZ_OX366399,1,590728,591520,+,792
151,NZ_OX366399,1,797700,798492,-,792
151,NZ_OX366399,1,1062252,1063044,-,792
151,NZ_OX366342,1,573726,574518,+,792
151,NZ_OX366342,1,687474,688266,+,792
151,NZ_OX366342,1,798867,799659,+,792
151,NZ_OX366342,1,1257037,1257829,-,792
151,NZ_CP072012,1,59213,60005,+,792
151,NZ_OX366338,1,184963,185738,-,775
151,NZ_CP054557,1,309149,309928,-,779
150,NZ_OX366376,1,479833,480574,+,741
150,NZ_OX366376,1,770588,771329,+,741
150,NZ_OX366376,1,1335638,1336379,+,741
150,NZ_OX366393,1,300047,300788,-,741
150,NZ_OX366393,1,303436,304177,+,741
150,NZ_OX366393,1,729045,729786,+,741
150,NZ_OX366393,1,880641,881382,-,741
150,NZ_OX366372,1,391382,392123,+,741
150,NZ_OX366372,1,788985,789726,-,741
150,NZ_OX366372,1,1104153,1104894,-,741
150,NZ_OX366368,1,544297,545038,+,741
150,NZ_OX366379,1,545342,546083,+,741
150,NZ_OX366367,1,293830,294571,+,741
150,NZ_OX366367,1,535684,536425,-,741
150,NZ_OX366367,1,677196,677937,-,741
150,NZ_OX366367,1,694413,695154,+,741
150,NZ_OX366367,1,796916,797657,+,741
150,NZ_OX366367,1,1176932,1177673,+,741
150,NZ_OX366367,1,1462613,1463354,+,741
150,NZ_OX366367,1,1483345,1484086,+,741
150,NZ_OX366399,1,589665,590406,+,741
150,NZ_OX366399,1,798813,799554,-,741
150,NZ_OX366399,1,1063365,1064106,-,741
150,NZ_OX366342,1,572663,573404,+,741
150,NZ_OX366342,1,686411,687152,+,741
150,NZ_OX366342,1,797804,798545,+,741
150,NZ_OX366342,1,1258150,1258891,-,741
150,NZ_CP072012,1,58150,58891,+,741
150,NZ_OX366338,1,186059,186833,-,774
150,NZ_CP054557,1,311116,311857,-,741
149,NZ_OX366376,1,476993,479439,+,2446
149,NZ_OX366393,1,156099,158545,+,2446
149,NZ_OX366372,1,1105289,1107735,-,2446
149,NZ_CP072672,1,77615,80090,-,2475
149,NZ_CP069060,1,88302,90777,-,2475
149,NZ_CP072667,1,77615,80090,-,2475
149,NZ_CP072671,1,77615,80090,-,2475
149,NZ_CP072668,1,77615,80090,-,2475
149,NZ_CP072666,1,77615,80090,-,2475
149,NZ_CP090902,1,77767,80242,-,2475
149,NZ_CP090948,1,77767,80242,-,2475
149,NZ_CP069052,1,149353,151829,+,2476
149,NZ_CP076228,1,82096,84571,-,2475
149,NZ_CP042445,1,77767,80242,-,2475
149,NZ_CP042904,1,162067,164526,+,2459
149,NC_012416,1,164649,167108,+,2459
149,NZ_CP069053,1,456499,458975,+,2476
149,NZ_CP042446,1,77767,80242,-,2475
149,NZ_CP041215,1,515877,518336,+,2459
149,NZ_OX366353,1,451589,454048,+,2459
149,NZ_OX366387,1,763894,766370,+,2476
149,NZ_OX366368,1,358866,361341,-,2475
149,NZ_OX366379,1,359884,362359,-,2475
149,NZ_CP091195,1,985281,987756,-,2475
149,NZ_OX366375,1,453384,455860,+,2476
149,NZ_CP046925,1,77615,80090,-,2475
149,NZ_OX366318,1,539232,541708,+,2476
149,NZ_OX366319,1,719006,721464,-,2458
149,NZ_OX366332,1,437828,440287,+,2459
149,NZ_CP110359,1,1078549,1081007,-,2458
149,NZ_OU953855,1,900468,902927,+,2459
149,NZ_OX366272,1,304186,306645,+,2459
149,NZ_OX366347,1,551584,554042,+,2458
149,NZ_OU909470,1,895434,897871,-,2437
149,NZ_OX366363,1,477799,480257,-,2458
149,NZ_OX366364,1,384992,387437,+,2445
149,NZ_OX366359,1,341044,343502,-,2458
149,NZ_OX366349,1,654963,657409,+,2446
149,NZ_OX366380,1,883251,885681,+,2430
149,NZ_OX366344,1,350162,352617,+,2455
149,NZ_CP090900,1,77767,80242,-,2475
149,NZ_OX366352,1,397326,399785,+,2459
149,NZ_OX366362,1,571331,573783,-,2452
149,NZ_OX366400,1,718838,721313,-,2475
149,NZ_OX366327,1,587701,590160,+,2459
149,NZ_OX366367,1,1074614,1077043,+,2429
149,NZ_CP042444,1,77768,80243,-,2475
149,NZ_OX366326,1,631034,633510,+,2476
149,NZ_CP037426,1,712720,715195,-,2475
149,NZ_OX366339,1,252485,254952,+,2467
149,NZ_OX366355,1,865180,867638,-,2458
149,NZ_CP046922,1,77601,80076,-,2475
149,NZ_OX366370,1,444147,446589,-,2442
149,NZ_OX366385,1,1010765,1013195,-,2430
149,NZ_OX366399,1,358368,360843,-,2475
149,NZ_OX366395,1,1483109,1485568,+,2459
149,NZ_OX366396,1,1279454,1281921,+,2467
149,NZ_OX366351,1,455728,458204,+,2476
149,NZ_OX366381,1,1026649,1029107,-,2458
149,NZ_OX366342,1,683571,686017,+,2446
149,NZ_OX366369,1,439417,441876,+,2459
149,NZ_OX366356,1,459906,462365,+,2459
149,NZ_OX366377,1,542491,544967,+,2476
149,NZ_OX366388,1,1273094,1275570,+,2476
149,NZ_OX366357,1,432882,435350,-,2468
149,NZ_CP072012,1,956610,959086,+,2476
149,NZ_OX366398,1,1015497,1017972,-,2475
149,NC_002978,6,77767,80242,-,2475
149,NZ_OX366389,1,421735,424210,-,2475
149,NZ_OX366397,1,676920,679378,-,2458
149,NZ_OX366378,1,851333,853809,+,2476
149,NZ_CP090903,1,77767,80242,-,2475
149,NZ_OX366374,1,982138,984596,-,2458
149,NZ_CP090901,1,77767,80242,-,2475
149,NZ_CP046923,1,77601,80076,-,2475
149,NZ_CP069055,1,145121,147597,+,2476
149,NZ_CP072670,1,77615,80090,-,2475
149,NZ_CP090899,1,77767,80242,-,2475
149,NZ_CP046924,1,77601,80076,-,2475
149,NZ_OX366348,1,812990,815465,-,2475
149,NZ_CP046921,1,77601,80076,-,2475
149,NZ_OX366338,1,1368656,1371114,-,2458
149,NZ_CP054557,1,1164899,1167375,+,2476
149,NZ_CP072669,1,77615,80090,-,2475
149,NC_021089,1,157171,159630,+,2459
148,NZ_OX366376,1,474601,475560,+,959
148,NZ_OX366393,1,151800,152751,+,951
148,NZ_OX366372,1,1109035,1109994,-,959
148,NZ_CP072672,1,526565,527524,+,959
148,NZ_CP069060,1,1264989,1265948,+,959
148,NZ_CP072667,1,526547,527506,+,959
148,NZ_CP072671,1,526547,527506,+,959
148,NZ_CP072668,1,526534,527493,+,959
148,NZ_CP072666,1,526547,527506,+,959
148,NZ_CP090902,1,526699,527658,+,959
148,NZ_CP090948,1,526699,527658,+,959
148,NZ_CP069052,1,507424,508383,+,959
148,NZ_CP076228,1,337013,337972,+,959
148,NZ_CP042445,1,526687,527646,+,959
148,NZ_CP042904,1,378864,379823,+,959
148,NC_012416,1,379954,380913,+,959
148,NZ_CP069053,1,1167533,1168492,-,959
148,NZ_CP042446,1,526699,527658,+,959
148,NZ_CP041215,1,1129309,1130265,-,956
148,NZ_OX366353,1,44523,45479,-,956
148,NZ_OX366387,1,1077684,1078643,+,959
148,NZ_OX366368,1,535599,536558,-,959
148,NZ_OX366379,1,536644,537603,-,959
148,NZ_CP091195,1,644185,645144,+,959
148,NZ_OX366375,1,687963,688922,-,959
148,NZ_CP046925,1,526547,527506,+,959
148,NZ_OX366318,1,639412,640371,-,959
148,NZ_OX366319,1,651362,652321,+,959
148,NZ_OX366332,1,759985,760941,-,956
148,NZ_CP110359,1,982521,983480,+,959
148,NZ_OU953855,1,353422,354381,+,959
148,NZ_OU953855,1,1384203,1385143,-,940
148,NZ_OX366272,1,554643,555602,+,959
148,NZ_OX366347,1,650846,651805,-,959
148,NZ_OU909470,1,848669,849628,-,959
148,NZ_OX366363,1,274985,275944,+,959
148,NZ_OX366364,1,433082,434041,+,959
148,NZ_OX366359,1,526752,527708,-,956
148,NZ_OX366349,1,649230,650189,+,959
148,NZ_OX366380,1,898021,898980,-,959
148,NZ_OX366344,1,347904,348863,+,959
148,NZ_CP090900,1,526699,527658,+,959
148,NZ_OX366352,1,973419,974375,+,956
148,NZ_OX366362,1,574612,575571,-,959
148,NZ_OX366400,1,611981,612940,+,959
148,NZ_OX366327,1,688458,689417,-,959
148,NZ_OX366367,1,1072475,1073434,+,959
148,NZ_CP042444,1,527236,528195,+,959
148,NZ_OX366326,1,734236,735195,-,959
148,NZ_CP037426,1,343094,344053,+,959
148,NZ_OX366339,1,363544,364503,-,959
148,NZ_OX366355,1,718476,719435,+,959
148,NZ_CP046922,1,588215,589174,+,959
148,NZ_OX366370,1,125465,126424,+,959
148,NZ_OX366385,1,965438,966397,+,959
148,NZ_OX366399,1,535136,536095,-,959
148,NZ_OX366395,1,676814,677757,-,943
148,NZ_OX366396,1,816883,817842,+,959
148,NZ_OX366351,1,556069,557028,-,959
148,NZ_OX366381,1,925927,926886,+,959
148,NZ_OX366342,1,681528,682487,+,959
148,NZ_OX366369,1,830047,831006,+,959
148,NZ_OX366356,1,741830,742789,+,959
148,NZ_OX366377,1,644761,645720,-,959
148,NZ_OX366388,1,726007,726966,+,959
148,NZ_OX366357,1,801816,802775,+,959
148,NZ_CP072012,1,457908,458867,-,959
148,NZ_OX366398,1,1196438,1197397,-,959
148,NC_002978,6,526699,527658,+,959
148,NZ_OX366389,1,714179,715138,-,959
148,NZ_OX366397,1,777691,778647,-,956
148,NZ_OX366378,1,709699,710658,-,959
148,NZ_CP090903,1,526699,527658,+,959
148,NZ_OX366374,1,861854,862813,+,959
148,NZ_CP090901,1,526699,527658,+,959
148,NZ_CP046923,1,504463,505422,+,959
148,NZ_CP069055,1,543404,544363,+,959
148,NZ_CP072670,1,526539,527498,+,959
148,NZ_CP090899,1,526699,527658,+,959
148,NZ_CP046924,1,525401,526360,+,959
148,NZ_OX366348,1,715154,716113,+,959
148,NZ_CP046921,1,588215,589174,+,959
148,NZ_OX366338,1,818845,819804,-,959
148,NZ_CP054557,1,1263810,1264769,-,959
148,NZ_CP072669,1,526547,527506,+,959
148,NC_021089,1,517620,518576,+,956
147,NZ_OX366376,1,471405,473051,+,1646
147,NZ_OX366393,1,148596,150242,+,1646
147,NZ_OX366372,1,1111591,1113261,-,1670
147,NZ_CP072672,1,87292,88925,+,1633
147,NZ_CP069060,1,97981,99614,+,1633
147,NZ_CP072667,1,87292,88925,+,1633
147,NZ_CP072671,1,87292,88925,+,1633
147,NZ_CP072668,1,87292,88925,+,1633
147,NZ_CP072666,1,87292,88925,+,1633
147,NZ_CP090902,1,87444,89077,+,1633
147,NZ_CP090948,1,87444,89077,+,1633
147,NZ_CP069052,1,140517,142150,-,1633
147,NZ_CP076228,1,91771,93403,+,1632
147,NZ_CP042445,1,87444,89077,+,1633
147,NZ_CP042904,1,153172,154814,-,1642
147,NC_012416,1,155754,157396,-,1642
147,NZ_CP069053,1,447663,449296,-,1633
147,NZ_CP042446,1,87444,89077,+,1633
147,NZ_CP041215,1,506898,508524,-,1626
147,NZ_OX366353,1,442615,444233,-,1618
147,NZ_OX366387,1,671117,672726,-,1609
147,NZ_OX366368,1,368545,370178,+,1633
147,NZ_OX366379,1,369563,371196,+,1633
147,NZ_CP091195,1,996539,998228,+,1689
147,NZ_OX366375,1,443486,445107,-,1621
147,NZ_CP046925,1,87292,88925,+,1633
147,NZ_OX366318,1,530249,531870,-,1621
147,NZ_OX366319,1,729509,731129,+,1620
147,NZ_OX366332,1,428832,430475,-,1643
147,NZ_CP110359,1,1088142,1089763,+,1621
147,NZ_OU953855,1,1580459,1582151,+,1692
147,NZ_OX366272,1,595897,597517,-,1620
147,NZ_OX366347,1,542513,544156,-,1643
147,NZ_OU909470,1,851145,852825,-,1680
147,NZ_OX366363,1,487902,489528,+,1626
147,NZ_OX366364,1,1003578,1005250,+,1672
147,NZ_OX366359,1,350856,352482,+,1626
147,NZ_OX366349,1,643720,645366,+,1646
147,NZ_OX366380,1,715402,717082,-,1680
147,NZ_OX366344,1,344865,346511,+,1646
147,NZ_CP090900,1,87444,89077,+,1633
147,NZ_OX366352,1,388330,389973,-,1643
147,NZ_OX366362,1,797864,799490,+,1626
147,NZ_OX366400,1,728676,730297,+,1621
147,NZ_OX366327,1,578795,580437,-,1642
147,NZ_OX366367,1,549690,551362,-,1672
147,NZ_CP042444,1,87445,89078,+,1633
147,NZ_OX366326,1,360486,362107,+,1621
147,NZ_CP037426,1,722552,724173,+,1621
147,NZ_OX366339,1,242406,244112,-,1706
147,NZ_OX366355,1,874756,876376,+,1620
147,NZ_CP046922,1,87278,88911,+,1633
147,NZ_OX366370,1,121957,123616,+,1659
147,NZ_OX366385,1,1056324,1058004,+,1680
147,NZ_OX366399,1,368047,369680,+,1633
147,NZ_OX366395,1,1473573,1475199,-,1626
147,NZ_OX366396,1,1289415,1291121,-,1706
147,NZ_OX366351,1,444942,446563,-,1621
147,NZ_OX366381,1,1036225,1037845,+,1620
147,NZ_OX366342,1,678403,680049,+,1646
147,NZ_OX366369,1,429004,430624,-,1620
147,NZ_OX366356,1,451446,453042,-,1596
147,NZ_OX366377,1,533517,535138,-,1621
147,NZ_OX366388,1,1360080,1361785,-,1705
147,NZ_OX366357,1,536956,538579,-,1623
147,NZ_CP072012,1,947774,949407,-,1633
147,NZ_OX366398,1,1025326,1026947,+,1621
147,NC_002978,6,87444,89077,+,1633
147,NZ_OX366389,1,533357,534978,+,1621
147,NZ_OX366397,1,422922,424565,+,1643
147,NZ_OX366378,1,840862,842551,-,1689
147,NZ_CP090903,1,87444,89077,+,1633
147,NZ_OX366374,1,999962,1001588,-,1626
147,NZ_CP090901,1,87444,89077,+,1633
147,NZ_CP046923,1,87278,88911,+,1633
147,NZ_CP069055,1,136286,137919,-,1633
147,NZ_CP072670,1,87292,88925,+,1633
147,NZ_CP090899,1,87444,89077,+,1633
147,NZ_CP046924,1,87278,88911,+,1633
147,NZ_OX366348,1,822815,824457,+,1642
147,NZ_CP046921,1,87278,88911,+,1633
147,NZ_OX366338,1,1379700,1381326,+,1626
147,NZ_CP054557,1,1154149,1155792,-,1643
147,NZ_CP072669,1,87292,88925,+,1633
147,NC_021089,1,148192,149818,-,1626
146,NZ_OX366376,1,469042,469652,+,610
146,NZ_OX366393,1,146233,146843,+,610
146,NZ_OX366372,1,1115013,1115624,-,611
146,NZ_CP072672,1,85011,85621,+,610
146,NZ_CP069060,1,95698,96308,+,610
146,NZ_CP072667,1,85011,85621,+,610
146,NZ_CP072671,1,85011,85621,+,610
146,NZ_CP072668,1,85011,85621,+,610
146,NZ_CP072666,1,85011,85621,+,610
146,NZ_CP090902,1,85163,85773,+,610
146,NZ_CP090948,1,85163,85773,+,610
146,NZ_CP069052,1,143822,144433,-,611
146,NZ_CP076228,1,89489,90099,+,610
146,NZ_CP042445,1,85163,85773,+,610
146,NZ_CP042904,1,156474,157087,-,613
146,NC_012416,1,159056,159669,-,613
146,NZ_CP069053,1,450968,451579,-,611
146,NZ_CP042446,1,85163,85773,+,610
146,NZ_CP041215,1,510196,510807,-,611
146,NZ_OX366353,1,445913,446524,-,611
146,NZ_OX366387,1,1430390,1431000,+,610
146,NZ_OX366368,1,366262,366872,+,610
146,NZ_OX366379,1,367280,367890,+,610
146,NZ_CP091195,1,993110,993720,+,610
146,NZ_OX366375,1,446791,447402,-,611
146,NZ_CP046925,1,85011,85621,+,610
146,NZ_OX366318,1,533563,534174,-,611
146,NZ_OX366319,1,727570,728180,+,610
146,NZ_OX366332,1,432147,432758,-,611
146,NZ_CP110359,1,1085847,1086457,+,610
146,NZ_OU953855,1,1577952,1578562,+,610
146,NZ_OX366272,1,599201,599812,-,611
146,NZ_OX366347,1,545827,546438,-,611
146,NZ_OU909470,1,853954,854565,-,611
146,NZ_OX366363,1,485620,486230,+,610
146,NZ_OX366364,1,999973,1000583,+,610
146,NZ_OX366359,1,348573,349183,+,610
146,NZ_OX366349,1,639991,640601,+,610
146,NZ_OX366380,1,426349,426959,+,610
146,NZ_OX366344,1,342463,343073,+,610
146,NZ_CP090900,1,85163,85773,+,610
146,NZ_OX366352,1,391645,392256,-,611
146,NZ_OX366362,1,796033,796643,+,610
146,NZ_OX366400,1,726372,726982,+,610
146,NZ_OX366327,1,582109,582720,-,611
146,NZ_OX366367,1,553808,554419,-,611
146,NZ_CP042444,1,85164,85774,+,610
146,NZ_OX366326,1,625371,625976,-,605
146,NZ_CP037426,1,720257,720867,+,610
146,NZ_OX366339,1,246010,246621,-,611
146,NZ_OX366355,1,872817,873427,+,610
146,NZ_CP046922,1,84997,85607,+,610
146,NZ_OX366370,1,120305,120915,+,610
146,NZ_OX366385,1,147317,147927,+,610
146,NZ_OX366399,1,365764,366374,+,610
146,NZ_OX366395,1,1476870,1477481,-,611
146,NZ_OX366396,1,1294646,1295257,-,611
146,NZ_OX366351,1,449113,449718,-,605
146,NZ_OX366381,1,1034286,1034896,+,610
146,NZ_OX366342,1,676040,676650,+,610
146,NZ_OX366369,1,431952,432563,-,611
146,NZ_OX366356,1,454161,454772,-,611
146,NZ_OX366377,1,536822,537433,-,611
146,NZ_OX366388,1,1363684,1364295,-,611
146,NZ_OX366357,1,540479,541089,-,610
146,NZ_CP072012,1,951079,951690,-,611
146,NZ_OX366398,1,1023031,1023641,+,610
146,NC_002978,6,85163,85773,+,610
146,NZ_OX366389,1,531062,531672,+,610
146,NZ_OX366397,1,420639,421249,+,610
146,NZ_OX366378,1,845369,845980,-,611
146,NZ_CP090903,1,85163,85773,+,610
146,NZ_CP090901,1,85163,85773,+,610
146,NZ_CP046923,1,84997,85607,+,610
146,NZ_CP069055,1,139591,140201,-,610
146,NZ_CP072670,1,85011,85621,+,610
146,NZ_CP090899,1,85163,85773,+,610
146,NZ_CP046924,1,84997,85607,+,610
146,NZ_OX366348,1,820533,821143,+,610
146,NZ_CP046921,1,84997,85607,+,610
146,NZ_OX366338,1,1377951,1378561,+,610
146,NZ_CP054557,1,1157463,1158032,-,569
146,NZ_CP072669,1,85011,85621,+,610
146,NC_021089,1,151490,152101,-,611
145,NZ_OX366376,1,466715,468426,+,1711
145,NZ_OX366393,1,143906,145617,+,1711
145,NZ_OX366372,1,1116240,1117947,-,1707
145,NZ_CP072672,1,82751,84541,+,1790
145,NZ_CP069060,1,93438,95228,+,1790
145,NZ_CP072667,1,82751,84541,+,1790
145,NZ_CP072671,1,82751,84541,+,1790
145,NZ_CP072668,1,82751,84541,+,1790
145,NZ_CP072666,1,82751,84541,+,1790
145,NZ_CP090902,1,82903,84693,+,1790
145,NZ_CP090948,1,82903,84693,+,1790
145,NZ_CP069052,1,144903,146693,-,1790
145,NZ_CP076228,1,87229,89019,+,1790
145,NZ_CP042445,1,82903,84693,+,1790
145,NZ_CP042904,1,157696,159407,-,1711
145,NC_012416,1,160278,161989,-,1711
145,NZ_CP069053,1,452049,453839,-,1790
145,NZ_CP042446,1,82903,84693,+,1790
145,NZ_CP041215,1,511426,513216,-,1790
145,NZ_OX366353,1,447142,448929,-,1787
145,NZ_OX366387,1,1428130,1429920,+,1790
145,NZ_OX366368,1,364002,365792,+,1790
145,NZ_OX366379,1,365020,366810,+,1790
145,NZ_CP091195,1,990964,992640,+,1676
145,NZ_OX366375,1,448932,450724,-,1792
145,NZ_CP046925,1,82751,84541,+,1790
145,NZ_OX366318,1,534783,536573,-,1790
145,NZ_OX366319,1,725052,726842,+,1790
145,NZ_OX366332,1,433377,435167,-,1790
145,NZ_CP110359,1,1083669,1085377,+,1708
145,NZ_OU953855,1,1575700,1577482,+,1782
145,NZ_OX366272,1,600282,601990,-,1708
145,NZ_OX366347,1,547133,548923,-,1790
145,NZ_OU909470,1,855292,857082,-,1790
145,NZ_OX366363,1,483464,485150,+,1686
145,NZ_OX366364,1,997537,999229,+,1692
145,NZ_OX366359,1,346164,347954,+,1790
145,NZ_OX366349,1,637664,639375,+,1711
145,NZ_OX366380,1,424019,425730,+,1711
145,NZ_OX366344,1,340136,341847,+,1711
145,NZ_CP090900,1,82903,84693,+,1790
145,NZ_OX366352,1,392875,394665,-,1790
145,NZ_OX366362,1,793613,795294,+,1681
145,NZ_OX366400,1,723973,725763,+,1790
145,NZ_OX366327,1,583329,585040,-,1711
145,NZ_OX366367,1,555175,556856,-,1681
145,NZ_CP042444,1,82904,84694,+,1790
145,NZ_OX366326,1,626585,628375,-,1790
145,NZ_CP037426,1,717856,719648,+,1792
145,NZ_OX366339,1,247091,248881,-,1790
145,NZ_OX366355,1,870299,872089,+,1790
145,NZ_CP046922,1,82737,84527,+,1790
145,NZ_OX366370,1,117850,119561,+,1711
145,NZ_OX366385,1,144260,145971,+,1711
145,NZ_OX366399,1,363504,365294,+,1790
145,NZ_OX366395,1,1478225,1479917,-,1692
145,NZ_OX366396,1,1295727,1297517,-,1790
145,NZ_OX366351,1,450327,452117,-,1790
145,NZ_OX366381,1,1031768,1033558,+,1790
145,NZ_OX366342,1,673713,675424,+,1711
145,NZ_OX366369,1,434129,435919,-,1790
145,NZ_OX366356,1,455345,457135,-,1790
145,NZ_OX366377,1,538042,539832,-,1790
145,NZ_OX366388,1,1366312,1367988,-,1676
145,NZ_OX366357,1,541566,543356,-,1790
145,NZ_CP072012,1,952160,953950,-,1790
145,NZ_OX366398,1,1020632,1022422,+,1790
145,NC_002978,6,82903,84693,+,1790
145,NZ_OX366389,1,528663,530453,+,1790
145,NZ_OX366397,1,418230,420020,+,1790
145,NZ_OX366378,1,846450,848126,-,1676
145,NZ_CP090903,1,82903,84693,+,1790
145,NZ_OX366374,1,988972,990657,+,1685
145,NZ_CP090901,1,82903,84693,+,1790
145,NZ_CP046923,1,82737,84527,+,1790
145,NZ_CP069055,1,140671,142461,-,1790
145,NZ_CP072670,1,82751,84541,+,1790
145,NZ_CP090899,1,82903,84693,+,1790
145,NZ_CP046924,1,82737,84527,+,1790
145,NZ_OX366348,1,818126,819916,+,1790
145,NZ_CP046921,1,82737,84527,+,1790
145,NZ_OX366338,1,1374673,1376361,+,1688
145,NZ_CP054557,1,1159595,1161385,-,1790
145,NZ_CP072669,1,82751,84541,+,1790
145,NC_021089,1,152720,154510,-,1790
144,NZ_OX366376,1,465203,466682,+,1479
144,NZ_OX366393,1,142394,143873,+,1479
144,NZ_OX366372,1,1117984,1119463,-,1479
144,NZ_CP072672,1,81239,82718,+,1479
144,NZ_CP069060,1,91926,93405,+,1479
144,NZ_CP072667,1,81239,82718,+,1479
144,NZ_CP072671,1,81239,82718,+,1479
144,NZ_CP072668,1,81239,82718,+,1479
144,NZ_CP072666,1,81239,82718,+,1479
144,NZ_CP090902,1,81391,82870,+,1479
144,NZ_CP090948,1,81391,82870,+,1479
144,NZ_CP069052,1,146726,148205,-,1479
144,NZ_CP076228,1,85717,87196,+,1479
144,NZ_CP042445,1,81391,82870,+,1479
144,NZ_CP042904,1,159440,160919,-,1479
144,NC_012416,1,162022,163501,-,1479
144,NZ_CP069053,1,453872,455351,-,1479
144,NZ_CP042446,1,81391,82870,+,1479
144,NZ_CP041215,1,513249,514728,-,1479
144,NZ_OX366353,1,448962,450441,-,1479
144,NZ_OX366387,1,1426618,1428097,+,1479
144,NZ_OX366368,1,362490,363969,+,1479
144,NZ_OX366379,1,363508,364987,+,1479
144,NZ_CP091195,1,988906,990383,+,1477
144,NZ_OX366375,1,450757,452236,-,1479
144,NZ_CP046925,1,81239,82718,+,1479
144,NZ_OX366318,1,536606,538085,-,1479
144,NZ_OX366319,1,723540,725019,+,1479
144,NZ_OX366332,1,435200,436679,-,1479
144,NZ_CP110359,1,1082157,1083636,+,1479
144,NZ_OU953855,1,1574188,1575667,+,1479
144,NZ_OX366272,1,602023,603502,-,1479
144,NZ_OX366347,1,548956,550435,-,1479
144,NZ_OU909470,1,857115,858591,-,1476
144,NZ_OX366363,1,481406,482883,+,1477
144,NZ_OX366364,1,1005514,1006993,-,1479
144,NZ_OX366359,1,344652,346131,+,1479
144,NZ_OX366349,1,636152,637631,+,1479
144,NZ_OX366380,1,422507,423986,+,1479
144,NZ_OX366344,1,338624,340103,+,1479
144,NZ_CP090900,1,81391,82870,+,1479
144,NZ_OX366352,1,394700,396177,-,1477
144,NZ_OX366362,1,791620,793099,+,1479
144,NZ_OX366400,1,722461,723940,+,1479
144,NZ_OX366327,1,585073,586552,-,1479
144,NZ_OX366367,1,547947,549426,+,1479
144,NZ_CP042444,1,81392,82871,+,1479
144,NZ_OX366326,1,628408,629887,-,1479
144,NZ_CP037426,1,716344,717823,+,1479
144,NZ_OX366339,1,248914,250393,-,1479
144,NZ_OX366355,1,868787,870266,+,1479
144,NZ_CP046922,1,81225,82704,+,1479
144,NZ_OX366370,1,116338,117817,+,1479
144,NZ_OX366385,1,142748,144227,+,1479
144,NZ_OX366399,1,361992,363471,+,1479
144,NZ_OX366395,1,1480484,1481961,-,1477
144,NZ_OX366396,1,1297550,1299029,-,1479
144,NZ_OX366351,1,452150,453629,-,1479
144,NZ_OX366381,1,1030256,1031735,+,1479
144,NZ_OX366342,1,672202,673678,+,1476
144,NZ_OX366369,1,435952,437431,-,1479
144,NZ_OX366356,1,457168,458647,-,1479
144,NZ_OX366377,1,539865,541344,-,1479
144,NZ_OX366388,1,1436327,1437804,-,1477
144,NZ_OX366357,1,543390,544867,-,1477
144,NZ_CP072012,1,953983,955462,-,1479
144,NZ_OX366398,1,1019120,1020599,+,1479
144,NC_002978,6,81391,82870,+,1479
144,NZ_OX366389,1,527151,528630,+,1479
144,NZ_OX366397,1,416718,418197,+,1479
144,NZ_OX366378,1,848707,850184,-,1477
144,NZ_CP090903,1,81391,82870,+,1479
144,NZ_OX366374,1,986068,987545,+,1477
144,NZ_CP090901,1,81391,82870,+,1479
144,NZ_CP046923,1,81225,82704,+,1479
144,NZ_CP069055,1,142494,143973,-,1479
144,NZ_CP072670,1,81239,82718,+,1479
144,NZ_CP090899,1,81391,82870,+,1479
144,NZ_CP046924,1,81225,82704,+,1479
144,NZ_OX366348,1,816614,818093,+,1479
144,NZ_CP046921,1,81225,82704,+,1479
144,NZ_OX366338,1,1372692,1374171,+,1479
144,NZ_CP054557,1,1161418,1162897,-,1479
144,NZ_CP072669,1,81239,82718,+,1479
144,NC_021089,1,154543,156022,-,1479
143,NZ_OX366376,1,464531,465142,+,611
143,NZ_OX366393,1,141719,142333,+,614
143,NZ_OX366372,1,1119524,1120138,-,614
143,NZ_CP072672,1,538324,538954,-,630
143,NZ_CP069060,1,1274749,1275379,-,630
143,NZ_CP072667,1,538306,538936,-,630
143,NZ_CP072671,1,538306,538936,-,630
143,NZ_CP072668,1,538293,538923,-,630
143,NZ_CP072666,1,538306,538936,-,630
143,NZ_CP090902,1,538458,539088,-,630
143,NZ_CP090948,1,538458,539088,-,630
143,NZ_CP069052,1,518103,518733,-,630
143,NZ_CP076228,1,500851,501481,-,630
143,NZ_CP042445,1,538446,539076,-,630
143,NZ_CP042904,1,392022,392652,-,630
143,NC_012416,1,394602,395232,-,630
143,NZ_CP069053,1,1158102,1158732,+,630
143,NZ_CP042446,1,538458,539088,-,630
143,NZ_CP041215,1,1119188,1119818,+,630
143,NZ_OX366353,1,34817,35447,+,630
143,NZ_OX366387,1,1025391,1026021,+,630
143,NZ_OX366368,1,524764,525394,+,630
143,NZ_OX366379,1,525809,526439,+,630
143,NZ_CP091195,1,655916,656546,-,630
143,NZ_OX366375,1,675830,676460,+,630
143,NZ_CP046925,1,538306,538936,-,630
143,NZ_OX366318,1,628353,628983,+,630
143,NZ_OX366319,1,662852,663482,-,630
143,NZ_OX366332,1,749805,750435,+,630
143,NZ_CP110359,1,994411,995041,-,630
143,NZ_OU953855,1,706463,707093,+,630
143,NZ_OX366272,1,697782,698412,-,630
143,NZ_OX366347,1,639742,640372,+,630
143,NZ_OU909470,1,858652,859269,-,617
143,NZ_OX366363,1,287088,287718,-,630
143,NZ_OX366364,1,1007054,1007663,-,609
143,NZ_OX366359,1,516530,517160,+,630
143,NZ_OX366349,1,635477,636091,+,614
143,NZ_OX366380,1,421829,422446,+,617
143,NZ_OX366344,1,337949,338563,+,614
143,NZ_CP090900,1,538458,539088,-,630
143,NZ_OX366352,1,984533,985163,-,630
143,NZ_OX366362,1,790942,791559,+,617
143,NZ_OX366400,1,621594,622224,-,630
143,NZ_OX366327,1,677908,678538,+,630
143,NZ_OX366367,1,547276,547886,+,610
143,NZ_CP042444,1,538995,539625,-,630
143,NZ_OX366326,1,722326,722956,+,630
143,NZ_CP037426,1,245259,245889,-,630
143,NZ_OX366339,1,353373,354003,+,630
143,NZ_OX366355,1,774632,775262,-,630
143,NZ_CP046922,1,600172,600802,-,630
143,NZ_OX366370,1,115663,116277,+,614
143,NZ_OX366385,1,142070,142687,+,617
143,NZ_OX366399,1,524301,524931,+,630
143,NZ_OX366395,1,231043,231673,+,630
143,NZ_OX366396,1,1007210,1007840,+,630
143,NZ_OX366351,1,544159,544789,+,630
143,NZ_OX366381,1,937417,938047,-,630
143,NZ_OX366342,1,671527,672141,+,614
143,NZ_OX366369,1,1110122,1110752,-,630
143,NZ_OX366356,1,751930,752560,-,630
143,NZ_OX366377,1,633725,634355,+,630
143,NZ_OX366388,1,738766,739396,-,630
143,NZ_OX366357,1,1129746,1130370,+,624
143,NZ_CP072012,1,447073,447703,+,630
143,NZ_OX366398,1,1185402,1186032,+,630
143,NC_002978,6,538458,539088,-,630
143,NZ_OX366389,1,701892,702522,+,630
143,NZ_OX366397,1,766279,766909,+,630
143,NZ_OX366378,1,746528,747158,-,630
143,NZ_CP090903,1,538458,539088,-,630
143,NZ_OX366374,1,874918,875532,-,614
143,NZ_CP090901,1,538458,539088,-,630
143,NZ_CP046923,1,516420,517050,-,630
143,NZ_CP069055,1,244270,244900,+,630
143,NZ_CP072670,1,538298,538928,-,630
143,NZ_CP090899,1,538458,539088,-,630
143,NZ_CP046924,1,537358,537988,-,630
143,NZ_OX366348,1,726918,727548,-,630
143,NZ_CP046921,1,600172,600802,-,630
143,NZ_OX366338,1,785595,786225,-,630
143,NZ_CP054557,1,1252446,1253076,+,630
143,NZ_CP072669,1,538306,538936,-,630
143,NC_021089,1,527467,528097,-,630
142,NZ_OX366376,1,460606,464357,+,3751
142,NZ_OX366393,1,137797,141548,+,3751
142,NZ_OX366372,1,1120309,1124059,-,3750
142,NZ_CP072672,1,185602,189330,+,3728
142,NZ_CP069060,1,195960,199688,+,3728
142,NZ_CP072667,1,185584,189312,+,3728
142,NZ_CP072671,1,185584,189312,+,3728
142,NZ_CP072668,1,185584,189312,+,3728
142,NZ_CP072666,1,185584,189312,+,3728
142,NZ_CP090902,1,185736,189464,+,3728
142,NZ_CP090948,1,185736,189464,+,3728
142,NZ_CP069052,1,190625,194353,+,3728
142,NZ_CP076228,1,188970,192698,+,3728
142,NZ_CP042445,1,185736,189464,+,3728
142,NZ_CP042904,1,190745,194440,+,3695
142,NC_012416,1,193327,197022,+,3695
142,NZ_CP069053,1,347589,351317,-,3728
142,NZ_CP042446,1,185736,189464,+,3728
142,NZ_CP041215,1,542758,546486,+,3728
142,NZ_OX366353,1,506532,510260,-,3728
142,NZ_OX366387,1,1421237,1424965,+,3728
142,NZ_OX366368,1,464739,468467,+,3728
142,NZ_OX366379,1,465757,469485,+,3728
142,NZ_CP091195,1,1459873,1463601,+,3728
142,NZ_OX366375,1,558429,562158,+,3729
142,NZ_CP046925,1,185584,189312,+,3728
142,NZ_OX366318,1,565769,569498,+,3729
142,NZ_OX366319,1,692108,695815,-,3707
142,NZ_OX366332,1,463860,467588,+,3728
142,NZ_CP110359,1,1052129,1055837,-,3708
142,NZ_OU953855,1,135915,139644,-,3729
142,NZ_OX366272,1,760119,763849,-,3730
142,NZ_OX366347,1,579119,582848,+,3729
142,NZ_OU909470,1,859684,863390,-,3706
142,NZ_OX366363,1,451406,455135,-,3729
142,NZ_OX366364,1,1007909,1011669,-,3760
142,NZ_OX366359,1,461971,465700,+,3729
142,NZ_OX366349,1,631546,635306,+,3760
142,NZ_OX366380,1,417708,421414,+,3706
142,NZ_OX366344,1,334018,337778,+,3760
142,NZ_CP090900,1,185736,189464,+,3728
142,NZ_OX366352,1,662672,666400,-,3728
142,NZ_OX366362,1,787004,790671,+,3667
142,NZ_OX366400,1,691392,695121,-,3729
142,NZ_OX366327,1,614534,618263,+,3729
142,NZ_OX366367,1,543271,547031,+,3760
142,NZ_CP042444,1,185674,189402,+,3728
142,NZ_OX366326,1,657571,661300,+,3729
142,NZ_CP037426,1,684409,688139,-,3730
142,NZ_OX366339,1,280758,284487,+,3729
142,NZ_OX366355,1,837970,841677,-,3707
142,NZ_CP046922,1,185434,189162,+,3728
142,NZ_OX366370,1,111753,115396,+,3643
142,NZ_OX366385,1,137949,141655,+,3706
142,NZ_OX366399,1,464250,467978,+,3728
142,NZ_OX366395,1,1027726,1031455,-,3729
142,NZ_OX366396,1,845338,849067,+,3729
142,NZ_OX366351,1,482265,485994,+,3729
142,NZ_OX366381,1,999439,1003146,-,3707
142,NZ_OX366342,1,667606,671356,+,3750
142,NZ_OX366369,1,465197,468904,+,3707
142,NZ_OX366356,1,810559,814288,-,3729
142,NZ_OX366377,1,570146,573875,+,3729
142,NZ_OX366388,1,815286,819015,-,3729
142,NZ_OX366357,1,29570,33298,+,3728
142,NZ_CP072012,1,387029,390757,+,3728
142,NZ_OX366398,1,1124392,1128121,+,3729
142,NC_002978,6,185736,189464,+,3728
142,NZ_OX366389,1,636729,640458,+,3729
142,NZ_OX366397,1,411335,415064,+,3729
142,NZ_OX366378,1,273469,277198,+,3729
142,NZ_CP090903,1,185736,189464,+,3728
142,NZ_OX366374,1,956216,959945,-,3729
142,NZ_CP090901,1,185736,189464,+,3728
142,NZ_CP046923,1,185434,189162,+,3728
142,NZ_CP069055,1,182798,186526,+,3728
142,NZ_CP072670,1,185584,189312,+,3728
142,NZ_CP090899,1,185736,189464,+,3728
142,NZ_CP046924,1,185434,189162,+,3728
142,NZ_OX366348,1,785346,789075,-,3729
142,NZ_CP046921,1,185434,189162,+,3728
142,NZ_OX366338,1,1161850,1165552,-,3702
142,NZ_CP054557,1,1189745,1193474,+,3729
142,NZ_CP072669,1,185584,189312,+,3728
142,NC_021089,1,183120,186848,+,3728
141,NZ_OX366376,1,454094,460350,+,6256
141,NZ_OX366393,1,131285,137541,+,6256
141,NZ_OX366372,1,1124315,1130570,-,6255
141,NZ_CP072672,1,178950,185242,+,6292
141,NZ_CP069060,1,189308,195600,+,6292
141,NZ_CP072667,1,178932,185224,+,6292
141,NZ_CP072671,1,178932,185224,+,6292
141,NZ_CP072668,1,178932,185224,+,6292
141,NZ_CP072666,1,178932,185224,+,6292
141,NZ_CP090902,1,179084,185376,+,6292
141,NZ_CP090948,1,179084,185376,+,6292
141,NZ_CP069052,1,183973,190265,+,6292
141,NZ_CP076228,1,182302,188610,+,6308
141,NZ_CP042445,1,179084,185376,+,6292
141,NZ_CP042904,1,182603,188895,+,6292
141,NC_012416,1,185185,191477,+,6292
141,NZ_CP069053,1,351677,357968,-,6291
141,NZ_CP042446,1,179084,185376,+,6292
141,NZ_CP041215,1,536107,542398,+,6291
141,NZ_OX366353,1,510620,516910,-,6290
141,NZ_OX366387,1,1414585,1420877,+,6292
141,NZ_OX366368,1,458087,464379,+,6292
141,NZ_OX366379,1,459105,465397,+,6292
141,NZ_CP091195,1,1451739,1458031,+,6292
141,NZ_OX366375,1,551777,558069,+,6292
141,NZ_CP046925,1,178932,185224,+,6292
141,NZ_OX366318,1,559090,565409,+,6319
141,NZ_OX366319,1,696175,702466,-,6291
141,NZ_OX366332,1,457209,463500,+,6291
141,NZ_CP110359,1,1056217,1062479,-,6262
141,NZ_OU953855,1,140004,146253,-,6249
141,NZ_OX366272,1,764209,770500,-,6291
141,NZ_OX366347,1,572468,578759,+,6291
141,NZ_OU909470,1,863640,869916,-,6276
141,NZ_OX366363,1,455495,461794,-,6299
141,NZ_OX366364,1,1011925,1018136,-,6211
141,NZ_OX366359,1,455320,461611,+,6291
141,NZ_OX366349,1,625034,631290,+,6256
141,NZ_OX366380,1,411153,417458,+,6305
141,NZ_OX366344,1,327551,333762,+,6211
141,NZ_CP090900,1,179084,185376,+,6292
141,NZ_OX366352,1,666760,673050,-,6290
141,NZ_OX366362,1,780495,786745,+,6250
141,NZ_OX366400,1,695481,701799,-,6318
141,NZ_OX366327,1,607882,614174,+,6292
141,NZ_OX366367,1,536803,543015,+,6212
141,NZ_CP042444,1,179022,185314,+,6292
141,NZ_OX366326,1,650892,657211,+,6319
141,NZ_CP037426,1,688499,694790,-,6291
141,NZ_OX366339,1,274106,280398,+,6292
141,NZ_OX366355,1,842037,848328,-,6291
141,NZ_CP046922,1,178782,185074,+,6292
141,NZ_OX366370,1,105238,111497,+,6259
141,NZ_OX366385,1,131390,137699,+,6309
141,NZ_OX366399,1,457598,463890,+,6292
141,NZ_OX366395,1,1031711,1037960,-,6249
141,NZ_OX366396,1,838686,844978,+,6292
141,NZ_OX366351,1,475586,481905,+,6319
141,NZ_OX366381,1,1003506,1009797,-,6291
141,NZ_OX366342,1,661094,667350,+,6256
141,NZ_OX366369,1,458545,464837,+,6292
141,NZ_OX366356,1,814656,820898,-,6242
141,NZ_OX366377,1,563494,569786,+,6292
141,NZ_OX366388,1,819375,825623,-,6248
141,NZ_OX366357,1,23063,29313,+,6250
141,NZ_CP072012,1,380377,386669,+,6292
141,NZ_OX366398,1,1117740,1124032,+,6292
141,NC_002978,6,179084,185376,+,6292
141,NZ_OX366389,1,630077,636369,+,6292
141,NZ_OX366397,1,404684,410975,+,6291
141,NZ_OX366378,1,265335,271627,+,6292
141,NZ_CP090903,1,179084,185376,+,6292
141,NZ_OX366374,1,960305,966596,-,6291
141,NZ_CP090901,1,179084,185376,+,6292
141,NZ_CP046923,1,178782,185074,+,6292
141,NZ_CP069055,1,176146,182424,+,6278
141,NZ_CP072670,1,178932,185224,+,6292
141,NZ_CP090899,1,179084,185376,+,6292
141,NZ_CP046924,1,178782,185074,+,6292
141,NZ_OX366348,1,789435,795726,-,6291
141,NZ_CP046921,1,178782,185074,+,6292
141,NZ_OX366338,1,1165912,1172169,-,6257
141,NZ_CP054557,1,1183093,1189385,+,6292
141,NZ_CP072669,1,178932,185224,+,6292
141,NC_021089,1,176469,182760,+,6291
140,NZ_OX366376,1,449565,450651,+,1086
140,NZ_OX366393,1,126608,127694,+,1086
140,NZ_OX366372,1,1388340,1389426,+,1086
140,NZ_CP072672,1,875341,876399,-,1058
140,NZ_CP069060,1,750196,751255,+,1059
140,NZ_CP072667,1,875315,876373,-,1058
140,NZ_CP072671,1,875323,876381,-,1058
140,NZ_CP072668,1,875310,876368,-,1058
140,NZ_CP072666,1,875323,876381,-,1058
140,NZ_CP090902,1,875475,876533,-,1058
140,NZ_CP090948,1,875475,876533,-,1058
140,NZ_CP069052,1,935751,936810,+,1059
140,NZ_CP076228,1,1033731,1034789,-,1058
140,NZ_CP042445,1,875463,876521,-,1058
140,NZ_CP042904,1,904388,905433,-,1045
140,NC_012416,1,939970,941015,-,1045
140,NZ_CP069053,1,719269,720327,-,1058
140,NZ_CP042446,1,875475,876533,-,1058
140,NZ_CP041215,1,1355292,1356350,-,1058
140,NZ_OX366353,1,245437,246496,+,1059
140,NZ_OX366387,1,1632099,1633157,-,1058
140,NZ_OX366368,1,1322587,1323645,-,1058
140,NZ_OX366379,1,1233517,1234576,+,1059
140,NZ_CP091195,1,1230711,1231778,-,1067
140,NZ_OX366375,1,1158359,1159417,-,1058
140,NZ_CP046925,1,875323,876381,-,1058
140,NZ_OX366318,1,1174720,1175778,-,1058
140,NZ_OX366319,1,1247457,1248515,-,1058
140,NZ_OX366332,1,1263227,1264285,-,1058
140,NZ_CP110359,1,1177471,1178529,-,1058
140,NZ_OU953855,1,1408470,1409529,+,1059
140,NZ_OX366272,1,248773,249831,-,1058
140,NZ_OX366347,1,10456,11514,-,1058
140,NZ_OU909470,1,870805,871872,-,1067
140,NZ_OX366363,1,1077485,1078543,-,1058
140,NZ_OX366364,1,1020193,1021229,-,1036
140,NZ_OX366359,1,1093232,1094290,-,1058
140,NZ_OX366349,1,621407,622466,+,1059
140,NZ_OX366380,1,409254,410313,+,1059
140,NZ_OX366344,1,825897,826982,-,1085
140,NZ_CP090900,1,875475,876533,-,1058
140,NZ_OX366352,1,192039,193098,+,1059
140,NZ_OX366362,1,778296,779382,+,1086
140,NZ_OX366400,1,1038201,1039259,-,1058
140,NZ_OX366327,1,1172124,1173169,-,1045
140,NZ_OX366367,1,1163604,1164776,-,1172
140,NZ_CP042444,1,875910,876968,-,1058
140,NZ_OX366326,1,1383278,1384336,-,1058
140,NZ_CP037426,1,1247840,1248898,-,1058
140,NZ_OX366339,1,1130664,1131722,-,1058
140,NZ_OX366355,1,1352971,1354029,-,1058
140,NZ_CP046922,1,937371,938429,-,1058
140,NZ_OX366370,1,44946,46101,+,1155
140,NZ_OX366385,1,169525,170584,+,1059
140,NZ_OX366399,1,1275696,1276754,-,1058
140,NZ_OX366395,1,1243309,1244368,+,1059
140,NZ_OX366396,1,591311,592370,+,1059
140,NZ_OX366351,1,1328857,1329915,-,1058
140,NZ_OX366381,1,1407647,1408705,-,1058
140,NZ_OX366342,1,274174,275260,+,1086
140,NZ_OX366369,1,1460007,1461066,+,1059
140,NZ_OX366356,1,153690,154749,+,1059
140,NZ_OX366377,1,224820,225878,-,1058
140,NZ_OX366388,1,753041,754108,-,1067
140,NZ_OX366388,1,1769306,1770374,+,1068
140,NZ_OX366357,1,963502,964560,-,1058
140,NZ_CP072012,1,689598,690657,+,1059
140,NZ_OX366398,1,355152,356210,-,1058
140,NC_002978,6,875475,876533,-,1058
140,NZ_OX366389,1,1247975,1249033,-,1058
140,NZ_OX366397,1,1487916,1488974,-,1058
140,NZ_OX366378,1,1175123,1176190,-,1067
140,NZ_CP090903,1,875475,876533,-,1058
140,NZ_OX366374,1,1155952,1157019,-,1067
140,NZ_CP090901,1,875475,876533,-,1058
140,NZ_CP046923,1,853619,854677,-,1058
140,NZ_CP069055,1,857591,858650,+,1059
140,NZ_CP072670,1,875315,876373,-,1058
140,NZ_CP090899,1,875475,876533,-,1058
140,NZ_CP046924,1,874557,875615,-,1058
140,NZ_OX366348,1,1185612,1186671,+,1059
140,NZ_CP046921,1,937371,938429,-,1058
140,NZ_OX366338,1,727762,728811,+,1049
140,NZ_CP072669,1,875323,876381,-,1058
140,NC_021089,1,912879,913937,-,1058
139,NZ_OX366376,1,448902,449564,+,662
139,NZ_OX366393,1,125945,126607,+,662
139,NZ_OX366372,1,1387677,1388339,+,662
139,NZ_CP072672,1,876401,877063,-,662
139,NZ_CP069060,1,749533,750195,+,662
139,NZ_CP072667,1,876375,877037,-,662
139,NZ_CP072671,1,876383,877045,-,662
139,NZ_CP072668,1,876370,877032,-,662
139,NZ_CP072666,1,876383,877045,-,662
139,NZ_CP090902,1,876535,877197,-,662
139,NZ_CP090948,1,876535,877197,-,662
139,NZ_CP069052,1,935088,935750,+,662
139,NZ_CP076228,1,1034791,1035453,-,662
139,NZ_CP042445,1,876523,877185,-,662
139,NZ_CP042904,1,905435,906097,-,662
139,NC_012416,1,941017,941679,-,662
139,NZ_CP069053,1,720329,720991,-,662
139,NZ_CP042446,1,876535,877197,-,662
139,NZ_CP041215,1,1356352,1357014,-,662
139,NZ_OX366353,1,244774,245436,+,662
139,NZ_OX366387,1,1633159,1633821,-,662
139,NZ_OX366368,1,1323647,1324309,-,662
139,NZ_OX366379,1,1232854,1233516,+,662
139,NZ_CP091195,1,1231780,1232442,-,662
139,NZ_OX366375,1,1159419,1160081,-,662
139,NZ_CP046925,1,876383,877045,-,662
139,NZ_OX366318,1,1175780,1176442,-,662
139,NZ_OX366319,1,1248517,1249179,-,662
139,NZ_OX366332,1,1264287,1264949,-,662
139,NZ_CP110359,1,1178531,1179193,-,662
139,NZ_OU953855,1,1407807,1408469,+,662
139,NZ_OX366272,1,249833,250495,-,662
139,NZ_OX366347,1,11516,12178,-,662
139,NZ_OU909470,1,871874,872536,-,662
139,NZ_OX366363,1,1078545,1079207,-,662
139,NZ_OX366364,1,1021231,1021893,-,662
139,NZ_OX366359,1,1094292,1094954,-,662
139,NZ_OX366349,1,620744,621406,+,662
139,NZ_OX366380,1,408591,409253,+,662
139,NZ_OX366344,1,826984,827646,-,662
139,NZ_CP090900,1,876535,877197,-,662
139,NZ_OX366352,1,191376,192038,+,662
139,NZ_OX366362,1,777633,778295,+,662
139,NZ_OX366400,1,1039261,1039923,-,662
139,NZ_OX366327,1,1173171,1173833,-,662
139,NZ_OX366367,1,1164778,1165440,-,662
139,NZ_CP042444,1,876970,877632,-,662
139,NZ_OX366326,1,1384338,1385000,-,662
139,NZ_CP037426,1,1248900,1249562,-,662
139,NZ_OX366339,1,1131724,1132386,-,662
139,NZ_OX366355,1,1354031,1354693,-,662
139,NZ_CP046922,1,938431,939093,-,662
139,NZ_OX366370,1,44283,44945,+,662
139,NZ_OX366385,1,168862,169524,+,662
139,NZ_OX366399,1,1276756,1277418,-,662
139,NZ_OX366395,1,1242646,1243308,+,662
139,NZ_OX366396,1,590648,591310,+,662
139,NZ_OX366351,1,1329917,1330579,-,662
139,NZ_OX366381,1,1408707,1409369,-,662
139,NZ_OX366342,1,273511,274173,+,662
139,NZ_OX366369,1,1459344,1460006,+,662
139,NZ_OX366356,1,153027,153689,+,662
139,NZ_OX366377,1,225880,226542,-,662
139,NZ_OX366388,1,754110,754772,-,662
139,NZ_OX366388,1,1768643,1769305,+,662
139,NZ_OX366357,1,964562,965224,-,662
139,NZ_CP072012,1,688935,689597,+,662
139,NZ_OX366398,1,356212,356874,-,662
139,NC_002978,6,876535,877197,-,662
139,NZ_OX366389,1,1249035,1249697,-,662
139,NZ_OX366397,1,1488976,1489638,-,662
139,NZ_OX366378,1,1176192,1176854,-,662
139,NZ_CP090903,1,876535,877197,-,662
139,NZ_OX366374,1,1157021,1157683,-,662
139,NZ_CP090901,1,876535,877197,-,662
139,NZ_CP046923,1,854679,855341,-,662
139,NZ_CP069055,1,856928,857590,+,662
139,NZ_CP072670,1,876375,877037,-,662
139,NZ_CP090899,1,876535,877197,-,662
139,NZ_CP046924,1,875617,876279,-,662
139,NZ_OX366348,1,1184949,1185611,+,662
139,NZ_CP046921,1,938431,939093,-,662
139,NZ_OX366338,1,727093,727761,+,668
139,NZ_CP054557,1,549138,549806,+,668
139,NZ_CP072669,1,876383,877045,-,662
139,NC_021089,1,913939,914601,-,662
138,NZ_OX366376,1,446006,447215,+,1209
138,NZ_OX366393,1,123049,124263,+,1214
138,NZ_OX366372,1,1384781,1385995,+,1214
138,NZ_CP072672,1,878860,880077,-,1217
138,NZ_CP069060,1,746519,747736,+,1217
138,NZ_CP072667,1,878834,880051,-,1217
138,NZ_CP072671,1,878842,880059,-,1217
138,NZ_CP072668,1,878829,880046,-,1217
138,NZ_CP072666,1,878842,880059,-,1217
138,NZ_CP090902,1,878994,880211,-,1217
138,NZ_CP090948,1,878994,880211,-,1217
138,NZ_CP069052,1,932074,933291,+,1217
138,NZ_CP076228,1,1037250,1038467,-,1217
138,NZ_CP042445,1,878982,880199,-,1217
138,NZ_CP042904,1,907801,909020,-,1219
138,NC_012416,1,943383,944602,-,1219
138,NZ_CP069053,1,722788,724005,-,1217
138,NZ_CP042446,1,878994,880211,-,1217
138,NZ_CP041215,1,1358580,1359799,-,1219
138,NZ_OX366353,1,241989,243208,+,1219
138,NZ_OX366387,1,1635406,1636625,-,1219
138,NZ_OX366368,1,1326106,1327323,-,1217
138,NZ_OX366379,1,1229840,1231057,+,1217
138,NZ_CP091195,1,1234134,1235353,-,1219
138,NZ_OX366375,1,1161879,1163094,-,1215
138,NZ_CP046925,1,878842,880059,-,1217
138,NZ_OX366318,1,1178239,1179453,-,1214
138,NZ_OX366319,1,1250977,1252192,-,1215
138,NZ_OX366332,1,1266515,1267734,-,1219
138,NZ_CP110359,1,1180885,1182104,-,1219
138,NZ_OU953855,1,1404790,1406009,+,1219
138,NZ_OX366272,1,252187,253406,-,1219
138,NZ_OX366347,1,13870,15089,-,1219
138,NZ_OU909470,1,874150,875364,-,1214
138,NZ_OX366363,1,1081053,1082272,-,1219
138,NZ_OX366364,1,1023616,1024831,-,1215
138,NZ_OX366359,1,1096520,1097739,-,1219
138,NZ_OX366349,1,617795,619014,+,1219
138,NZ_OX366380,1,405763,406977,+,1214
138,NZ_OX366344,1,830263,831482,-,1219
138,NZ_CP090900,1,878994,880211,-,1217
138,NZ_OX366352,1,188591,189810,+,1219
138,NZ_OX366362,1,774495,775691,+,1196
138,NZ_OX366400,1,1041720,1042934,-,1214
138,NZ_OX366327,1,1175681,1176900,-,1219
138,NZ_OX366367,1,1167418,1168631,-,1213
138,NZ_CP042444,1,879429,880646,-,1217
138,NZ_OX366326,1,1386797,1388011,-,1214
138,NZ_CP037426,1,1251360,1252575,-,1215
138,NZ_OX366339,1,1134201,1135420,-,1219
138,NZ_OX366355,1,1356491,1357706,-,1215
138,NZ_CP046922,1,940890,942107,-,1217
138,NZ_OX366370,1,41507,42721,+,1214
138,NZ_OX366385,1,166034,167248,+,1214
138,NZ_OX366399,1,1279215,1280432,-,1217
138,NZ_OX366395,1,1239611,1240830,+,1219
138,NZ_OX366396,1,587614,588833,+,1219
138,NZ_OX366351,1,1332376,1333590,-,1214
138,NZ_OX366381,1,1411167,1412382,-,1215
138,NZ_OX366342,1,270615,271829,+,1214
138,NZ_OX366369,1,1456331,1457546,+,1215
138,NZ_OX366356,1,150163,151382,+,1219
138,NZ_OX366377,1,228339,229556,-,1217
138,NZ_OX366388,1,756799,758018,-,1219
138,NZ_OX366388,1,1764633,1765852,+,1219
138,NZ_OX366357,1,966857,968076,-,1219
138,NZ_CP072012,1,685921,687138,+,1217
138,NZ_OX366398,1,358671,359888,-,1217
138,NC_002978,6,878994,880211,-,1217
138,NZ_OX366389,1,1251494,1252711,-,1217
138,NZ_OX366397,1,1491204,1492423,-,1219
138,NZ_OX366378,1,1178546,1179765,-,1219
138,NZ_CP090903,1,878994,880211,-,1217
138,NZ_OX366374,1,1159460,1160679,-,1219
138,NZ_CP090901,1,878994,880211,-,1217
138,NZ_CP046923,1,857138,858355,-,1217
138,NZ_CP069055,1,853914,855131,+,1217
138,NZ_CP072670,1,878834,880051,-,1217
138,NZ_CP090899,1,878994,880211,-,1217
138,NZ_CP046924,1,878076,879293,-,1217
138,NZ_OX366348,1,1181935,1183152,+,1217
138,NZ_CP046921,1,940890,942107,-,1217
138,NZ_OX366338,1,724181,725400,+,1219
138,NZ_CP054557,1,546124,547341,+,1217
138,NZ_CP072669,1,878842,880059,-,1217
138,NC_021089,1,916167,917386,-,1219
137,NZ_OX366376,1,440889,443734,+,2845
137,NZ_OX366393,1,117707,120552,+,2845
137,NZ_OX366372,1,1379664,1382509,+,2845
137,NZ_CP072672,1,882409,885254,-,2845
137,NZ_CP069060,1,741353,744198,+,2845
137,NZ_CP072667,1,882383,885228,-,2845
137,NZ_CP072671,1,882391,885236,-,2845
137,NZ_CP072668,1,882378,885223,-,2845
137,NZ_CP072666,1,882391,885236,-,2845
137,NZ_CP090902,1,882543,885388,-,2845
137,NZ_CP090948,1,882543,885388,-,2845
137,NZ_CP069052,1,926908,929753,+,2845
137,NZ_CP076228,1,1040799,1043644,-,2845
137,NZ_CP042445,1,882531,885376,-,2845
137,NZ_CP042904,1,911368,914213,-,2845
137,NC_012416,1,946950,949795,-,2845
137,NZ_CP069053,1,726326,729171,-,2845
137,NZ_CP042446,1,882543,885388,-,2845
137,NZ_CP041215,1,1362159,1365004,-,2845
137,NZ_OX366353,1,236795,239640,+,2845
137,NZ_OX366387,1,1638962,1641807,-,2845
137,NZ_OX366368,1,1329655,1332500,-,2845
137,NZ_OX366379,1,1224663,1227508,+,2845
137,NZ_CP091195,1,1237824,1240669,-,2845
137,NZ_OX366375,1,1165442,1168287,-,2845
137,NZ_CP046925,1,882391,885236,-,2845
137,NZ_OX366318,1,1181797,1184642,-,2845
137,NZ_OX366319,1,1254540,1257385,-,2845
137,NZ_OX366332,1,1270094,1272939,-,2845
137,NZ_CP110359,1,1184575,1187420,-,2845
137,NZ_OU953855,1,164212,167057,+,2845
137,NZ_OX366272,1,255877,258722,-,2845
137,NZ_OX366347,1,17297,20142,-,2845
137,NZ_OU909470,1,884965,887810,-,2845
137,NZ_OX366363,1,1085986,1088831,-,2845
137,NZ_OX366364,1,448819,451636,+,2817
137,NZ_OX366359,1,1100017,1102862,-,2845
137,NZ_OX366349,1,612173,615018,+,2845
137,NZ_OX366380,1,29380,32225,+,2845
137,NZ_OX366344,1,833751,836596,-,2845
137,NZ_CP090900,1,882543,885388,-,2845
137,NZ_OX366352,1,183386,186231,+,2845
137,NZ_OX366362,1,769310,772107,+,2797
137,NZ_OX366400,1,1045278,1048123,-,2845
137,NZ_OX366327,1,1179536,1182381,-,2845
137,NZ_OX366367,1,1276249,1279061,+,2812
137,NZ_CP042444,1,882978,885823,-,2845
137,NZ_OX366326,1,1390355,1393200,-,2845
137,NZ_CP037426,1,1254923,1257768,-,2845
137,NZ_OX366339,1,1137768,1140613,-,2845
137,NZ_OX366355,1,1360054,1362899,-,2845
137,NZ_CP046922,1,944439,947284,-,2845
137,NZ_OX366370,1,36474,39328,+,2854
137,NZ_OX366385,1,834500,837345,-,2845
137,NZ_OX366399,1,1282764,1285609,-,2845
137,NZ_OX366395,1,1233091,1235936,+,2845
137,NZ_OX366396,1,582421,585266,+,2845
137,NZ_OX366351,1,1335934,1338779,-,2845
137,NZ_OX366381,1,1414730,1417575,-,2845
137,NZ_OX366342,1,265483,268328,+,2845
137,NZ_OX366369,1,1451138,1453983,+,2845
137,NZ_OX366356,1,144970,147815,+,2845
137,NZ_OX366377,1,233139,235984,-,2845
137,NZ_OX366388,1,761923,764768,-,2845
137,NZ_OX366388,1,1759317,1762162,+,2845
137,NZ_OX366357,1,980734,983579,+,2845
137,NZ_CP072012,1,680744,683589,+,2845
137,NZ_OX366398,1,364322,367167,-,2845
137,NC_002978,6,882543,885388,-,2845
137,NZ_OX366389,1,1256294,1259139,-,2845
137,NZ_OX366397,1,1494783,1497628,-,2845
137,NZ_OX366378,1,1182340,1185185,-,2845
137,NZ_CP090903,1,882543,885388,-,2845
137,NZ_OX366374,1,486068,488913,-,2845
137,NZ_CP090901,1,882543,885388,-,2845
137,NZ_CP046923,1,860687,863532,-,2845
137,NZ_CP069055,1,848737,851582,+,2845
137,NZ_CP072670,1,882383,885228,-,2845
137,NZ_CP090899,1,882543,885388,-,2845
137,NZ_CP046924,1,881625,884470,-,2845
137,NZ_OX366348,1,1176763,1179603,+,2840
137,NZ_CP046921,1,944439,947284,-,2845
137,NZ_OX366338,1,365200,368045,+,2845
137,NZ_CP054557,1,540947,543792,+,2845
137,NZ_CP072669,1,882391,885236,-,2845
137,NC_021089,1,919746,922591,-,2845
136,NZ_OX366376,1,438130,439102,+,972
136,NZ_OX366393,1,114951,115920,+,969
136,NZ_OX366372,1,1376905,1377877,+,972
136,NZ_CP072672,1,888442,889423,-,981
136,NZ_CP069060,1,775562,776543,+,981
136,NZ_CP072667,1,888416,889397,-,981
136,NZ_CP072671,1,888424,889405,-,981
136,NZ_CP072668,1,888411,889392,-,981
136,NZ_CP072666,1,888424,889405,-,981
136,NZ_CP090902,1,888576,889557,-,981
136,NZ_CP090948,1,888576,889557,-,981
136,NZ_CP069052,1,879528,880509,-,981
136,NZ_CP076228,1,1079194,1080175,-,981
136,NZ_CP042445,1,888564,889545,-,981
136,NZ_CP042904,1,916018,916981,-,963
136,NC_012416,1,951600,952563,-,963
136,NZ_CP069053,1,775570,776551,+,981
136,NZ_CP042446,1,888576,889557,-,981
136,NZ_CP041215,1,1366588,1367551,-,963
136,NZ_OX366353,1,234248,235211,+,963
136,NZ_OX366387,1,1703401,1704373,+,972
136,NZ_OX366368,1,1334813,1335794,-,981
136,NZ_OX366379,1,1220450,1221431,+,981
136,NZ_CP091195,1,1244500,1245463,-,963
136,NZ_OX366375,1,1112879,1113842,-,963
136,NZ_CP046925,1,888424,889405,-,981
136,NZ_OX366318,1,1187523,1188486,-,963
136,NZ_OX366319,1,1239088,1240060,+,972
136,NZ_OX366332,1,1274523,1275486,-,963
136,NZ_CP110359,1,84444,85407,+,963
136,NZ_OU953855,1,161147,162110,+,963
136,NZ_OX366272,1,1165694,1166657,+,963
136,NZ_OX366347,1,1335126,1336089,-,963
136,NZ_OU909470,1,338143,339098,-,955
136,NZ_OX366363,1,1129331,1130294,+,963
136,NZ_OX366364,1,446241,447213,+,972
136,NZ_OX366359,1,1104446,1105409,-,963
136,NZ_OX366349,1,607704,608676,+,972
136,NZ_OX366380,1,26799,27764,+,965
136,NZ_OX366344,1,839121,840093,-,972
136,NZ_CP090900,1,888576,889557,-,981
136,NZ_OX366352,1,180839,181802,+,963
136,NZ_OX366362,1,766295,767258,+,963
136,NZ_OX366400,1,1051004,1051967,-,963
136,NZ_OX366327,1,1184987,1185968,-,981
136,NZ_OX366367,1,1273676,1274622,+,946
136,NZ_CP042444,1,889011,889992,-,981
136,NZ_OX366326,1,1396081,1397044,-,963
136,NZ_CP037426,1,1138701,1139664,+,963
136,NZ_OX366339,1,43302,44265,+,963
136,NZ_OX366355,1,167861,168833,+,972
136,NZ_CP046922,1,950472,951453,-,981
136,NZ_OX366370,1,47831,48782,-,951
136,NZ_OX366385,1,838961,839926,-,965
136,NZ_OX366399,1,1287922,1288903,-,981
136,NZ_OX366395,1,1230323,1231286,+,963
136,NZ_OX366396,1,572067,573030,-,963
136,NZ_OX366351,1,1341660,1342623,-,963
136,NZ_OX366381,1,106944,107916,-,972
136,NZ_OX366342,1,262724,263696,+,972
136,NZ_OX366369,1,1447265,1448237,+,972
136,NZ_OX366356,1,141541,142504,+,963
136,NZ_OX366377,1,238849,239812,-,963
136,NZ_OX366388,1,1755086,1756049,+,963
136,NZ_OX366357,1,978025,978988,+,963
136,NZ_CP072012,1,677450,678431,+,981
136,NZ_OX366398,1,370032,370995,-,963
136,NC_002978,6,888576,889557,-,981
136,NZ_OX366389,1,1262923,1263886,-,963
136,NZ_OX366397,1,1499212,1500175,-,963
136,NZ_OX366378,1,107067,108030,+,963
136,NZ_CP090903,1,888576,889557,-,981
136,NZ_OX366374,1,271936,272899,+,963
136,NZ_CP090901,1,888576,889557,-,981
136,NZ_CP046923,1,866720,867701,-,981
136,NZ_CP069055,1,1011185,1012166,-,981
136,NZ_CP072670,1,888416,889397,-,981
136,NZ_CP090899,1,888576,889557,-,981
136,NZ_CP046924,1,887658,888639,-,981
136,NZ_OX366348,1,90942,91905,+,963
136,NZ_CP046921,1,950472,951453,-,981
136,NZ_OX366338,1,362613,363594,+,981
136,NZ_CP054557,1,535240,536203,+,963
136,NZ_CP072669,1,888424,889405,-,981
136,NC_021089,1,924175,925138,-,963
135,NZ_OX366376,1,431637,437698,+,6061
135,NZ_OX366393,1,108458,114519,+,6061
135,NZ_OX366372,1,1370412,1376473,+,6061
135,NZ_CP072672,1,889855,895907,-,6052
135,NZ_CP069060,1,769078,775130,+,6052
135,NZ_CP072667,1,889829,895881,-,6052
135,NZ_CP072671,1,889837,895889,-,6052
135,NZ_CP072668,1,889824,895876,-,6052
135,NZ_CP072666,1,889837,895889,-,6052
135,NZ_CP090902,1,889989,896041,-,6052
135,NZ_CP090948,1,889989,896041,-,6052
135,NZ_CP069052,1,880941,886993,-,6052
135,NZ_CP076228,1,1080607,1086659,-,6052
135,NZ_CP042445,1,889977,896029,-,6052
135,NZ_CP042904,1,917281,923341,-,6060
135,NC_012416,1,952863,958923,-,6060
135,NZ_CP069053,1,769086,775138,+,6052
135,NZ_CP042446,1,889989,896041,-,6052
135,NZ_CP041215,1,1367851,1373911,-,6060
135,NZ_OX366353,1,227888,233948,+,6060
135,NZ_OX366387,1,1697050,1703101,+,6051
135,NZ_OX366368,1,1336226,1342278,-,6052
135,NZ_OX366379,1,1213966,1220018,+,6052
135,NZ_CP091195,1,1245883,1251926,-,6043
135,NZ_OX366375,1,1114142,1120193,-,6051
135,NZ_CP046925,1,889837,895889,-,6052
135,NZ_OX366318,1,1188906,1194949,-,6043
135,NZ_OX366319,1,1232737,1238788,+,6051
135,NZ_OX366332,1,1275786,1281846,-,6060
135,NZ_CP110359,1,77972,84024,+,6052
135,NZ_OU953855,1,154675,160727,+,6052
135,NZ_OX366272,1,1159222,1165274,+,6052
135,NZ_OX366347,1,1336509,1342561,-,6052
135,NZ_OU909470,1,339386,345448,-,6062
135,NZ_OX366363,1,1122859,1128911,+,6052
135,NZ_OX366364,1,439881,445919,+,6038
135,NZ_OX366359,1,1105709,1111769,-,6060
135,NZ_OX366349,1,601211,607272,+,6061
135,NZ_OX366380,1,20449,26511,+,6062
135,NZ_OX366344,1,840381,846442,-,6061
135,NZ_CP090900,1,889989,896041,-,6052
135,NZ_OX366352,1,174479,180539,+,6060
135,NZ_OX366362,1,759813,765875,+,6062
135,NZ_OX366400,1,1052387,1058430,-,6043
135,NZ_OX366327,1,1186268,1192319,-,6051
135,NZ_OX366367,1,1267212,1273256,+,6044
135,NZ_CP042444,1,890424,896476,-,6052
135,NZ_OX366326,1,1397464,1403507,-,6043
135,NZ_CP037426,1,1132350,1138401,+,6051
135,NZ_OX366339,1,36839,42882,+,6043
135,NZ_OX366355,1,161510,167561,+,6051
135,NZ_CP046922,1,951885,957937,-,6052
135,NZ_OX366370,1,49091,55152,-,6061
135,NZ_OX366385,1,840214,846276,-,6062
135,NZ_OX366399,1,1289335,1295387,-,6052
135,NZ_OX366395,1,1223830,1229891,+,6061
135,NZ_OX366396,1,573450,579493,-,6043
135,NZ_OX366351,1,1343043,1349086,-,6043
135,NZ_OX366381,1,108216,114267,-,6051
135,NZ_OX366342,1,256231,262292,+,6061
135,NZ_OX366369,1,1440914,1446965,+,6051
135,NZ_OX366356,1,135078,141121,+,6043
135,NZ_OX366377,1,240232,246284,-,6052
135,NZ_OX366388,1,1748623,1754666,+,6043
135,NZ_OX366357,1,971531,977584,+,6053
135,NZ_CP072012,1,670966,677018,+,6052
135,NZ_OX366398,1,371415,377467,-,6052
135,NC_002978,6,889989,896041,-,6052
135,NZ_OX366389,1,1264306,1270358,-,6052
135,NZ_OX366397,1,1500475,1506535,-,6060
135,NZ_OX366378,1,100604,106647,+,6043
135,NZ_CP090903,1,889989,896041,-,6052
135,NZ_OX366374,1,265479,271494,+,6015
135,NZ_CP090901,1,889989,896041,-,6052
135,NZ_CP046923,1,868133,874185,-,6052
135,NZ_CP069055,1,1012598,1018650,-,6052
135,NZ_CP072670,1,889829,895881,-,6052
135,NZ_CP090899,1,889989,896041,-,6052
135,NZ_CP046924,1,889071,895123,-,6052
135,NZ_OX366348,1,84480,90522,+,6042
135,NZ_CP046921,1,951885,957937,-,6052
135,NZ_OX366338,1,356118,362190,+,6072
135,NZ_CP054557,1,528777,534820,+,6043
135,NZ_CP072669,1,889837,895889,-,6052
135,NC_021089,1,925438,931498,-,6060
134,NZ_OX366376,1,428539,431554,+,3015
134,NZ_OX366393,1,105360,108375,+,3015
134,NZ_OX366372,1,1367314,1370329,+,3015
134,NZ_CP072672,1,898264,901282,-,3018
134,NZ_CP069060,1,764622,767640,+,3018
134,NZ_CP072667,1,898238,901256,-,3018
134,NZ_CP072671,1,898246,901264,-,3018
134,NZ_CP072668,1,898233,901251,-,3018
134,NZ_CP072666,1,898246,901264,-,3018
134,NZ_CP090902,1,898398,901416,-,3018
134,NZ_CP090948,1,898398,901416,-,3018
134,NZ_CP069052,1,888431,891449,-,3018
134,NZ_CP076228,1,1089014,1092032,-,3018
134,NZ_CP042445,1,898386,901404,-,3018
134,NZ_CP042904,1,923416,926412,-,2996
134,NC_012416,1,958999,961995,-,2996
134,NZ_CP069053,1,764630,767648,+,3018
134,NZ_CP042446,1,898398,901416,-,3018
134,NZ_CP041215,1,1373986,1376982,-,2996
134,NZ_OX366353,1,224817,227813,+,2996
134,NZ_OX366387,1,1693652,1696670,+,3018
134,NZ_OX366368,1,1343717,1346735,-,3018
134,NZ_OX366379,1,1263210,1266228,-,3018
134,NZ_CP091195,1,1252001,1254997,-,2996
134,NZ_OX366375,1,1120573,1123591,-,3018
134,NZ_CP046925,1,898246,901264,-,3018
134,NZ_OX366318,1,1196428,1199446,-,3018
134,NZ_OX366319,1,1229339,1232357,+,3018
134,NZ_OX366332,1,1281921,1284917,-,2996
134,NZ_CP110359,1,74901,77897,+,2996
134,NZ_OU953855,1,151604,154600,+,2996
134,NZ_OX366272,1,1156151,1159147,+,2996
134,NZ_OX366347,1,1342636,1345632,-,2996
134,NZ_OU909470,1,345523,348519,-,2996
134,NZ_OX366363,1,1119788,1122784,+,2996
134,NZ_OX366364,1,436801,439797,+,2996
134,NZ_OX366359,1,1111844,1114840,-,2996
134,NZ_OX366349,1,598113,601128,+,3015
134,NZ_OX366380,1,17378,20374,+,2996
134,NZ_OX366344,1,846525,849540,-,3015
134,NZ_CP090900,1,898398,901416,-,3018
134,NZ_OX366352,1,171408,174404,+,2996
134,NZ_OX366362,1,756392,759410,+,3018
134,NZ_OX366400,1,1059931,1062927,-,2996
134,NZ_OX366327,1,1192731,1195727,-,2996
134,NZ_OX366367,1,1263798,1266816,+,3018
134,NZ_CP042444,1,898833,901851,-,3018
134,NZ_OX366326,1,1404982,1408000,-,3018
134,NZ_CP037426,1,1128952,1131970,+,3018
134,NZ_OX366339,1,32343,35361,+,3018
134,NZ_OX366355,1,158112,161130,+,3018
134,NZ_CP046922,1,960294,963312,-,3018
134,NZ_OX366370,1,55235,58250,-,3015
134,NZ_OX366385,1,846351,849347,-,2996
134,NZ_OX366399,1,1296826,1299844,-,3018
134,NZ_OX366395,1,1220416,1223434,+,3018
134,NZ_OX366396,1,564800,567818,+,3018
134,NZ_OX366351,1,1350565,1353583,-,3018
134,NZ_OX366381,1,114647,117665,-,3018
134,NZ_OX366342,1,253133,256148,+,3015
134,NZ_OX366369,1,1437516,1440534,+,3018
134,NZ_OX366356,1,131680,134698,+,3018
134,NZ_OX366377,1,249173,252191,-,3018
134,NZ_OX366388,1,1745552,1748548,+,2996
134,NZ_OX366357,1,985206,988224,-,3018
134,NZ_CP072012,1,248164,251182,-,3018
134,NZ_OX366398,1,380356,383374,-,3018
134,NC_002978,6,898398,901416,-,3018
134,NZ_OX366389,1,1273247,1276265,-,3018
134,NZ_OX366397,1,1506610,1509606,-,2996
134,NZ_OX366378,1,97533,100529,+,2996
134,NZ_CP090903,1,898398,901416,-,3018
134,NZ_OX366374,1,262397,265393,+,2996
134,NZ_CP090901,1,898398,901416,-,3018
134,NZ_CP046923,1,876542,879560,-,3018
134,NZ_CP069055,1,969704,972722,+,3018
134,NZ_CP072670,1,898238,901256,-,3018
134,NZ_CP090899,1,898398,901416,-,3018
134,NZ_CP046924,1,897480,900498,-,3018
134,NZ_OX366348,1,79983,83001,+,3018
134,NZ_CP046921,1,960294,963312,-,3018
134,NZ_OX366338,1,351849,354867,+,3018
134,NZ_CP054557,1,524280,527298,+,3018
134,NZ_CP072669,1,898246,901264,-,3018
134,NC_021089,1,931573,934569,-,2996
133,NZ_OX366376,1,427181,428485,+,1304
133,NZ_OX366393,1,104002,105306,+,1304
133,NZ_OX366372,1,1365956,1367260,+,1304
133,NZ_CP072672,1,1051033,1052351,+,1318
133,NZ_CP069060,1,897001,898319,+,1318
133,NZ_CP072667,1,1051007,1052325,+,1318
133,NZ_CP072671,1,1051015,1052333,+,1318
133,NZ_CP072668,1,1051002,1052320,+,1318
133,NZ_CP072666,1,1051015,1052333,+,1318
133,NZ_CP090902,1,1051167,1052485,+,1318
133,NZ_CP090948,1,1051165,1052483,+,1318
133,NZ_CP069052,1,756308,757627,-,1319
133,NZ_CP076228,1,912662,913980,+,1318
133,NZ_CP042445,1,1051155,1052473,+,1318
133,NZ_CP042904,1,1315309,1316633,+,1324
133,NC_012416,1,1360007,1361331,+,1324
133,NZ_CP069053,1,897009,898327,+,1318
133,NZ_CP042446,1,1051165,1052483,+,1318
133,NZ_CP041215,1,1387307,1388626,-,1319
133,NZ_OX366353,1,1065650,1066969,-,1319
133,NZ_OX366387,1,434414,435733,-,1319
133,NZ_OX366368,1,63467,64785,+,1318
133,NZ_OX366379,1,63485,64803,+,1318
133,NZ_CP091195,1,488997,490315,+,1318
133,NZ_OX366375,1,63228,64546,+,1318
133,NZ_CP046925,1,1051015,1052333,+,1318
133,NZ_OX366318,1,61555,62873,+,1318
133,NZ_OX366319,1,1133806,1135125,-,1319
133,NZ_OX366332,1,62961,64279,+,1318
133,NZ_CP110359,1,405485,406804,-,1319
133,NZ_OU953855,1,92519,93838,-,1319
133,NZ_OX366272,1,1197420,1198738,+,1318
133,NZ_OX366347,1,56565,57884,-,1319
133,NZ_OU909470,1,348580,349869,-,1289
133,NZ_OX366363,1,872596,873914,+,1318
133,NZ_OX366364,1,435442,436740,+,1298
133,NZ_OX366359,1,62864,64182,+,1318
133,NZ_OX366349,1,596748,598052,+,1304
133,NZ_OX366380,1,16029,17317,+,1288
133,NZ_OX366344,1,849601,850905,-,1304
133,NZ_CP090900,1,1051167,1052485,+,1318
133,NZ_OX366352,1,1635238,1636557,-,1319
133,NZ_OX366362,1,755029,756332,+,1303
133,NZ_OX366400,1,111312,112554,-,1242
133,NZ_OX366327,1,63369,64687,+,1318
133,NZ_OX366367,1,1262441,1263737,+,1296
133,NZ_CP042444,1,1052521,1053839,+,1318
133,NZ_OX366326,1,64884,66202,+,1318
133,NZ_CP037426,1,1311362,1312680,+,1318
133,NZ_OX366339,1,1090028,1091347,-,1319
133,NZ_OX366355,1,1251896,1253215,-,1319
133,NZ_CP046922,1,1113084,1114402,+,1318
133,NZ_OX366370,1,58311,59615,-,1304
133,NZ_OX366385,1,849408,850696,-,1288
133,NZ_OX366399,1,62976,64294,+,1318
133,NZ_OX366395,1,27390,28578,-,1188
133,NZ_OX366396,1,1419794,1421113,-,1319
133,NZ_OX366351,1,71424,72742,+,1318
133,NZ_OX366381,1,1315843,1317162,-,1319
133,NZ_OX366342,1,251775,253079,+,1304
133,NZ_OX366369,1,63900,65218,+,1318
133,NZ_OX366356,1,61235,62553,+,1318
133,NZ_OX366377,1,62086,63404,+,1318
133,NZ_OX366388,1,213583,214901,+,1318
133,NZ_OX366357,1,876543,877867,-,1324
133,NZ_CP072012,1,1316258,1317576,+,1318
133,NZ_OX366398,1,533445,534763,+,1318
133,NC_002978,6,1051165,1052483,+,1318
133,NZ_OX366389,1,188032,189351,-,1319
133,NZ_OX366397,1,38924,40243,-,1319
133,NZ_OX366378,1,1227848,1229166,+,1318
133,NZ_CP090903,1,1051167,1052485,+,1318
133,NZ_OX366374,1,341003,342321,+,1318
133,NZ_CP090901,1,1051167,1052485,+,1318
133,NZ_CP046923,1,1029332,1030650,+,1318
133,NZ_CP069055,1,1002335,1003653,+,1318
133,NZ_CP072670,1,1051007,1052325,+,1318
133,NZ_CP090899,1,1051167,1052485,+,1318
133,NZ_CP046924,1,1050270,1051588,+,1318
133,NZ_OX366348,1,110773,112092,-,1319
133,NZ_CP046921,1,1113084,1114402,+,1318
133,NZ_OX366338,1,337664,338982,+,1318
133,NZ_OX366338,1,1443982,1445301,-,1319
133,NZ_CP054557,1,844157,845475,+,1318
133,NZ_CP072669,1,1051015,1052333,+,1318
133,NC_021089,1,1079268,1080586,+,1318
132,NZ_OX366376,1,425017,425960,+,943
132,NZ_OX366393,1,101815,102758,+,943
132,NZ_OX366372,1,1363769,1364712,+,943
132,NZ_CP072672,1,792930,793916,-,986
132,NZ_CP069060,1,636817,637803,-,986
132,NZ_CP072667,1,792912,793898,-,986
132,NZ_CP072671,1,792912,793898,-,986
132,NZ_CP072668,1,792899,793885,-,986
132,NZ_CP072666,1,792912,793898,-,986
132,NZ_CP090902,1,793064,794050,-,986
132,NZ_CP090948,1,793064,794050,-,986
132,NZ_CP069052,1,1187807,1188793,-,986
132,NZ_CP076228,1,807818,808804,+,986
132,NZ_CP042445,1,793052,794038,-,986
132,NZ_CP042904,1,816844,817813,-,969
132,NC_012416,1,853343,854312,-,969
132,NZ_CP069053,1,636825,637811,-,986
132,NZ_CP042446,1,793064,794050,-,986
132,NZ_CP041215,1,1265891,1266877,-,986
132,NZ_OX366353,1,217792,218778,-,986
132,NZ_OX366387,1,1450750,1451736,-,986
132,NZ_OX366368,1,1238969,1239955,-,986
132,NZ_OX366379,1,1158484,1159470,-,986
132,NZ_CP091195,1,839729,840715,+,986
132,NZ_OX366375,1,1087090,1088050,-,960
132,NZ_CP046925,1,792912,793898,-,986
132,NZ_OX366318,1,1092545,1093531,-,986
132,NZ_OX366319,1,57244,58213,-,969
132,NZ_OX366332,1,1176080,1177066,-,986
132,NZ_CP110359,1,277130,278116,-,986
132,NZ_OU953855,1,865017,866003,+,986
132,NZ_OX366272,1,1247219,1248205,+,986
132,NZ_OX366347,1,147115,148075,+,960
132,NZ_OU909470,1,351136,352122,-,986
132,NZ_OX366363,1,1150701,1151687,+,986
132,NZ_OX366364,1,1295405,1296366,+,961
132,NZ_OX366359,1,1006422,1007408,-,986
132,NZ_OX366349,1,594717,595660,+,943
132,NZ_OX366380,1,14001,14936,+,935
132,NZ_OX366344,1,852173,853116,-,943
132,NZ_CP090900,1,793064,794050,-,986
132,NZ_OX366352,1,1208768,1209754,+,986
132,NZ_OX366362,1,1465067,1466063,-,996
132,NZ_OX366400,1,955715,956701,-,986
132,NZ_OX366327,1,1090141,1091127,-,986
132,NZ_OX366367,1,1358988,1359945,+,957
132,NZ_CP042444,1,793499,794485,-,986
132,NZ_OX366326,1,1300190,1301176,-,986
132,NZ_CP037426,1,1162744,1163704,+,960
132,NZ_OX366339,1,902087,903073,+,986
132,NZ_OX366355,1,61119,62088,-,969
132,NZ_CP046922,1,854877,855863,-,986
132,NZ_OX366370,1,60824,61776,-,952
132,NZ_OX366385,1,851790,852725,-,935
132,NZ_OX366399,1,1193112,1194098,-,986
132,NZ_OX366395,1,104929,105915,+,986
132,NZ_OX366396,1,538496,539482,-,986
132,NZ_OX366351,1,1246615,1247601,-,986
132,NZ_OX366381,1,168724,169693,-,969
132,NZ_OX366342,1,249613,250554,+,941
132,NZ_OX366369,1,1279892,1280861,-,969
132,NZ_OX366356,1,996514,997500,-,986
132,NZ_OX366377,1,1134475,1135461,+,986
132,NZ_OX366388,1,275368,276345,-,977
132,NZ_OX366357,1,415170,416157,+,987
132,NZ_CP072012,1,1385444,1386430,+,986
132,NZ_OX366398,1,272695,273681,-,986
132,NC_002978,6,793064,794050,-,986
132,NZ_OX366389,1,1166328,1167266,-,938
132,NZ_OX366397,1,1400484,1401470,-,986
132,NZ_OX366378,1,121284,122270,+,986
132,NZ_CP090903,1,793064,794050,-,986
132,NZ_OX366374,1,648326,649313,-,987
132,NZ_CP090901,1,793064,794050,-,986
132,NZ_CP046923,1,771125,772111,-,986
132,NZ_CP069055,1,792175,793161,-,986
132,NZ_CP072670,1,792904,793890,-,986
132,NZ_CP090899,1,793064,794050,-,986
132,NZ_CP046924,1,792063,793049,-,986
132,NZ_OX366348,1,187083,188069,+,986
132,NZ_CP046921,1,854877,855863,-,986
132,NZ_OX366338,1,1264592,1265544,-,952
132,NZ_CP054557,1,1012891,1013877,+,986
132,NZ_CP072669,1,792912,793898,-,986
132,NC_021089,1,826239,827225,-,986
131,NZ_OX366376,1,422648,423473,+,825
131,NZ_OX366393,1,99470,100295,+,825
131,NZ_OX366372,1,1361358,1362183,+,825
131,NZ_OX366370,1,63048,63874,-,826
131,NZ_OX366342,1,247265,248090,+,825
130,NZ_OX366376,1,418909,422473,+,3564
130,NZ_OX366393,1,95731,99295,+,3564
130,NZ_OX366372,1,1357613,1361186,+,3573
130,NZ_CP072672,1,796031,799614,-,3583
130,NZ_CP069060,1,639918,643501,-,3583
130,NZ_CP072667,1,796013,799596,-,3583
130,NZ_CP072671,1,796013,799596,-,3583
130,NZ_CP072668,1,796000,799583,-,3583
130,NZ_CP072666,1,796013,799596,-,3583
130,NZ_CP090902,1,796165,799748,-,3583
130,NZ_CP090948,1,796165,799748,-,3583
130,NZ_CP069052,1,1190908,1194491,-,3583
130,NZ_CP076228,1,802120,805703,+,3583
130,NZ_CP042445,1,796153,799736,-,3583
130,NZ_CP042904,1,821211,824776,-,3565
130,NC_012416,1,857710,861275,-,3565
130,NZ_CP069053,1,639926,643509,-,3583
130,NZ_CP042446,1,796165,799748,-,3583
130,NZ_CP041215,1,1270479,1274062,-,3583
130,NZ_OX366353,1,814196,817779,+,3583
130,NZ_OX366387,1,1454933,1458516,-,3583
130,NZ_OX366368,1,1242070,1245653,-,3583
130,NZ_OX366379,1,1161585,1165168,-,3583
130,NZ_CP091195,1,769779,773362,+,3583
130,NZ_OX366375,1,1090165,1093739,-,3574
130,NZ_CP046925,1,796013,799596,-,3583
130,NZ_OX366318,1,1095646,1099229,-,3583
130,NZ_OX366319,1,60693,64266,-,3573
130,NZ_OX366332,1,1180658,1184241,-,3583
130,NZ_CP110359,1,280541,284115,-,3574
130,NZ_OU953855,1,804585,808152,-,3567
130,NZ_OX366272,1,1241219,1244793,+,3574
130,NZ_OX366347,1,141679,145253,+,3574
130,NZ_OU909470,1,354099,357672,-,3573
130,NZ_OX366363,1,1144677,1148250,+,3573
130,NZ_OX366364,1,1036104,1039672,-,3568
130,NZ_OX366359,1,1011009,1014592,-,3583
130,NZ_OX366349,1,583891,587464,-,3573
130,NZ_OX366380,1,54225,57799,+,3574
130,NZ_OX366344,1,855816,859389,-,3573
130,NZ_CP090900,1,796165,799748,-,3583
130,NZ_OX366352,1,1201585,1205168,+,3583
130,NZ_OX366362,1,1468708,1472254,-,3546
130,NZ_OX366400,1,958816,962399,-,3583
130,NZ_OX366327,1,1093577,1097151,-,3574
130,NZ_OX366367,1,526643,530211,+,3568
130,NZ_CP042444,1,796600,800183,-,3583
130,NZ_OX366326,1,1303291,1306874,-,3583
130,NZ_CP037426,1,1157055,1160629,+,3574
130,NZ_OX366339,1,896398,899972,+,3574
130,NZ_OX366355,1,64568,68141,-,3573
130,NZ_CP046922,1,857978,861561,-,3583
130,NZ_OX366370,1,64049,67622,-,3573
130,NZ_OX366385,1,787081,790655,+,3574
130,NZ_OX366399,1,1196213,1199796,-,3583
130,NZ_OX366395,1,99282,102846,+,3564
130,NZ_OX366396,1,541597,545171,-,3574
130,NZ_OX366351,1,1249716,1253299,-,3583
130,NZ_OX366381,1,172173,175746,-,3573
130,NZ_OX366342,1,243517,247090,+,3573
130,NZ_OX366369,1,1283341,1286914,-,3573
130,NZ_OX366356,1,999618,1003192,-,3574
130,NZ_OX366377,1,1128777,1132360,+,3583
130,NZ_OX366388,1,279812,283386,-,3574
130,NZ_OX366357,1,313581,317145,-,3564
130,NZ_CP072012,1,1379746,1383329,+,3583
130,NZ_OX366398,1,275796,279379,-,3583
130,NC_002978,6,796165,799748,-,3583
130,NZ_OX366389,1,1169381,1172964,-,3583
130,NZ_OX366397,1,1405071,1408654,-,3583
130,NZ_OX366378,1,115248,118831,+,3583
130,NZ_CP090903,1,796165,799748,-,3583
130,NZ_OX366374,1,652068,655632,-,3564
130,NZ_CP090901,1,796165,799748,-,3583
130,NZ_CP046923,1,774226,777809,-,3583
130,NZ_CP069055,1,795276,798859,-,3583
130,NZ_CP072670,1,796005,799588,-,3583
130,NZ_CP090899,1,796165,799748,-,3583
130,NZ_CP046924,1,795164,798747,-,3583
130,NZ_OX366348,1,181051,184634,+,3583
130,NZ_CP046921,1,857978,861561,-,3583
130,NZ_OX366338,1,1268973,1272537,-,3564
130,NZ_CP054557,1,1006859,1010442,+,3583
130,NZ_CP072669,1,796013,799596,-,3583
130,NC_021089,1,830826,834409,-,3583
129,NZ_OX366376,1,407399,409320,+,1921
129,NZ_OX366393,1,84305,86226,+,1921
129,NZ_OX366372,1,1346073,1347994,+,1921
129,NZ_CP072672,1,805431,807352,-,1921
129,NZ_CP069060,1,649318,651239,-,1921
129,NZ_CP072667,1,805413,807334,-,1921
129,NZ_CP072671,1,805413,807334,-,1921
129,NZ_CP072668,1,805400,807321,-,1921
129,NZ_CP072666,1,805413,807334,-,1921
129,NZ_CP090902,1,805565,807486,-,1921
129,NZ_CP090948,1,805565,807486,-,1921
129,NZ_CP069052,1,1200308,1202229,-,1921
129,NZ_CP076228,1,741649,743570,-,1921
129,NZ_CP042445,1,805553,807474,-,1921
129,NZ_CP042904,1,831682,833619,-,1937
129,NC_012416,1,868181,870118,-,1937
129,NZ_CP069053,1,649326,651247,-,1921
129,NZ_CP042446,1,805565,807486,-,1921
129,NZ_CP041215,1,1284542,1286479,-,1937
129,NZ_OX366353,1,801251,803188,+,1937
129,NZ_OX366387,1,1468982,1470919,-,1937
129,NZ_OX366368,1,1251476,1253397,-,1921
129,NZ_OX366379,1,1170993,1172914,-,1921
129,NZ_CP091195,1,760821,762758,+,1937
129,NZ_OX366375,1,1171399,1173336,-,1937
129,NZ_CP046925,1,805413,807334,-,1921
129,NZ_OX366318,1,1105028,1106949,-,1921
129,NZ_OX366319,1,75877,77814,-,1937
129,NZ_OX366332,1,1194721,1196658,-,1937
129,NZ_CP110359,1,294722,296659,-,1937
129,NZ_OU953855,1,816306,818243,+,1937
129,NZ_OX366272,1,1263295,1265232,-,1937
129,NZ_OX366347,1,128702,130639,+,1937
129,NZ_OU909470,1,370994,372915,-,1921
129,NZ_OX366363,1,802522,804459,-,1937
129,NZ_OX366364,1,1050825,1052717,-,1892
129,NZ_OX366359,1,1025333,1027270,-,1937
129,NZ_OX366349,1,251625,253546,-,1921
129,NZ_OX366380,1,397278,399199,+,1921
129,NZ_OX366344,1,811675,813596,-,1921
129,NZ_CP090900,1,805565,807486,-,1921
129,NZ_OX366352,1,1189144,1191081,+,1937
129,NZ_OX366362,1,325604,327541,-,1937
129,NZ_OX366400,1,968193,970114,-,1921
129,NZ_OX366327,1,1107857,1109794,-,1937
129,NZ_OX366367,1,251704,253596,+,1892
129,NZ_CP042444,1,806000,807921,-,1921
129,NZ_OX366326,1,1312672,1314593,-,1921
129,NZ_CP037426,1,952809,954746,+,1937
129,NZ_OX366339,1,1009151,1011088,-,1937
129,NZ_OX366355,1,79753,81690,-,1937
129,NZ_CP046922,1,867378,869299,-,1921
129,NZ_OX366370,1,274732,276653,+,1921
129,NZ_OX366385,1,748770,750691,-,1921
129,NZ_OX366399,1,1205621,1207542,-,1921
129,NZ_OX366395,1,1306231,1308168,+,1937
129,NZ_OX366396,1,747937,749874,+,1937
129,NZ_OX366351,1,1259097,1261018,-,1921
129,NZ_OX366381,1,187357,189294,-,1937
129,NZ_OX366342,1,232147,234068,+,1921
129,NZ_OX366369,1,1298479,1300416,-,1937
129,NZ_OX366356,1,1013088,1015025,-,1937
129,NZ_OX366377,1,1120409,1122346,+,1937
129,NZ_OX366388,1,290991,292928,-,1937
129,NZ_OX366357,1,677678,679615,-,1937
129,NZ_CP072012,1,1372000,1373921,+,1921
129,NZ_OX366398,1,285810,287747,-,1937
129,NC_002978,6,805565,807486,-,1921
129,NZ_OX366389,1,1179395,1181332,-,1937
129,NZ_OX366397,1,1419663,1421600,-,1937
129,NZ_OX366378,1,249616,251553,+,1937
129,NZ_CP090903,1,805565,807486,-,1921
129,NZ_OX366374,1,1168543,1170480,+,1937
129,NZ_OX366374,1,1180088,1182025,-,1937
129,NZ_CP090901,1,805565,807486,-,1921
129,NZ_CP046923,1,783626,785547,-,1921
129,NZ_CP069055,1,804685,806606,-,1921
129,NZ_CP072670,1,805405,807326,-,1921
129,NZ_CP090899,1,805565,807486,-,1921
129,NZ_CP046924,1,804564,806485,-,1921
129,NZ_OX366348,1,173329,175266,+,1937
129,NZ_CP046921,1,867378,869299,-,1921
129,NZ_OX366338,1,1287110,1289047,-,1937
129,NZ_CP054557,1,999208,1001145,+,1937
129,NZ_CP072669,1,805413,807334,-,1921
129,NC_021089,1,845193,847130,-,1937
128,NZ_OX366376,1,405102,405705,+,603
128,NZ_OX366393,1,82006,82609,+,603
128,NZ_OX366372,1,511488,512091,+,603
128,NZ_OX366344,1,799699,800302,+,603
128,NZ_OX366342,1,229847,230451,+,604
59,NZ_OX366376,1,216931,221825,+,4894
59,NZ_OX366393,1,1401075,1405969,+,4894
59,NZ_OX366372,1,1236109,1241004,-,4895
59,NZ_CP072672,1,5401,10190,-,4789
59,NZ_CP069060,1,5458,10304,-,4846
59,NZ_CP072667,1,5401,10190,-,4789
59,NZ_CP072671,1,5401,10190,-,4789
59,NZ_CP072668,1,5401,10190,-,4789
59,NZ_CP072666,1,5401,10190,-,4789
59,NZ_CP090902,1,5553,10342,-,4789
59,NZ_CP090948,1,5553,10342,-,4789
59,NZ_CP069052,1,5458,10304,-,4846
59,NZ_CP076228,1,5401,10247,-,4846
59,NZ_CP042445,1,5553,10342,-,4789
59,NZ_CP042904,1,5552,10450,-,4898
59,NC_012416,1,5553,10451,-,4898
59,NZ_CP069053,1,5458,10304,-,4846
59,NZ_CP042446,1,5553,10342,-,4789
59,NZ_CP041215,1,569837,574718,+,4881
59,NZ_OX366353,1,745291,750173,-,4882
59,NZ_OX366387,1,563112,567957,+,4845
59,NZ_OX366368,1,287471,292317,-,4846
59,NZ_OX366379,1,288489,293335,-,4846
59,NZ_CP091195,1,1390008,1394853,+,4845
59,NZ_OX366375,1,305819,310647,-,4828
59,NZ_CP046925,1,5401,10190,-,4789
59,NZ_OX366318,1,378868,383705,-,4837
59,NZ_OX366319,1,910207,915052,+,4845
59,NZ_OX366332,1,286057,290940,-,4883
59,NZ_CP110359,1,5392,10220,-,4828
59,NZ_OU953855,1,721595,726414,-,4819
59,NZ_OX366272,1,1094426,1099253,+,4827
59,NZ_OX366347,1,396106,400953,-,4847
59,NZ_OU909470,1,1094391,1099244,+,4853
59,NZ_OX366363,1,645820,650647,+,4827
59,NZ_OX366364,1,1252308,1257148,+,4840
59,NZ_OX366359,1,284641,289523,-,4882
59,NZ_OX366349,1,155369,160264,-,4895
59,NZ_OX366380,1,1279277,1284173,+,4896
59,NZ_OX366344,1,1111101,1115995,+,4894
59,NZ_CP090900,1,5553,10342,-,4789
59,NZ_OX366352,1,1042682,1047563,+,4881
59,NZ_OX366362,1,1164800,1169629,-,4829
59,NZ_OX366400,1,288094,292931,-,4837
59,NZ_OX366327,1,290099,294945,-,4846
59,NZ_OX366367,1,1105409,1110249,+,4840
59,NZ_CP042444,1,5553,10342,-,4789
59,NZ_OX366326,1,502751,507587,+,4836
59,NZ_CP037426,1,5401,10229,-,4828
59,NZ_OX366339,1,1055631,1060462,-,4831
59,NZ_OX366355,1,1024067,1028912,+,4845
59,NZ_CP046922,1,5401,10190,-,4789
59,NZ_OX366370,1,880379,885190,+,4811
59,NZ_OX366385,1,103337,108219,-,4882
59,NZ_OX366399,1,286973,291819,-,4846
59,NZ_OX366395,1,432744,437626,-,4882
59,NZ_OX366396,1,347147,352002,-,4855
59,NZ_OX366351,1,297543,302352,-,4809
59,NZ_OX366381,1,1350463,1355309,-,4846
59,NZ_OX366342,1,505561,510471,-,4910
59,NZ_OX366369,1,282126,286972,-,4846
59,NZ_OX366356,1,316271,321132,-,4861
59,NZ_OX366377,1,293712,298557,+,4845
59,NZ_OX366388,1,1487949,1492794,+,4845
59,NZ_OX366357,1,731162,736007,+,4845
59,NZ_CP072012,1,1025638,1030483,+,4845
59,NZ_OX366398,1,901390,906199,+,4809
59,NC_002978,6,5553,10342,-,4789
59,NZ_OX366389,1,344242,349088,-,4846
59,NZ_OX366397,1,285907,290789,-,4882
59,NZ_OX366378,1,907249,912094,+,4845
59,NZ_CP090903,1,5553,10342,-,4789
59,NZ_OX366374,1,1140811,1145615,+,4804
59,NZ_CP090901,1,5553,10342,-,4789
59,NZ_CP046923,1,5401,10190,-,4789
59,NZ_CP069055,1,5553,10399,-,4846
59,NZ_CP072670,1,5401,10190,-,4789
59,NZ_CP090899,1,5553,10342,-,4789
59,NZ_CP046924,1,5401,10190,-,4789
59,NZ_OX366348,1,959322,964158,+,4836
59,NZ_CP046921,1,5401,10190,-,4789
59,NZ_OX366338,1,50625,55546,-,4921
59,NZ_CP054557,1,405912,410749,-,4837
59,NZ_CP072669,1,5401,10190,-,4789
59,NC_021089,1,5553,10420,-,4867
58,NZ_OX366376,1,216387,216929,+,542
58,NZ_OX366393,1,1400531,1401073,+,542
58,NZ_OX366372,1,1241005,1241548,-,543
58,NZ_CP072672,1,10191,10751,-,560
58,NZ_CP069060,1,10305,10865,-,560
58,NZ_CP072667,1,10191,10751,-,560
58,NZ_CP072671,1,10191,10751,-,560
58,NZ_CP072668,1,10191,10751,-,560
58,NZ_CP072666,1,10191,10751,-,560
58,NZ_CP090902,1,10343,10903,-,560
58,NZ_CP090948,1,10343,10903,-,560
58,NZ_CP069052,1,10305,10865,-,560
58,NZ_CP076228,1,10248,10808,-,560
58,NZ_CP042445,1,10343,10903,-,560
58,NZ_CP042904,1,10451,10995,-,544
58,NC_012416,1,10452,10996,-,544
58,NZ_CP069053,1,10305,10865,-,560
58,NZ_CP042446,1,10343,10903,-,560
58,NZ_CP041215,1,569276,569835,+,559
58,NZ_OX366353,1,750174,750733,-,559
58,NZ_OX366387,1,562551,563110,+,559
58,NZ_OX366368,1,292318,292878,-,560
58,NZ_OX366379,1,293336,293896,-,560
58,NZ_CP091195,1,1389466,1390006,+,540
58,NZ_OX366375,1,310648,311208,-,560
58,NZ_CP046925,1,10191,10751,-,560
58,NZ_OX366318,1,383707,384275,-,568
58,NZ_OX366319,1,909646,910205,+,559
58,NZ_OX366332,1,290941,291501,-,560
58,NZ_CP110359,1,10221,10762,-,541
58,NZ_OU953855,1,726416,726984,-,568
58,NZ_OX366272,1,1093884,1094424,+,540
58,NZ_OX366347,1,400954,401504,-,550
58,NZ_OU909470,1,1093849,1094389,+,540
58,NZ_OX366363,1,645259,645818,+,559
58,NZ_OX366364,1,1251775,1252306,+,531
58,NZ_OX366359,1,289524,290084,-,560
58,NZ_OX366349,1,160265,160828,-,563
58,NZ_OX366380,1,1278707,1279275,+,568
58,NZ_OX366344,1,1110525,1111099,+,574
58,NZ_CP090900,1,10343,10903,-,560
58,NZ_OX366352,1,1042121,1042680,+,559
58,NZ_OX366362,1,670219,670777,-,558
58,NZ_OX366400,1,292933,293501,-,568
58,NZ_OX366327,1,294946,295497,-,551
58,NZ_OX366367,1,1104864,1105407,+,543
58,NZ_CP042444,1,10343,10903,-,560
58,NZ_OX366326,1,502181,502749,+,568
58,NZ_CP037426,1,10230,10790,-,560
58,NZ_OX366339,1,1061425,1061983,-,558
58,NZ_OX366355,1,1023506,1024065,+,559
58,NZ_CP046922,1,10191,10751,-,560
58,NZ_OX366370,1,879801,880377,+,576
58,NZ_OX366385,1,108220,108789,-,569
58,NZ_OX366399,1,291820,292380,-,560
58,NZ_OX366395,1,437627,438159,-,532
58,NZ_OX366396,1,352003,352547,-,544
58,NZ_OX366351,1,303233,303801,-,568
58,NZ_OX366381,1,1355310,1355870,-,560
58,NZ_OX366342,1,510472,511015,-,543
58,NZ_OX366369,1,286973,287533,-,560
58,NZ_OX366356,1,321133,321674,-,541
58,NZ_OX366377,1,293151,293710,+,559
58,NZ_OX366388,1,1487398,1487947,+,549
58,NZ_OX366357,1,730620,731160,+,540
58,NZ_CP072012,1,1025077,1025636,+,559
58,NZ_OX366398,1,899942,900516,+,574
58,NC_002978,6,10343,10903,-,560
58,NZ_OX366389,1,349089,349649,-,560
58,NZ_OX366397,1,290790,291350,-,560
58,NZ_OX366378,1,906707,907247,+,540
58,NZ_CP090903,1,10343,10903,-,560
58,NZ_CP090901,1,10343,10903,-,560
58,NZ_CP046923,1,10191,10751,-,560
58,NZ_CP069055,1,10400,10960,-,560
58,NZ_CP072670,1,10191,10751,-,560
58,NZ_CP090899,1,10343,10903,-,560
58,NZ_CP046924,1,10191,10751,-,560
58,NZ_OX366348,1,958752,959320,+,568
58,NZ_CP046921,1,10191,10751,-,560
58,NZ_OX366338,1,55547,56107,-,560
58,NZ_CP054557,1,410751,411319,-,568
58,NZ_CP072669,1,10191,10751,-,560
58,NC_021089,1,10421,10980,-,559
57,NZ_OX366376,1,215039,215900,+,861
57,NZ_OX366393,1,1399206,1400067,+,861
57,NZ_OX366372,1,1242012,1242873,-,861
57,NZ_CP072672,1,11188,12049,-,861
57,NZ_CP069060,1,11302,12163,-,861
57,NZ_CP072667,1,11188,12049,-,861
57,NZ_CP072671,1,11188,12049,-,861
57,NZ_CP072668,1,11188,12049,-,861
57,NZ_CP072666,1,11188,12049,-,861
57,NZ_CP090902,1,11340,12201,-,861
57,NZ_CP090948,1,11340,12201,-,861
57,NZ_CP069052,1,11302,12163,-,861
57,NZ_CP076228,1,11245,12106,-,861
57,NZ_CP042445,1,11340,12201,-,861
57,NZ_CP042904,1,11484,12325,-,841
57,NC_012416,1,11485,12326,-,841
57,NZ_CP069053,1,11302,12163,-,861
57,NZ_CP042446,1,11340,12201,-,861
57,NZ_CP041215,1,567978,568839,+,861
57,NZ_OX366353,1,751170,752031,-,861
57,NZ_OX366387,1,561253,562114,+,861
57,NZ_OX366368,1,293315,294176,-,861
57,NZ_OX366379,1,294333,295194,-,861
57,NZ_CP091195,1,1388139,1389000,+,861
57,NZ_OX366375,1,311663,312524,-,861
57,NZ_CP046925,1,11188,12049,-,861
57,NZ_OX366318,1,384712,385573,-,861
57,NZ_OX366319,1,908348,909209,+,861
57,NZ_OX366332,1,291928,292789,-,861
57,NZ_CP110359,1,11228,12089,-,861
57,NZ_OU953855,1,727421,728282,-,861
57,NZ_OX366272,1,1092557,1093418,+,861
57,NZ_OX366347,1,401984,402845,-,861
57,NZ_OU909470,1,1092475,1093336,+,861
57,NZ_OX366363,1,643012,643873,+,861
57,NZ_OX366364,1,1250441,1251302,+,861
57,NZ_OX366359,1,290521,291382,-,861
57,NZ_OX366349,1,162795,163656,-,861
57,NZ_OX366380,1,1277395,1278256,+,861
57,NZ_OX366344,1,1109220,1110081,+,861
57,NZ_CP090900,1,11340,12201,-,861
57,NZ_OX366352,1,1040823,1041684,+,861
57,NZ_OX366362,1,671206,672067,-,861
57,NZ_OX366400,1,293938,294799,-,861
57,NZ_OX366327,1,295952,296813,-,861
57,NZ_OX366367,1,1103538,1104399,+,861
57,NZ_CP042444,1,11340,12201,-,861
57,NZ_OX366326,1,500883,501744,+,861
57,NZ_CP037426,1,11222,12083,-,861
57,NZ_OX366339,1,1062414,1063275,-,861
57,NZ_OX366355,1,1022208,1023069,+,861
57,NZ_CP046922,1,11188,12049,-,861
57,NZ_OX366370,1,878526,879387,+,861
57,NZ_OX366385,1,109240,110101,-,861
57,NZ_OX366399,1,292817,293678,-,861
57,NZ_OX366395,1,438621,439482,-,861
57,NZ_OX366396,1,355801,356662,-,861
57,NZ_OX366351,1,304238,305099,-,861
57,NZ_OX366381,1,1356307,1357168,-,861
57,NZ_OX366342,1,511501,512362,-,861
57,NZ_OX366369,1,287970,288831,-,861
57,NZ_OX366356,1,322234,323095,-,861
57,NZ_OX366377,1,291853,292714,+,861
57,NZ_OX366388,1,1486049,1486910,+,861
57,NZ_OX366357,1,729305,730166,+,861
57,NZ_CP072012,1,1023779,1024640,+,861
57,NZ_OX366398,1,898644,899505,+,861
57,NC_002978,6,11340,12201,-,861
57,NZ_OX366389,1,350086,350947,-,861
57,NZ_OX366397,1,291787,292648,-,861
57,NZ_OX366378,1,905380,906241,+,861
57,NZ_CP090903,1,11340,12201,-,861
57,NZ_OX366374,1,1138999,1139860,+,861
57,NZ_CP090901,1,11340,12201,-,861
57,NZ_CP046923,1,11188,12049,-,861
57,NZ_CP069055,1,11397,12258,-,861
57,NZ_CP072670,1,11188,12049,-,861
57,NZ_CP090899,1,11340,12201,-,861
57,NZ_CP046924,1,11188,12049,-,861
57,NZ_OX366348,1,957454,958315,+,861
57,NZ_CP046921,1,11188,12049,-,861
57,NZ_OX366338,1,1470032,1470893,-,861
57,NZ_CP054557,1,411756,412617,-,861
57,NZ_CP072669,1,11188,12049,-,861
57,NC_021089,1,11417,12278,-,861
56,NZ_OX366376,1,213151,214447,+,1296
56,NZ_OX366393,1,1397318,1398634,+,1316
56,NZ_OX366372,1,1243465,1244761,-,1296
56,NZ_CP072672,1,1094332,1095515,-,1183
56,NZ_CP069060,1,940752,941935,-,1183
56,NZ_CP072667,1,1094306,1095489,-,1183
56,NZ_CP072671,1,1094314,1095497,-,1183
56,NZ_CP072668,1,1094301,1095484,-,1183
56,NZ_CP072666,1,1094314,1095497,-,1183
56,NZ_CP090902,1,1094466,1095649,-,1183
56,NZ_CP090948,1,1094467,1095646,-,1179
56,NZ_CP069052,1,1055579,1056761,+,1182
56,NZ_CP076228,1,1108847,1110030,-,1183
56,NZ_CP042445,1,1094454,1095637,-,1183
56,NZ_CP042904,1,1024571,1025753,+,1182
56,NC_012416,1,1067128,1068310,+,1182
56,NZ_CP069053,1,940784,941967,-,1183
56,NZ_CP042446,1,1094464,1095647,-,1183
56,NZ_CP041215,1,85252,86447,+,1195
56,NZ_OX366353,1,716952,718147,+,1195
56,NZ_OX366387,1,1564842,1566024,+,1182
56,NZ_OX366368,1,107183,108366,-,1183
56,NZ_OX366379,1,107281,108464,-,1183
56,NZ_CP091195,1,1010310,1011489,+,1179
56,NZ_OX366375,1,72828,74010,+,1182
56,NZ_CP046925,1,1094314,1095497,-,1183
56,NZ_OX366318,1,102014,103197,-,1183
56,NZ_OX366319,1,1125247,1126430,-,1183
56,NZ_OX366332,1,71656,72851,+,1195
56,NZ_CP110359,1,381006,382189,-,1183
56,NZ_OU953855,1,1667110,1668293,-,1183
56,NZ_OX366272,1,187177,188359,+,1182
56,NZ_OX366347,1,32178,33361,-,1183
56,NZ_OU909470,1,726517,727804,-,1287
56,NZ_OX366363,1,897289,898471,+,1182
56,NZ_OX366364,1,1299148,1300444,-,1296
56,NZ_OX366359,1,71543,72738,+,1195
56,NZ_OX366349,1,164226,165522,-,1296
56,NZ_OX366380,1,1267541,1268848,-,1307
56,NZ_OX366344,1,1107322,1108621,+,1299
56,NZ_CP090900,1,1094466,1095649,-,1183
56,NZ_OX366352,1,1626667,1627862,-,1195
56,NZ_OX366362,1,1353040,1354326,-,1286
56,NZ_OX366400,1,71679,72861,+,1182
56,NZ_OX366327,1,72152,73334,+,1182
56,NZ_OX366367,1,1160939,1162118,+,1179
56,NZ_CP042444,1,1095820,1097003,-,1183
56,NZ_OX366326,1,105720,106903,-,1183
56,NZ_CP037426,1,1072790,1073973,-,1183
56,NZ_OX366339,1,1335940,1337123,-,1183
56,NZ_OX366355,1,1242357,1243540,-,1183
56,NZ_CP046922,1,1156278,1157461,-,1183
56,NZ_OX366370,1,876603,877799,+,1196
56,NZ_OX366385,1,1147403,1148710,+,1307
56,NZ_OX366399,1,106684,107867,-,1183
56,NZ_OX366395,1,244550,245729,-,1179
56,NZ_OX366396,1,1411121,1412322,-,1201
56,NZ_OX366351,1,113135,114318,-,1183
56,NZ_OX366381,1,1307284,1308467,-,1183
56,NZ_OX366342,1,512954,514250,-,1296
56,NZ_OX366369,1,103566,104749,-,1183
56,NZ_OX366356,1,100860,102043,-,1183
56,NZ_OX366377,1,108784,109967,-,1183
56,NZ_OX366388,1,87110,88289,-,1179
56,NZ_OX366357,1,895200,896379,+,1179
56,NZ_CP072012,1,1208602,1209784,+,1182
56,NZ_OX366398,1,755574,756757,-,1183
56,NC_002978,6,1094467,1095646,-,1179
56,NZ_OX366389,1,143288,144470,+,1182
56,NZ_OX366397,1,105631,106826,-,1195
56,NZ_OX366378,1,238998,240177,-,1179
56,NZ_CP090903,1,1094466,1095649,-,1183
56,NZ_OX366374,1,366727,368014,+,1287
56,NZ_CP090901,1,1094466,1095649,-,1183
56,NZ_CP046923,1,1072526,1073709,-,1183
56,NZ_CP069055,1,1094236,1095419,-,1183
56,NZ_CP072670,1,1094294,1095477,-,1183
56,NZ_CP090899,1,1094466,1095649,-,1183
56,NZ_CP046924,1,1093464,1094647,-,1183
56,NZ_OX366348,1,1144360,1145543,-,1183
56,NZ_CP046921,1,1156278,1157461,-,1183
56,NZ_OX366338,1,1408889,1410068,+,1179
56,NZ_CP054557,1,889414,890597,-,1183
56,NZ_CP072669,1,1094314,1095497,-,1183
56,NC_021089,1,1121814,1123009,-,1195
55,NZ_OX366376,1,210143,212114,+,1971
55,NZ_OX366393,1,1394310,1396281,+,1971
55,NZ_OX366372,1,1245798,1247769,-,1971
55,NZ_CP072672,1,1095755,1097709,-,1954
55,NZ_CP069060,1,942175,944129,-,1954
55,NZ_CP072667,1,1095729,1097683,-,1954
55,NZ_CP072671,1,1095737,1097691,-,1954
55,NZ_CP072668,1,1095724,1097678,-,1954
55,NZ_CP072666,1,1095737,1097691,-,1954
55,NZ_CP090902,1,1095889,1097843,-,1954
55,NZ_CP090948,1,1095886,1097840,-,1954
55,NZ_CP069052,1,1053385,1055339,+,1954
55,NZ_CP076228,1,1110270,1112224,-,1954
55,NZ_CP042445,1,1095877,1097831,-,1954
55,NZ_CP042904,1,1021590,1023544,+,1954
55,NC_012416,1,1064147,1066101,+,1954
55,NZ_CP069053,1,942207,944161,-,1954
55,NZ_CP042446,1,1095887,1097841,-,1954
55,NZ_CP041215,1,83058,85012,+,1954
55,NZ_OX366353,1,714758,716712,+,1954
55,NZ_OX366387,1,1562648,1564602,+,1954
55,NZ_OX366368,1,108606,110560,-,1954
55,NZ_OX366379,1,108704,110658,-,1954
55,NZ_CP091195,1,1008116,1010070,+,1954
55,NZ_OX366375,1,70634,72588,+,1954
55,NZ_CP046925,1,1095737,1097691,-,1954
55,NZ_OX366318,1,103437,105391,-,1954
55,NZ_OX366319,1,1126670,1128624,-,1954
55,NZ_OX366332,1,69462,71416,+,1954
55,NZ_CP110359,1,382429,384383,-,1954
55,NZ_OU953855,1,1668533,1670487,-,1954
55,NZ_OX366272,1,184983,186937,+,1954
55,NZ_OX366347,1,33601,35555,-,1954
55,NZ_OU909470,1,728829,730733,-,1904
55,NZ_OX366363,1,895095,897049,+,1954
55,NZ_OX366364,1,1301471,1303425,-,1954
55,NZ_OX366359,1,69349,71303,+,1954
55,NZ_OX366349,1,166559,168522,-,1963
55,NZ_OX366380,1,1269873,1271827,-,1954
55,NZ_OX366344,1,1104314,1106285,+,1971
55,NZ_CP090900,1,1095889,1097843,-,1954
55,NZ_OX366352,1,1628102,1630056,-,1954
55,NZ_OX366362,1,1355363,1357326,-,1963
55,NZ_OX366400,1,69485,71439,+,1954
55,NZ_OX366327,1,69961,71912,+,1951
55,NZ_OX366367,1,1157958,1159912,+,1954
55,NZ_CP042444,1,1097243,1099197,-,1954
55,NZ_OX366326,1,107143,109097,-,1954
55,NZ_CP037426,1,1074213,1076167,-,1954
55,NZ_OX366339,1,1337363,1339317,-,1954
55,NZ_OX366355,1,1243780,1245734,-,1954
55,NZ_CP046922,1,1157701,1159655,-,1954
55,NZ_OX366370,1,873605,875576,+,1971
55,NZ_OX366385,1,1144423,1146377,+,1954
55,NZ_OX366399,1,108107,110061,-,1954
55,NZ_OX366395,1,245969,247910,-,1941
55,NZ_OX366396,1,1412562,1414516,-,1954
55,NZ_OX366351,1,114558,116512,-,1954
55,NZ_OX366381,1,1308707,1310661,-,1954
55,NZ_OX366342,1,515287,517258,-,1971
55,NZ_OX366369,1,104989,106943,-,1954
55,NZ_OX366356,1,102283,104229,-,1946
55,NZ_OX366377,1,110207,112161,-,1954
55,NZ_OX366388,1,88529,90483,-,1954
55,NZ_OX366357,1,893006,894960,+,1954
55,NZ_CP072012,1,1206408,1208362,+,1954
55,NZ_OX366398,1,756997,758951,-,1954
55,NC_002978,6,1095886,1097840,-,1954
55,NZ_OX366389,1,141094,143048,+,1954
55,NZ_OX366397,1,107066,109020,-,1954
55,NZ_OX366378,1,240417,242371,-,1954
55,NZ_CP090903,1,1095889,1097843,-,1954
55,NZ_OX366374,1,363742,365700,+,1958
55,NZ_CP090901,1,1095889,1097843,-,1954
55,NZ_CP046923,1,1073949,1075903,-,1954
55,NZ_CP069055,1,1095659,1097613,-,1954
55,NZ_CP072670,1,1095717,1097671,-,1954
55,NZ_CP090899,1,1095889,1097843,-,1954
55,NZ_CP046924,1,1094887,1096841,-,1954
55,NZ_OX366348,1,1145783,1147737,-,1954
55,NZ_CP046921,1,1157701,1159655,-,1954
55,NZ_OX366338,1,1406695,1408649,+,1954
55,NZ_CP054557,1,890837,892791,-,1954
55,NZ_CP072669,1,1095737,1097691,-,1954
55,NC_021089,1,1123249,1125203,-,1954
54,NZ_OX366376,1,206395,210093,+,3698
54,NZ_OX366393,1,1390531,1394260,+,3729
54,NZ_OX366372,1,1247819,1251548,-,3729
54,NZ_CP072672,1,1097759,1101476,-,3717
54,NZ_CP069060,1,944179,947896,-,3717
54,NZ_CP072667,1,1097733,1101450,-,3717
54,NZ_CP072671,1,1097741,1101458,-,3717
54,NZ_CP072668,1,1097728,1101445,-,3717
54,NZ_CP072666,1,1097741,1101458,-,3717
54,NZ_CP090902,1,1097893,1101610,-,3717
54,NZ_CP090948,1,1097890,1101607,-,3717
54,NZ_CP069052,1,1049618,1053335,+,3717
54,NZ_CP076228,1,1112274,1115991,-,3717
54,NZ_CP042445,1,1097881,1101598,-,3717
54,NZ_CP042904,1,1017844,1021540,+,3696
54,NC_012416,1,1060401,1064097,+,3696
54,NZ_CP069053,1,944211,947928,-,3717
54,NZ_CP042446,1,1097891,1101608,-,3717
54,NZ_CP041215,1,79291,83008,+,3717
54,NZ_OX366353,1,710991,714708,+,3717
54,NZ_OX366387,1,1558881,1562598,+,3717
54,NZ_OX366368,1,110610,114327,-,3717
54,NZ_OX366379,1,110708,114425,-,3717
54,NZ_CP091195,1,1004349,1008066,+,3717
54,NZ_OX366375,1,66867,70584,+,3717
54,NZ_CP046925,1,1097741,1101458,-,3717
54,NZ_OX366318,1,105441,109158,-,3717
54,NZ_OX366319,1,1128674,1132391,-,3717
54,NZ_OX366332,1,65695,69412,+,3717
54,NZ_CP110359,1,384433,388150,-,3717
54,NZ_OU953855,1,1670537,1674254,-,3717
54,NZ_OX366272,1,181216,184933,+,3717
54,NZ_OX366347,1,35605,39322,-,3717
54,NZ_OU909470,1,219028,222698,+,3670
54,NZ_OX366363,1,891328,895045,+,3717
54,NZ_OX366364,1,1303475,1307179,-,3704
54,NZ_OX366359,1,65582,69299,+,3717
54,NZ_OX366349,1,168572,172270,-,3698
54,NZ_OX366380,1,1271872,1275560,-,3688
54,NZ_OX366344,1,1100566,1104264,+,3698
54,NZ_CP090900,1,1097893,1101610,-,3717
54,NZ_OX366352,1,1630106,1633823,-,3717
54,NZ_OX366362,1,1357376,1361074,-,3698
54,NZ_OX366400,1,65718,69435,+,3717
54,NZ_OX366327,1,66087,69801,+,3714
54,NZ_OX366367,1,1154204,1157908,+,3704
54,NZ_CP042444,1,1099247,1102964,-,3717
54,NZ_OX366326,1,109147,112864,-,3717
54,NZ_CP037426,1,1076217,1079934,-,3717
54,NZ_OX366339,1,1339367,1343084,-,3717
54,NZ_OX366355,1,1245784,1249501,-,3717
54,NZ_CP046922,1,1159705,1163422,-,3717
54,NZ_OX366370,1,869895,873555,+,3660
54,NZ_OX366385,1,1140690,1144378,+,3688
54,NZ_OX366399,1,110111,113828,-,3717
54,NZ_OX366395,1,247973,251688,-,3715
54,NZ_OX366396,1,1414566,1418283,-,3717
54,NZ_OX366351,1,116562,120279,-,3717
54,NZ_OX366381,1,1310711,1314428,-,3717
54,NZ_OX366342,1,517291,521000,-,3709
54,NZ_OX366369,1,106993,110710,-,3717
54,NZ_OX366356,1,104391,108239,-,3848
54,NZ_OX366377,1,112211,115928,-,3717
54,NZ_OX366388,1,90533,94250,-,3717
54,NZ_OX366357,1,1054016,1057701,-,3685
54,NZ_CP072012,1,1202641,1206358,+,3717
54,NZ_OX366398,1,759001,762718,-,3717
54,NC_002978,6,1097890,1101607,-,3717
54,NZ_OX366389,1,137327,141044,+,3717
54,NZ_OX366397,1,109070,112787,-,3717
54,NZ_OX366378,1,242421,246138,-,3717
54,NZ_CP090903,1,1097893,1101610,-,3717
54,NZ_OX366374,1,359970,363687,+,3717
54,NZ_CP090901,1,1097893,1101610,-,3717
54,NZ_CP046923,1,1075953,1079670,-,3717
54,NZ_CP069055,1,1097663,1101380,-,3717
54,NZ_CP072670,1,1097721,1101438,-,3717
54,NZ_CP090899,1,1097893,1101610,-,3717
54,NZ_CP046924,1,1096891,1100608,-,3717
54,NZ_OX366348,1,1147787,1151504,-,3717
54,NZ_CP046921,1,1159705,1163422,-,3717
54,NZ_OX366338,1,570648,574365,+,3717
54,NZ_CP054557,1,892841,896558,-,3717
54,NZ_CP072669,1,1097741,1101458,-,3717
54,NC_021089,1,1125253,1128970,-,3717
53,NZ_OX366376,1,203075,205090,+,2015
53,NZ_OX366393,1,1386966,1388987,+,2021
53,NZ_OX366372,1,1252598,1254619,-,2021
53,NZ_CP072672,1,961017,963041,+,2024
53,NZ_CP069060,1,805957,807981,+,2024
53,NZ_CP072667,1,960991,963015,+,2024
53,NZ_CP072671,1,960999,963023,+,2024
53,NZ_CP072668,1,960986,963010,+,2024
53,NZ_CP072666,1,960999,963023,+,2024
53,NZ_CP090902,1,961151,963175,+,2024
53,NZ_CP090948,1,961151,963175,+,2024
53,NZ_CP069052,1,848090,850114,-,2024
53,NZ_CP076228,1,1020758,1022782,-,2024
53,NZ_CP042445,1,961139,963163,+,2024
53,NZ_CP042904,1,984853,986877,+,2024
53,NC_012416,1,1023955,1025979,+,2024
53,NZ_CP069053,1,805965,807989,+,2024
53,NZ_CP042446,1,961149,963173,+,2024
53,NZ_CP041215,1,25249,27282,-,2033
53,NZ_OX366353,1,1191492,1193525,-,2033
53,NZ_OX366387,1,946281,948310,-,2029
53,NZ_OX366368,1,1406639,1408663,+,2024
53,NZ_OX366379,1,1326084,1328108,+,2024
53,NZ_CP091195,1,1111132,1113165,-,2033
53,NZ_OX366375,1,1250221,1252254,-,2033
53,NZ_CP046925,1,960999,963023,+,2024
53,NZ_OX366318,1,1257481,1259505,+,2024
53,NZ_OX366319,1,1187239,1189272,+,2033
53,NZ_OX366332,1,1340711,1342744,+,2033
53,NZ_CP110359,1,193455,195488,+,2033
53,NZ_OU953855,1,938193,940226,+,2033
53,NZ_OX366272,1,1312811,1314844,-,2033
53,NZ_OX366347,1,1403965,1405998,+,2033
53,NZ_OU909470,1,215942,217963,+,2021
53,NZ_OX366363,1,978652,980676,+,2024
53,NZ_OX366364,1,348183,350200,+,2017
53,NZ_OX366359,1,1170430,1172463,+,2033
53,NZ_OX366349,1,113083,115030,+,1947
53,NZ_OX366380,1,757864,759885,+,2021
53,NZ_OX366344,1,1097696,1099717,+,2021
53,NZ_CP090900,1,961151,963175,+,2024
53,NZ_OX366352,1,1664438,1666471,+,2033
53,NZ_OX366362,1,484761,486782,+,2021
53,NZ_OX366400,1,1114510,1116534,+,2024
53,NZ_OX366327,1,1253176,1255197,+,2021
53,NZ_OX366367,1,1030578,1032599,+,2021
53,NZ_CP042444,1,961586,963610,+,2024
53,NZ_OX366326,1,1466739,1468763,+,2024
53,NZ_CP037426,1,677059,679092,-,2033
53,NZ_OX366339,1,82031,84064,-,2033
53,NZ_OX366355,1,1287809,1289842,-,2033
53,NZ_CP046922,1,1023047,1025071,+,2024
53,NZ_OX366370,1,867220,869250,+,2030
53,NZ_OX366385,1,335836,337857,+,2021
53,NZ_OX366399,1,1359700,1361724,+,2024
53,NZ_OX366395,1,1192954,1194978,-,2024
53,NZ_OX366396,1,507978,510011,+,2033
53,NZ_OX366351,1,1410602,1412626,+,2024
53,NZ_OX366381,1,1096186,1098219,+,2033
53,NZ_OX366342,1,521733,523754,-,2021
53,NZ_OX366369,1,1377030,1379063,-,2033
53,NZ_OX366356,1,1123831,1125855,+,2024
53,NZ_OX366377,1,1003612,1005636,-,2024
53,NZ_OX366388,1,1784289,1786322,+,2033
53,NZ_OX366357,1,198911,200935,+,2024
53,NZ_OX366357,1,1006650,1008674,-,2024
53,NZ_CP072012,1,1223043,1225067,+,2024
53,NZ_OX366398,1,441173,443197,+,2024
53,NC_002978,6,961151,963175,+,2024
53,NZ_OX366389,1,1337585,1339609,+,2024
53,NZ_OX366397,1,1567059,1569092,+,2033
53,NZ_OX366378,1,1273647,1275680,+,2033
53,NZ_CP090903,1,961151,963175,+,2024
53,NZ_OX366374,1,354336,356360,+,2024
53,NZ_CP090901,1,961151,963175,+,2024
53,NZ_CP046923,1,939295,941319,+,2024
53,NZ_CP069055,1,1079071,1081095,-,2024
53,NZ_CP072670,1,960991,963015,+,2024
53,NZ_CP090899,1,961151,963175,+,2024
53,NZ_CP046924,1,960233,962257,+,2024
53,NZ_OX366348,1,1237259,1239283,+,2024
53,NZ_CP046921,1,1023047,1025071,+,2024
53,NZ_OX366338,1,57630,59651,-,2021
53,NZ_CP054557,1,756068,758092,+,2024
53,NZ_CP072669,1,960999,963023,+,2024
53,NC_021089,1,990517,992550,+,2033
52,NZ_OX366376,1,202455,203073,+,618
52,NZ_OX366393,1,1386346,1386964,+,618
52,NZ_OX366372,1,1254620,1255239,-,619
52,NZ_CP072672,1,960388,961015,+,627
52,NZ_CP069060,1,805328,805955,+,627
52,NZ_CP072667,1,960362,960989,+,627
52,NZ_CP072671,1,960370,960997,+,627
52,NZ_CP072668,1,960357,960984,+,627
52,NZ_CP072666,1,960370,960997,+,627
52,NZ_CP090902,1,960522,961149,+,627
52,NZ_CP090948,1,960522,961149,+,627
52,NZ_CP069052,1,850115,850743,-,628
52,NZ_CP076228,1,1022783,1023411,-,628
52,NZ_CP042445,1,960510,961137,+,627
52,NZ_CP042904,1,984224,984851,+,627
52,NC_012416,1,1023326,1023953,+,627
52,NZ_CP069053,1,805336,805963,+,627
52,NZ_CP042446,1,960520,961147,+,627
52,NZ_CP041215,1,27283,27902,-,619
52,NZ_OX366353,1,1193526,1194145,-,619
52,NZ_OX366387,1,948311,948939,-,628
52,NZ_OX366368,1,1406010,1406637,+,627
52,NZ_OX366379,1,1325455,1326082,+,627
52,NZ_CP091195,1,1113166,1113785,-,619
52,NZ_OX366375,1,1252255,1252883,-,628
52,NZ_CP046925,1,960370,960997,+,627
52,NZ_OX366318,1,1256852,1257479,+,627
52,NZ_OX366319,1,1186619,1187237,+,618
52,NZ_OX366332,1,1340091,1340709,+,618
52,NZ_CP110359,1,192826,193453,+,627
52,NZ_OU953855,1,937564,938191,+,627
52,NZ_OX366272,1,1314845,1315473,-,628
52,NZ_OX366347,1,1403336,1403963,+,627
52,NZ_OU909470,1,215322,215940,+,618
52,NZ_OX366363,1,978023,978650,+,627
52,NZ_OX366364,1,347554,348181,+,627
52,NZ_OX366359,1,1169810,1170428,+,618
52,NZ_OX366349,1,110489,111123,+,634
52,NZ_OX366380,1,757235,757862,+,627
52,NZ_OX366344,1,1097098,1097694,+,596
52,NZ_CP090900,1,960522,961149,+,627
52,NZ_OX366352,1,1663818,1664436,+,618
52,NZ_OX366362,1,484138,484759,+,621
52,NZ_OX366400,1,1113881,1114508,+,627
52,NZ_OX366327,1,1252547,1253174,+,627
52,NZ_OX366367,1,1029949,1030576,+,627
52,NZ_CP042444,1,960957,961584,+,627
52,NZ_OX366326,1,1466110,1466737,+,627
52,NZ_CP037426,1,679093,679721,-,628
52,NZ_OX366339,1,84065,84693,-,628
52,NZ_OX366355,1,1289843,1290462,-,619
52,NZ_CP046922,1,1022418,1023045,+,627
52,NZ_OX366370,1,866591,867218,+,627
52,NZ_OX366385,1,335207,335834,+,627
52,NZ_OX366399,1,1359071,1359698,+,627
52,NZ_OX366395,1,1194979,1195598,-,619
52,NZ_OX366396,1,507349,507976,+,627
52,NZ_OX366351,1,1409973,1410600,+,627
52,NZ_OX366381,1,1095566,1096184,+,618
52,NZ_OX366342,1,523755,524374,-,619
52,NZ_OX366369,1,1379064,1379683,-,619
52,NZ_OX366356,1,1123202,1123829,+,627
52,NZ_OX366377,1,1005637,1006265,-,628
52,NZ_OX366388,1,1783669,1784287,+,618
52,NZ_OX366357,1,198282,198909,+,627
52,NZ_OX366357,1,1008675,1009303,-,628
52,NZ_CP072012,1,1222414,1223041,+,627
52,NZ_OX366398,1,440544,441171,+,627
52,NC_002978,6,960522,961149,+,627
52,NZ_OX366389,1,1336956,1337583,+,627
52,NZ_OX366397,1,1566439,1567057,+,618
52,NZ_OX366378,1,1273027,1273645,+,618
52,NZ_CP090903,1,960522,961149,+,627
52,NZ_OX366374,1,353707,354334,+,627
52,NZ_CP090901,1,960522,961149,+,627
52,NZ_CP046923,1,938666,939293,+,627
52,NZ_CP069055,1,1081096,1081724,-,628
52,NZ_CP072670,1,960362,960989,+,627
52,NZ_CP090899,1,960522,961149,+,627
52,NZ_CP046924,1,959604,960231,+,627
52,NZ_OX366348,1,1236630,1237257,+,627
52,NZ_CP046921,1,1022418,1023045,+,627
52,NZ_OX366338,1,59652,60271,-,619
52,NZ_CP054557,1,755439,756066,+,627
52,NZ_CP072669,1,960370,960997,+,627
52,NC_021089,1,989897,990515,+,618
51,NZ_OX366376,1,199772,201242,+,1470
51,NZ_OX366393,1,1383663,1385133,+,1470
51,NZ_OX366372,1,1256452,1257922,-,1470
51,NZ_CP072672,1,957773,959243,+,1470
51,NZ_CP069060,1,802713,804183,+,1470
51,NZ_CP072667,1,957747,959217,+,1470
51,NZ_CP072671,1,957755,959225,+,1470
51,NZ_CP072668,1,957742,959212,+,1470
51,NZ_CP072666,1,957755,959225,+,1470
51,NZ_CP090902,1,957907,959377,+,1470
51,NZ_CP090948,1,957907,959377,+,1470
51,NZ_CP069052,1,851888,853358,-,1470
51,NZ_CP076228,1,1024553,1026023,-,1470
51,NZ_CP042445,1,957895,959365,+,1470
51,NZ_CP042904,1,981592,983062,+,1470
51,NC_012416,1,1020694,1022164,+,1470
51,NZ_CP069053,1,802721,804191,+,1470
51,NZ_CP042446,1,957905,959375,+,1470
51,NZ_CP041215,1,29057,30527,-,1470
51,NZ_OX366353,1,1195300,1196770,-,1470
51,NZ_OX366387,1,950213,951683,-,1470
51,NZ_OX366368,1,1403395,1404865,+,1470
51,NZ_OX366379,1,1322840,1324310,+,1470
51,NZ_CP091195,1,1114947,1116417,-,1470
51,NZ_OX366375,1,1254162,1255632,-,1470
51,NZ_CP046925,1,957755,959225,+,1470
51,NZ_OX366318,1,1254091,1255561,+,1470
51,NZ_OX366319,1,1183984,1185454,+,1470
51,NZ_OX366332,1,1337463,1338933,+,1470
51,NZ_CP110359,1,190194,191664,+,1470
51,NZ_OU953855,1,934932,936402,+,1470
51,NZ_OX366272,1,1316635,1318105,-,1470
51,NZ_OX366347,1,1400743,1402201,+,1458
51,NZ_OU909470,1,212715,214185,+,1470
51,NZ_OX366363,1,975391,976861,+,1470
51,NZ_OX366364,1,344823,346293,+,1470
51,NZ_OX366359,1,1167182,1168652,+,1470
51,NZ_OX366349,1,107806,109276,+,1470
51,NZ_OX366380,1,754522,755992,+,1470
51,NZ_OX366344,1,1094512,1095982,+,1470
51,NZ_CP090900,1,957907,959377,+,1470
51,NZ_OX366352,1,1661190,1662660,+,1470
51,NZ_OX366362,1,481411,482881,+,1470
51,NZ_OX366400,1,1111120,1112590,+,1470
51,NZ_OX366327,1,1249789,1251259,+,1470
51,NZ_OX366367,1,1027209,1028679,+,1470
51,NZ_CP042444,1,958342,959812,+,1470
51,NZ_OX366326,1,1463349,1464819,+,1470
51,NZ_CP037426,1,681000,682470,-,1470
51,NZ_OX366339,1,87767,89237,-,1470
51,NZ_OX366355,1,1291627,1293097,-,1470
51,NZ_CP046922,1,1019803,1021273,+,1470
51,NZ_OX366370,1,863871,865341,+,1470
51,NZ_OX366385,1,332473,333943,+,1470
51,NZ_OX366399,1,1356456,1357926,+,1470
51,NZ_OX366395,1,1196760,1198230,-,1470
51,NZ_OX366396,1,504726,506196,+,1470
51,NZ_OX366351,1,1407212,1408682,+,1470
51,NZ_OX366381,1,1092931,1094401,+,1470
51,NZ_OX366342,1,525587,527057,-,1470
51,NZ_OX366369,1,1380848,1382318,-,1470
51,NZ_OX366356,1,1120603,1122073,+,1470
51,NZ_OX366377,1,1007373,1008843,-,1470
51,NZ_OX366388,1,1781037,1782507,+,1470
51,NZ_OX366357,1,195569,197039,+,1470
51,NZ_OX366357,1,1010546,1012016,-,1470
51,NZ_CP072012,1,1219799,1221269,+,1470
51,NZ_OX366398,1,437966,439436,+,1470
51,NC_002978,6,957907,959377,+,1470
51,NZ_OX366389,1,1334378,1335848,+,1470
51,NZ_OX366397,1,1563811,1565281,+,1470
51,NZ_OX366378,1,1270395,1271865,+,1470
51,NZ_CP090903,1,957907,959377,+,1470
51,NZ_OX366374,1,350972,352442,+,1470
51,NZ_CP090901,1,957907,959377,+,1470
51,NZ_CP046923,1,936051,937521,+,1470
51,NZ_CP069055,1,1082869,1084339,-,1470
51,NZ_CP072670,1,957747,959217,+,1470
51,NZ_CP090899,1,957907,959377,+,1470
51,NZ_CP046924,1,956989,958459,+,1470
51,NZ_OX366348,1,1234015,1235485,+,1470
51,NZ_CP046921,1,1019803,1021273,+,1470
51,NZ_OX366338,1,61464,62934,-,1470
51,NZ_CP054557,1,752827,754297,+,1470
51,NZ_CP072669,1,957755,959225,+,1470
51,NC_021089,1,987282,988739,+,1457
50,NZ_OX366376,1,197809,198759,+,950
50,NZ_OX366393,1,1381700,1382650,+,950
50,NZ_OX366372,1,1258935,1259885,-,950
50,NZ_CP072672,1,956150,957100,+,950
50,NZ_CP069060,1,801090,802040,+,950
50,NZ_CP072667,1,956124,957074,+,950
50,NZ_CP072671,1,956132,957082,+,950
50,NZ_CP072668,1,956119,957069,+,950
50,NZ_CP072666,1,956132,957082,+,950
50,NZ_CP090902,1,956284,957234,+,950
50,NZ_CP090948,1,956284,957234,+,950
50,NZ_CP069052,1,854031,854981,-,950
50,NZ_CP076228,1,1026696,1027646,-,950
50,NZ_CP042445,1,956272,957222,+,950
50,NZ_CP042904,1,979978,980928,+,950
50,NC_012416,1,1019080,1020030,+,950
50,NZ_CP069053,1,801098,802048,+,950
50,NZ_CP042446,1,956282,957232,+,950
50,NZ_CP041215,1,31185,32135,-,950
50,NZ_OX366353,1,1197428,1198378,-,950
50,NZ_OX366387,1,952356,953306,-,950
50,NZ_OX366368,1,1401772,1402722,+,950
50,NZ_OX366379,1,1321217,1322167,+,950
50,NZ_CP091195,1,1117081,1118031,-,950
50,NZ_OX366375,1,1259098,1260048,-,950
50,NZ_CP046925,1,956132,957082,+,950
50,NZ_OX366318,1,1252468,1253418,+,950
50,NZ_OX366319,1,1182361,1183311,+,950
50,NZ_OX366332,1,1335855,1336805,+,950
50,NZ_CP110359,1,188571,189521,+,950
50,NZ_OU953855,1,933310,934260,+,950
50,NZ_OX366272,1,1318778,1319728,-,950
50,NZ_OX366347,1,1399135,1400085,+,950
50,NZ_OU909470,1,210737,211687,+,950
50,NZ_OX366363,1,973768,974718,+,950
50,NZ_OX366364,1,342843,343780,+,937
50,NZ_OX366359,1,1165574,1166524,+,950
50,NZ_OX366349,1,105846,106796,+,950
50,NZ_OX366380,1,752544,753494,+,950
50,NZ_OX366344,1,1092879,1093829,+,950
50,NZ_CP090900,1,956284,957234,+,950
50,NZ_OX366352,1,1659582,1660532,+,950
50,NZ_OX366362,1,479825,480775,+,950
50,NZ_OX366400,1,1109497,1110447,+,950
50,NZ_OX366327,1,1248175,1249125,+,950
50,NZ_OX366367,1,1025229,1026166,+,937
50,NZ_CP042444,1,956731,957669,+,938
50,NZ_OX366326,1,1461735,1462685,+,950
50,NZ_CP037426,1,779984,780934,-,950
50,NZ_OX366339,1,89910,90860,-,950
50,NZ_OX366355,1,1293770,1294720,-,950
50,NZ_CP046922,1,1018180,1019130,+,950
50,NZ_OX366370,1,861890,862828,+,938
50,NZ_OX366385,1,30968,31918,-,950
50,NZ_OX366399,1,1354833,1355783,+,950
50,NZ_OX366395,1,1198876,1199826,-,950
50,NZ_OX366396,1,503103,504053,+,950
50,NZ_OX366351,1,1405589,1406539,+,950
50,NZ_OX366381,1,1091308,1092258,+,950
50,NZ_OX366342,1,528070,529020,-,950
50,NZ_OX366369,1,1382991,1383941,-,950
50,NZ_OX366356,1,1118995,1119945,+,950
50,NZ_OX366377,1,1012085,1013036,-,951
50,NZ_OX366388,1,1646045,1646995,-,950
50,NZ_OX366357,1,584024,584974,+,950
50,NZ_CP072012,1,1218176,1219126,+,950
50,NZ_OX366398,1,436342,437293,+,951
50,NC_002978,6,956284,957234,+,950
50,NZ_OX366389,1,1332754,1333705,+,951
50,NZ_OX366397,1,1562203,1563153,+,950
50,NZ_OX366378,1,1268781,1269731,+,950
50,NZ_CP090903,1,956284,957234,+,950
50,NZ_OX366374,1,349376,350326,+,950
50,NZ_CP090901,1,956284,957234,+,950
50,NZ_CP046923,1,934428,935378,+,950
50,NZ_CP069055,1,1085012,1085962,-,950
50,NZ_CP072670,1,956124,957074,+,950
50,NZ_CP090899,1,956284,957234,+,950
50,NZ_CP046924,1,955366,956316,+,950
50,NZ_OX366348,1,1232392,1233342,+,950
50,NZ_CP046921,1,1018180,1019130,+,950
50,NZ_OX366338,1,63592,64542,-,950
50,NZ_CP054557,1,751204,752154,+,950
50,NZ_CP072669,1,956132,957082,+,950
50,NC_021089,1,985661,986611,+,950
49,NZ_OX366376,1,195035,195933,+,898
49,NZ_OX366393,1,1378926,1379824,+,898
49,NZ_OX366372,1,1261761,1262659,-,898
49,NZ_CP072672,1,723842,724768,-,926
49,NZ_CP069060,1,565296,566222,-,926
49,NZ_CP072667,1,723824,724750,-,926
49,NZ_CP072671,1,723824,724750,-,926
49,NZ_CP072668,1,723811,724737,-,926
49,NZ_CP072666,1,723824,724750,-,926
49,NZ_CP090902,1,723976,724902,-,926
49,NZ_CP090948,1,723976,724902,-,926
49,NZ_CP069052,1,1116285,1117211,-,926
49,NZ_CP076228,1,718750,719676,-,926
49,NZ_CP042445,1,723964,724890,-,926
49,NZ_CP042904,1,752034,752960,+,926
49,NC_012416,1,786907,787833,+,926
49,NZ_CP069053,1,565304,566230,-,926
49,NZ_CP042446,1,723976,724902,-,926
49,NZ_CP041215,1,957022,957948,+,926
49,NZ_OX366353,1,1261556,1262482,+,926
49,NZ_OX366387,1,980733,981659,-,926
49,NZ_OX366368,1,1167246,1168172,-,926
49,NZ_OX366379,1,1088631,1089557,-,926
49,NZ_CP091195,1,1530555,1531481,+,926
49,NZ_OX366375,1,1015032,1015958,-,926
49,NZ_CP046925,1,723824,724750,-,926
49,NZ_OX366318,1,1019021,1019947,-,926
49,NZ_OX366319,1,197719,198645,+,926
49,NZ_OX366332,1,1106369,1107295,-,926
49,NZ_CP110359,1,481872,482798,+,926
49,NZ_OU953855,1,246791,247717,+,926
49,NZ_OX366272,1,1346139,1347065,-,926
49,NZ_OX366347,1,738140,739066,+,926
49,NZ_OU909470,1,731466,732382,+,916
49,NZ_OX366363,1,1218747,1219673,+,926
49,NZ_OX366364,1,391813,392739,-,926
49,NZ_OX366359,1,935465,936391,-,926
49,NZ_OX366349,1,103066,103964,+,898
49,NZ_OX366380,1,319840,320756,+,916
49,NZ_OX366344,1,1090277,1091175,+,898
49,NZ_CP090900,1,723976,724902,-,926
49,NZ_OX366352,1,1280291,1281217,+,926
49,NZ_OX366362,1,239262,240188,-,926
49,NZ_OX366400,1,881417,882343,-,926
49,NZ_OX366327,1,1020446,1021372,-,926
49,NZ_OX366367,1,1081283,1082209,-,926
49,NZ_CP042444,1,724513,725439,-,926
49,NZ_OX366326,1,1225653,1226579,-,926
49,NZ_CP037426,1,813292,814218,-,926
49,NZ_OX366339,1,836359,837285,-,926
49,NZ_OX366355,1,221990,222916,+,926
49,NZ_CP046922,1,785690,786616,-,926
49,NZ_OX366370,1,972651,973549,-,898
49,NZ_OX366385,1,293065,293981,+,916
49,NZ_OX366399,1,1123259,1124185,-,926
49,NZ_OX366395,1,1356415,1357341,+,926
49,NZ_OX366396,1,1365930,1366856,+,926
49,NZ_OX366351,1,1172902,1173828,-,926
49,NZ_OX366381,1,308580,309506,+,926
49,NZ_OX366342,1,530895,531793,-,898
49,NZ_OX366369,1,1210088,1211014,-,926
49,NZ_OX366356,1,927649,928575,-,926
49,NZ_OX366377,1,1207720,1208646,+,926
49,NZ_OX366388,1,128458,129384,+,926
49,NZ_OX366357,1,590701,591627,+,926
49,NZ_CP072012,1,1457616,1458542,+,926
49,NZ_OX366398,1,692162,693088,+,926
49,NC_002978,6,723976,724902,-,926
49,NZ_OX366389,1,1153042,1153968,+,926
49,NZ_OX366397,1,1327482,1328408,-,926
49,NZ_OX366378,1,584875,585801,+,926
49,NZ_CP090903,1,723976,724902,-,926
49,NZ_OX366374,1,221261,222159,-,898
49,NZ_OX366374,1,623228,624126,+,898
49,NZ_CP090901,1,723976,724902,-,926
49,NZ_CP046923,1,701938,702864,-,926
49,NZ_CP069055,1,723022,723948,-,926
49,NZ_CP072670,1,723816,724742,-,926
49,NZ_CP090899,1,723976,724902,-,926
49,NZ_CP046924,1,722876,723802,-,926
49,NZ_OX366348,1,257881,258807,+,926
49,NZ_CP046921,1,785690,786616,-,926
49,NZ_OX366338,1,200299,201225,+,926
49,NZ_CP054557,1,1084971,1085897,+,926
49,NZ_CP072669,1,723824,724750,-,926
49,NC_021089,1,756904,757830,-,926
48,NZ_OX366376,1,192558,195018,+,2460
48,NZ_OX366393,1,1376449,1378909,+,2460
48,NZ_OX366372,1,1262676,1265136,-,2460
48,NZ_CP072672,1,724769,727208,-,2439
48,NZ_CP069060,1,566223,568662,-,2439
48,NZ_CP072667,1,724751,727190,-,2439
48,NZ_CP072671,1,724751,727190,-,2439
48,NZ_CP072668,1,724738,727177,-,2439
48,NZ_CP072666,1,724751,727190,-,2439
48,NZ_CP090902,1,724903,727342,-,2439
48,NZ_CP090948,1,724903,727342,-,2439
48,NZ_CP069052,1,1117212,1119651,-,2439
48,NZ_CP076228,1,719677,722116,-,2439
48,NZ_CP042445,1,724891,727330,-,2439
48,NZ_CP042904,1,749612,752032,+,2420
48,NC_012416,1,784485,786905,+,2420
48,NZ_CP069053,1,566231,568670,-,2439
48,NZ_CP042446,1,724903,727342,-,2439
48,NZ_CP041215,1,954591,957020,+,2429
48,NZ_OX366353,1,1259125,1261554,+,2429
48,NZ_OX366387,1,981660,984099,-,2439
48,NZ_OX366368,1,1168173,1170612,-,2439
48,NZ_OX366379,1,1089558,1091997,-,2439
48,NZ_CP091195,1,1528100,1530553,+,2453
48,NZ_OX366375,1,1015959,1018398,-,2439
48,NZ_CP046925,1,724751,727190,-,2439
48,NZ_OX366318,1,1019948,1022396,-,2448
48,NZ_OX366319,1,195279,197717,+,2438
48,NZ_OX366332,1,1107296,1109726,-,2430
48,NZ_CP110359,1,479434,481870,+,2436
48,NZ_OU953855,1,244111,246569,+,2458
48,NZ_OX366272,1,1347066,1349511,-,2445
48,NZ_OX366347,1,735703,738138,+,2435
48,NZ_OX366363,1,1216307,1218745,+,2438
48,NZ_OX366364,1,392740,395323,-,2583
48,NZ_OX366359,1,936392,938822,-,2430
48,NZ_OX366349,1,100589,103049,+,2460
48,NZ_OX366380,1,317390,319838,+,2448
48,NZ_OX366344,1,1087800,1090260,+,2460
48,NZ_CP090900,1,724903,727342,-,2439
48,NZ_OX366352,1,1277860,1280289,+,2429
48,NZ_OX366362,1,240189,242781,-,2592
48,NZ_OX366400,1,882344,884792,-,2448
48,NZ_OX366327,1,1021373,1023794,-,2421
48,NZ_OX366367,1,1082210,1084790,-,2580
48,NZ_CP042444,1,725440,727879,-,2439
48,NZ_OX366326,1,1226580,1229028,-,2448
48,NZ_CP037426,1,814219,816658,-,2439
48,NZ_OX366339,1,837286,839711,-,2425
48,NZ_OX366355,1,219550,221988,+,2438
48,NZ_CP046922,1,786617,789056,-,2439
48,NZ_OX366370,1,973566,976026,-,2460
48,NZ_OX366385,1,290615,293063,+,2448
48,NZ_OX366399,1,1124186,1126625,-,2439
48,NZ_OX366395,1,1353975,1356413,+,2438
48,NZ_OX366396,1,1363493,1365928,+,2435
48,NZ_OX366351,1,1173829,1176277,-,2448
48,NZ_OX366381,1,306140,308578,+,2438
48,NZ_OX366342,1,531810,534270,-,2460
48,NZ_OX366369,1,1211015,1213454,-,2439
48,NZ_OX366356,1,928576,931015,-,2439
48,NZ_OX366377,1,1205283,1207718,+,2435
48,NZ_OX366388,1,126036,128456,+,2420
48,NZ_OX366357,1,588264,590699,+,2435
48,NZ_CP072012,1,1455176,1457614,+,2438
48,NZ_OX366398,1,689725,692160,+,2435
48,NC_002978,6,724903,727342,-,2439
48,NZ_OX366389,1,1150605,1153040,+,2435
48,NZ_OX366397,1,1328410,1330839,-,2429
48,NZ_OX366378,1,582420,584873,+,2453
48,NZ_CP090903,1,724903,727342,-,2439
48,NZ_OX366374,1,222176,224615,-,2439
48,NZ_OX366374,1,620772,623211,+,2439
48,NZ_CP090901,1,724903,727342,-,2439
48,NZ_CP046923,1,702865,705304,-,2439
48,NZ_CP069055,1,723949,726388,-,2439
48,NZ_CP072670,1,724743,727182,-,2439
48,NZ_CP090899,1,724903,727342,-,2439
48,NZ_CP046924,1,723803,726242,-,2439
48,NZ_OX366348,1,255441,257879,+,2438
48,NZ_CP046921,1,786617,789056,-,2439
48,NZ_OX366338,1,197857,200297,+,2440
48,NZ_CP054557,1,1082531,1084969,+,2438
48,NZ_CP072669,1,724751,727190,-,2439
48,NC_021089,1,757831,760261,-,2430
47,NZ_OX366376,1,189090,190743,+,1653
47,NZ_OX366393,1,1372981,1374634,+,1653
47,NZ_OX366372,1,1266951,1268604,-,1653
47,NZ_CP072672,1,728958,730638,-,1680
47,NZ_CP069060,1,570412,572092,-,1680
47,NZ_CP072667,1,728940,730620,-,1680
47,NZ_CP072671,1,728940,730620,-,1680
47,NZ_CP072668,1,728927,730607,-,1680
47,NZ_CP072666,1,728940,730620,-,1680
47,NZ_CP090902,1,729092,730772,-,1680
47,NZ_CP090948,1,729092,730772,-,1680
47,NZ_CP069052,1,1121402,1123082,-,1680
47,NZ_CP076228,1,724786,726466,-,1680
47,NZ_CP042445,1,729080,730760,-,1680
47,NZ_CP042904,1,608544,610216,-,1672
47,NC_012416,1,644199,645871,-,1672
47,NZ_CP069053,1,570420,572100,-,1680
47,NZ_CP042446,1,729092,730772,-,1680
47,NZ_CP041215,1,951283,952955,+,1672
47,NZ_OX366353,1,1255818,1257490,+,1672
47,NZ_OX366387,1,985735,987416,-,1681
47,NZ_OX366368,1,1173281,1174961,-,1680
47,NZ_OX366379,1,1093747,1095427,-,1680
47,NZ_CP091195,1,1524869,1526541,+,1672
47,NZ_OX366375,1,1020501,1022189,-,1688
47,NZ_CP046925,1,728940,730620,-,1680
47,NZ_OX366318,1,1024146,1025826,-,1680
47,NZ_OX366319,1,191457,193145,+,1688
47,NZ_OX366332,1,1111362,1113034,-,1672
47,NZ_CP110359,1,476118,477790,+,1672
47,NZ_OU953855,1,240495,242167,+,1672
47,NZ_OX366272,1,1351147,1352819,-,1672
47,NZ_OX366347,1,732100,733761,+,1661
47,NZ_OU909470,1,162277,163927,-,1650
47,NZ_OX366363,1,1213011,1214692,+,1681
47,NZ_OX366364,1,397094,398745,-,1651
47,NZ_OX366359,1,940458,942130,-,1672
47,NZ_OX366349,1,97219,98870,+,1651
47,NZ_OX366380,1,314088,315757,+,1669
47,NZ_OX366344,1,1084687,1086340,+,1653
47,NZ_CP090900,1,729092,730772,-,1680
47,NZ_OX366352,1,1274552,1276224,+,1672
47,NZ_OX366362,1,244380,246043,-,1663
47,NZ_OX366400,1,886542,888222,-,1680
47,NZ_OX366327,1,1025409,1027090,-,1681
47,NZ_OX366367,1,1088009,1089660,-,1651
47,NZ_CP042444,1,729629,731309,-,1680
47,NZ_OX366326,1,1230778,1232458,-,1680
47,NZ_CP037426,1,818761,820449,-,1688
47,NZ_OX366339,1,841654,843326,-,1672
47,NZ_OX366355,1,215728,217416,+,1688
47,NZ_CP046922,1,790806,792486,-,1680
47,NZ_OX366370,1,977701,979368,-,1667
47,NZ_OX366385,1,286460,288129,+,1669
47,NZ_OX366399,1,1128375,1130055,-,1680
47,NZ_OX366395,1,1350731,1352403,+,1672
47,NZ_OX366396,1,1359889,1361561,+,1672
47,NZ_OX366351,1,1178027,1179707,-,1680
47,NZ_OX366381,1,302318,304006,+,1688
47,NZ_OX366342,1,536084,537737,-,1653
47,NZ_OX366369,1,1215588,1217276,-,1688
47,NZ_OX366356,1,932903,934575,-,1672
47,NZ_OX366377,1,1201866,1203546,+,1680
47,NZ_OX366388,1,122723,124404,+,1681
47,NZ_OX366357,1,1013131,1014803,-,1672
47,NZ_CP072012,1,1451746,1453426,+,1680
47,NZ_OX366398,1,686308,687988,+,1680
47,NC_002978,6,729092,730772,-,1680
47,NZ_OX366389,1,1147188,1148868,+,1680
47,NZ_OX366397,1,1332473,1334145,-,1672
47,NZ_OX366378,1,579189,580861,+,1672
47,NZ_CP090903,1,729092,730772,-,1680
47,NZ_OX366374,1,55387,57059,-,1672
47,NZ_CP090901,1,729092,730772,-,1680
47,NZ_CP046923,1,707054,708734,-,1680
47,NZ_CP069055,1,728138,729818,-,1680
47,NZ_CP072670,1,728932,730612,-,1680
47,NZ_CP090899,1,729092,730772,-,1680
47,NZ_CP046924,1,727992,729672,-,1680
47,NZ_OX366348,1,252146,253827,+,1681
47,NZ_CP046921,1,790806,792486,-,1680
47,NZ_OX366338,1,1244599,1246235,-,1636
47,NZ_CP054557,1,1078381,1080062,+,1681
47,NZ_CP072669,1,728940,730620,-,1680
47,NC_021089,1,761896,763568,-,1672
46,NZ_OX366376,1,187171,188608,+,1437
46,NZ_OX366393,1,1370704,1372141,+,1437
46,NZ_OX366372,1,1269086,1270523,-,1437
46,NZ_CP072672,1,1232206,1233647,+,1441
46,NZ_CP069060,1,1373105,1374546,+,1441
46,NZ_CP072667,1,1232180,1233621,+,1441
46,NZ_CP072671,1,1232188,1233629,+,1441
46,NZ_CP072668,1,1232175,1233616,+,1441
46,NZ_CP072666,1,1232188,1233629,+,1441
46,NZ_CP090902,1,1232341,1233782,+,1441
46,NZ_CP090948,1,1232339,1233780,+,1441
46,NZ_CP069052,1,1317405,1318846,+,1441
46,NZ_CP076228,1,1253076,1254517,+,1441
46,NZ_CP042445,1,1231993,1233434,+,1441
46,NZ_CP042904,1,1362837,1364278,+,1441
46,NC_012416,1,1406046,1407487,+,1441
46,NZ_CP069053,1,1358403,1359844,+,1441
46,NZ_CP042446,1,1232338,1233779,+,1441
46,NZ_CP041215,1,616429,617870,-,1441
46,NZ_OX366353,1,605878,607319,-,1441
46,NZ_OX366387,1,609578,611019,-,1441
46,NZ_OX366368,1,245761,247202,+,1441
46,NZ_OX366379,1,246779,248220,+,1441
46,NZ_CP091195,1,890260,891701,-,1441
46,NZ_OX366375,1,264489,265930,+,1441
46,NZ_CP046925,1,1232188,1233629,+,1441
46,NZ_OX366318,1,336147,337588,+,1441
46,NZ_OX366319,1,956803,958244,-,1441
46,NZ_OX366332,1,243734,245175,+,1441
46,NZ_CP110359,1,1271964,1273405,+,1441
46,NZ_OU953855,1,762318,763759,+,1441
46,NZ_OX366272,1,1121007,1122448,-,1441
46,NZ_OX366347,1,355074,356515,+,1441
46,NZ_OU909470,1,669522,670956,-,1434
46,NZ_OX366363,1,692604,694045,-,1441
46,NZ_OX366364,1,118854,120304,-,1450
46,NZ_OX366359,1,242573,244014,+,1441
46,NZ_OX366349,1,1634554,1635984,-,1430
46,NZ_OX366380,1,83439,84873,-,1434
46,NZ_OX366344,1,745196,746633,+,1437
46,NZ_CP090900,1,1232343,1233784,+,1441
46,NZ_OX366352,1,1446223,1447664,-,1441
46,NZ_OX366362,1,1080602,1082036,+,1434
46,NZ_OX366400,1,245128,246569,+,1441
46,NZ_OX366327,1,246745,248186,+,1441
46,NZ_OX366367,1,1433664,1435105,+,1441
46,NZ_CP042444,1,1233694,1235135,+,1441
46,NZ_OX366326,1,547925,549366,-,1441
46,NZ_CP037426,1,1316268,1317709,+,1441
46,NZ_OX366339,1,1289325,1290766,-,1441
46,NZ_OX366355,1,1072558,1073999,-,1441
46,NZ_CP046922,1,1294143,1295584,+,1441
46,NZ_OX366370,1,1110997,1112427,-,1430
46,NZ_OX366385,1,1127873,1129307,+,1434
46,NZ_OX366399,1,245263,246704,+,1441
46,NZ_OX366395,1,351567,353001,-,1434
46,NZ_OX366396,1,1219475,1220916,-,1441
46,NZ_OX366351,1,255765,257206,+,1441
46,NZ_OX366381,1,1140459,1141900,-,1441
46,NZ_OX366342,1,538039,539476,-,1437
46,NZ_OX366369,1,239523,240964,+,1441
46,NZ_OX366356,1,275904,277338,+,1434
46,NZ_OX366377,1,338959,340400,-,1441
46,NZ_OX366388,1,1533089,1534530,-,1441
46,NZ_OX366357,1,1156530,1157971,-,1441
46,NZ_CP072012,1,1070847,1072288,-,1441
46,NZ_OX366398,1,947482,948923,-,1441
46,NC_002978,6,1232339,1233780,+,1441
46,NZ_OX366389,1,301777,303218,+,1441
46,NZ_OX366397,1,243439,244880,+,1441
46,NZ_OX366378,1,1024128,1025569,+,1441
46,NZ_CP090903,1,1232343,1233784,+,1441
46,NZ_OX366374,1,1163105,1164542,-,1437
46,NZ_CP090901,1,1232343,1233784,+,1441
46,NZ_CP046923,1,1210391,1211832,+,1441
46,NZ_CP069055,1,1232477,1233918,+,1441
46,NZ_CP072670,1,1232168,1233609,+,1441
46,NZ_CP090899,1,1232343,1233784,+,1441
46,NZ_CP046924,1,1231329,1232770,+,1441
46,NZ_OX366348,1,1005810,1007238,-,1428
46,NZ_CP046921,1,1294143,1295584,+,1441
46,NZ_OX366338,1,1439226,1440663,+,1437
46,NZ_CP054557,1,570781,572222,-,1441
46,NZ_CP072669,1,1232191,1233632,+,1441
46,NC_021089,1,1258891,1260332,+,1441
45,NZ_OX366376,1,183992,185571,+,1579
45,NZ_OX366393,1,1367525,1369104,+,1579
45,NZ_OX366372,1,1272123,1273701,-,1578
45,NZ_CP072672,1,1164571,1166151,+,1580
45,NZ_CP069060,1,1016571,1018151,+,1580
45,NZ_CP072667,1,1164545,1166125,+,1580
45,NZ_CP072671,1,1164553,1166133,+,1580
45,NZ_CP072668,1,1164540,1166120,+,1580
45,NZ_CP072666,1,1164553,1166133,+,1580
45,NZ_CP090902,1,1164705,1166285,+,1580
45,NZ_CP090948,1,1164703,1166283,+,1580
45,NZ_CP069052,1,979363,980942,-,1579
45,NZ_CP076228,1,1183280,1184860,+,1580
45,NZ_CP042445,1,1164693,1166273,+,1580
45,NZ_CP042904,1,1241598,1243178,+,1580
45,NC_012416,1,1286814,1288394,+,1580
45,NZ_CP069053,1,1016603,1018183,+,1580
45,NZ_CP042446,1,1164703,1166283,+,1580
45,NZ_CP041215,1,188495,190075,+,1580
45,NZ_OX366353,1,646716,648295,-,1579
45,NZ_OX366387,1,409489,411068,-,1579
45,NZ_OX366368,1,177748,179328,+,1580
45,NZ_OX366379,1,177847,179427,+,1580
45,NZ_CP091195,1,1423118,1424698,+,1580
45,NZ_OX366375,1,179804,181384,+,1580
45,NZ_CP046925,1,1164553,1166133,+,1580
45,NZ_OX366318,1,173877,175457,+,1580
45,NZ_OX366319,1,1022794,1024373,-,1579
45,NZ_OX366332,1,176083,177663,+,1580
45,NZ_CP110359,1,1202172,1203752,+,1580
45,NZ_OU953855,1,452852,454432,+,1580
45,NZ_OX366272,1,274938,276518,+,1580
45,NZ_OX366347,1,288482,290062,+,1580
45,NZ_OU909470,1,1089876,1091455,+,1579
45,NZ_OX366363,1,761536,763115,-,1579
45,NZ_OX366364,1,135276,136855,-,1579
45,NZ_OX366359,1,175209,176789,+,1580
45,NZ_OX366380,1,1215607,1217186,+,1579
45,NZ_OX366344,1,1184109,1185687,-,1578
45,NZ_CP090900,1,1164707,1166287,+,1580
45,NZ_OX366352,1,1513743,1515322,-,1579
45,NZ_OX366362,1,1082206,1083785,-,1579
45,NZ_OX366400,1,176996,178576,+,1580
45,NZ_OX366327,1,175495,177075,+,1580
45,NZ_OX366367,1,1418141,1419721,+,1580
45,NZ_CP042444,1,1166059,1167639,+,1580
45,NZ_OX366326,1,177598,179178,+,1580
45,NZ_CP037426,1,963599,965178,-,1579
45,NZ_OX366339,1,1200797,1202377,+,1580
45,NZ_OX366355,1,1139569,1141148,-,1579
45,NZ_CP046922,1,1226508,1228088,+,1580
45,NZ_OX366370,1,1114232,1115810,-,1578
45,NZ_OX366385,1,115759,117337,-,1578
45,NZ_OX366399,1,177250,178830,+,1580
45,NZ_OX366395,1,318401,319981,+,1580
45,NZ_OX366396,1,50868,52448,+,1580
45,NZ_OX366351,1,230285,231864,-,1579
45,NZ_OX366381,1,1206450,1208029,-,1579
45,NZ_OX366342,1,541076,542654,-,1578
45,NZ_OX366369,1,173270,174850,+,1580
45,NZ_OX366356,1,209100,210678,+,1578
45,NZ_OX366377,1,179483,181063,+,1580
45,NZ_OX366388,1,1621172,1622752,+,1580
45,NZ_OX366357,1,1083331,1084909,-,1578
45,NZ_CP072012,1,1137618,1139197,-,1579
45,NZ_OX366398,1,826273,827853,+,1580
45,NC_002978,6,1164703,1166283,+,1580
45,NZ_OX366389,1,71610,73189,-,1579
45,NZ_OX366397,1,175781,177361,+,1580
45,NZ_OX366378,1,1082984,1084564,+,1580
45,NZ_CP090903,1,1164707,1166287,+,1580
45,NZ_OX366374,1,121874,123454,+,1580
45,NZ_CP090901,1,1164707,1166287,+,1580
45,NZ_CP046923,1,1142756,1144336,+,1580
45,NZ_CP069055,1,1164661,1166241,+,1580
45,NZ_CP072670,1,1164533,1166113,+,1580
45,NZ_CP090899,1,1164707,1166287,+,1580
45,NZ_CP046924,1,1163694,1165274,+,1580
45,NZ_OX366348,1,1072766,1074345,-,1579
45,NZ_CP046921,1,1226508,1228088,+,1580
45,NZ_OX366338,1,248572,250145,+,1573
45,NZ_CP054557,1,640143,641722,-,1579
45,NZ_CP072669,1,1164553,1166133,+,1580
45,NC_021089,1,1192316,1193896,+,1580
44,NZ_OX366376,1,181198,183991,+,2793
44,NZ_OX366393,1,1364731,1367524,+,2793
44,NZ_OX366372,1,1273703,1276496,-,2793
44,NZ_CP072672,1,1161777,1164570,+,2793
44,NZ_CP069060,1,1013777,1016570,+,2793
44,NZ_CP072667,1,1161751,1164544,+,2793
44,NZ_CP072671,1,1161759,1164552,+,2793
44,NZ_CP072668,1,1161746,1164539,+,2793
44,NZ_CP072666,1,1161759,1164552,+,2793
44,NZ_CP090902,1,1161911,1164704,+,2793
44,NZ_CP090948,1,1161908,1164702,+,2794
44,NZ_CP069052,1,980944,983737,-,2793
44,NZ_CP076228,1,1180486,1183279,+,2793
44,NZ_CP042445,1,1161899,1164692,+,2793
44,NZ_CP042904,1,1238801,1241597,+,2796
44,NC_012416,1,1284017,1286813,+,2796
44,NZ_CP069053,1,1013809,1016602,+,2793
44,NZ_CP042446,1,1161909,1164702,+,2793
44,NZ_CP041215,1,185698,188494,+,2796
44,NZ_OX366353,1,648297,651093,-,2796
44,NZ_OX366387,1,411070,413863,-,2793
44,NZ_OX366368,1,174954,177747,+,2793
44,NZ_OX366379,1,175053,177846,+,2793
44,NZ_CP091195,1,1420324,1423117,+,2793
44,NZ_OX366375,1,177010,179803,+,2793
44,NZ_CP046925,1,1161759,1164552,+,2793
44,NZ_OX366318,1,171083,173876,+,2793
44,NZ_OX366319,1,1024375,1027171,-,2796
44,NZ_OX366332,1,173286,176082,+,2796
44,NZ_CP110359,1,1199375,1202171,+,2796
44,NZ_OU953855,1,450058,452851,+,2793
44,NZ_OX366272,1,272141,274937,+,2796
44,NZ_OX366347,1,285685,288481,+,2796
44,NZ_OU909470,1,1087082,1089875,+,2793
44,NZ_OX366363,1,763117,765910,-,2793
44,NZ_OX366364,1,136857,139650,-,2793
44,NZ_OX366359,1,172412,175208,+,2796
44,NZ_OX366349,1,1636389,1639182,-,2793
44,NZ_OX366380,1,1212814,1215606,+,2792
44,NZ_OX366344,1,1185689,1188482,-,2793
44,NZ_CP090900,1,1161912,1164706,+,2794
44,NZ_OX366352,1,1515324,1518120,-,2796
44,NZ_OX366362,1,1083787,1086580,-,2793
44,NZ_OX366400,1,174202,176995,+,2793
44,NZ_OX366327,1,172701,175494,+,2793
44,NZ_OX366367,1,1415347,1418140,+,2793
44,NZ_CP042444,1,1163265,1166058,+,2793
44,NZ_OX366326,1,174804,177597,+,2793
44,NZ_CP037426,1,965180,967973,-,2793
44,NZ_OX366339,1,1198003,1200796,+,2793
44,NZ_OX366355,1,1141150,1143946,-,2796
44,NZ_CP046922,1,1223714,1226507,+,2793
44,NZ_OX366370,1,1115812,1118605,-,2793
44,NZ_OX366385,1,117339,120128,-,2789
44,NZ_OX366399,1,174456,177249,+,2793
44,NZ_OX366395,1,315607,318400,+,2793
44,NZ_OX366396,1,48074,50867,+,2793
44,NZ_OX366351,1,231866,234659,-,2793
44,NZ_OX366381,1,1208031,1210827,-,2796
44,NZ_OX366342,1,542656,545449,-,2793
44,NZ_OX366369,1,170473,173269,+,2796
44,NZ_OX366356,1,206308,209099,+,2791
44,NZ_OX366377,1,176689,179482,+,2793
44,NZ_OX366388,1,1618378,1621171,+,2793
44,NZ_OX366357,1,1084911,1087704,-,2793
44,NZ_CP072012,1,1139199,1141992,-,2793
44,NZ_OX366398,1,823479,826272,+,2793
44,NC_002978,6,1161908,1164702,+,2794
44,NZ_OX366389,1,73191,75984,-,2793
44,NZ_OX366397,1,172984,175780,+,2796
44,NZ_OX366378,1,1080190,1082983,+,2793
44,NZ_CP090903,1,1161912,1164706,+,2794
44,NZ_OX366374,1,119080,121873,+,2793
44,NZ_CP090901,1,1161912,1164706,+,2794
44,NZ_CP046923,1,1139962,1142755,+,2793
44,NZ_CP069055,1,1161867,1164660,+,2793
44,NZ_CP072670,1,1161739,1164532,+,2793
44,NZ_CP090899,1,1161912,1164706,+,2794
44,NZ_CP046924,1,1160900,1163693,+,2793
44,NZ_OX366348,1,1074347,1077140,-,2793
44,NZ_CP046921,1,1223714,1226507,+,2793
44,NZ_OX366338,1,245778,248571,+,2793
44,NZ_CP054557,1,641724,644517,-,2793
44,NZ_CP072669,1,1161759,1164552,+,2793
44,NC_021089,1,1189519,1192315,+,2796
43,NZ_OX366376,1,180337,181196,+,859
43,NZ_OX366393,1,1363870,1364729,+,859
43,NZ_OX366372,1,1276497,1277357,-,860
43,NZ_CP072672,1,1160916,1161775,+,859
43,NZ_CP069060,1,1012916,1013775,+,859
43,NZ_CP072667,1,1160890,1161749,+,859
43,NZ_CP072671,1,1160898,1161757,+,859
43,NZ_CP072668,1,1160885,1161744,+,859
43,NZ_CP072666,1,1160898,1161757,+,859
43,NZ_CP090902,1,1161050,1161909,+,859
43,NZ_CP090948,1,1161048,1161906,+,858
43,NZ_CP069052,1,983738,984598,-,860
43,NZ_CP076228,1,1179625,1180484,+,859
43,NZ_CP042445,1,1161038,1161897,+,859
43,NZ_CP042904,1,1237940,1238799,+,859
43,NC_012416,1,1283156,1284015,+,859
43,NZ_CP069053,1,1012948,1013807,+,859
43,NZ_CP042446,1,1161048,1161907,+,859
43,NZ_CP041215,1,184837,185696,+,859
43,NZ_OX366353,1,651094,651954,-,860
43,NZ_OX366387,1,413864,414724,-,860
43,NZ_OX366368,1,174093,174952,+,859
43,NZ_OX366379,1,174192,175051,+,859
43,NZ_CP091195,1,1419463,1420322,+,859
43,NZ_OX366375,1,176149,177008,+,859
43,NZ_CP046925,1,1160898,1161757,+,859
43,NZ_OX366318,1,170222,171081,+,859
43,NZ_OX366319,1,1027172,1028032,-,860
43,NZ_OX366332,1,172425,173284,+,859
43,NZ_CP110359,1,1198514,1199373,+,859
43,NZ_OU953855,1,449197,450056,+,859
43,NZ_OX366272,1,271280,272139,+,859
43,NZ_OX366347,1,284824,285683,+,859
43,NZ_OU909470,1,1086221,1087080,+,859
43,NZ_OX366363,1,765911,766771,-,860
43,NZ_OX366364,1,139651,140511,-,860
43,NZ_OX366359,1,171551,172410,+,859
43,NZ_OX366349,1,1639183,1640043,-,860
43,NZ_OX366380,1,1211086,1211951,+,865
43,NZ_OX366344,1,1188483,1189343,-,860
43,NZ_CP090900,1,1161051,1161910,+,859
43,NZ_OX366352,1,1518121,1518981,-,860
43,NZ_OX366362,1,1086581,1087441,-,860
43,NZ_OX366400,1,173341,174200,+,859
43,NZ_OX366327,1,171840,172699,+,859
43,NZ_OX366367,1,1414486,1415345,+,859
43,NZ_CP042444,1,1162404,1163263,+,859
43,NZ_OX366326,1,173943,174802,+,859
43,NZ_CP037426,1,967974,968834,-,860
43,NZ_OX366339,1,1197142,1198001,+,859
43,NZ_OX366355,1,1143947,1144807,-,860
43,NZ_CP046922,1,1222853,1223712,+,859
43,NZ_OX366370,1,1118606,1119466,-,860
43,NZ_OX366385,1,631299,632164,+,865
43,NZ_OX366399,1,173595,174454,+,859
43,NZ_OX366395,1,314746,315605,+,859
43,NZ_OX366396,1,47213,48072,+,859
43,NZ_OX366351,1,234660,235520,-,860
43,NZ_OX366381,1,1210828,1211688,-,860
43,NZ_OX366342,1,545450,546310,-,860
43,NZ_OX366369,1,169612,170471,+,859
43,NZ_OX366356,1,205447,206306,+,859
43,NZ_OX366377,1,175828,176687,+,859
43,NZ_OX366388,1,1617517,1618376,+,859
43,NZ_OX366357,1,1087705,1088565,-,860
43,NZ_CP072012,1,1141993,1142853,-,860
43,NZ_OX366398,1,822618,823477,+,859
43,NC_002978,6,1161048,1161906,+,858
43,NZ_OX366389,1,75985,76845,-,860
43,NZ_OX366397,1,172123,172982,+,859
43,NZ_OX366378,1,1079329,1080188,+,859
43,NZ_CP090903,1,1161051,1161910,+,859
43,NZ_OX366374,1,118219,119078,+,859
43,NZ_CP090901,1,1161051,1161910,+,859
43,NZ_CP046923,1,1139101,1139960,+,859
43,NZ_CP069055,1,1161006,1161865,+,859
43,NZ_CP072670,1,1160878,1161737,+,859
43,NZ_CP090899,1,1161051,1161910,+,859
43,NZ_CP046924,1,1160039,1160898,+,859
43,NZ_OX366348,1,1077141,1078001,-,860
43,NZ_CP046921,1,1222853,1223712,+,859
43,NZ_OX366338,1,244917,245776,+,859
43,NZ_CP054557,1,644518,645378,-,860
43,NZ_CP072669,1,1160898,1161757,+,859
43,NC_021089,1,1188658,1189517,+,859
42,NZ_OX366376,1,179125,179926,+,801
42,NZ_OX366393,1,1362659,1363459,+,800
42,NZ_OX366372,1,1277768,1278569,-,801
42,NZ_CP072672,1,1158749,1159550,+,801
42,NZ_CP069060,1,1009306,1010107,+,801
42,NZ_CP072667,1,1158723,1159524,+,801
42,NZ_CP072671,1,1158731,1159532,+,801
42,NZ_CP072668,1,1158718,1159519,+,801
42,NZ_CP072666,1,1158731,1159532,+,801
42,NZ_CP090902,1,1158883,1159684,+,801
42,NZ_CP090948,1,1158881,1159682,+,801
42,NZ_CP069052,1,987407,988208,-,801
42,NZ_CP076228,1,1177460,1178261,+,801
42,NZ_CP042445,1,1158871,1159672,+,801
42,NZ_CP042904,1,1235848,1236649,+,801
42,NC_012416,1,1281064,1281865,+,801
42,NZ_CP069053,1,1009338,1010139,+,801
42,NZ_CP042446,1,1158881,1159682,+,801
42,NZ_CP041215,1,182670,183471,+,801
42,NZ_OX366353,1,653317,654118,-,801
42,NZ_OX366387,1,416089,416890,-,801
42,NZ_OX366368,1,171927,172728,+,801
42,NZ_OX366379,1,172025,172826,+,801
42,NZ_CP091195,1,1213607,1214408,+,801
42,NZ_OX366375,1,173983,174784,+,801
42,NZ_CP046925,1,1158731,1159532,+,801
42,NZ_OX366318,1,168055,168856,+,801
42,NZ_OX366319,1,1029398,1030199,-,801
42,NZ_OX366332,1,170258,171059,+,801
42,NZ_CP110359,1,1196420,1197224,+,804
42,NZ_OU953855,1,1722119,1722920,+,801
42,NZ_OX366272,1,269189,269990,+,801
42,NZ_OX366347,1,282657,283458,+,801
42,NZ_OU909470,1,1085311,1086112,+,801
42,NZ_OX366363,1,768136,768937,-,801
42,NZ_OX366364,1,140619,141420,-,801
42,NZ_OX366359,1,169384,170185,+,801
42,NZ_OX366349,1,1640454,1641255,-,801
42,NZ_OX366380,1,1210176,1210977,+,801
42,NZ_OX366344,1,1189754,1190555,-,801
42,NZ_CP090900,1,1158884,1159685,+,801
42,NZ_OX366352,1,1520347,1521148,-,801
42,NZ_OX366362,1,1088863,1089664,-,801
42,NZ_OX366400,1,171174,171975,+,801
42,NZ_OX366327,1,169673,170474,+,801
42,NZ_OX366367,1,1413577,1414378,+,801
42,NZ_CP042444,1,1160237,1161038,+,801
42,NZ_OX366326,1,171777,172578,+,801
42,NZ_CP037426,1,970199,971000,-,801
42,NZ_OX366339,1,1194976,1195777,+,801
42,NZ_OX366355,1,1146173,1146974,-,801
42,NZ_CP046922,1,1220686,1221487,+,801
42,NZ_OX366370,1,1092960,1093761,-,801
42,NZ_OX366385,1,630389,631190,+,801
42,NZ_OX366399,1,171428,172229,+,801
42,NZ_OX366395,1,312593,313394,+,801
42,NZ_OX366396,1,45047,45848,+,801
42,NZ_OX366351,1,236886,237687,-,801
42,NZ_OX366381,1,1213054,1213855,-,801
42,NZ_OX366342,1,546721,547522,-,801
42,NZ_OX366369,1,167445,168246,+,801
42,NZ_OX366356,1,203177,203978,+,801
42,NZ_OX366377,1,173662,174463,+,801
42,NZ_OX366388,1,1615425,1616226,+,801
42,NZ_OX366357,1,931417,932218,+,801
42,NZ_CP072012,1,1144219,1145020,-,801
42,NZ_OX366398,1,820452,821253,+,801
42,NC_002978,6,1158881,1159682,+,801
42,NZ_OX366389,1,78209,79010,-,801
42,NZ_OX366397,1,169956,170757,+,801
42,NZ_OX366378,1,1143936,1144737,-,801
42,NZ_CP090903,1,1158884,1159685,+,801
42,NZ_OX366374,1,112992,113793,+,801
42,NZ_CP090901,1,1158884,1159685,+,801
42,NZ_CP046923,1,1136934,1137735,+,801
42,NZ_CP069055,1,1158839,1159640,+,801
42,NZ_CP072670,1,1158711,1159512,+,801
42,NZ_CP090899,1,1158884,1159685,+,801
42,NZ_CP046924,1,1157872,1158673,+,801
42,NZ_OX366348,1,1079364,1080165,-,801
42,NZ_CP046921,1,1220686,1221487,+,801
42,NZ_OX366338,1,241731,242532,+,801
42,NZ_CP054557,1,646743,647544,-,801
42,NZ_CP072669,1,1158731,1159532,+,801
42,NC_021089,1,1186491,1187292,+,801
41,NZ_OX366376,1,176429,178987,+,2558
41,NZ_OX366393,1,1359962,1362520,+,2558
41,NZ_OX366372,1,1278707,1281265,-,2558
41,NZ_CP072672,1,1156006,1158634,+,2628
41,NZ_CP069060,1,1006563,1009191,+,2628
41,NZ_CP072667,1,1155980,1158608,+,2628
41,NZ_CP072671,1,1155988,1158616,+,2628
41,NZ_CP072668,1,1155975,1158603,+,2628
41,NZ_CP072666,1,1155988,1158616,+,2628
41,NZ_CP090902,1,1156140,1158768,+,2628
41,NZ_CP090948,1,1156138,1158766,+,2628
41,NZ_CP069052,1,988323,990951,-,2628
41,NZ_CP076228,1,1174717,1177345,+,2628
41,NZ_CP042445,1,1156128,1158756,+,2628
41,NZ_CP042904,1,1233105,1235733,+,2628
41,NC_012416,1,1278321,1280949,+,2628
41,NZ_CP069053,1,1006595,1009223,+,2628
41,NZ_CP042446,1,1156138,1158766,+,2628
41,NZ_CP041215,1,179936,182564,+,2628
41,NZ_OX366353,1,654224,656852,-,2628
41,NZ_OX366387,1,195529,198157,+,2628
41,NZ_OX366368,1,169184,171812,+,2628
41,NZ_OX366379,1,169282,171910,+,2628
41,NZ_CP091195,1,1210864,1213492,+,2628
41,NZ_OX366375,1,171249,173877,+,2628
41,NZ_CP046925,1,1155988,1158616,+,2628
41,NZ_OX366318,1,165312,167940,+,2628
41,NZ_OX366319,1,1030305,1032933,-,2628
41,NZ_OX366332,1,167524,170152,+,2628
41,NZ_CP110359,1,1193677,1196305,+,2628
41,NZ_OU953855,1,1719376,1722004,+,2628
41,NZ_OX366272,1,266446,269074,+,2628
41,NZ_OX366347,1,279923,282551,+,2628
41,NZ_OU909470,1,1082592,1085198,+,2606
41,NZ_OX366363,1,769052,771680,-,2628
41,NZ_OX366364,1,233945,236574,+,2629
41,NZ_OX366359,1,166650,169278,+,2628
41,NZ_OX366349,1,1641393,1643951,-,2558
41,NZ_OX366380,1,1207432,1210055,+,2623
41,NZ_OX366344,1,1190693,1193251,-,2558
41,NZ_CP090900,1,1156141,1158769,+,2628
41,NZ_OX366352,1,1521254,1523882,-,2628
41,NZ_OX366362,1,1089794,1092398,-,2604
41,NZ_OX366400,1,168431,171059,+,2628
41,NZ_OX366327,1,166931,169560,+,2629
41,NZ_OX366367,1,1410843,1413471,+,2628
41,NZ_CP042444,1,1157494,1160122,+,2628
41,NZ_OX366326,1,169034,171662,+,2628
41,NZ_CP037426,1,971106,973734,-,2628
41,NZ_OX366339,1,1192233,1194861,+,2628
41,NZ_OX366355,1,1147080,1149708,-,2628
41,NZ_CP046922,1,1217943,1220571,+,2628
41,NZ_OX366370,1,1093899,1096457,-,2558
41,NZ_OX366385,1,627645,630268,+,2623
41,NZ_OX366399,1,168685,171313,+,2628
41,NZ_OX366395,1,309859,312487,+,2628
41,NZ_OX366396,1,42304,44932,+,2628
41,NZ_OX366351,1,237802,240430,-,2628
41,NZ_OX366381,1,1213961,1216589,-,2628
41,NZ_OX366342,1,547660,550218,-,2558
41,NZ_OX366369,1,164711,167339,+,2628
41,NZ_OX366356,1,200443,203071,+,2628
41,NZ_OX366377,1,170919,173547,+,2628
41,NZ_OX366388,1,1612682,1615310,+,2628
41,NZ_OX366357,1,928683,931310,+,2627
41,NZ_CP072012,1,1145135,1147763,-,2628
41,NZ_OX366398,1,817709,820337,+,2628
41,NC_002978,6,1156138,1158766,+,2628
41,NZ_OX366389,1,79125,81753,-,2628
41,NZ_OX366397,1,167222,169850,+,2628
41,NZ_OX366378,1,1144852,1147480,-,2628
41,NZ_CP090903,1,1156141,1158769,+,2628
41,NZ_OX366374,1,110258,112886,+,2628
41,NZ_CP090901,1,1156141,1158769,+,2628
41,NZ_CP046923,1,1134191,1136819,+,2628
41,NZ_CP069055,1,1156096,1158724,+,2628
41,NZ_CP072670,1,1155968,1158596,+,2628
41,NZ_CP090899,1,1156141,1158769,+,2628
41,NZ_CP046924,1,1155129,1157757,+,2628
41,NZ_OX366348,1,1080280,1082908,-,2628
41,NZ_CP046921,1,1217943,1220571,+,2628
41,NZ_OX366338,1,238997,241625,+,2628
41,NZ_CP054557,1,647659,650287,-,2628
41,NZ_CP072669,1,1155988,1158616,+,2628
41,NC_021089,1,1183757,1186385,+,2628
40,NZ_OX366376,1,173458,174467,+,1009
40,NZ_OX366393,1,1356991,1358000,+,1009
40,NZ_OX366372,1,1283227,1284236,-,1009
40,NZ_CP072672,1,765149,766158,+,1009
40,NZ_CP069060,1,608107,609116,+,1009
40,NZ_CP072667,1,765131,766140,+,1009
40,NZ_CP072671,1,765131,766140,+,1009
40,NZ_CP072668,1,765118,766127,+,1009
40,NZ_CP072666,1,765131,766140,+,1009
40,NZ_CP090902,1,765283,766292,+,1009
40,NZ_CP090948,1,765283,766292,+,1009
40,NZ_CP069052,1,1159097,1160106,+,1009
40,NZ_CP076228,1,773769,774778,-,1009
40,NZ_CP042445,1,765271,766280,+,1009
40,NZ_CP042904,1,647948,648957,+,1009
40,NC_012416,1,683601,684610,+,1009
40,NZ_CP069053,1,608115,609124,+,1009
40,NZ_CP042446,1,765283,766292,+,1009
40,NZ_CP041215,1,915798,916807,-,1009
40,NZ_OX366353,1,186142,187151,+,1009
40,NZ_OX366387,1,687661,688670,-,1009
40,NZ_OX366368,1,1211178,1212187,+,1009
40,NZ_OX366379,1,1130693,1131702,+,1009
40,NZ_CP091195,1,1490487,1491492,-,1005
40,NZ_OX366375,1,1057250,1058259,+,1009
40,NZ_CP046925,1,765131,766140,+,1009
40,NZ_OX366318,1,1062964,1063965,+,1001
40,NZ_OX366319,1,157812,158821,-,1009
40,NZ_OX366332,1,1147118,1148127,+,1009
40,NZ_CP110359,1,441971,442976,-,1005
40,NZ_OU953855,1,205904,206909,-,1005
40,NZ_OX366272,1,1214557,1215562,+,1005
40,NZ_OX366347,1,195298,196303,+,1005
40,NZ_OU909470,1,962369,963378,-,1009
40,NZ_OX366363,1,1178609,1179614,-,1005
40,NZ_OX366364,1,277473,278482,-,1009
40,NZ_OX366359,1,974926,975935,+,1009
40,NZ_OX366349,1,1645312,1646321,-,1009
40,NZ_OX366380,1,1318658,1319664,+,1006
40,NZ_OX366344,1,1194794,1195803,-,1009
40,NZ_CP090900,1,765283,766292,+,1009
40,NZ_OX366352,1,1240007,1241016,-,1009
40,NZ_OX366362,1,236806,237815,-,1009
40,NZ_OX366400,1,926382,927383,+,1001
40,NZ_OX366327,1,1062024,1063033,+,1009
40,NZ_OX366367,1,82813,83822,-,1009
40,NZ_CP042444,1,765718,766727,+,1009
40,NZ_OX366326,1,1270615,1271616,+,1001
40,NZ_CP037426,1,855730,856739,+,1009
40,NZ_OX366339,1,930876,931885,-,1009
40,NZ_OX366355,1,182030,183039,-,1009
40,NZ_CP046922,1,827096,828105,+,1009
40,NZ_OX366370,1,1098452,1099456,-,1004
40,NZ_OX366385,1,1334325,1335331,-,1006
40,NZ_OX366399,1,1165321,1166330,+,1009
40,NZ_OX366395,1,132950,133959,-,1009
40,NZ_OX366396,1,1339746,1340755,+,1009
40,NZ_OX366351,1,1217040,1218041,+,1001
40,NZ_OX366381,1,268521,269530,-,1009
40,NZ_OX366342,1,552180,553189,-,1009
40,NZ_OX366369,1,1250868,1251877,+,1009
40,NZ_OX366356,1,968422,969431,+,1009
40,NZ_OX366377,1,1163458,1164467,-,1009
40,NZ_OX366388,1,246382,247387,+,1005
40,NZ_OX366357,1,1168815,1169824,-,1009
40,NZ_CP072012,1,1415552,1416561,-,1009
40,NZ_OX366398,1,244940,245949,+,1009
40,NC_002978,6,765283,766292,+,1009
40,NZ_OX366389,1,1111238,1112247,-,1009
40,NZ_OX366397,1,1368651,1369660,+,1009
40,NZ_OX366378,1,544906,545911,-,1005
40,NZ_CP090903,1,765283,766292,+,1009
40,NZ_OX366374,1,19745,20754,-,1009
40,NZ_CP090901,1,765283,766292,+,1009
40,NZ_CP046923,1,743344,744353,+,1009
40,NZ_CP069055,1,764385,765394,+,1009
40,NZ_CP072670,1,765123,766132,+,1009
40,NZ_CP090899,1,765283,766292,+,1009
40,NZ_CP046924,1,764282,765291,+,1009
40,NZ_OX366348,1,215789,216798,-,1009
40,NZ_CP046921,1,827096,828105,+,1009
40,NZ_OX366338,1,1226939,1227948,-,1009
40,NZ_CP054557,1,1042212,1043221,-,1009
40,NZ_CP072669,1,765131,766140,+,1009
40,NC_021089,1,797379,798388,+,1009
39,NZ_OX366376,1,172412,173010,+,598
39,NZ_OX366393,1,1355945,1356543,+,598
39,NZ_OX366372,1,1284684,1285282,-,598
39,NZ_CP072672,1,762663,763321,+,658
39,NZ_CP069060,1,605621,606279,+,658
39,NZ_CP072667,1,762645,763303,+,658
39,NZ_CP072671,1,762645,763303,+,658
39,NZ_CP072668,1,762632,763290,+,658
39,NZ_CP072666,1,762645,763303,+,658
39,NZ_CP090902,1,762797,763455,+,658
39,NZ_CP090948,1,762797,763455,+,658
39,NZ_CP069052,1,1156611,1157269,+,658
39,NZ_CP076228,1,776613,777271,-,658
39,NZ_CP042445,1,762785,763443,+,658
39,NZ_CP042904,1,645445,646103,+,658
39,NC_012416,1,681098,681756,+,658
39,NZ_CP069053,1,605629,606287,+,658
39,NZ_CP042446,1,762797,763455,+,658
39,NZ_CP041215,1,917273,917931,-,658
39,NZ_OX366353,1,185018,185676,+,658
39,NZ_OX366387,1,691155,691813,-,658
39,NZ_OX366368,1,1208691,1209349,+,658
39,NZ_OX366379,1,1128206,1128864,+,658
39,NZ_CP091195,1,1491953,1492611,-,658
39,NZ_OX366375,1,1054699,1055357,+,658
39,NZ_CP046925,1,762645,763303,+,658
39,NZ_OX366318,1,1060518,1061168,+,650
39,NZ_OX366319,1,159287,159945,-,658
39,NZ_OX366332,1,1145994,1146652,+,658
39,NZ_CP110359,1,443437,444095,-,658
39,NZ_OU953855,1,207370,208028,-,658
39,NZ_OX366272,1,1213438,1214096,+,658
39,NZ_OX366347,1,194179,194837,+,658
39,NZ_OU909470,1,965221,965819,-,598
39,NZ_OX366363,1,1180075,1180733,-,658
39,NZ_OX366364,1,278939,279590,-,651
39,NZ_OX366359,1,973802,974460,+,658
39,NZ_OX366349,1,1646794,1647367,-,573
39,NZ_OX366380,1,1315368,1315966,+,598
39,NZ_OX366344,1,1196276,1196849,-,573
39,NZ_CP090900,1,762797,763455,+,658
39,NZ_OX366352,1,1241482,1242140,-,658
39,NZ_OX366362,1,238281,238937,-,656
39,NZ_OX366400,1,923936,924586,+,650
39,NZ_OX366327,1,1059576,1060234,+,658
39,NZ_OX366367,1,84279,84930,-,651
39,NZ_CP042444,1,763232,763890,+,658
39,NZ_OX366326,1,1268169,1268819,+,650
39,NZ_CP037426,1,853179,853837,+,658
39,NZ_OX366339,1,935586,936244,-,658
39,NZ_OX366355,1,183505,184163,-,658
39,NZ_CP046922,1,824610,825268,+,658
39,NZ_OX366370,1,1101336,1101934,-,598
39,NZ_OX366385,1,1330639,1331237,+,598
39,NZ_OX366399,1,1162834,1163492,+,658
39,NZ_OX366395,1,136826,137484,-,658
39,NZ_OX366396,1,1337307,1337965,+,658
39,NZ_OX366351,1,1214594,1215244,+,650
39,NZ_OX366381,1,269996,270654,-,658
39,NZ_OX366342,1,553637,554235,-,598
39,NZ_OX366369,1,1249744,1250402,+,658
39,NZ_OX366356,1,967316,967974,+,658
39,NZ_OX366377,1,1167499,1168157,-,658
39,NZ_OX366388,1,245263,245921,+,658
39,NZ_OX366357,1,510731,511389,+,658
39,NZ_CP072012,1,1418390,1419048,-,658
39,NZ_OX366398,1,241250,241908,+,658
39,NC_002978,6,762797,763455,+,658
39,NZ_OX366389,1,1114028,1114686,-,658
39,NZ_OX366397,1,1367527,1368185,+,658
39,NZ_OX366378,1,546372,547030,-,658
39,NZ_CP090903,1,762797,763455,+,658
39,NZ_OX366374,1,23500,24158,-,658
39,NZ_CP090901,1,762797,763455,+,658
39,NZ_CP046923,1,740858,741516,+,658
39,NZ_CP069055,1,761898,762556,+,658
39,NZ_CP072670,1,762637,763295,+,658
39,NZ_CP090899,1,762797,763455,+,658
39,NZ_CP046924,1,761796,762454,+,658
39,NZ_OX366348,1,218578,219236,-,658
39,NZ_CP046921,1,824610,825268,+,658
39,NZ_OX366338,1,1228396,1229054,-,658
39,NZ_CP054557,1,1045328,1045986,-,658
39,NZ_CP072669,1,762645,763303,+,658
39,NC_021089,1,796255,796913,+,658
38,NZ_OX366376,1,168950,169676,+,726
38,NZ_OX366393,1,1352483,1353209,+,726
38,NZ_OX366372,1,1288017,1288743,-,726
38,NZ_OX366342,1,556969,557697,-,728
37,NZ_OX366376,1,166497,167728,+,1231
37,NZ_OX366393,1,1350030,1351261,+,1231
37,NZ_OX366372,1,1289966,1291197,-,1231
37,NZ_CP072672,1,709332,710570,+,1238
37,NZ_CP069060,1,550786,552024,+,1238
37,NZ_CP072667,1,709314,710552,+,1238
37,NZ_CP072671,1,709314,710552,+,1238
37,NZ_CP072668,1,709301,710539,+,1238
37,NZ_CP072666,1,709314,710552,+,1238
37,NZ_CP090902,1,709466,710704,+,1238
37,NZ_CP090948,1,709466,710704,+,1238
37,NZ_CP069052,1,1101775,1103013,+,1238
37,NZ_CP076228,1,703325,704563,+,1238
37,NZ_CP042445,1,709454,710692,+,1238
37,NZ_CP042904,1,768240,769478,-,1238
37,NC_012416,1,803113,804351,-,1238
37,NZ_CP069053,1,550794,552032,+,1238
37,NZ_CP042446,1,709466,710704,+,1238
37,NZ_CP041215,1,972982,974220,-,1238
37,NZ_OX366353,1,834833,836071,-,1238
37,NZ_OX366387,1,1685536,1686774,+,1238
37,NZ_OX366368,1,1152809,1154047,+,1238
37,NZ_OX366379,1,1074194,1075432,+,1238
37,NZ_CP091195,1,1544683,1545921,-,1238
37,NZ_OX366375,1,999557,1000795,+,1238
37,NZ_CP046925,1,709314,710552,+,1238
37,NZ_OX366318,1,1004584,1005822,+,1238
37,NZ_OX366319,1,212067,213305,-,1238
37,NZ_OX366332,1,1090001,1091239,+,1238
37,NZ_CP110359,1,496934,498172,-,1238
37,NZ_OU953855,1,616781,618019,+,1238
37,NZ_OX366272,1,853070,854308,+,1238
37,NZ_OX366347,1,754571,755809,-,1238
37,NZ_OU909470,1,697746,698984,+,1238
37,NZ_OX366363,1,1234154,1235392,-,1238
37,NZ_OX366364,1,313587,314815,-,1228
37,NZ_OX366359,1,919193,920431,+,1238
37,NZ_OX366349,1,393426,394663,+,1237
37,NZ_OX366380,1,724850,726088,-,1238
37,NZ_OX366344,1,1249422,1250659,+,1237
37,NZ_CP090900,1,709466,710704,+,1238
37,NZ_OX366352,1,1296191,1297429,-,1238
37,NZ_OX366362,1,886206,887444,-,1238
37,NZ_OX366400,1,866980,868218,+,1238
37,NZ_OX366327,1,1004660,1005898,+,1238
37,NZ_OX366367,1,928941,930169,-,1228
37,NZ_CP042444,1,710003,711241,+,1238
37,NZ_OX366326,1,1211216,1212454,+,1238
37,NZ_CP037426,1,746327,747565,+,1238
37,NZ_OX366339,1,797637,798875,+,1238
37,NZ_OX366355,1,236183,237421,-,1238
37,NZ_CP046922,1,771180,772418,+,1238
37,NZ_OX366370,1,164827,166064,+,1237
37,NZ_OX366385,1,223201,224439,+,1238
37,NZ_OX366385,1,1198936,1200174,-,1238
37,NZ_OX366399,1,1108822,1110060,+,1238
37,NZ_OX366395,1,1370946,1372184,-,1238
37,NZ_OX366396,1,1342723,1343961,-,1238
37,NZ_OX366351,1,1158465,1159703,+,1238
37,NZ_OX366381,1,322928,324166,-,1238
37,NZ_OX366342,1,558920,560151,-,1231
37,NZ_OX366369,1,1195301,1196539,+,1238
37,NZ_OX366356,1,913039,914277,+,1238
37,NZ_OX366377,1,1221954,1223192,-,1238
37,NZ_OX366388,1,142672,143910,-,1238
37,NZ_OX366357,1,290123,291361,+,1238
37,NZ_CP072012,1,1471822,1473060,-,1238
37,NZ_OX366398,1,706391,707629,-,1238
37,NC_002978,6,709466,710704,+,1238
37,NZ_OX366389,1,772806,774044,-,1238
37,NZ_OX366397,1,1311114,1312352,+,1238
37,NZ_OX366378,1,599003,600241,-,1238
37,NZ_CP090903,1,709466,710704,+,1238
37,NZ_OX366374,1,1196015,1197253,-,1238
37,NZ_CP090901,1,709466,710704,+,1238
37,NZ_CP046923,1,687428,688666,+,1238
37,NZ_CP069055,1,708520,709758,+,1238
37,NZ_CP072670,1,709306,710544,+,1238
37,NZ_CP090899,1,709466,710704,+,1238
37,NZ_CP046924,1,708366,709604,+,1238
37,NZ_OX366348,1,272354,273592,-,1238
37,NZ_CP046921,1,771180,772418,+,1238
37,NZ_OX366338,1,977424,978646,+,1222
37,NZ_CP054557,1,1099421,1100659,-,1238
37,NZ_CP072669,1,709314,710552,+,1238
37,NC_021089,1,740632,741870,+,1238
36,NZ_OX366376,1,165814,166377,+,563
36,NZ_OX366393,1,1349348,1349909,+,561
36,NZ_OX366372,1,1291317,1291879,-,562
36,NZ_OU909470,1,697043,697625,+,582
36,NZ_OX366349,1,391689,392210,+,521
36,NZ_OX366380,1,727291,727873,-,582
36,NZ_OX366344,1,1248740,1249302,+,562
36,NZ_OX366362,1,887566,888122,-,556
36,NZ_OX366370,1,164137,164707,+,570
36,NZ_OX366385,1,222498,223080,+,582
36,NZ_OX366385,1,1200295,1200877,-,582
36,NZ_OX366342,1,560271,560833,-,562
36,NZ_OX366357,1,289411,289993,+,582
36,NZ_OX366338,1,976721,977303,+,582
35,NZ_OX366376,1,156912,162805,+,5893
35,NZ_OX366393,1,1340439,1346339,+,5900
35,NZ_OX366372,1,1294966,1300859,-,5893
35,NZ_CP072672,1,700640,706535,+,5895
35,NZ_CP069060,1,542094,547989,+,5895
35,NZ_CP072667,1,700622,706517,+,5895
35,NZ_CP072671,1,700622,706517,+,5895
35,NZ_CP072668,1,700609,706504,+,5895
35,NZ_CP072666,1,700622,706517,+,5895
35,NZ_CP090902,1,700774,706669,+,5895
35,NZ_CP090948,1,700774,706669,+,5895
35,NZ_CP069052,1,1092164,1098059,+,5895
35,NZ_CP076228,1,694633,700528,+,5895
35,NZ_CP042445,1,700762,706657,+,5895
35,NZ_CP042904,1,772251,778146,-,5895
35,NC_012416,1,807124,813019,-,5895
35,NZ_CP069053,1,542102,547997,+,5895
35,NZ_CP042446,1,700774,706669,+,5895
35,NZ_CP041215,1,976906,982801,-,5895
35,NZ_OX366353,1,838757,844652,-,5895
35,NZ_OX366387,1,1676276,1682171,+,5895
35,NZ_OX366368,1,1144117,1150012,+,5895
35,NZ_OX366379,1,1065502,1071397,+,5895
35,NZ_CP091195,1,1548694,1554589,-,5895
35,NZ_OX366375,1,989968,995863,+,5895
35,NZ_CP046925,1,700622,706517,+,5895
35,NZ_OX366318,1,995276,1001171,+,5895
35,NZ_OX366319,1,216078,221973,-,5895
35,NZ_OX366332,1,1081420,1087315,+,5895
35,NZ_CP110359,1,500945,506841,-,5896
35,NZ_OU953855,1,1606625,1612520,+,5895
35,NZ_OX366272,1,326108,332003,+,5895
35,NZ_OX366347,1,758582,764477,-,5895
35,NZ_OU909470,1,688165,694060,+,5895
35,NZ_OX366363,1,1238165,1244060,-,5895
35,NZ_OX366364,1,317762,323657,-,5895
35,NZ_OX366359,1,910612,916507,+,5895
35,NZ_OX366349,1,382709,388602,+,5893
35,NZ_OX366380,1,730977,736872,-,5895
35,NZ_OX366344,1,1240003,1245895,+,5892
35,NZ_CP090900,1,700774,706669,+,5895
35,NZ_OX366352,1,1300115,1306010,-,5895
35,NZ_OX366362,1,890974,896869,-,5895
35,NZ_OX366400,1,859005,864907,+,5902
35,NZ_OX366327,1,995888,1001783,+,5895
35,NZ_OX366367,1,933200,939095,-,5895
35,NZ_CP042444,1,701311,707206,+,5895
35,NZ_OX366326,1,1202636,1208531,+,5895
35,NZ_CP037426,1,736738,742633,+,5895
35,NZ_OX366339,1,788969,794864,+,5895
35,NZ_OX366355,1,240194,246089,-,5895
35,NZ_CP046922,1,762488,768383,+,5895
35,NZ_OX366370,1,1032157,1038056,+,5899
35,NZ_OX366385,1,1161736,1167631,-,5895
35,NZ_OX366399,1,1100130,1106025,+,5895
35,NZ_OX366395,1,1377611,1383479,-,5868
35,NZ_OX366396,1,1307595,1313490,+,5895
35,NZ_OX366351,1,1149885,1155780,+,5895
35,NZ_OX366381,1,326939,332834,-,5895
35,NZ_OX366342,1,563764,569657,-,5893
35,NZ_OX366369,1,1186633,1192528,+,5895
35,NZ_OX366356,1,904208,910207,+,5999
35,NZ_OX366377,1,1225965,1231860,-,5895
35,NZ_OX366388,1,146683,152578,-,5895
35,NZ_OX366357,1,422685,428580,-,5895
35,NZ_CP072012,1,1475825,1481720,-,5895
35,NZ_OX366398,1,710402,716297,-,5895
35,NC_002978,6,700774,706669,+,5895
35,NZ_OX366389,1,776817,782712,-,5895
35,NZ_OX366397,1,1302533,1308428,+,5895
35,NZ_OX366378,1,603014,608909,-,5895
35,NZ_CP090903,1,700774,706669,+,5895
35,NZ_OX366374,1,584708,590603,+,5895
35,NZ_CP090901,1,700774,706669,+,5895
35,NZ_CP046923,1,678736,684631,+,5895
35,NZ_CP069055,1,699828,705723,+,5895
35,NZ_CP072670,1,700614,706509,+,5895
35,NZ_CP090899,1,700774,706669,+,5895
35,NZ_CP046924,1,699674,705569,+,5895
35,NZ_OX366348,1,276365,282260,-,5895
35,NZ_CP046921,1,762488,768383,+,5895
35,NZ_OX366338,1,965312,971207,+,5895
35,NZ_CP054557,1,1103432,1109327,-,5895
35,NZ_CP072669,1,700622,706517,+,5895
35,NC_021089,1,732058,737946,+,5888
34,NZ_OX366376,1,155191,156882,+,1691
34,NZ_OX366393,1,1338718,1340409,+,1691
34,NZ_OX366372,1,1300889,1302580,-,1691
34,NZ_CP072672,1,698528,700217,+,1689
34,NZ_CP069060,1,539982,541671,+,1689
34,NZ_CP072667,1,698510,700199,+,1689
34,NZ_CP072671,1,698510,700199,+,1689
34,NZ_CP072668,1,698497,700186,+,1689
34,NZ_CP072666,1,698510,700199,+,1689
34,NZ_CP090902,1,698662,700351,+,1689
34,NZ_CP090948,1,698662,700351,+,1689
34,NZ_CP069052,1,1090052,1091741,+,1689
34,NZ_CP076228,1,692521,694210,+,1689
34,NZ_CP042445,1,698650,700339,+,1689
34,NZ_CP042904,1,778569,780258,-,1689
34,NC_012416,1,813442,815131,-,1689
34,NZ_CP069053,1,539990,541679,+,1689
34,NZ_CP042446,1,698662,700351,+,1689
34,NZ_CP041215,1,983224,984913,-,1689
34,NZ_OX366353,1,845075,846764,-,1689
34,NZ_OX366387,1,1674164,1675853,+,1689
34,NZ_OX366368,1,1142005,1143694,+,1689
34,NZ_OX366379,1,1063390,1065079,+,1689
34,NZ_CP091195,1,1555012,1556701,-,1689
34,NZ_OX366375,1,987872,989542,+,1670
34,NZ_CP046925,1,698510,700199,+,1689
34,NZ_OX366318,1,993164,994853,+,1689
34,NZ_OX366319,1,222396,224085,-,1689
34,NZ_OX366332,1,1079308,1080997,+,1689
34,NZ_CP110359,1,507264,508953,-,1689
34,NZ_OU953855,1,1604529,1606202,+,1673
34,NZ_OX366272,1,323996,325685,+,1689
34,NZ_OX366347,1,764900,766589,-,1689
34,NZ_OU909470,1,686065,687726,+,1661
34,NZ_OX366363,1,1244483,1246172,-,1689
34,NZ_OX366364,1,323687,325379,-,1692
34,NZ_OX366359,1,908500,910189,+,1689
34,NZ_OX366349,1,380988,382679,+,1691
34,NZ_OX366380,1,737295,738984,-,1689
34,NZ_OX366344,1,1238282,1239973,+,1691
34,NZ_CP090900,1,698662,700351,+,1689
34,NZ_OX366352,1,1306433,1308122,-,1689
34,NZ_OX366362,1,897271,898960,-,1689
34,NZ_OX366400,1,856893,858582,+,1689
34,NZ_OX366327,1,993776,995465,+,1689
34,NZ_OX366367,1,939518,941192,-,1674
34,NZ_CP042444,1,699199,700888,+,1689
34,NZ_OX366326,1,1200524,1202213,+,1689
34,NZ_CP037426,1,734642,736315,+,1673
34,NZ_OX366339,1,786857,788546,+,1689
34,NZ_OX366355,1,246512,248201,-,1689
34,NZ_CP046922,1,760376,762065,+,1689
34,NZ_OX366370,1,1030261,1031952,+,1691
34,NZ_OX366385,1,1168054,1169743,-,1689
34,NZ_OX366399,1,1098018,1099707,+,1689
34,NZ_OX366395,1,1383902,1385591,-,1689
34,NZ_OX366396,1,1305483,1307172,+,1689
34,NZ_OX366351,1,1147773,1149462,+,1689
34,NZ_OX366381,1,333257,334946,-,1689
34,NZ_OX366342,1,569687,571378,-,1691
34,NZ_OX366369,1,1184521,1186210,+,1689
34,NZ_OX366356,1,902096,903785,+,1689
34,NZ_OX366377,1,1232283,1233972,-,1689
34,NZ_OX366388,1,153001,154690,-,1689
34,NZ_OX366357,1,428854,430545,-,1691
34,NZ_CP072012,1,1482143,1483832,-,1689
34,NZ_OX366398,1,716720,718409,-,1689
34,NC_002978,6,698662,700351,+,1689
34,NZ_OX366389,1,783135,784824,-,1689
34,NZ_OX366397,1,1300421,1302110,+,1689
34,NZ_OX366378,1,609332,611021,-,1689
34,NZ_CP090903,1,698662,700351,+,1689
34,NZ_OX366374,1,582596,584285,+,1689
34,NZ_CP090901,1,698662,700351,+,1689
34,NZ_CP046923,1,676624,678313,+,1689
34,NZ_CP069055,1,697716,699405,+,1689
34,NZ_CP072670,1,698502,700191,+,1689
34,NZ_CP090899,1,698662,700351,+,1689
34,NZ_CP046924,1,697562,699251,+,1689
34,NZ_OX366348,1,282683,284372,-,1689
34,NZ_CP046921,1,760376,762065,+,1689
34,NZ_OX366338,1,963200,964889,+,1689
34,NZ_CP054557,1,1109750,1111439,-,1689
34,NZ_CP072669,1,698510,700199,+,1689
34,NC_021089,1,729946,731635,+,1689
33,NZ_OX366376,1,150604,153053,+,2449
33,NZ_OX366393,1,1334129,1336578,+,2449
33,NZ_OX366372,1,1304721,1307170,-,2449
33,NZ_CP072672,1,693913,696381,+,2468
33,NZ_CP069060,1,535367,537835,+,2468
33,NZ_CP072667,1,693895,696363,+,2468
33,NZ_CP072671,1,693895,696363,+,2468
33,NZ_CP072668,1,693882,696350,+,2468
33,NZ_CP072666,1,693895,696363,+,2468
33,NZ_CP090902,1,694047,696515,+,2468
33,NZ_CP090948,1,694047,696515,+,2468
33,NZ_CP069052,1,1085437,1087905,+,2468
33,NZ_CP076228,1,687897,690365,+,2468
33,NZ_CP042445,1,694035,696503,+,2468
33,NZ_CP042904,1,723299,725767,-,2468
33,NC_012416,1,712470,714938,+,2468
33,NZ_CP069053,1,535375,537843,+,2468
33,NZ_CP042446,1,694047,696515,+,2468
33,NZ_CP041215,1,1053765,1056233,-,2468
33,NZ_OX366353,1,1031334,1033801,-,2467
33,NZ_OX366387,1,1662771,1665239,+,2468
33,NZ_OX366368,1,1060136,1062604,+,2468
33,NZ_OX366379,1,1058775,1061243,+,2468
33,NZ_CP091195,1,863958,866426,-,2468
33,NZ_OX366375,1,983173,985641,+,2468
33,NZ_CP046925,1,693895,696363,+,2468
33,NZ_OX366318,1,988546,991014,+,2468
33,NZ_OX366319,1,226237,228705,-,2468
33,NZ_OX366332,1,1074688,1077156,+,2468
33,NZ_CP110359,1,511094,513562,-,2468
33,NZ_OU953855,1,1599830,1602298,+,2468
33,NZ_OX366272,1,936520,938988,+,2468
33,NZ_OX366347,1,821184,823652,-,2468
33,NZ_OU909470,1,681398,683869,+,2471
33,NZ_OX366363,1,1248319,1250787,-,2468
33,NZ_OX366364,1,327520,329994,-,2474
33,NZ_OX366359,1,903880,906348,+,2468
33,NZ_OX366349,1,376396,378845,+,2449
33,NZ_OX366380,1,741125,743596,-,2471
33,NZ_OX366344,1,1233683,1236132,+,2449
33,NZ_CP090900,1,694047,696515,+,2468
33,NZ_OX366352,1,1175807,1178275,+,2468
33,NZ_OX366362,1,389544,392012,+,2468
33,NZ_OX366400,1,852278,854746,+,2468
33,NZ_OX366327,1,989162,991630,+,2468
33,NZ_OX366367,1,1019019,1021493,-,2474
33,NZ_CP042444,1,694584,697052,+,2468
33,NZ_OX366326,1,1117879,1120347,+,2468
33,NZ_CP037426,1,729943,732411,+,2468
33,NZ_OX366339,1,782237,784705,+,2468
33,NZ_OX366355,1,251331,253799,-,2468
33,NZ_CP046922,1,755761,758229,+,2468
33,NZ_OX366370,1,314000,316421,-,2421
33,NZ_OX366385,1,1171884,1174355,-,2471
33,NZ_OX366399,1,1093403,1095871,+,2468
33,NZ_OX366395,1,1463643,1466111,-,2468
33,NZ_OX366396,1,1300872,1303340,+,2468
33,NZ_OX366351,1,1067260,1069728,+,2468
33,NZ_OX366381,1,337098,339566,-,2468
33,NZ_OX366342,1,126912,129361,+,2449
33,NZ_OX366369,1,1179901,1182369,+,2468
33,NZ_OX366356,1,897378,899846,+,2468
33,NZ_OX366377,1,1236119,1238587,-,2468
33,NZ_OX366388,1,156837,159305,-,2468
33,NZ_OX366357,1,154643,157111,-,2468
33,NZ_CP072012,1,26857,29325,-,2468
33,NZ_OX366398,1,720556,723024,-,2468
33,NC_002978,6,694047,696515,+,2468
33,NZ_OX366389,1,786971,789439,-,2468
33,NZ_OX366397,1,1226097,1228565,+,2468
33,NZ_OX366378,1,145168,147636,-,2468
33,NZ_CP090903,1,694047,696515,+,2468
33,NZ_OX366374,1,1201967,1204435,+,2468
33,NZ_CP090901,1,694047,696515,+,2468
33,NZ_CP046923,1,672009,674477,+,2468
33,NZ_CP069055,1,693101,695569,+,2468
33,NZ_CP072670,1,693887,696355,+,2468
33,NZ_CP090899,1,694047,696515,+,2468
33,NZ_CP046924,1,692947,695415,+,2468
33,NZ_OX366348,1,286519,288987,-,2468
33,NZ_CP046921,1,755761,758229,+,2468
33,NZ_OX366338,1,997839,1000307,-,2468
33,NZ_CP054557,1,1113585,1116053,-,2468
33,NZ_CP072669,1,693895,696363,+,2468
33,NC_021089,1,725326,727794,+,2468
32,NZ_OX366376,1,149306,150600,+,1294
32,NZ_OX366393,1,1332828,1334125,+,1297
32,NZ_OX366372,1,1307174,1308470,-,1296
32,NZ_OX366342,1,125608,126908,+,1300
31,NZ_OX366376,1,146916,148422,+,1506
31,NZ_OX366393,1,1330677,1332183,+,1506
31,NZ_OX366372,1,1309115,1310621,-,1506
31,NZ_CP072672,1,478968,480463,-,1495
31,NZ_CP069060,1,466677,468172,-,1495
31,NZ_CP072667,1,478950,480445,-,1495
31,NZ_CP072671,1,478950,480445,-,1495
31,NZ_CP072668,1,478937,480432,-,1495
31,NZ_CP072666,1,478950,480445,-,1495
31,NZ_CP090902,1,479102,480597,-,1495
31,NZ_CP090948,1,479102,480597,-,1495
31,NZ_CP069052,1,403247,404741,+,1494
31,NZ_CP076228,1,232081,233574,+,1493
31,NZ_CP042445,1,479102,480597,-,1495
31,NZ_CP042904,1,256019,257513,+,1494
31,NC_012416,1,258602,260096,+,1494
31,NZ_CP069053,1,79097,80591,+,1494
31,NZ_CP042446,1,479102,480597,-,1495
31,NZ_CP041215,1,1242719,1244214,-,1495
31,NZ_OX366353,1,1284941,1286436,-,1495
31,NZ_OX366387,1,1102673,1104167,+,1494
31,NZ_OX366368,1,753246,754740,+,1494
31,NZ_OX366379,1,709451,710945,+,1494
31,NZ_CP091195,1,459009,460504,-,1495
31,NZ_OX366375,1,791405,792899,+,1494
31,NZ_CP046925,1,478950,480445,-,1495
31,NZ_OX366318,1,660395,661889,+,1494
31,NZ_OX366319,1,629875,631370,-,1495
31,NZ_OX366332,1,871158,872653,-,1495
31,NZ_CP110359,1,960979,962474,-,1495
31,NZ_OU953855,1,603489,604984,-,1495
31,NZ_OX366272,1,531765,533260,-,1495
31,NZ_OX366347,1,996488,997982,-,1494
31,NZ_OU909470,1,678105,679592,+,1487
31,NZ_OX366363,1,253436,254931,-,1495
31,NZ_OX366364,1,146946,148470,+,1524
31,NZ_OX366359,1,547500,548993,+,1493
31,NZ_OX366349,1,374232,375729,+,1497
31,NZ_OX366380,1,91646,93135,+,1489
31,NZ_OX366344,1,1231511,1233017,+,1506
31,NZ_CP090900,1,479102,480597,-,1495
31,NZ_OX366352,1,600188,601683,-,1495
31,NZ_OX366362,1,1382191,1383695,-,1504
31,NZ_OX366400,1,590462,591957,-,1495
31,NZ_OX366327,1,710603,712101,+,1498
31,NZ_OX366367,1,1259570,1261094,+,1524
31,NZ_CP042444,1,479603,481098,-,1495
31,NZ_OX366326,1,755219,756713,+,1494
31,NZ_CP037426,1,263483,264978,-,1495
31,NZ_OX366339,1,578146,579641,-,1495
31,NZ_OX366355,1,696023,697518,-,1495
31,NZ_CP046922,1,482935,484429,+,1494
31,NZ_OX366370,1,1089209,1090715,+,1506
31,NZ_OX366399,1,679034,680528,+,1494
31,NZ_OX366395,1,652357,653851,+,1494
31,NZ_OX366396,1,787042,788536,+,1494
31,NZ_OX366351,1,577052,578546,+,1494
31,NZ_OX366381,1,904440,905935,-,1495
31,NZ_OX366342,1,123218,124724,+,1506
31,NZ_OX366369,1,808553,810048,-,1495
31,NZ_OX366356,1,720983,722478,-,1495
31,NZ_OX366377,1,867155,868649,+,1494
31,NZ_OX366388,1,703058,704553,-,1495
31,NZ_OX366357,1,302644,304138,+,1494
31,NZ_CP072012,1,577798,579293,-,1495
31,NZ_OX366398,1,643678,645172,+,1494
31,NC_002978,6,479102,480597,-,1495
31,NZ_OX366389,1,739289,740783,+,1494
31,NZ_OX366397,1,967100,968595,-,1495
31,NZ_OX366378,1,1197860,1199355,-,1495
31,NZ_CP090903,1,479102,480597,-,1495
31,NZ_OX366374,1,839760,841267,-,1507
31,NZ_CP090901,1,479102,480597,-,1495
31,NZ_CP046923,1,399183,400677,+,1494
31,NZ_CP069055,1,517703,519197,-,1494
31,NZ_CP072670,1,478942,480437,-,1495
31,NZ_CP090899,1,479102,480597,-,1495
31,NZ_CP046924,1,420121,421615,+,1494
31,NZ_OX366348,1,445183,446677,+,1494
31,NZ_CP046921,1,482935,484429,+,1494
31,NZ_OX366338,1,631935,633429,+,1494
31,NZ_CP054557,1,27720,29214,+,1494
31,NZ_CP072669,1,478950,480445,-,1495
31,NC_021089,1,340689,342183,+,1494
30,NZ_OX366376,1,145689,146687,+,998
30,NZ_OX366393,1,1329450,1330448,+,998
30,NZ_OX366372,1,1310850,1311847,-,997
30,NZ_CP072672,1,480526,481506,-,980
30,NZ_CP069060,1,468235,469215,-,980
30,NZ_CP072667,1,480508,481488,-,980
30,NZ_CP072671,1,480508,481488,-,980
30,NZ_CP072668,1,480495,481475,-,980
30,NZ_CP072666,1,480508,481488,-,980
30,NZ_CP090902,1,480660,481640,-,980
30,NZ_CP090948,1,480660,481640,-,980
30,NZ_CP069052,1,402203,403184,+,981
30,NZ_CP076228,1,231037,232018,+,981
30,NZ_CP042445,1,480660,481640,-,980
30,NZ_CP042904,1,253485,254466,+,981
30,NC_012416,1,256068,257049,+,981
30,NZ_CP069053,1,78053,79034,+,981
30,NZ_CP042446,1,480660,481640,-,980
30,NZ_CP041215,1,1244277,1245256,-,979
30,NZ_OX366353,1,1286499,1287478,-,979
30,NZ_OX366387,1,1101629,1102610,+,981
30,NZ_OX366368,1,752202,753183,+,981
30,NZ_OX366379,1,708407,709388,+,981
30,NZ_CP091195,1,460567,461547,-,980
30,NZ_OX366375,1,790361,791342,+,981
30,NZ_CP046925,1,480508,481488,-,980
30,NZ_OX366318,1,659351,660332,+,981
30,NZ_OX366319,1,631433,632413,-,980
30,NZ_OX366332,1,872716,873695,-,979
30,NZ_CP110359,1,962537,963517,-,980
30,NZ_OU953855,1,605047,606027,-,980
30,NZ_OX366272,1,533323,534303,-,980
30,NZ_OX366347,1,998046,999026,-,980
30,NZ_OU909470,1,677041,678040,+,999
30,NZ_OX366363,1,254994,255974,-,980
30,NZ_OX366364,1,145873,146872,+,999
30,NZ_OX366359,1,546457,547437,+,980
30,NZ_OX366349,1,373004,374002,+,998
30,NZ_OX366380,1,90591,91581,+,990
30,NZ_OX366344,1,1230276,1231274,+,998
30,NZ_CP090900,1,480660,481640,-,980
30,NZ_OX366352,1,601746,602725,-,979
30,NZ_OX366362,1,1383758,1384755,-,997
30,NZ_OX366400,1,592020,593000,-,980
30,NZ_OX366327,1,709559,710540,+,981
30,NZ_OX366367,1,1257105,1258104,+,999
30,NZ_CP042444,1,481161,482141,-,980
30,NZ_OX366326,1,754175,755156,+,981
30,NZ_CP037426,1,265041,266021,-,980
30,NZ_OX366339,1,579704,580684,-,980
30,NZ_OX366355,1,697581,698561,-,980
30,NZ_CP046922,1,481891,482872,+,981
30,NZ_OX366370,1,1088136,1089134,+,998
30,NZ_OX366399,1,677990,678971,+,981
30,NZ_OX366395,1,651313,652294,+,981
30,NZ_OX366396,1,785998,786979,+,981
30,NZ_OX366351,1,576008,576989,+,981
30,NZ_OX366381,1,905998,906978,-,980
30,NZ_OX366342,1,121991,122989,+,998
30,NZ_OX366369,1,810111,811091,-,980
30,NZ_OX366356,1,722541,723521,-,980
30,NZ_OX366377,1,866111,867092,+,981
30,NZ_OX366388,1,704616,705596,-,980
30,NZ_OX366357,1,301600,302581,+,981
30,NZ_CP072012,1,579356,580336,-,980
30,NZ_OX366398,1,642634,643615,+,981
30,NC_002978,6,480660,481640,-,980
30,NZ_OX366389,1,737326,738305,+,979
30,NZ_OX366397,1,968658,969637,-,979
30,NZ_OX366378,1,1199418,1200398,-,980
30,NZ_CP090903,1,480660,481640,-,980
30,NZ_OX366374,1,841330,842310,-,980
30,NZ_CP090901,1,480660,481640,-,980
30,NZ_CP046923,1,398139,399120,+,981
30,NZ_CP069055,1,519260,520240,-,980
30,NZ_CP072670,1,480500,481480,-,980
30,NZ_CP090899,1,480660,481640,-,980
30,NZ_CP046924,1,419077,420058,+,981
30,NZ_OX366348,1,444139,445120,+,981
30,NZ_CP046921,1,481891,482872,+,981
30,NZ_OX366338,1,630891,631872,+,981
30,NZ_CP054557,1,26676,27657,+,981
30,NZ_CP072669,1,480508,481488,-,980
30,NC_021089,1,339646,340626,+,980
13,NZ_OX366376,1,81525,82263,+,738
13,NZ_OX366398,1,1264538,1265275,-,737
12,NZ_OX366376,1,63454,64317,+,863
12,NZ_OX366376,1,1160249,1161112,+,863
12,NZ_OX366393,1,1068579,1069442,+,863
12,NZ_OX366372,1,234452,235316,-,864
12,NZ_CP091195,1,1161245,1162104,+,859
12,NZ_OX366349,1,1542147,1543010,+,863
12,NZ_OX366342,1,885854,886719,-,865
12,NZ_OX366378,1,813047,813906,+,859
11,NZ_OX366376,1,53399,54075,+,676
11,NZ_OX366393,1,1058524,1059200,+,676
11,NZ_OX366375,1,628214,628779,-,565
11,NZ_CP037426,1,859632,860197,+,565
10,NZ_OX366376,1,52292,53397,+,1105
10,NZ_OX366393,1,1057417,1058522,+,1105
9,NZ_OX366376,1,42200,43454,+,1254
9,NZ_OX366387,1,243410,244675,+,1265
9,NZ_CP091195,1,1324219,1325484,-,1265
9,NZ_OU953855,1,1152693,1153958,-,1265
9,NZ_OX366380,1,1063127,1064392,+,1265
9,NZ_OX366370,1,1225202,1226467,-,1265
9,NZ_OX366396,1,735402,736667,+,1265
9,NZ_OX366378,1,1123865,1125130,+,1265
8,NZ_OX366376,1,41324,42125,+,801
8,NZ_OX366370,1,696384,697156,+,772
7,NZ_OX366376,1,38124,38718,+,594
7,NZ_OX366349,1,216148,216741,-,593
6,NZ_OX366376,1,34122,34781,+,659
6,NZ_OX366372,1,251515,252190,-,675
6,NZ_OX366364,1,502083,502755,-,672
6,NZ_OX366342,1,860580,861247,-,667
5,NZ_OX366376,1,10812,11403,+,591
5,NZ_OX366372,1,32065,32656,-,591
5,NZ_OX366342,1,856563,857154,-,591
4,NZ_OX366376,1,8566,9688,+,1122
4,NZ_OX366372,1,33780,34825,-,1045
4,NZ_OX366362,1,1050693,1051738,-,1045
4,NZ_OX366342,1,858277,859400,-,1123
3,NZ_OX366376,1,7266,7897,+,631
3,NZ_OX366372,1,35493,36124,-,631
3,NZ_OX366362,1,1052406,1053037,-,631
2,NZ_OX366376,1,1006,2332,+,1326
2,NZ_OX366393,1,1006,2332,+,1326
2,NZ_OX366372,1,1006,2332,+,1326
2,NZ_CP072672,1,989638,990975,+,1337
2,NZ_CP069060,1,834445,835782,+,1337
2,NZ_CP072667,1,989612,990949,+,1337
2,NZ_CP072671,1,989620,990957,+,1337
2,NZ_CP072668,1,989607,990944,+,1337
2,NZ_CP072666,1,989620,990957,+,1337
2,NZ_CP090902,1,989772,991109,+,1337
2,NZ_CP090948,1,989772,991109,+,1337
2,NZ_CP069052,1,820289,821626,-,1337
2,NZ_CP076228,1,992910,994247,-,1337
2,NZ_CP042445,1,989760,991097,+,1337
2,NZ_CP042904,1,1014826,1016164,+,1338
2,NC_012416,1,1057383,1058721,+,1338
2,NZ_CP069053,1,834453,835790,+,1337
2,NZ_CP042446,1,989770,991107,+,1337
2,NZ_CP041215,1,1447000,1448338,-,1338
2,NZ_OX366353,1,1125814,1127152,-,1338
2,NZ_OX366387,1,1006,2343,+,1337
2,NZ_OX366368,1,1006,2343,+,1337
2,NZ_OX366379,1,1006,2343,+,1337
2,NZ_CP091195,1,1085247,1086585,-,1338
2,NZ_OX366375,1,931,2268,+,1337
2,NZ_CP046925,1,989620,990957,+,1337
2,NZ_OX366318,1,1006,2343,+,1337
2,NZ_OX366319,1,1006,2343,+,1337
2,NZ_OX366332,1,1063,2401,+,1338
2,NZ_CP110359,1,221936,223274,+,1338
2,NZ_OU953855,1,559925,561263,+,1338
2,NZ_OX366272,1,1006,2344,+,1338
2,NZ_OX366347,1,1006,2344,+,1338
2,NZ_OU909470,1,931530,932875,-,1345
2,NZ_OX366363,1,1007224,1008562,+,1338
2,NZ_OX366364,1,1006,2344,+,1338
2,NZ_OX366359,1,1063,2401,+,1338
2,NZ_OX366349,1,1006,2352,+,1346
2,NZ_OX366380,1,1007,2352,+,1345
2,NZ_OX366344,1,1006,2352,+,1346
2,NZ_CP090900,1,989772,991109,+,1337
2,NZ_OX366352,1,1063,2401,+,1338
2,NZ_OX366362,1,931,2268,+,1337
2,NZ_OX366400,1,1006,2343,+,1337
2,NZ_OX366327,1,1006,2343,+,1337
2,NZ_OX366367,1,1006,2344,+,1338
2,NZ_CP042444,1,991126,992463,+,1337
2,NZ_OX366326,1,1006,2343,+,1337
2,NZ_CP037426,1,1178874,1180211,+,1337
2,NZ_OX366339,1,1006,2343,+,1337
2,NZ_OX366355,1,1006,2343,+,1337
2,NZ_CP046922,1,1051668,1053005,+,1337
2,NZ_OX366370,1,1006,2347,+,1341
2,NZ_OX366385,1,1007,2352,+,1345
2,NZ_OX366399,1,1006,2343,+,1337
2,NZ_OX366395,1,1006,2344,+,1338
2,NZ_OX366396,1,1006,2343,+,1337
2,NZ_OX366351,1,1006,2343,+,1337
2,NZ_OX366381,1,1006,2343,+,1337
2,NZ_OX366342,1,278980,280306,-,1326
2,NZ_OX366369,1,1006,2343,+,1337
2,NZ_OX366356,1,1063,2400,+,1337
2,NZ_OX366377,1,1006,2343,+,1337
2,NZ_OX366388,1,931,2269,+,1338
2,NZ_OX366357,1,931,2269,+,1338
2,NZ_CP072012,1,1251696,1253033,+,1337
2,NZ_OX366398,1,471487,472824,+,1337
2,NC_002978,6,989772,991109,+,1337
2,NZ_OX366389,1,1006,2343,+,1337
2,NZ_OX366397,1,1063,2401,+,1338
2,NZ_OX366378,1,1006,2344,+,1338
2,NZ_CP090903,1,989772,991109,+,1337
2,NZ_OX366374,1,392664,393970,+,1306
2,NZ_CP090901,1,989772,991109,+,1337
2,NZ_CP046923,1,967916,969253,+,1337
2,NZ_CP069055,1,1051286,1052623,-,1337
2,NZ_CP072670,1,989612,990949,+,1337
2,NZ_CP090899,1,989772,991109,+,1337
2,NZ_CP046924,1,988854,990191,+,1337
2,NZ_OX366348,1,1006,2343,+,1337
2,NZ_CP046921,1,1051668,1053005,+,1337
2,NZ_OX366338,1,931,2269,+,1338
2,NZ_CP054557,1,784785,786122,+,1337
2,NZ_CP072669,1,989620,990957,+,1337
2,NC_021089,1,1018775,1020113,+,1338
1,NZ_OX366376,1,69,1004,+,935
1,NZ_OX366393,1,69,1004,+,935
1,NZ_OX366372,1,69,1004,+,935
1,NZ_CP072672,1,988701,989636,+,935
1,NZ_CP069060,1,833508,834443,+,935
1,NZ_CP072667,1,988675,989610,+,935
1,NZ_CP072671,1,988683,989618,+,935
1,NZ_CP072668,1,988670,989605,+,935
1,NZ_CP072666,1,988683,989618,+,935
1,NZ_CP090902,1,988835,989770,+,935
1,NZ_CP090948,1,988835,989770,+,935
1,NZ_CP069052,1,821627,822563,-,936
1,NZ_CP076228,1,994248,995184,-,936
1,NZ_CP042445,1,988823,989758,+,935
1,NZ_CP042904,1,1013889,1014824,+,935
1,NC_012416,1,1056446,1057381,+,935
1,NZ_CP069053,1,833516,834451,+,935
1,NZ_CP042446,1,988833,989768,+,935
1,NZ_CP041215,1,1448339,1449275,-,936
1,NZ_OX366353,1,1127153,1128089,-,936
1,NZ_OX366387,1,69,1004,+,935
1,NZ_OX366368,1,69,1004,+,935
1,NZ_OX366379,1,69,1004,+,935
1,NZ_CP091195,1,1086586,1087522,-,936
1,NZ_OX366375,1,1,929,+,928
1,NZ_CP046925,1,988683,989618,+,935
1,NZ_OX366318,1,69,1004,+,935
1,NZ_OX366319,1,69,1004,+,935
1,NZ_OX366332,1,126,1061,+,935
1,NZ_CP110359,1,220999,221934,+,935
1,NZ_OU953855,1,558988,559923,+,935
1,NZ_OX366272,1,69,1004,+,935
1,NZ_OX366347,1,69,1004,+,935
1,NZ_OU909470,1,932876,933813,-,937
1,NZ_OX366363,1,1006287,1007222,+,935
1,NZ_OX366364,1,69,1004,+,935
1,NZ_OX366359,1,126,1061,+,935
1,NZ_OX366349,1,69,1004,+,935
1,NZ_OX366380,1,69,1005,+,936
1,NZ_OX366344,1,69,1004,+,935
1,NZ_CP090900,1,988835,989770,+,935
1,NZ_OX366352,1,126,1061,+,935
1,NZ_OX366362,1,1,929,+,928
1,NZ_OX366400,1,69,1004,+,935
1,NZ_OX366327,1,69,1004,+,935
1,NZ_OX366367,1,69,1004,+,935
1,NZ_CP042444,1,990189,991124,+,935
1,NZ_OX366326,1,69,1004,+,935
1,NZ_CP037426,1,1177937,1178872,+,935
1,NZ_OX366339,1,69,1004,+,935
1,NZ_OX366355,1,69,1004,+,935
1,NZ_CP046922,1,1050731,1051666,+,935
1,NZ_OX366370,1,69,1004,+,935
1,NZ_OX366385,1,69,1005,+,936
1,NZ_OX366399,1,69,1004,+,935
1,NZ_OX366395,1,69,1004,+,935
1,NZ_OX366396,1,69,1004,+,935
1,NZ_OX366351,1,69,1004,+,935
1,NZ_OX366381,1,69,1004,+,935
1,NZ_OX366342,1,280307,281243,-,936
1,NZ_OX366369,1,69,1004,+,935
1,NZ_OX366356,1,126,1061,+,935
1,NZ_OX366377,1,69,1004,+,935
1,NZ_OX366388,1,1,929,+,928
1,NZ_OX366357,1,1,929,+,928
1,NZ_CP072012,1,1250759,1251694,+,935
1,NZ_OX366398,1,470550,471485,+,935
1,NC_002978,6,988835,989770,+,935
1,NZ_OX366389,1,69,1004,+,935
1,NZ_OX366397,1,126,1061,+,935
1,NZ_OX366378,1,69,1004,+,935
1,NZ_CP090903,1,988835,989770,+,935
1,NZ_OX366374,1,390842,391794,+,952
1,NZ_CP090901,1,988835,989770,+,935
1,NZ_CP046923,1,966979,967914,+,935
1,NZ_CP069055,1,1052624,1053560,-,936
1,NZ_CP072670,1,988675,989610,+,935
1,NZ_CP090899,1,988835,989770,+,935
1,NZ_CP046924,1,987917,988852,+,935
1,NZ_OX366348,1,69,1004,+,935
1,NZ_CP046921,1,1050731,1051666,+,935
1,NZ_OX366338,1,1,929,+,928
1,NZ_CP054557,1,783848,784783,+,935
1,NZ_CP072669,1,988683,989618,+,935
1,NC_021089,1,1017838,1018773,+,935
14,NZ_OX366376,1,82432,83313,+,881
14,NZ_OX366376,1,896457,897218,-,761
14,NZ_OX366393,1,483440,484201,-,761
14,NZ_OX366372,1,664809,665570,-,761
14,NZ_OX366363,1,387364,388134,-,770
14,NZ_OX366364,1,487097,487858,-,761
14,NZ_OX366362,1,1378218,1378985,-,767
14,NZ_OX366342,1,1041513,1042274,-,761
14,NZ_OX366377,1,699653,700420,-,767
14,NZ_OX366398,1,1251853,1252620,+,767
14,NZ_OX366398,1,1263488,1264369,-,881
15,NZ_OX366376,1,83314,84741,+,1427
15,NZ_OX366398,1,1262059,1263486,-,1427
16,NZ_OX366376,1,104870,105411,+,541
16,NZ_OX366319,1,608168,608709,+,541
16,NZ_OX366352,1,499912,500453,+,541
16,NZ_OX366327,1,354314,354856,-,542
16,NZ_OX366367,1,410162,410712,-,550
16,NZ_OX366326,1,356769,357310,+,541
16,NZ_OX366355,1,620130,620671,+,541
16,NZ_OX366351,1,998767,999309,-,542
16,NZ_OX366381,1,882634,883175,+,541
16,NZ_OX366369,1,567942,568484,-,542
16,NZ_CP072012,1,752792,753333,+,541
16,NZ_OX366397,1,567610,568152,-,542
17,NZ_OX366376,1,113945,114702,+,757
17,NZ_OX366393,1,1297777,1298534,+,757
17,NZ_OX366372,1,1342848,1343604,-,756
17,NZ_OX366349,1,1650459,1651186,+,727
17,NZ_OX366344,1,1199933,1200690,+,757
17,NZ_OX366342,1,90385,91142,+,757
18,NZ_OX366376,1,114875,115461,+,586
18,NZ_OX366393,1,1298707,1299293,+,586
18,NZ_OX366372,1,1342089,1342675,-,586
18,NZ_OX366349,1,1651359,1651945,+,586
18,NZ_OX366344,1,1200863,1201449,+,586
18,NZ_OX366342,1,91315,91901,+,586
18,NZ_OX366388,1,653882,654468,+,586
19,NZ_OX366376,1,117152,118021,+,869
19,NZ_OX366393,1,1300985,1301854,+,869
19,NZ_OX366372,1,1339527,1340397,-,870
19,NZ_OU909470,1,823338,824208,-,870
19,NZ_OX366349,1,1653637,1654506,+,869
19,NZ_OX366380,1,1239193,1240062,+,869
19,NZ_OX366344,1,1203140,1204009,+,869
19,NZ_OX366370,1,1059158,1060027,+,869
19,NZ_OX366385,1,1176447,1177316,+,869
19,NZ_OX366342,1,93593,94462,+,869
20,NZ_OX366376,1,119160,121289,+,2129
20,NZ_OX366393,1,1302993,1305122,+,2129
20,NZ_OX366372,1,1336260,1338389,-,2129
20,NZ_CP072672,1,1142056,1144187,-,2131
20,NZ_CP069060,1,982130,984257,+,2127
20,NZ_CP072667,1,1142030,1144161,-,2131
20,NZ_CP072671,1,1142038,1144169,-,2131
20,NZ_CP072668,1,1142025,1144156,-,2131
20,NZ_CP072666,1,1142038,1144169,-,2131
20,NZ_CP090902,1,1142190,1144321,-,2131
20,NZ_CP090948,1,1142188,1144319,-,2131
20,NZ_CP069052,1,1013257,1015384,-,2127
20,NZ_CP076228,1,1150244,1152375,+,2131
20,NZ_CP042445,1,1142178,1144309,-,2131
20,NZ_CP042904,1,1217293,1219424,-,2131
20,NC_012416,1,1262509,1264640,-,2131
20,NZ_CP069053,1,982162,984289,+,2127
20,NZ_CP042446,1,1142188,1144319,-,2131
20,NZ_CP041215,1,165660,167791,-,2131
20,NZ_OX366353,1,668995,671126,+,2131
20,NZ_OX366387,1,181966,184097,-,2131
20,NZ_OX366368,1,155234,157365,-,2131
20,NZ_OX366379,1,155332,157463,-,2131
20,NZ_CP091195,1,1196588,1198719,-,2131
20,NZ_OX366375,1,157869,160000,-,2131
20,NZ_CP046925,1,1142038,1144169,-,2131
20,NZ_OX366318,1,149962,152093,-,2131
20,NZ_OX366319,1,1044521,1046652,+,2131
20,NZ_OX366332,1,153248,155379,-,2131
20,NZ_CP110359,1,139342,141469,-,2127
20,NZ_OU953855,1,535414,537545,-,2131
20,NZ_OX366272,1,109185,111316,-,2131
20,NZ_OX366347,1,264520,266651,-,2131
20,NZ_OU909470,1,818801,820927,-,2126
20,NZ_OX366363,1,783999,786130,+,2131
20,NZ_OX366364,1,213060,215191,-,2131
20,NZ_OX366359,1,152373,154510,-,2137
20,NZ_OX366349,1,345113,347242,+,2129
20,NZ_OX366380,1,1242474,1244600,+,2126
20,NZ_OX366344,1,1205148,1207277,+,2129
20,NZ_CP090900,1,1142191,1144322,-,2131
20,NZ_OX366352,1,1536027,1538158,+,2131
20,NZ_OX366362,1,143056,145185,+,2129
20,NZ_OX366400,1,18864,20995,+,2131
20,NZ_OX366327,1,152221,154348,-,2127
20,NZ_OX366367,1,1388992,1391123,-,2131
20,NZ_CP042444,1,1143544,1145675,-,2131
20,NZ_OX366326,1,153684,155815,-,2131
20,NZ_CP037426,1,986927,989058,+,2131
20,NZ_OX366339,1,1175298,1177429,-,2131
20,NZ_OX366355,1,1161296,1163427,+,2131
20,NZ_CP046922,1,1204002,1206133,-,2131
20,NZ_OX366370,1,1062442,1064556,+,2114
20,NZ_OX366385,1,1179448,1181574,+,2126
20,NZ_OX366399,1,154735,156866,-,2131
20,NZ_OX366395,1,294742,296873,-,2131
20,NZ_OX366396,1,26355,28486,-,2131
20,NZ_OX366351,1,161099,163230,-,2131
20,NZ_OX366381,1,1228177,1230308,+,2131
20,NZ_OX366342,1,95601,97730,+,2129
20,NZ_OX366369,1,150992,153123,-,2131
20,NZ_OX366356,1,186162,188293,-,2131
20,NZ_OX366377,1,157393,159524,-,2131
20,NZ_OX366388,1,1597307,1599438,-,2131
20,NZ_OX366357,1,382672,384803,-,2131
20,NZ_CP072012,1,1159582,1161713,+,2131
20,NZ_OX366398,1,804183,806314,-,2131
20,NC_002978,6,1142188,1144319,-,2131
20,NZ_OX366389,1,93148,95279,+,2131
20,NZ_OX366397,1,152946,155077,-,2131
20,NZ_OX366378,1,1159625,1161756,+,2131
20,NZ_CP090903,1,1142191,1144322,-,2131
20,NZ_OX366374,1,97078,99207,-,2129
20,NZ_CP090901,1,1142191,1144322,-,2131
20,NZ_CP046923,1,1120250,1122381,-,2131
20,NZ_CP069055,1,1142146,1144277,-,2131
20,NZ_CP072670,1,1142018,1144149,-,2131
20,NZ_CP090899,1,1142191,1144322,-,2131
20,NZ_CP046924,1,1141188,1143319,-,2131
20,NZ_OX366348,1,1096644,1098775,+,2131
20,NZ_CP046921,1,1204002,1206133,-,2131
20,NZ_OX366338,1,223491,225620,-,2129
20,NZ_CP054557,1,665569,667700,+,2131
20,NZ_CP072669,1,1142038,1144169,-,2131
20,NC_021089,1,1169481,1171612,-,2131
21,NZ_OX366376,1,121421,124824,+,3403
21,NZ_OX366393,1,1305254,1308657,+,3403
21,NZ_OX366372,1,1332725,1336128,-,3403
21,NZ_CP072672,1,1137206,1140828,-,3622
21,NZ_CP069060,1,985500,989122,+,3622
21,NZ_CP072667,1,1137180,1140802,-,3622
21,NZ_CP072671,1,1137188,1140810,-,3622
21,NZ_CP072668,1,1137175,1140797,-,3622
21,NZ_CP072666,1,1137188,1140810,-,3622
21,NZ_CP090902,1,1137340,1140962,-,3622
21,NZ_CP090948,1,1137338,1140960,-,3622
21,NZ_CP069052,1,1008392,1012014,-,3622
21,NZ_CP076228,1,1153614,1157236,+,3622
21,NZ_CP042445,1,1137328,1140950,-,3622
21,NZ_CP042904,1,1209850,1213250,-,3400
21,NC_012416,1,1255065,1258465,-,3400
21,NZ_CP069053,1,985532,989154,+,3622
21,NZ_CP042446,1,1137338,1140960,-,3622
21,NZ_CP041215,1,161015,164421,-,3406
21,NZ_OX366353,1,672366,675772,+,3406
21,NZ_OX366387,1,177105,180727,-,3622
21,NZ_OX366368,1,150373,153995,-,3622
21,NZ_OX366379,1,150471,154093,-,3622
21,NZ_CP091195,1,1191943,1195349,-,3406
21,NZ_OX366375,1,153008,156630,-,3622
21,NZ_CP046925,1,1137188,1140810,-,3622
21,NZ_OX366318,1,145100,148722,-,3622
21,NZ_OX366319,1,1047891,1051513,+,3622
21,NZ_OX366332,1,148603,152009,-,3406
21,NZ_CP110359,1,134499,138121,-,3622
21,NZ_OU953855,1,530580,534197,-,3617
21,NZ_OX366272,1,104346,107968,-,3622
21,NZ_OX366347,1,259659,263281,-,3622
21,NZ_OU909470,1,815258,818669,-,3411
21,NZ_OX366363,1,787347,790969,+,3622
21,NZ_OX366364,1,209256,212869,-,3613
21,NZ_OX366359,1,147728,151134,-,3406
21,NZ_OX366349,1,347380,350777,+,3397
21,NZ_OX366380,1,1244732,1248109,+,3377
21,NZ_OX366344,1,1207409,1210812,+,3403
21,NZ_CP090900,1,1137341,1140963,-,3622
21,NZ_OX366352,1,1539397,1542803,+,3406
21,NZ_OX366362,1,145317,148728,+,3411
21,NZ_OX366400,1,22234,25856,+,3622
21,NZ_OX366327,1,147572,150978,-,3406
21,NZ_OX366367,1,1385182,1388795,-,3613
21,NZ_CP042444,1,1138694,1142316,-,3622
21,NZ_OX366326,1,148824,152446,-,3622
21,NZ_CP037426,1,990297,993919,+,3622
21,NZ_OX366339,1,1170437,1174059,-,3622
21,NZ_OX366355,1,1164666,1168288,+,3622
21,NZ_CP046922,1,1199152,1202774,-,3622
21,NZ_OX366370,1,1064688,1068090,+,3402
21,NZ_OX366385,1,1181706,1185083,+,3377
21,NZ_OX366399,1,149874,153496,-,3622
21,NZ_OX366395,1,289881,293503,-,3622
21,NZ_OX366396,1,699032,702654,-,3622
21,NZ_OX366351,1,156239,159861,-,3622
21,NZ_OX366381,1,1231547,1235169,+,3622
21,NZ_OX366342,1,97862,101265,+,3403
21,NZ_OX366369,1,146131,149753,-,3622
21,NZ_OX366356,1,181197,184819,-,3622
21,NZ_OX366377,1,152532,156154,-,3622
21,NZ_OX366388,1,1592662,1596068,-,3406
21,NZ_OX366357,1,377812,381434,-,3622
21,NZ_CP072012,1,1162952,1166574,+,3622
21,NZ_OX366398,1,799322,802944,-,3622
21,NC_002978,6,1137338,1140960,-,3622
21,NZ_OX366389,1,96518,100140,+,3622
21,NZ_OX366397,1,148301,151707,-,3406
21,NZ_OX366378,1,1162995,1166401,+,3406
21,NZ_CP090903,1,1137341,1140963,-,3622
21,NZ_OX366374,1,93324,96946,-,3622
21,NZ_CP090901,1,1137341,1140963,-,3622
21,NZ_CP046923,1,1115400,1119022,-,3622
21,NZ_CP069055,1,1137285,1140907,-,3622
21,NZ_CP072670,1,1137168,1140790,-,3622
21,NZ_CP090899,1,1137341,1140963,-,3622
21,NZ_CP046924,1,1136338,1139960,-,3622
21,NZ_OX366348,1,1100013,1103635,+,3622
21,NZ_CP046921,1,1199152,1202774,-,3622
21,NZ_OX366338,1,219737,223359,-,3622
21,NZ_CP054557,1,668939,672561,+,3622
21,NZ_CP072669,1,1137188,1140810,-,3622
21,NC_021089,1,1164836,1168242,-,3406
22,NZ_OX366376,1,124825,127924,+,3099
22,NZ_OX366393,1,1308658,1311769,+,3111
22,NZ_OX366372,1,1329613,1332723,-,3110
22,NZ_CP072672,1,1134106,1137204,-,3098
22,NZ_CP069060,1,989123,992222,+,3099
22,NZ_CP072667,1,1134080,1137178,-,3098
22,NZ_CP072671,1,1134088,1137186,-,3098
22,NZ_CP072668,1,1134075,1137173,-,3098
22,NZ_CP072666,1,1134088,1137186,-,3098
22,NZ_CP090902,1,1134240,1137338,-,3098
22,NZ_CP090948,1,1134238,1137336,-,3098
22,NZ_CP069052,1,1005292,1008390,-,3098
22,NZ_CP076228,1,1157237,1160336,+,3099
22,NZ_CP042445,1,1134228,1137326,-,3098
22,NZ_CP042904,1,1205260,1208367,-,3107
22,NC_012416,1,1250475,1253582,-,3107
22,NZ_CP069053,1,989155,992254,+,3099
22,NZ_CP042446,1,1134238,1137336,-,3098
22,NZ_CP041215,1,157915,161013,-,3098
22,NZ_OX366353,1,675773,678872,+,3099
22,NZ_OX366387,1,174005,177103,-,3098
22,NZ_OX366368,1,147273,150371,-,3098
22,NZ_OX366379,1,147371,150469,-,3098
22,NZ_CP091195,1,1188843,1191941,-,3098
22,NZ_OX366375,1,149908,153006,-,3098
22,NZ_CP046925,1,1134088,1137186,-,3098
22,NZ_OX366318,1,142000,145098,-,3098
22,NZ_OX366319,1,1051514,1054613,+,3099
22,NZ_OX366332,1,145503,148601,-,3098
22,NZ_CP110359,1,131399,134497,-,3098
22,NZ_OU953855,1,524134,527204,-,3070
22,NZ_OX366272,1,101246,104344,-,3098
22,NZ_OX366347,1,256559,259657,-,3098
22,NZ_OU909470,1,812158,815256,-,3098
22,NZ_OX366363,1,1138351,1141421,-,3070
22,NZ_OX366364,1,206153,209254,-,3101
22,NZ_OX366359,1,144628,147726,-,3098
22,NZ_OX366349,1,350778,353877,+,3099
22,NZ_OX366380,1,1249597,1252709,+,3112
22,NZ_OX366344,1,1210813,1213912,+,3099
22,NZ_CP090900,1,1134241,1137339,-,3098
22,NZ_OX366352,1,1542804,1545903,+,3099
22,NZ_OX366362,1,148991,152087,+,3096
22,NZ_OX366400,1,25857,28956,+,3099
22,NZ_OX366327,1,144472,147570,-,3098
22,NZ_OX366367,1,1382083,1385180,-,3097
22,NZ_CP042444,1,1135594,1138692,-,3098
22,NZ_OX366326,1,145724,148822,-,3098
22,NZ_CP037426,1,993920,997019,+,3099
22,NZ_OX366339,1,1167338,1170435,-,3097
22,NZ_OX366355,1,1168289,1171388,+,3099
22,NZ_CP046922,1,1196052,1199150,-,3098
22,NZ_OX366370,1,1068091,1071190,+,3099
22,NZ_OX366385,1,1279912,1283024,+,3112
22,NZ_OX366399,1,146774,149872,-,3098
22,NZ_OX366395,1,286781,289879,-,3098
22,NZ_OX366396,1,695932,699030,-,3098
22,NZ_OX366351,1,153139,156237,-,3098
22,NZ_OX366381,1,1235170,1238269,+,3099
22,NZ_OX366342,1,101266,104377,+,3111
22,NZ_OX366369,1,143031,146129,-,3098
22,NZ_OX366356,1,178097,181195,-,3098
22,NZ_OX366377,1,149432,152530,-,3098
22,NZ_OX366388,1,1589562,1592660,-,3098
22,NZ_OX366357,1,374712,377810,-,3098
22,NZ_CP072012,1,1166575,1169674,+,3099
22,NZ_OX366398,1,796222,799320,-,3098
22,NC_002978,6,1134238,1137336,-,3098
22,NZ_OX366389,1,100141,103240,+,3099
22,NZ_OX366397,1,145201,148299,-,3098
22,NZ_OX366378,1,1166402,1169501,+,3099
22,NZ_CP090903,1,1134241,1137339,-,3098
22,NZ_OX366374,1,90224,93322,-,3098
22,NZ_CP090901,1,1134241,1137339,-,3098
22,NZ_CP046923,1,1112300,1115398,-,3098
22,NZ_CP069055,1,1134185,1137283,-,3098
22,NZ_CP072670,1,1134068,1137166,-,3098
22,NZ_CP090899,1,1134241,1137339,-,3098
22,NZ_CP046924,1,1133238,1136336,-,3098
22,NZ_OX366348,1,1103636,1106735,+,3099
22,NZ_CP046921,1,1196052,1199150,-,3098
22,NZ_OX366338,1,216637,219735,-,3098
22,NZ_CP054557,1,672562,675661,+,3099
22,NZ_CP072669,1,1134088,1137186,-,3098
22,NC_021089,1,1161736,1164834,-,3098
23,NZ_OX366376,1,128187,129869,+,1682
23,NZ_OX366393,1,1312032,1313714,+,1682
23,NZ_OX366372,1,1327668,1329350,-,1682
23,NZ_CP072672,1,1132193,1133843,-,1650
23,NZ_CP069060,1,992485,994135,+,1650
23,NZ_CP072667,1,1132167,1133817,-,1650
23,NZ_CP072671,1,1132175,1133825,-,1650
23,NZ_CP072668,1,1132162,1133812,-,1650
23,NZ_CP072666,1,1132175,1133825,-,1650
23,NZ_CP090902,1,1132327,1133977,-,1650
23,NZ_CP090948,1,1132325,1133975,-,1650
23,NZ_CP069052,1,1003379,1005029,-,1650
23,NZ_CP076228,1,1160599,1162249,+,1650
23,NZ_CP042445,1,1132315,1133965,-,1650
23,NZ_CP042904,1,1203347,1204997,-,1650
23,NC_012416,1,1248562,1250212,-,1650
23,NZ_CP069053,1,992517,994167,+,1650
23,NZ_CP042446,1,1132325,1133975,-,1650
23,NZ_CP041215,1,156002,157652,-,1650
23,NZ_OX366353,1,679135,680785,+,1650
23,NZ_OX366387,1,172092,173742,-,1650
23,NZ_OX366368,1,145360,147010,-,1650
23,NZ_OX366379,1,145458,147108,-,1650
23,NZ_CP091195,1,1186898,1188580,-,1682
23,NZ_OX366375,1,147995,149645,-,1650
23,NZ_CP046925,1,1132175,1133825,-,1650
23,NZ_OX366318,1,140087,141737,-,1650
23,NZ_OX366319,1,1054876,1056526,+,1650
23,NZ_OX366332,1,143590,145240,-,1650
23,NZ_CP110359,1,129468,131042,-,1574
23,NZ_OU953855,1,522189,523871,-,1682
23,NZ_OX366272,1,99315,100889,-,1574
23,NZ_OX366347,1,254682,256202,-,1520
23,NZ_OU909470,1,810344,811895,-,1551
23,NZ_OX366363,1,1136406,1138088,-,1682
23,NZ_OX366364,1,204253,205890,-,1637
23,NZ_OX366359,1,142715,144365,-,1650
23,NZ_OX366349,1,354140,355822,+,1682
23,NZ_OX366380,1,1252972,1254683,+,1711
23,NZ_OX366344,1,1214175,1215857,+,1682
23,NZ_CP090900,1,1132328,1133978,-,1650
23,NZ_OX366352,1,1546166,1547816,+,1650
23,NZ_OX366362,1,152350,154013,+,1663
23,NZ_OX366400,1,29219,30869,+,1650
23,NZ_OX366327,1,142559,144209,-,1650
23,NZ_OX366367,1,1380183,1381820,-,1637
23,NZ_CP042444,1,1133681,1135331,-,1650
23,NZ_OX366326,1,143811,145461,-,1650
23,NZ_CP037426,1,997282,998932,+,1650
23,NZ_OX366339,1,1165425,1167075,-,1650
23,NZ_OX366355,1,1171651,1173301,+,1650
23,NZ_CP046922,1,1194139,1195789,-,1650
23,NZ_OX366370,1,1071453,1073090,+,1637
23,NZ_OX366385,1,1283287,1284998,+,1711
23,NZ_OX366399,1,144861,146511,-,1650
23,NZ_OX366395,1,284844,286518,-,1674
23,NZ_OX366396,1,694019,695669,-,1650
23,NZ_OX366351,1,151226,152876,-,1650
23,NZ_OX366381,1,1238532,1240182,+,1650
23,NZ_OX366342,1,104640,106322,+,1682
23,NZ_OX366369,1,141118,142768,-,1650
23,NZ_OX366356,1,176184,177834,-,1650
23,NZ_OX366377,1,147556,149169,-,1613
23,NZ_OX366388,1,1587617,1589299,-,1682
23,NZ_OX366357,1,372820,374449,-,1629
23,NZ_CP072012,1,1169937,1171587,+,1650
23,NZ_OX366398,1,794346,795959,-,1613
23,NC_002978,6,1132325,1133975,-,1650
23,NZ_OX366389,1,103503,105116,+,1613
23,NZ_OX366397,1,143288,144938,-,1650
23,NZ_OX366378,1,1169764,1171446,+,1682
23,NZ_CP090903,1,1132328,1133978,-,1650
23,NZ_OX366374,1,88401,89961,-,1560
23,NZ_CP090901,1,1132328,1133978,-,1650
23,NZ_CP046923,1,1110387,1112037,-,1650
23,NZ_CP069055,1,1132274,1133922,-,1648
23,NZ_CP072670,1,1132155,1133805,-,1650
23,NZ_CP090899,1,1132328,1133978,-,1650
23,NZ_CP046924,1,1131325,1132975,-,1650
23,NZ_OX366348,1,1106998,1108611,+,1613
23,NZ_CP046921,1,1194139,1195789,-,1650
23,NZ_OX366338,1,303000,304676,+,1676
23,NZ_CP054557,1,675924,677537,+,1613
23,NZ_CP072669,1,1132175,1133825,-,1650
23,NC_021089,1,1159823,1161473,-,1650
24,NZ_OX366376,1,133603,134146,+,543
24,NZ_OX366393,1,1317365,1317908,+,543
24,NZ_OX366372,1,1323391,1323934,-,543
24,NZ_CP072672,1,1014816,1015380,+,564
24,NZ_CP069060,1,860552,861112,+,560
24,NZ_CP072667,1,1014790,1015354,+,564
24,NZ_CP072671,1,1014798,1015362,+,564
24,NZ_CP072668,1,1014785,1015349,+,564
24,NZ_CP072666,1,1014798,1015362,+,564
24,NZ_CP090902,1,1014950,1015514,+,564
24,NZ_CP090948,1,1014949,1015513,+,564
24,NZ_CP069052,1,794955,795519,-,564
24,NZ_CP076228,1,876743,877307,+,564
24,NZ_CP042445,1,1014938,1015502,+,564
24,NZ_CP042904,1,1137422,1137986,+,564
24,NC_012416,1,1181147,1181711,+,564
24,NZ_CP069053,1,860560,861120,+,560
24,NZ_CP042446,1,1014948,1015512,+,564
24,NZ_CP041215,1,1425884,1426448,-,564
24,NZ_OX366353,1,1103159,1103723,-,564
24,NZ_OX366387,1,27964,28528,+,564
24,NZ_OX366368,1,26333,26897,+,564
24,NZ_OX366379,1,26351,26915,+,564
24,NZ_CP091195,1,124716,125278,+,562
24,NZ_CP091195,1,1066056,1066618,-,562
24,NZ_OX366375,1,27282,27846,+,564
24,NZ_CP046925,1,1014798,1015362,+,564
24,NZ_OX366318,1,25499,26063,+,564
24,NZ_OX366319,1,27114,27678,+,564
24,NZ_OX366332,1,26002,26566,+,564
24,NZ_CP110359,1,247370,247932,+,562
24,NZ_OU953855,1,589214,589776,+,562
24,NZ_OX366272,1,27345,27907,+,562
24,NZ_OX366347,1,1239609,1240171,-,562
24,NZ_OU909470,1,805641,806238,-,597
24,NZ_OX366363,1,1034464,1035005,+,541
24,NZ_OX366364,1,179057,179619,-,562
24,NZ_OX366359,1,25998,26562,+,564
24,NZ_OX366349,1,359783,360347,+,564
24,NZ_OX366380,1,1258425,1258989,+,564
24,NZ_OX366344,1,1218541,1219105,+,564
24,NZ_CP090900,1,1014950,1015514,+,564
24,NZ_OX366352,1,28566,29130,+,564
24,NZ_OX366362,1,202151,202694,+,543
24,NZ_OX366400,1,148046,148610,-,564
24,NZ_OX366327,1,27600,28164,+,564
24,NZ_OX366367,1,1185040,1185602,+,562
24,NZ_CP042444,1,1016304,1016868,+,564
24,NZ_OX366326,1,28827,29391,+,564
24,NZ_CP037426,1,1274700,1275264,+,564
24,NZ_OX366339,1,1127990,1128554,-,564
24,NZ_OX366355,1,30911,31475,+,564
24,NZ_CP046922,1,1076846,1077410,+,564
24,NZ_OX366370,1,1075778,1076375,+,597
24,NZ_OX366385,1,1158101,1158665,-,564
24,NZ_OX366399,1,26329,26893,+,564
24,NZ_OX366395,1,63327,63868,-,541
24,NZ_OX366396,1,1457635,1458199,-,564
24,NZ_OX366351,1,33740,34304,+,564
24,NZ_OX366381,1,28937,29501,+,564
24,NZ_OX366342,1,109906,110449,+,543
24,NZ_OX366369,1,27926,28490,+,564
24,NZ_OX366356,1,25195,25759,+,564
24,NZ_OX366377,1,25966,26530,+,564
24,NZ_OX366388,1,30770,31332,+,562
24,NZ_OX366357,1,819192,819774,-,582
24,NZ_CP072012,1,1277018,1277582,+,564
24,NZ_OX366398,1,497325,497889,+,564
24,NC_002978,6,1014949,1015513,+,564
24,NZ_OX366389,1,225826,226390,-,564
24,NZ_OX366397,1,25876,26440,+,564
24,NZ_OX366378,1,43251,43813,+,562
24,NZ_CP090903,1,1014950,1015514,+,564
24,NZ_OX366374,1,444302,444866,+,564
24,NZ_CP090901,1,1014950,1015514,+,564
24,NZ_CP046923,1,993094,993658,+,564
24,NZ_CP069055,1,1027123,1027687,-,564
24,NZ_CP072670,1,1014790,1015354,+,564
24,NZ_CP090899,1,1014950,1015514,+,564
24,NZ_CP046924,1,1014032,1014596,+,564
24,NZ_OX366348,1,26093,26657,+,564
24,NZ_CP046921,1,1076846,1077410,+,564
24,NZ_OX366338,1,23595,24136,+,541
24,NZ_CP054557,1,808141,808705,+,564
24,NZ_CP072669,1,1014798,1015362,+,564
24,NC_021089,1,1042343,1042907,+,564
25,NZ_OX366376,1,134175,136243,+,2068
25,NZ_OX366393,1,1317937,1320005,+,2068
25,NZ_OX366372,1,1321294,1323362,-,2068
25,NZ_CP072672,1,1015388,1017472,+,2084
25,NZ_CP069060,1,861124,863208,+,2084
25,NZ_CP072667,1,1015362,1017446,+,2084
25,NZ_CP072671,1,1015370,1017454,+,2084
25,NZ_CP072668,1,1015357,1017441,+,2084
25,NZ_CP072666,1,1015370,1017454,+,2084
25,NZ_CP090902,1,1015522,1017606,+,2084
25,NZ_CP090948,1,1015521,1017605,+,2084
25,NZ_CP069052,1,792863,794947,-,2084
25,NZ_CP076228,1,877315,879399,+,2084
25,NZ_CP042445,1,1015510,1017594,+,2084
25,NZ_CP042904,1,1137994,1140045,+,2051
25,NC_012416,1,1181719,1183770,+,2051
25,NZ_CP069053,1,861132,863216,+,2084
25,NZ_CP042446,1,1015520,1017604,+,2084
25,NZ_CP041215,1,1423825,1425876,-,2051
25,NZ_OX366353,1,1101100,1103151,-,2051
25,NZ_OX366387,1,28536,30620,+,2084
25,NZ_OX366368,1,26905,28989,+,2084
25,NZ_OX366379,1,26923,29007,+,2084
25,NZ_CP091195,1,125286,127357,+,2071
25,NZ_CP091195,1,1063977,1066048,-,2071
25,NZ_OX366375,1,27854,29938,+,2084
25,NZ_CP046925,1,1015370,1017454,+,2084
25,NZ_OX366318,1,26071,28155,+,2084
25,NZ_OX366319,1,27686,29770,+,2084
25,NZ_OX366332,1,26574,28625,+,2051
25,NZ_CP110359,1,247940,250024,+,2084
25,NZ_OU953855,1,589784,591868,+,2084
25,NZ_OX366272,1,27915,29999,+,2084
25,NZ_OX366347,1,1237550,1239601,-,2051
25,NZ_OU909470,1,803562,805612,-,2050
25,NZ_OX366363,1,1035034,1037118,+,2084
25,NZ_OX366364,1,176655,178669,-,2014
25,NZ_OX366359,1,26570,28621,+,2051
25,NZ_OX366349,1,360355,362423,+,2068
25,NZ_OX366380,1,1258997,1261071,+,2074
25,NZ_OX366344,1,1219113,1221181,+,2068
25,NZ_CP090900,1,1015522,1017606,+,2084
25,NZ_OX366352,1,29138,31189,+,2051
25,NZ_OX366362,1,202723,204800,+,2077
25,NZ_OX366400,1,145954,148038,-,2084
25,NZ_OX366327,1,28172,30256,+,2084
25,NZ_OX366367,1,1185610,1187662,+,2052
25,NZ_CP042444,1,1016876,1018960,+,2084
25,NZ_OX366326,1,29399,31483,+,2084
25,NZ_CP037426,1,1275272,1277356,+,2084
25,NZ_OX366339,1,1125898,1127982,-,2084
25,NZ_OX366355,1,31483,33567,+,2084
25,NZ_CP046922,1,1077418,1079502,+,2084
25,NZ_OX366370,1,1076404,1078479,+,2075
25,NZ_OX366385,1,1156019,1158093,-,2074
25,NZ_OX366399,1,26901,28985,+,2084
25,NZ_OX366395,1,61239,63298,-,2059
25,NZ_OX366396,1,1455543,1457627,-,2084
25,NZ_OX366351,1,34312,36396,+,2084
25,NZ_OX366381,1,29509,31593,+,2084
25,NZ_OX366342,1,110478,112546,+,2068
25,NZ_OX366369,1,28498,30582,+,2084
25,NZ_OX366356,1,25767,27851,+,2084
25,NZ_OX366377,1,26538,28622,+,2084
25,NZ_OX366388,1,31340,33411,+,2071
25,NZ_OX366357,1,817118,819184,-,2066
25,NZ_CP072012,1,1277590,1279674,+,2084
25,NZ_OX366398,1,497897,499981,+,2084
25,NC_002978,6,1015521,1017605,+,2084
25,NZ_OX366389,1,223734,225818,-,2084
25,NZ_OX366397,1,26448,28499,+,2051
25,NZ_OX366378,1,43821,45892,+,2071
25,NZ_CP090903,1,1015522,1017606,+,2084
25,NZ_OX366374,1,444874,446958,+,2084
25,NZ_CP090901,1,1015522,1017606,+,2084
25,NZ_CP046923,1,993666,995750,+,2084
25,NZ_CP069055,1,1025031,1027115,-,2084
25,NZ_CP072670,1,1015362,1017446,+,2084
25,NZ_CP090899,1,1015522,1017606,+,2084
25,NZ_CP046924,1,1014604,1016688,+,2084
25,NZ_OX366348,1,26665,28749,+,2084
25,NZ_CP046921,1,1077418,1079502,+,2084
25,NZ_OX366338,1,24165,26224,+,2059
25,NZ_CP054557,1,808713,810797,+,2084
25,NZ_CP072669,1,1015370,1017454,+,2084
25,NC_021089,1,1042915,1044966,+,2051
26,NZ_OX366376,1,136355,138601,+,2246
26,NZ_OX366393,1,1320117,1322363,+,2246
26,NZ_OX366372,1,1318936,1321182,-,2246
26,NZ_CP072672,1,1017584,1019819,+,2235
26,NZ_CP069060,1,863320,865555,+,2235
26,NZ_CP072667,1,1017558,1019793,+,2235
26,NZ_CP072671,1,1017566,1019801,+,2235
26,NZ_CP072668,1,1017553,1019788,+,2235
26,NZ_CP072666,1,1017566,1019801,+,2235
26,NZ_CP090902,1,1017718,1019953,+,2235
26,NZ_CP090948,1,1017717,1019952,+,2235
26,NZ_CP069052,1,790516,792751,-,2235
26,NZ_CP076228,1,879511,881741,+,2230
26,NZ_CP042445,1,1017706,1019941,+,2235
26,NZ_CP042904,1,1140157,1142393,+,2236
26,NC_012416,1,1183882,1186118,+,2236
26,NZ_CP069053,1,863328,865563,+,2235
26,NZ_CP042446,1,1017716,1019951,+,2235
26,NZ_CP041215,1,1421477,1423713,-,2236
26,NZ_OX366353,1,1098752,1100988,-,2236
26,NZ_OX366387,1,30732,32967,+,2235
26,NZ_OX366368,1,29101,31336,+,2235
26,NZ_OX366379,1,29119,31354,+,2235
26,NZ_CP091195,1,1061630,1063865,-,2235
26,NZ_OX366375,1,30050,32285,+,2235
26,NZ_CP046925,1,1017566,1019801,+,2235
26,NZ_OX366318,1,28267,30502,+,2235
26,NZ_OX366319,1,29882,32116,+,2234
26,NZ_OX366332,1,28737,30973,+,2236
26,NZ_CP110359,1,250136,252371,+,2235
26,NZ_OU953855,1,591980,594215,+,2235
26,NZ_OX366272,1,30111,32346,+,2235
26,NZ_OX366347,1,1235203,1237438,-,2235
26,NZ_OU909470,1,801182,803422,-,2240
26,NZ_OX366363,1,1037230,1039463,+,2233
26,NZ_OX366364,1,174301,176543,-,2242
26,NZ_OX366359,1,28733,30969,+,2236
26,NZ_OX366349,1,362535,364781,+,2246
26,NZ_OX366380,1,1261183,1263426,+,2243
26,NZ_OX366344,1,1221293,1223539,+,2246
26,NZ_CP090900,1,1017718,1019953,+,2235
26,NZ_OX366352,1,31301,33537,+,2236
26,NZ_OX366362,1,204912,207146,+,2234
26,NZ_OX366400,1,143607,145842,-,2235
26,NZ_OX366327,1,30368,32603,+,2235
26,NZ_OX366367,1,1187774,1190016,+,2242
26,NZ_CP042444,1,1019072,1021307,+,2235
26,NZ_OX366326,1,31595,33831,+,2236
26,NZ_CP037426,1,1277468,1279703,+,2235
26,NZ_OX366339,1,1123551,1125786,-,2235
26,NZ_OX366355,1,33679,35913,+,2234
26,NZ_CP046922,1,1079614,1081849,+,2235
26,NZ_OX366370,1,1078591,1080834,+,2243
26,NZ_OX366385,1,1153664,1155907,-,2243
26,NZ_OX366399,1,29097,31332,+,2235
26,NZ_OX366395,1,58892,61127,-,2235
26,NZ_OX366396,1,1453196,1455431,-,2235
26,NZ_OX366351,1,36508,38744,+,2236
26,NZ_OX366381,1,31705,33939,+,2234
26,NZ_OX366342,1,112658,114904,+,2246
26,NZ_OX366369,1,30694,32929,+,2235
26,NZ_OX366356,1,27963,30197,+,2234
26,NZ_OX366377,1,28734,30969,+,2235
26,NZ_OX366388,1,33523,35758,+,2235
26,NZ_OX366357,1,814771,817006,-,2235
26,NZ_CP072012,1,1279786,1282021,+,2235
26,NZ_OX366398,1,500093,502328,+,2235
26,NC_002978,6,1017717,1019952,+,2235
26,NZ_OX366389,1,221387,223622,-,2235
26,NZ_OX366397,1,28611,30847,+,2236
26,NZ_OX366378,1,46004,48239,+,2235
26,NZ_CP090903,1,1017718,1019953,+,2235
26,NZ_OX366374,1,447070,449304,+,2234
26,NZ_CP090901,1,1017718,1019953,+,2235
26,NZ_CP046923,1,995862,998097,+,2235
26,NZ_CP069055,1,1022684,1024919,-,2235
26,NZ_CP072670,1,1017558,1019793,+,2235
26,NZ_CP090899,1,1017718,1019953,+,2235
26,NZ_CP046924,1,1016800,1019035,+,2235
26,NZ_OX366348,1,28861,31096,+,2235
26,NZ_CP046921,1,1079614,1081849,+,2235
26,NZ_OX366338,1,26336,28571,+,2235
26,NZ_CP054557,1,810909,813144,+,2235
26,NZ_CP072669,1,1017566,1019801,+,2235
26,NC_021089,1,1045078,1047314,+,2236
27,NZ_OX366376,1,138774,140770,+,1996
27,NZ_OX366393,1,1322536,1324531,+,1995
27,NZ_OX366372,1,1316767,1318763,-,1996
27,NZ_CP072672,1,1020230,1022344,+,2114
27,NZ_CP069060,1,865966,868080,+,2114
27,NZ_CP072667,1,1020204,1022318,+,2114
27,NZ_CP072671,1,1020212,1022326,+,2114
27,NZ_CP072668,1,1020199,1022313,+,2114
27,NZ_CP072666,1,1020212,1022326,+,2114
27,NZ_CP090902,1,1020364,1022478,+,2114
27,NZ_CP090948,1,1020363,1022476,+,2113
27,NZ_CP069052,1,787991,790105,-,2114
27,NZ_CP076228,1,882158,884272,+,2114
27,NZ_CP042445,1,1020352,1022466,+,2114
27,NZ_CP042904,1,1142684,1144798,+,2114
27,NC_012416,1,1186409,1188523,+,2114
27,NZ_CP069053,1,865974,868088,+,2114
27,NZ_CP042446,1,1020362,1022476,+,2114
27,NZ_CP041215,1,1419190,1421304,-,2114
27,NZ_OX366353,1,1096465,1098579,-,2114
27,NZ_OX366387,1,33258,35372,+,2114
27,NZ_OX366368,1,31747,33861,+,2114
27,NZ_OX366379,1,31765,33879,+,2114
27,NZ_CP091195,1,1059106,1061220,-,2114
27,NZ_OX366375,1,32696,34810,+,2114
27,NZ_CP046925,1,1020212,1022326,+,2114
27,NZ_OX366318,1,30913,33027,+,2114
27,NZ_OX366319,1,32527,34641,+,2114
27,NZ_OX366332,1,31146,33260,+,2114
27,NZ_CP110359,1,252786,254779,+,1993
27,NZ_OU953855,1,594630,596623,+,1993
27,NZ_OX366272,1,32761,34753,+,1992
27,NZ_OX366347,1,1232795,1234788,-,1993
27,NZ_OU909470,1,799022,801018,-,1996
27,NZ_OX366363,1,1039880,1041873,+,1993
27,NZ_OX366364,1,170700,172813,-,2113
27,NZ_OX366359,1,31142,33256,+,2114
27,NZ_OX366349,1,364955,366959,+,2004
27,NZ_OX366380,1,1263590,1265586,+,1996
27,NZ_OX366344,1,1223713,1225710,+,1997
27,NZ_CP090900,1,1020364,1022478,+,2114
27,NZ_OX366352,1,33710,35824,+,2114
27,NZ_OX366362,1,207580,209702,+,2122
27,NZ_OX366400,1,141082,143196,-,2114
27,NZ_OX366327,1,33014,35128,+,2114
27,NZ_OX366367,1,1190411,1192520,+,2109
27,NZ_CP042444,1,1021718,1023832,+,2114
27,NZ_OX366326,1,34242,36356,+,2114
27,NZ_CP037426,1,1280114,1282228,+,2114
27,NZ_OX366339,1,1121026,1123140,-,2114
27,NZ_OX366355,1,36324,38438,+,2114
27,NZ_CP046922,1,1082260,1084374,+,2114
27,NZ_OX366370,1,1081008,1083012,+,2004
27,NZ_OX366385,1,1151504,1153500,-,1996
27,NZ_OX366399,1,31743,33857,+,2114
27,NZ_OX366395,1,56485,58481,-,1996
27,NZ_OX366396,1,1450671,1452785,-,2114
27,NZ_OX366351,1,39155,41269,+,2114
27,NZ_OX366381,1,34350,36464,+,2114
27,NZ_OX366342,1,115077,117072,+,1995
27,NZ_OX366369,1,33340,35454,+,2114
27,NZ_OX366356,1,30608,32722,+,2114
27,NZ_OX366377,1,31380,33494,+,2114
27,NZ_OX366388,1,36168,38281,+,2113
27,NZ_OX366357,1,812364,814361,-,1997
27,NZ_CP072012,1,1282432,1284546,+,2114
27,NZ_OX366398,1,502739,504853,+,2114
27,NC_002978,6,1020363,1022476,+,2113
27,NZ_OX366389,1,218862,220976,-,2114
27,NZ_OX366397,1,31020,33134,+,2114
27,NZ_OX366378,1,48649,50763,+,2114
27,NZ_CP090903,1,1020364,1022478,+,2114
27,NZ_OX366374,1,449699,451808,+,2109
27,NZ_CP090901,1,1020364,1022478,+,2114
27,NZ_CP046923,1,998508,1000622,+,2114
27,NZ_CP069055,1,1020159,1022273,-,2114
27,NZ_CP072670,1,1020204,1022318,+,2114
27,NZ_CP090899,1,1020364,1022478,+,2114
27,NZ_CP046924,1,1019446,1021560,+,2114
27,NZ_OX366348,1,31507,33621,+,2114
27,NZ_CP046921,1,1082260,1084374,+,2114
27,NZ_OX366338,1,31219,33204,+,1985
27,NZ_CP054557,1,813555,815669,+,2114
27,NZ_CP072669,1,1020212,1022326,+,2114
27,NC_021089,1,1047487,1049601,+,2114
28,NZ_OX366376,1,141441,142353,+,912
28,NZ_OX366393,1,1325202,1326114,+,912
28,NZ_OX366372,1,1315184,1316096,-,912
28,NZ_CP072672,1,1022742,1023695,+,953
28,NZ_CP069060,1,868478,869431,+,953
28,NZ_CP072667,1,1022716,1023669,+,953
28,NZ_CP072671,1,1022724,1023677,+,953
28,NZ_CP072668,1,1022711,1023664,+,953
28,NZ_CP072666,1,1022724,1023677,+,953
28,NZ_CP090902,1,1022876,1023829,+,953
28,NZ_CP090948,1,1022874,1023827,+,953
28,NZ_CP069052,1,786640,787593,-,953
28,NZ_CP076228,1,884670,885623,+,953
28,NZ_CP042445,1,1022864,1023817,+,953
28,NZ_CP042904,1,1145196,1146129,+,933
28,NC_012416,1,1188921,1189854,+,933
28,NZ_CP069053,1,868486,869439,+,953
28,NZ_CP042446,1,1022874,1023827,+,953
28,NZ_CP041215,1,1416760,1417702,-,942
28,NZ_OX366353,1,1094044,1094986,-,942
28,NZ_OX366387,1,37920,38848,+,928
28,NZ_OX366368,1,34259,35212,+,953
28,NZ_OX366379,1,34277,35230,+,953
28,NZ_CP091195,1,79723,80663,-,940
28,NZ_OX366375,1,35208,36137,+,929
28,NZ_CP046925,1,1022724,1023677,+,953
28,NZ_OX366318,1,33424,34385,+,961
28,NZ_OX366319,1,35039,35965,+,926
28,NZ_OX366332,1,34739,35681,+,942
28,NZ_CP110359,1,433948,434894,-,946
28,NZ_OU953855,1,121567,122513,-,946
28,NZ_OX366272,1,1168116,1169062,+,946
28,NZ_OX366347,1,83858,84796,-,938
28,NZ_OU909470,1,673003,673939,+,936
28,NZ_OX366363,1,846041,846987,+,946
28,NZ_OX366364,1,168045,168996,-,951
28,NZ_OX366359,1,34743,35685,+,942
28,NZ_OX366349,1,367651,368574,+,923
28,NZ_OX366380,1,86556,87489,+,933
28,NZ_OX366344,1,1225995,1226940,+,945
28,NZ_CP090900,1,1022876,1023829,+,953
28,NZ_OX366352,1,37311,38253,+,942
28,NZ_OX366362,1,210127,211061,+,934
28,NZ_OX366400,1,139724,140685,-,961
28,NZ_OX366327,1,35526,36460,+,934
28,NZ_OX366367,1,1193126,1194055,+,929
28,NZ_CP042444,1,1024230,1025183,+,953
28,NZ_OX366326,1,36753,37714,+,961
28,NZ_CP037426,1,1282626,1283555,+,929
28,NZ_OX366339,1,1118603,1119530,-,927
28,NZ_OX366355,1,38836,39762,+,926
28,NZ_CP046922,1,1084772,1085725,+,953
28,NZ_OX366370,1,1083170,1084136,+,966
28,NZ_OX366385,1,1125257,1126190,-,933
28,NZ_OX366399,1,34255,35208,+,953
28,NZ_OX366395,1,55094,56047,-,953
28,NZ_OX366396,1,1448256,1449183,-,927
28,NZ_OX366351,1,41666,42627,+,961
28,NZ_OX366381,1,36862,37788,+,926
28,NZ_OX366342,1,117743,118655,+,912
28,NZ_OX366369,1,35852,36778,+,926
28,NZ_OX366356,1,33120,34053,+,933
28,NZ_OX366377,1,33892,34818,+,926
28,NZ_OX366388,1,184367,185300,+,933
28,NZ_OX366357,1,811255,812206,-,951
28,NZ_CP072012,1,1284944,1285897,+,953
28,NZ_OX366398,1,505251,506177,+,926
28,NC_002978,6,1022874,1023827,+,953
28,NZ_OX366389,1,217538,218464,-,926
28,NZ_OX366397,1,67502,68444,-,942
28,NZ_OX366378,1,1136106,1137046,+,940
28,NZ_CP090903,1,1022876,1023829,+,953
28,NZ_OX366374,1,452282,453228,+,946
28,NZ_CP090901,1,1022876,1023829,+,953
28,NZ_CP046923,1,1001020,1001973,+,953
28,NZ_CP069055,1,974102,975055,+,953
28,NZ_CP072670,1,1022716,1023669,+,953
28,NZ_CP090899,1,1022876,1023829,+,953
28,NZ_CP046924,1,1021958,1022911,+,953
28,NZ_OX366348,1,34019,34980,+,961
28,NZ_CP046921,1,1084772,1085725,+,953
28,NZ_OX366338,1,33714,34632,+,918
28,NZ_CP054557,1,816067,816987,+,920
28,NZ_CP072669,1,1022724,1023677,+,953
28,NC_021089,1,1051088,1052030,+,942
29,NZ_OX366376,1,143006,145355,+,2349
29,NZ_OX366393,1,1326767,1329116,+,2349
29,NZ_OX366372,1,1312181,1314531,-,2350
29,NZ_CP072672,1,481840,484306,-,2466
29,NZ_CP069060,1,469549,472015,-,2466
29,NZ_CP072667,1,481822,484288,-,2466
29,NZ_CP072671,1,481822,484288,-,2466
29,NZ_CP072668,1,481809,484275,-,2466
29,NZ_CP072666,1,481822,484288,-,2466
29,NZ_CP090902,1,481974,484440,-,2466
29,NZ_CP090948,1,481974,484440,-,2466
29,NZ_CP069052,1,399404,401869,+,2465
29,NZ_CP076228,1,228238,230703,+,2465
29,NZ_CP042445,1,481974,484440,-,2466
29,NZ_CP042904,1,250668,253151,+,2483
29,NC_012416,1,253251,255734,+,2483
29,NZ_CP069053,1,75254,77719,+,2465
29,NZ_CP042446,1,481974,484440,-,2466
29,NZ_CP041215,1,1245590,1248057,-,2467
29,NZ_OX366353,1,1287812,1290279,-,2467
29,NZ_OX366387,1,1098830,1101295,+,2465
29,NZ_OX366368,1,749403,751868,+,2465
29,NZ_OX366379,1,705608,708073,+,2465
29,NZ_CP091195,1,461881,464374,-,2493
29,NZ_OX366375,1,787562,790027,+,2465
29,NZ_CP046925,1,481822,484288,-,2466
29,NZ_OX366318,1,656552,659017,+,2465
29,NZ_OX366319,1,632747,635213,-,2466
29,NZ_OX366332,1,874029,876496,-,2467
29,NZ_CP110359,1,963851,966344,-,2493
29,NZ_OU953855,1,606358,608854,-,2496
29,NZ_OX366272,1,534637,537130,-,2493
29,NZ_OX366347,1,999360,1001853,-,2493
29,NZ_OU909470,1,674368,676707,+,2339
29,NZ_OX366363,1,256308,258801,-,2493
29,NZ_OX366364,1,143165,145539,+,2374
29,NZ_OX366359,1,543657,546123,+,2466
29,NZ_OX366349,1,369227,371583,+,2356
29,NZ_OX366380,1,87920,90257,+,2337
29,NZ_OX366344,1,1227593,1229942,+,2349
29,NZ_CP090900,1,481974,484440,-,2466
29,NZ_OX366352,1,603059,605526,-,2467
29,NZ_OX366362,1,1385089,1387951,-,2862
29,NZ_OX366400,1,593334,595800,-,2466
29,NZ_OX366327,1,706742,709225,+,2483
29,NZ_OX366367,1,1254406,1256771,+,2365
29,NZ_CP042444,1,482475,484941,-,2466
29,NZ_OX366326,1,751376,753841,+,2465
29,NZ_CP037426,1,266355,268821,-,2466
29,NZ_OX366339,1,581018,583484,-,2466
29,NZ_OX366355,1,698895,701361,-,2466
29,NZ_CP046922,1,479092,481557,+,2465
29,NZ_OX366370,1,1085438,1087802,+,2364
29,NZ_OX366385,1,1122488,1124826,-,2338
29,NZ_OX366399,1,675191,677656,+,2465
29,NZ_OX366395,1,648487,650979,+,2492
29,NZ_OX366396,1,783199,785664,+,2465
29,NZ_OX366351,1,573209,575674,+,2465
29,NZ_OX366381,1,907312,909778,-,2466
29,NZ_OX366342,1,119308,121657,+,2349
29,NZ_OX366369,1,811425,813891,-,2466
29,NZ_OX366356,1,723855,726321,-,2466
29,NZ_OX366377,1,863312,865777,+,2465
29,NZ_OX366388,1,705930,708423,-,2493
29,NZ_OX366357,1,298774,301266,+,2492
29,NZ_CP072012,1,580670,583136,-,2466
29,NZ_OX366398,1,639835,642300,+,2465
29,NC_002978,6,481974,484440,-,2466
29,NZ_OX366389,1,734527,736992,+,2465
29,NZ_OX366397,1,969971,972438,-,2467
29,NZ_OX366378,1,1200732,1203225,-,2493
29,NZ_CP090903,1,481974,484440,-,2466
29,NZ_OX366374,1,842644,845137,-,2493
29,NZ_CP090901,1,481974,484440,-,2466
29,NZ_CP046923,1,395340,397805,+,2465
29,NZ_CP069055,1,520574,523040,-,2466
29,NZ_CP072670,1,481814,484280,-,2466
29,NZ_CP090899,1,481974,484440,-,2466
29,NZ_CP046924,1,416278,418743,+,2465
29,NZ_OX366348,1,441340,443805,+,2465
29,NZ_CP046921,1,479092,481557,+,2465
29,NZ_OX366338,1,628064,630557,+,2493
29,NZ_CP054557,1,23877,26342,+,2465
29,NZ_CP072669,1,481822,484288,-,2466
29,NC_021089,1,336846,339312,+,2466
60,NZ_OX366376,1,221827,225903,+,4076
60,NZ_OX366393,1,1405971,1410047,+,4076
60,NZ_OX366372,1,1232032,1236108,-,4076
60,NZ_CP072672,1,1317,5400,-,4083
60,NZ_CP069060,1,1374,5457,-,4083
60,NZ_CP072667,1,1317,5400,-,4083
60,NZ_CP072671,1,1317,5400,-,4083
60,NZ_CP072668,1,1317,5400,-,4083
60,NZ_CP072666,1,1317,5400,-,4083
60,NZ_CP090902,1,1469,5552,-,4083
60,NZ_CP090948,1,1469,5552,-,4083
60,NZ_CP069052,1,1374,5457,-,4083
60,NZ_CP076228,1,1317,5400,-,4083
60,NZ_CP042445,1,1469,5552,-,4083
60,NZ_CP042904,1,1468,5551,-,4083
60,NC_012416,1,1469,5552,-,4083
60,NZ_CP069053,1,1374,5457,-,4083
60,NZ_CP042446,1,1469,5552,-,4083
60,NZ_CP041215,1,574720,578803,+,4083
60,NZ_OX366353,1,741207,745290,-,4083
60,NZ_OX366387,1,567959,572042,+,4083
60,NZ_OX366368,1,283387,287470,-,4083
60,NZ_OX366379,1,284405,288488,-,4083
60,NZ_CP091195,1,1394855,1398938,+,4083
60,NZ_OX366375,1,301735,305818,-,4083
60,NZ_CP046925,1,1317,5400,-,4083
60,NZ_OX366318,1,374784,378867,-,4083
60,NZ_OX366319,1,915054,919137,+,4083
60,NZ_OX366332,1,281973,286056,-,4083
60,NZ_CP110359,1,1317,5391,-,4074
60,NZ_OU953855,1,717520,721594,-,4074
60,NZ_OX366272,1,1099255,1103329,+,4074
60,NZ_OX366347,1,392031,396105,-,4074
60,NZ_OU909470,1,1099246,1103322,+,4076
60,NZ_OX366363,1,650649,654723,+,4074
60,NZ_OX366364,1,1257150,1261224,+,4074
60,NZ_OX366359,1,280557,284640,-,4083
60,NZ_OX366349,1,151292,155368,-,4076
60,NZ_OX366380,1,1284175,1288251,+,4076
60,NZ_OX366344,1,1115997,1120073,+,4076
60,NZ_CP090900,1,1469,5552,-,4083
60,NZ_OX366352,1,1047565,1051648,+,4083
60,NZ_OX366362,1,1160716,1164799,-,4083
60,NZ_OX366400,1,284010,288093,-,4083
60,NZ_OX366327,1,286015,290098,-,4083
60,NZ_OX366367,1,1110251,1114325,+,4074
60,NZ_CP042444,1,1469,5552,-,4083
60,NZ_OX366326,1,507589,511672,+,4083
60,NZ_CP037426,1,1317,5400,-,4083
60,NZ_OX366339,1,1051547,1055630,-,4083
60,NZ_OX366355,1,1028914,1032997,+,4083
60,NZ_CP046922,1,1317,5400,-,4083
60,NZ_OX366370,1,885192,889269,+,4077
60,NZ_OX366385,1,99260,103336,-,4076
60,NZ_OX366399,1,282889,286972,-,4083
60,NZ_OX366395,1,428660,432743,-,4083
60,NZ_OX366396,1,343063,347146,-,4083
60,NZ_OX366351,1,293459,297542,-,4083
60,NZ_OX366381,1,1346379,1350462,-,4083
60,NZ_OX366342,1,501484,505560,-,4076
60,NZ_OX366369,1,278042,282125,-,4083
60,NZ_OX366356,1,312187,316270,-,4083
60,NZ_OX366377,1,298559,302642,+,4083
60,NZ_OX366388,1,1492796,1496879,+,4083
60,NZ_OX366357,1,736009,740093,+,4084
60,NZ_CP072012,1,1030485,1034568,+,4083
60,NZ_OX366398,1,906201,910284,+,4083
60,NC_002978,6,1469,5552,-,4083
60,NZ_OX366389,1,340218,344241,-,4023
60,NZ_OX366397,1,281823,285906,-,4083
60,NZ_OX366378,1,912096,916179,+,4083
60,NZ_CP090903,1,1469,5552,-,4083
60,NZ_OX366374,1,1145617,1149700,+,4083
60,NZ_CP090901,1,1469,5552,-,4083
60,NZ_CP046923,1,1317,5400,-,4083
60,NZ_CP069055,1,1469,5552,-,4083
60,NZ_CP072670,1,1317,5400,-,4083
60,NZ_CP090899,1,1469,5552,-,4083
60,NZ_CP046924,1,1317,5400,-,4083
60,NZ_OX366348,1,964160,968181,+,4021
60,NZ_CP046921,1,1317,5400,-,4083
60,NZ_OX366338,1,44940,48975,-,4035
60,NZ_CP054557,1,401888,405911,-,4023
60,NZ_CP072669,1,1317,5400,-,4083
60,NC_021089,1,1469,5552,-,4083
61,NZ_OX366376,1,225904,227223,+,1319
61,NZ_OX366393,1,1410048,1411367,+,1319
61,NZ_OX366372,1,1230712,1232030,-,1318
61,NZ_CP072672,1,1,1315,-,1314
61,NZ_CP069060,1,54,1372,-,1318
61,NZ_CP072667,1,1,1315,-,1314
61,NZ_CP072671,1,1,1315,-,1314
61,NZ_CP072668,1,1,1315,-,1314
61,NZ_CP072666,1,1,1315,-,1314
61,NZ_CP090902,1,149,1467,-,1318
61,NZ_CP090948,1,149,1467,-,1318
61,NZ_CP069052,1,54,1372,-,1318
61,NZ_CP076228,1,1,1315,-,1314
61,NZ_CP042445,1,149,1467,-,1318
61,NZ_CP042904,1,148,1466,-,1318
61,NC_012416,1,149,1467,-,1318
61,NZ_CP069053,1,54,1372,-,1318
61,NZ_CP042446,1,149,1467,-,1318
61,NZ_CP041215,1,578804,580123,+,1319
61,NZ_OX366353,1,739887,741205,-,1318
61,NZ_OX366387,1,572043,573362,+,1319
61,NZ_OX366368,1,282067,283385,-,1318
61,NZ_OX366379,1,283085,284403,-,1318
61,NZ_CP091195,1,1398939,1400258,+,1319
61,NZ_OX366375,1,300415,301733,-,1318
61,NZ_CP046925,1,1,1315,-,1314
61,NZ_OX366318,1,373464,374782,-,1318
61,NZ_OX366319,1,919138,920457,+,1319
61,NZ_OX366332,1,280653,281971,-,1318
61,NZ_CP110359,1,1,1315,-,1314
61,NZ_OU953855,1,716200,717518,-,1318
61,NZ_OX366272,1,1103330,1104649,+,1319
61,NZ_OX366347,1,390711,392029,-,1318
61,NZ_OU909470,1,1103323,1104632,+,1309
61,NZ_OX366363,1,654724,656043,+,1319
61,NZ_OX366364,1,1261225,1262544,+,1319
61,NZ_OX366359,1,279237,280555,-,1318
61,NZ_OX366349,1,149972,151290,-,1318
61,NZ_OX366380,1,1288252,1289571,+,1319
61,NZ_OX366344,1,1120074,1121393,+,1319
61,NZ_CP090900,1,149,1467,-,1318
61,NZ_OX366352,1,1051649,1052968,+,1319
61,NZ_OX366362,1,1159396,1160714,-,1318
61,NZ_OX366400,1,282690,284008,-,1318
61,NZ_OX366327,1,284695,286013,-,1318
61,NZ_OX366367,1,1114326,1115645,+,1319
61,NZ_CP042444,1,149,1467,-,1318
61,NZ_OX366326,1,511673,512992,+,1319
61,NZ_CP037426,1,1,1315,-,1314
61,NZ_OX366339,1,1050227,1051545,-,1318
61,NZ_OX366355,1,1032998,1034317,+,1319
61,NZ_CP046922,1,1,1315,-,1314
61,NZ_OX366370,1,889270,890589,+,1319
61,NZ_OX366385,1,97940,99258,-,1318
61,NZ_OX366399,1,281569,282887,-,1318
61,NZ_OX366395,1,427340,428658,-,1318
61,NZ_OX366396,1,341743,343061,-,1318
61,NZ_OX366351,1,292139,293457,-,1318
61,NZ_OX366381,1,1345059,1346377,-,1318
61,NZ_OX366342,1,500164,501482,-,1318
61,NZ_OX366369,1,276722,278040,-,1318
61,NZ_OX366356,1,310867,312185,-,1318
61,NZ_OX366377,1,302643,303962,+,1319
61,NZ_OX366388,1,1496880,1498199,+,1319
61,NZ_OX366357,1,740094,741413,+,1319
61,NZ_CP072012,1,1034569,1035888,+,1319
61,NZ_OX366398,1,910285,911604,+,1319
61,NC_002978,6,149,1467,-,1318
61,NZ_OX366389,1,337919,339253,-,1334
61,NZ_OX366397,1,280503,281821,-,1318
61,NZ_OX366378,1,916180,917499,+,1319
61,NZ_CP090903,1,149,1467,-,1318
61,NZ_OX366374,1,1149701,1151020,+,1319
61,NZ_CP090901,1,149,1467,-,1318
61,NZ_CP046923,1,1,1315,-,1314
61,NZ_CP069055,1,149,1467,-,1318
61,NZ_CP072670,1,1,1315,-,1314
61,NZ_CP090899,1,149,1467,-,1318
61,NZ_CP046924,1,1,1315,-,1314
61,NZ_OX366348,1,969148,970482,+,1334
61,NZ_CP046921,1,1,1315,-,1314
61,NZ_OX366338,1,43620,44938,-,1318
61,NZ_CP054557,1,714010,715344,-,1334
61,NZ_CP072669,1,1,1315,-,1314
61,NC_021089,1,149,1467,-,1318
62,NZ_OX366376,1,227450,228253,+,803
62,NZ_OX366393,1,1411594,1412397,+,803
62,NZ_OX366372,1,1229682,1230485,-,803
62,NZ_CP072672,1,1266768,1267571,-,803
62,NZ_CP069060,1,1408118,1408921,-,803
62,NZ_CP072667,1,1266742,1267545,-,803
62,NZ_CP072671,1,1266750,1267553,-,803
62,NZ_CP072668,1,1266737,1267540,-,803
62,NZ_CP072666,1,1266750,1267553,-,803
62,NZ_CP090902,1,1266903,1267706,-,803
62,NZ_CP090948,1,1266901,1267704,-,803
62,NZ_CP069052,1,1352418,1353221,-,803
62,NZ_CP076228,1,1289555,1290358,-,803
62,NZ_CP042445,1,1266555,1267358,-,803
62,NZ_CP042904,1,1400578,1401381,-,803
62,NC_012416,1,1444992,1445795,-,803
62,NZ_CP069053,1,1393416,1394219,-,803
62,NZ_CP042446,1,1266900,1267703,-,803
62,NZ_CP041215,1,580350,581153,+,803
62,NZ_OX366353,1,738861,739664,-,803
62,NZ_OX366387,1,573589,574392,+,803
62,NZ_OX366368,1,281037,281840,-,803
62,NZ_OX366379,1,282055,282858,-,803
62,NZ_CP091195,1,1401418,1402207,+,789
62,NZ_OX366375,1,299386,300189,-,803
62,NZ_CP046925,1,1266750,1267553,-,803
62,NZ_OX366318,1,372434,373237,-,803
62,NZ_OX366319,1,920684,921487,+,803
62,NZ_OX366332,1,279623,280426,-,803
62,NZ_CP110359,1,1307382,1308185,-,803
62,NZ_OU953855,1,715170,715973,-,803
62,NZ_OX366272,1,1104876,1105679,+,803
62,NZ_OX366347,1,389681,390484,-,803
62,NZ_OU909470,1,1104858,1105661,+,803
62,NZ_OX366363,1,656270,657073,+,803
62,NZ_OX366364,1,1262770,1263573,+,803
62,NZ_OX366359,1,278211,279014,-,803
62,NZ_OX366349,1,148942,149745,-,803
62,NZ_OX366380,1,1289797,1290600,+,803
62,NZ_OX366344,1,1121620,1122423,+,803
62,NZ_CP090900,1,1266905,1267708,-,803
62,NZ_OX366352,1,1053195,1053998,+,803
62,NZ_OX366362,1,1158366,1159169,-,803
62,NZ_OX366400,1,281660,282463,-,803
62,NZ_OX366327,1,283665,284468,-,803
62,NZ_OX366367,1,1115872,1116675,+,803
62,NZ_CP042444,1,1268256,1269059,-,803
62,NZ_OX366326,1,513219,514022,+,803
62,NZ_CP037426,1,1351321,1352124,-,803
62,NZ_OX366339,1,1049197,1050000,-,803
62,NZ_OX366355,1,1034544,1035347,+,803
62,NZ_CP046922,1,1329624,1330427,-,803
62,NZ_OX366370,1,890816,891619,+,803
62,NZ_OX366385,1,96911,97714,-,803
62,NZ_OX366399,1,280539,281342,-,803
62,NZ_OX366395,1,426310,427113,-,803
62,NZ_OX366396,1,340713,341516,-,803
62,NZ_OX366351,1,291109,291912,-,803
62,NZ_OX366381,1,1344029,1344832,-,803
62,NZ_OX366342,1,499134,499937,-,803
62,NZ_OX366369,1,275692,276495,-,803
62,NZ_OX366356,1,309838,310641,-,803
62,NZ_OX366377,1,304189,304992,+,803
62,NZ_OX366388,1,1498426,1499229,+,803
62,NZ_OX366357,1,741640,742443,+,803
62,NZ_CP072012,1,1036115,1036918,+,803
62,NZ_OX366398,1,911831,912634,+,803
62,NC_002978,6,1266901,1267704,-,803
62,NZ_OX366389,1,336889,337692,-,803
62,NZ_OX366397,1,279477,280280,-,803
62,NZ_OX366378,1,918659,919448,+,789
62,NZ_CP090903,1,1266905,1267708,-,803
62,NZ_OX366374,1,1151246,1152049,+,803
62,NZ_CP090901,1,1266905,1267708,-,803
62,NZ_CP046923,1,1245872,1246675,-,803
62,NZ_CP069055,1,1267574,1268377,-,803
62,NZ_CP072670,1,1266730,1267533,-,803
62,NZ_CP090899,1,1266905,1267708,-,803
62,NZ_CP046924,1,1266810,1267613,-,803
62,NZ_OX366348,1,970709,971502,+,793
62,NZ_CP046921,1,1329624,1330427,-,803
62,NZ_OX366338,1,42590,43393,-,803
62,NZ_CP054557,1,712980,713783,-,803
62,NZ_CP072669,1,1266753,1267556,-,803
62,NC_021089,1,1294927,1295730,-,803
63,NZ_OX366376,1,230949,237375,+,6426
63,NZ_OX366393,1,1415112,1421538,+,6426
63,NZ_OX366372,1,1220560,1226986,-,6426
63,NZ_CP072672,1,1257505,1263913,-,6408
63,NZ_CP069060,1,1398855,1405263,-,6408
63,NZ_CP072667,1,1257479,1263887,-,6408
63,NZ_CP072671,1,1257487,1263895,-,6408
63,NZ_CP072668,1,1257474,1263882,-,6408
63,NZ_CP072666,1,1257487,1263895,-,6408
63,NZ_CP090902,1,1257640,1264048,-,6408
63,NZ_CP090948,1,1257638,1264046,-,6408
63,NZ_CP069052,1,1343155,1349563,-,6408
63,NZ_CP076228,1,1279375,1285783,-,6408
63,NZ_CP042445,1,1257292,1263700,-,6408
63,NZ_CP042904,1,1391297,1397705,-,6408
63,NC_012416,1,1435711,1442119,-,6408
63,NZ_CP069053,1,1384153,1390561,-,6408
63,NZ_CP042446,1,1257637,1264045,-,6408
63,NZ_CP041215,1,584026,590434,+,6408
63,NZ_OX366353,1,729580,735988,-,6408
63,NZ_OX366387,1,577247,583655,+,6408
63,NZ_OX366368,1,271774,278182,-,6408
63,NZ_OX366379,1,272792,279200,-,6408
63,NZ_CP091195,1,1404960,1411377,+,6417
63,NZ_OX366375,1,290123,296531,-,6408
63,NZ_CP046925,1,1257487,1263895,-,6408
63,NZ_OX366318,1,362633,369041,-,6408
63,NZ_OX366319,1,924351,930759,+,6408
63,NZ_OX366332,1,270342,276750,-,6408
63,NZ_CP110359,1,1298088,1304496,-,6408
63,NZ_OU953855,1,1745704,1752121,+,6417
63,NZ_OX366272,1,1108564,1114972,+,6408
63,NZ_OX366347,1,380388,386796,-,6408
63,NZ_OU909470,1,513688,520106,-,6418
63,NZ_OX366363,1,659826,666243,+,6417
63,NZ_OX366364,1,1266289,1272706,+,6417
63,NZ_OX366359,1,268930,275338,-,6408
63,NZ_OX366349,1,139730,146156,-,6426
63,NZ_OX366380,1,1293302,1299728,+,6426
63,NZ_OX366344,1,1125174,1131596,+,6422
63,NZ_CP090900,1,1257642,1264050,-,6408
63,NZ_OX366352,1,1414623,1421031,+,6408
63,NZ_OX366362,1,1149140,1155566,-,6426
63,NZ_OX366400,1,272502,278910,-,6408
63,NZ_OX366327,1,274384,280792,-,6408
63,NZ_OX366367,1,1121050,1127458,+,6408
63,NZ_CP042444,1,1258993,1265401,-,6408
63,NZ_OX366326,1,516772,523180,+,6408
63,NZ_CP037426,1,1342058,1348466,-,6408
63,NZ_OX366339,1,1039916,1046324,-,6408
63,NZ_OX366355,1,1038211,1044619,+,6408
63,NZ_CP046922,1,1320361,1326769,-,6408
63,NZ_OX366370,1,194324,200967,+,6643
63,NZ_OX366385,1,87783,94209,-,6426
63,NZ_OX366399,1,271276,277684,-,6408
63,NZ_OX366395,1,417120,423527,-,6407
63,NZ_OX366396,1,331465,337873,-,6408
63,NZ_OX366351,1,281951,288359,-,6408
63,NZ_OX366381,1,1334757,1341165,-,6408
63,NZ_OX366342,1,490012,496438,-,6426
63,NZ_OX366369,1,266420,272828,-,6408
63,NZ_OX366356,1,300613,307125,-,6512
63,NZ_OX366377,1,307847,314255,+,6408
63,NZ_OX366388,1,1502012,1508420,+,6408
63,NZ_OX366357,1,1268519,1274928,+,6409
63,NZ_CP072012,1,1039773,1046181,+,6408
63,NZ_OX366398,1,915489,921897,+,6408
63,NC_002978,6,1257638,1264046,-,6408
63,NZ_OX366389,1,327626,334034,-,6408
63,NZ_OX366397,1,270196,276604,-,6408
63,NZ_OX366378,1,922201,928618,+,6417
63,NZ_CP090903,1,1257642,1264050,-,6408
63,NZ_OX366374,1,226143,232445,+,6302
63,NZ_CP090901,1,1257642,1264050,-,6408
63,NZ_CP046923,1,1236609,1243017,-,6408
63,NZ_CP069055,1,1258312,1264719,-,6407
63,NZ_CP072670,1,1257467,1263875,-,6408
63,NZ_CP090899,1,1257642,1264050,-,6408
63,NZ_CP046924,1,1257547,1263955,-,6408
63,NZ_OX366348,1,974343,980751,+,6408
63,NZ_CP046921,1,1320361,1326769,-,6408
63,NZ_OX366338,1,385631,392039,-,6408
63,NZ_CP054557,1,703717,710125,-,6408
63,NZ_CP072669,1,1257490,1263898,-,6408
63,NC_021089,1,1285646,1292054,-,6408
64,NZ_OX366376,1,238744,239324,+,580
64,NZ_OX366393,1,1423290,1423870,+,580
64,NZ_OX366372,1,1218519,1219100,-,581
64,NZ_OU909470,1,512074,512667,-,593
64,NZ_OX366349,1,137287,137883,-,596
64,NZ_OX366344,1,1132906,1133502,+,596
64,NZ_OX366367,1,202288,202867,+,579
64,NZ_OX366370,1,273442,274023,-,581
64,NZ_OX366342,1,488251,488832,-,581
65,NZ_OX366376,1,240471,241003,+,532
65,NZ_OX366393,1,1425017,1425549,+,532
65,NZ_OX366372,1,1216840,1217373,-,533
65,NZ_OU909470,1,510437,510966,-,529
65,NZ_OX366364,1,1100838,1101371,-,533
65,NZ_OX366349,1,135599,136132,-,533
65,NZ_OX366380,1,1303887,1304419,+,532
65,NZ_OX366344,1,1134657,1135189,+,532
65,NZ_OX366362,1,50572,51104,-,532
65,NZ_OX366367,1,204023,204555,+,532
65,NZ_OX366370,1,271756,272289,-,533
65,NZ_OX366385,1,83099,83632,-,533
65,NZ_OX366395,1,1500888,1501420,+,532
65,NZ_OX366342,1,486572,487105,-,533
65,NZ_OX366338,1,926795,927328,-,533
66,NZ_OX366376,1,241843,243124,+,1281
66,NZ_OX366393,1,1426389,1427670,+,1281
66,NZ_OX366372,1,1214720,1216001,-,1281
66,NZ_CP072672,1,913442,914723,-,1281
66,NZ_CP069060,1,718123,719404,-,1281
66,NZ_CP072667,1,913416,914697,-,1281
66,NZ_CP072671,1,913424,914705,-,1281
66,NZ_CP072668,1,913411,914692,-,1281
66,NZ_CP072666,1,913424,914705,-,1281
66,NZ_CP090902,1,913576,914857,-,1281
66,NZ_CP090948,1,913576,914857,-,1281
66,NZ_CP069052,1,903678,904959,-,1281
66,NZ_CP076228,1,954559,955840,-,1281
66,NZ_CP042445,1,913564,914845,-,1281
66,NZ_CP042904,1,933974,935255,-,1281
66,NC_012416,1,969557,970838,-,1281
66,NZ_CP069053,1,751120,752401,+,1281
66,NZ_CP042446,1,913574,914855,-,1281
66,NZ_CP041215,1,129095,130376,-,1281
66,NZ_OX366353,1,1236272,1237553,+,1281
66,NZ_OX366387,1,1715682,1716963,-,1281
66,NZ_OX366368,1,1358964,1360245,-,1281
66,NZ_OX366379,1,1278457,1279738,-,1281
66,NZ_CP091195,1,1304958,1306239,+,1281
66,NZ_OX366375,1,1136048,1137329,-,1281
66,NZ_CP046925,1,913424,914705,-,1281
66,NZ_OX366318,1,1211724,1213005,-,1281
66,NZ_OX366319,1,1216602,1217883,+,1281
66,NZ_OX366332,1,1296717,1297998,-,1281
66,NZ_CP110359,1,88423,89704,+,1281
66,NZ_OU953855,1,1460907,1462188,-,1281
66,NZ_OX366272,1,39281,40562,+,1281
66,NZ_OX366347,1,1356703,1357984,-,1281
66,NZ_OU909470,1,508372,509598,-,1226
66,NZ_OX366363,1,1070023,1071304,-,1281
66,NZ_OX366364,1,1098701,1099982,-,1281
66,NZ_OX366359,1,1126499,1127779,-,1280
66,NZ_OX366349,1,133483,134763,-,1280
66,NZ_OX366380,1,1305259,1306527,+,1268
66,NZ_OX366344,1,1136026,1137306,+,1280
66,NZ_CP090900,1,913576,914857,-,1281
66,NZ_OX366352,1,158319,159600,+,1281
66,NZ_OX366362,1,48136,49427,-,1291
66,NZ_OX366400,1,1068640,1069921,-,1281
66,NZ_OX366327,1,1209268,1210549,-,1281
66,NZ_OX366367,1,205412,206693,+,1281
66,NZ_CP042444,1,914011,915292,-,1281
66,NZ_OX366326,1,1420285,1421566,-,1281
66,NZ_CP037426,1,1117053,1118334,+,1281
66,NZ_OX366339,1,887693,888974,-,1281
66,NZ_OX366355,1,145375,146656,+,1281
66,NZ_CP046922,1,975472,976753,-,1281
66,NZ_OX366370,1,269637,270917,-,1280
66,NZ_OX366385,1,80992,82260,-,1268
66,NZ_OX366399,1,1312073,1313354,-,1281
66,NZ_OX366395,1,1502566,1503847,+,1281
66,NZ_OX366396,1,427112,428393,-,1281
66,NZ_OX366351,1,1365861,1367142,-,1281
66,NZ_OX366381,1,129121,130402,-,1281
66,NZ_OX366342,1,484452,485733,-,1281
66,NZ_OX366369,1,1424770,1426051,+,1281
66,NZ_OX366356,1,1062313,1063594,+,1281
66,NZ_OX366377,1,1052425,1053706,+,1281
66,NZ_OX366388,1,1692571,1693852,+,1281
66,NZ_OX366357,1,71873,73154,+,1281
66,NZ_CP072012,1,263410,264682,-,1272
66,NZ_OX366398,1,395636,396917,-,1281
66,NC_002978,6,913576,914857,-,1281
66,NZ_OX366389,1,1288527,1289733,-,1206
66,NZ_OX366397,1,1521414,1522695,-,1281
66,NZ_OX366378,1,166051,167332,+,1281
66,NZ_CP090903,1,913576,914857,-,1281
66,NZ_OX366374,1,197466,198747,+,1281
66,NZ_CP090901,1,913576,914857,-,1281
66,NZ_CP046923,1,891720,893001,-,1281
66,NZ_CP069055,1,930311,931592,+,1281
66,NZ_CP072670,1,913416,914697,-,1281
66,NZ_CP090899,1,913576,914857,-,1281
66,NZ_CP046924,1,912658,913939,-,1281
66,NZ_OX366348,1,66423,67704,+,1281
66,NZ_CP046921,1,975472,976753,-,1281
66,NZ_OX366338,1,341353,342634,-,1281
66,NZ_CP054557,1,928830,930111,+,1281
66,NZ_CP072669,1,913424,914705,-,1281
66,NC_021089,1,946502,947783,-,1281
67,NZ_OX366376,1,244446,246996,+,2550
67,NZ_OX366393,1,1428802,1431158,+,2356
67,NZ_OX366372,1,1211238,1213398,-,2160
67,NZ_OX366342,1,480987,483342,-,2355
68,NZ_OX366376,1,247871,248996,+,1125
68,NZ_OX366393,1,1432033,1433158,+,1125
68,NZ_OX366372,1,1209238,1210363,-,1125
68,NZ_CP072672,1,1092263,1093393,-,1130
68,NZ_CP069060,1,938683,939813,-,1130
68,NZ_CP072667,1,1092237,1093367,-,1130
68,NZ_CP072671,1,1092245,1093375,-,1130
68,NZ_CP072668,1,1092232,1093362,-,1130
68,NZ_CP072666,1,1092245,1093375,-,1130
68,NZ_CP090902,1,1092397,1093527,-,1130
68,NZ_CP090948,1,1092395,1093525,-,1130
68,NZ_CP069052,1,1057701,1058831,+,1130
68,NZ_CP076228,1,1106778,1107908,-,1130
68,NZ_CP042445,1,1092385,1093515,-,1130
68,NZ_CP042904,1,1026693,1027823,+,1130
68,NC_012416,1,1069250,1070380,+,1130
68,NZ_CP069053,1,938715,939845,-,1130
68,NZ_CP042446,1,1092395,1093525,-,1130
68,NZ_CP041215,1,87388,88510,+,1122
68,NZ_OX366353,1,135564,136686,-,1122
68,NZ_OX366387,1,1566964,1568094,+,1130
68,NZ_OX366368,1,105114,106244,-,1130
68,NZ_OX366379,1,105212,106342,-,1130
68,NZ_CP091195,1,1012302,1013432,+,1130
68,NZ_OX366375,1,74880,76010,+,1130
68,NZ_CP046925,1,1092245,1093375,-,1130
68,NZ_OX366318,1,99876,101006,-,1130
68,NZ_OX366319,1,1123248,1124375,-,1127
68,NZ_OX366332,1,73722,74844,+,1122
68,NZ_CP110359,1,379069,380198,-,1129
68,NZ_OU953855,1,1665173,1666302,-,1129
68,NZ_OX366272,1,189167,190297,+,1130
68,NZ_OX366347,1,30241,31370,-,1129
68,NZ_OU909470,1,507246,508353,-,1107
68,NZ_OX366363,1,899279,900409,+,1130
68,NZ_OX366364,1,39814,40944,+,1130
68,NZ_OX366359,1,73609,74731,+,1122
68,NZ_OX366349,1,405102,406227,+,1125
68,NZ_OX366380,1,1306546,1307653,+,1107
68,NZ_OX366344,1,1258761,1259886,+,1125
68,NZ_CP090900,1,1092397,1093527,-,1130
68,NZ_OX366352,1,1624604,1625726,-,1122
68,NZ_OX366362,1,46647,47762,-,1115
68,NZ_OX366400,1,73800,74930,+,1130
68,NZ_OX366327,1,74212,75342,+,1130
68,NZ_OX366367,1,1324130,1325260,+,1130
68,NZ_CP042444,1,1093751,1094881,-,1130
68,NZ_OX366326,1,103590,104720,-,1130
68,NZ_CP037426,1,1069802,1070932,-,1130
68,NZ_OX366339,1,885107,886206,-,1099
68,NZ_OX366355,1,1240358,1241485,-,1127
68,NZ_CP046922,1,1154209,1155339,-,1130
68,NZ_OX366370,1,25476,26601,-,1125
68,NZ_OX366385,1,79866,80973,-,1107
68,NZ_OX366399,1,104615,105745,-,1130
68,NZ_OX366395,1,242468,243598,-,1130
68,NZ_OX366396,1,1409935,1411065,-,1130
68,NZ_OX366351,1,110997,112127,-,1130
68,NZ_OX366381,1,1305285,1306412,-,1127
68,NZ_OX366342,1,478987,480112,-,1125
68,NZ_OX366369,1,101567,102694,-,1127
68,NZ_OX366356,1,98869,99999,-,1130
68,NZ_OX366377,1,106646,107776,-,1130
68,NZ_OX366388,1,85167,86296,-,1129
68,NZ_OX366357,1,897155,898285,+,1130
68,NZ_CP072012,1,1210724,1211854,+,1130
68,NZ_OX366398,1,753436,754566,-,1130
68,NC_002978,6,1092395,1093525,-,1130
68,NZ_OX366389,1,145479,146609,+,1130
68,NZ_OX366397,1,103568,104690,-,1122
68,NZ_OX366378,1,237055,238184,-,1129
68,NZ_CP090903,1,1092397,1093527,-,1130
68,NZ_OX366374,1,369619,370750,+,1131
68,NZ_CP090901,1,1092397,1093527,-,1130
68,NZ_CP046923,1,1070457,1071587,-,1130
68,NZ_CP069055,1,1092167,1093297,-,1130
68,NZ_CP072670,1,1092225,1093355,-,1130
68,NZ_CP090899,1,1092397,1093527,-,1130
68,NZ_CP046924,1,1091395,1092525,-,1130
68,NZ_OX366348,1,1142283,1143413,-,1130
68,NZ_CP046921,1,1154209,1155339,-,1130
68,NZ_OX366338,1,112688,113789,-,1101
68,NZ_CP054557,1,887407,888537,-,1130
68,NZ_CP072669,1,1092245,1093375,-,1130
68,NC_021089,1,1119976,1121098,-,1122
69,NZ_OX366376,1,250701,252369,+,1668
69,NZ_OX366393,1,1434853,1436521,+,1668
69,NZ_OX366372,1,1205877,1207545,-,1668
69,NZ_CP072672,1,1086715,1088383,-,1668
69,NZ_CP069060,1,932787,934455,-,1668
69,NZ_CP072667,1,1086689,1088357,-,1668
69,NZ_CP072671,1,1086697,1088365,-,1668
69,NZ_CP072668,1,1086684,1088352,-,1668
69,NZ_CP072666,1,1086697,1088365,-,1668
69,NZ_CP090902,1,1086849,1088517,-,1668
69,NZ_CP090948,1,1086847,1088515,-,1668
69,NZ_CP069052,1,720173,721841,+,1668
69,NZ_CP076228,1,1049670,1051338,-,1668
69,NZ_CP042445,1,1086837,1088505,-,1668
69,NZ_CP042904,1,1099140,1100808,+,1668
69,NC_012416,1,1143187,1144855,+,1668
69,NZ_CP069053,1,932795,934463,-,1668
69,NZ_CP042446,1,1086847,1088515,-,1668
69,NZ_CP041215,1,90099,91767,+,1668
69,NZ_OX366353,1,132307,133975,-,1668
69,NZ_OX366387,1,1569611,1571279,+,1668
69,NZ_OX366368,1,99558,101226,-,1668
69,NZ_OX366379,1,99567,101235,-,1668
69,NZ_CP091195,1,1017302,1018970,+,1668
69,NZ_OX366375,1,81806,83474,+,1668
69,NZ_CP046925,1,1086697,1088365,-,1668
69,NZ_OX366318,1,96676,98344,-,1668
69,NZ_OX366319,1,1120003,1121671,-,1668
69,NZ_OX366332,1,76433,78101,+,1668
69,NZ_CP110359,1,375869,377537,-,1668
69,NZ_OU953855,1,784314,785982,+,1668
69,NZ_OX366272,1,191829,193497,+,1668
69,NZ_OX366347,1,27041,28709,-,1668
69,NZ_OU909470,1,494907,496575,+,1668
69,NZ_OX366363,1,901953,903621,+,1668
69,NZ_OX366364,1,41421,43076,+,1655
69,NZ_OX366359,1,76309,77977,+,1668
69,NZ_OX366349,1,1664598,1666266,-,1668
69,NZ_OX366380,1,1311483,1313151,+,1668
69,NZ_OX366344,1,1261579,1263247,+,1668
69,NZ_CP090900,1,1086849,1088517,-,1668
69,NZ_OX366352,1,1616745,1618413,-,1668
69,NZ_OX366362,1,44515,46169,-,1654
69,NZ_OX366400,1,76462,78130,+,1668
69,NZ_OX366327,1,77033,78701,+,1668
69,NZ_OX366367,1,1325737,1327392,+,1655
69,NZ_CP042444,1,1088203,1089871,-,1668
69,NZ_OX366326,1,100390,102058,-,1668
69,NZ_CP037426,1,1064193,1065861,-,1668
69,NZ_OX366339,1,881907,883575,-,1668
69,NZ_OX366355,1,1237113,1238781,-,1668
69,NZ_CP046922,1,1148661,1150329,-,1668
69,NZ_OX366370,1,1204613,1206281,-,1668
69,NZ_OX366385,1,72159,73827,-,1668
69,NZ_OX366399,1,99059,100727,-,1668
69,NZ_OX366395,1,236989,238644,-,1655
69,NZ_OX366396,1,1406780,1408448,-,1668
69,NZ_OX366351,1,107797,109465,-,1668
69,NZ_OX366381,1,1302040,1303708,-,1668
69,NZ_OX366342,1,475578,477246,-,1668
69,NZ_OX366369,1,98322,99990,-,1668
69,NZ_OX366356,1,95685,97349,-,1664
69,NZ_OX366377,1,98586,100254,-,1668
69,NZ_OX366388,1,81943,83611,-,1668
69,NZ_OX366357,1,899810,901473,+,1663
69,NZ_CP072012,1,905353,907021,+,1668
69,NZ_OX366398,1,570228,571896,-,1668
69,NC_002978,6,1086847,1088515,-,1668
69,NZ_OX366389,1,150440,152108,+,1668
69,NZ_OX366397,1,100311,101979,-,1668
69,NZ_OX366378,1,233843,235511,-,1668
69,NZ_CP090903,1,1086849,1088517,-,1668
69,NZ_OX366374,1,371227,372882,+,1655
69,NZ_CP090901,1,1086849,1088517,-,1668
69,NZ_CP046923,1,1064909,1066577,-,1668
69,NZ_CP069055,1,889535,891203,-,1668
69,NZ_CP072670,1,1086677,1088345,-,1668
69,NZ_CP090899,1,1086849,1088517,-,1668
69,NZ_CP046924,1,1085847,1087515,-,1668
69,NZ_OX366348,1,1139086,1140754,-,1668
69,NZ_CP046921,1,1148661,1150329,-,1668
69,NZ_OX366338,1,106309,107963,-,1654
69,NZ_CP054557,1,884210,885878,-,1668
69,NZ_CP072669,1,1086697,1088365,-,1668
69,NC_021089,1,1116719,1118387,-,1668
70,NZ_OX366376,1,252578,253184,+,606
70,NZ_OX366393,1,1436730,1437336,+,606
70,NZ_OX366372,1,1205062,1205668,-,606
70,NZ_CP072672,1,1085900,1086513,-,613
70,NZ_CP069060,1,931972,932585,-,613
70,NZ_CP072667,1,1085874,1086487,-,613
70,NZ_CP072671,1,1085882,1086495,-,613
70,NZ_CP072668,1,1085869,1086482,-,613
70,NZ_CP072666,1,1085882,1086495,-,613
70,NZ_CP090902,1,1086034,1086647,-,613
70,NZ_CP090948,1,1086032,1086645,-,613
70,NZ_CP069052,1,722043,722656,+,613
70,NZ_CP076228,1,1048855,1049468,-,613
70,NZ_CP042445,1,1086022,1086635,-,613
70,NZ_CP042904,1,1101010,1101623,+,613
70,NC_012416,1,1145057,1145670,+,613
70,NZ_CP069053,1,931980,932593,-,613
70,NZ_CP042446,1,1086032,1086645,-,613
70,NZ_CP041215,1,91969,92582,+,613
70,NZ_OX366353,1,131492,132105,-,613
70,NZ_OX366387,1,1571481,1572094,+,613
70,NZ_OX366368,1,98743,99356,-,613
70,NZ_OX366379,1,98752,99365,-,613
70,NZ_CP091195,1,1019179,1019785,+,606
70,NZ_OX366375,1,83676,84289,+,613
70,NZ_CP046925,1,1085882,1086495,-,613
70,NZ_OX366318,1,95861,96474,-,613
70,NZ_OX366319,1,1119058,1119671,-,613
70,NZ_OX366332,1,78303,78916,+,613
70,NZ_CP110359,1,374369,374982,-,613
70,NZ_OU953855,1,787048,787604,+,556
70,NZ_OX366272,1,194049,194662,+,613
70,NZ_OX366347,1,26226,26839,-,613
70,NZ_OU909470,1,496777,497390,+,613
70,NZ_OX366363,1,904179,904786,+,607
70,NZ_OX366364,1,43278,43891,+,613
70,NZ_OX366359,1,78179,78792,+,613
70,NZ_OX366349,1,1663644,1664250,-,606
70,NZ_OX366380,1,1313353,1313966,+,613
70,NZ_OX366344,1,1263456,1264062,+,606
70,NZ_CP090900,1,1086034,1086647,-,613
70,NZ_OX366352,1,1613612,1614225,-,613
70,NZ_OX366362,1,43333,43937,-,604
70,NZ_OX366400,1,78332,78945,+,613
70,NZ_OX366327,1,78903,79516,+,613
70,NZ_OX366367,1,1327594,1328207,+,613
70,NZ_CP042444,1,1087388,1088001,-,613
70,NZ_OX366326,1,99575,100188,-,613
70,NZ_CP037426,1,1063378,1063991,-,613
70,NZ_OX366339,1,881092,881698,-,606
70,NZ_OX366355,1,1236168,1236781,-,613
70,NZ_CP046922,1,1147846,1148459,-,613
70,NZ_OX366370,1,1203798,1204404,-,606
70,NZ_OX366385,1,71344,71957,-,613
70,NZ_OX366399,1,98244,98857,-,613
70,NZ_OX366395,1,235771,236378,-,607
70,NZ_OX366396,1,1405965,1406571,-,606
70,NZ_OX366351,1,106982,107595,-,613
70,NZ_OX366381,1,1301095,1301708,-,613
70,NZ_OX366342,1,474763,475369,-,606
70,NZ_OX366369,1,97377,97990,-,613
70,NZ_OX366356,1,94762,95375,-,613
70,NZ_OX366377,1,97771,98384,-,613
70,NZ_OX366388,1,81138,81734,-,596
70,NZ_OX366357,1,902048,902661,+,613
70,NZ_CP072012,1,907223,907836,+,613
70,NZ_OX366398,1,569413,570026,-,613
70,NC_002978,6,1086032,1086645,-,613
70,NZ_OX366389,1,152310,152923,+,613
70,NZ_OX366397,1,99496,100109,-,613
70,NZ_OX366378,1,233028,233634,-,606
70,NZ_CP090903,1,1086034,1086647,-,613
70,NZ_OX366374,1,373474,374078,+,604
70,NZ_CP090901,1,1086034,1086647,-,613
70,NZ_CP046923,1,1064094,1064707,-,613
70,NZ_CP069055,1,888720,889333,-,613
70,NZ_CP072670,1,1085862,1086475,-,613
70,NZ_CP090899,1,1086034,1086647,-,613
70,NZ_CP046924,1,1085032,1085645,-,613
70,NZ_OX366348,1,1138271,1138884,-,613
70,NZ_CP046921,1,1147846,1148459,-,613
70,NZ_OX366338,1,115757,116364,+,607
70,NZ_CP054557,1,883395,884008,-,613
70,NZ_CP072669,1,1085882,1086495,-,613
70,NC_021089,1,1115904,1116517,-,613
71,NZ_OX366376,1,253411,255804,+,2393
71,NZ_OX366393,1,1437563,1439956,+,2393
71,NZ_OX366372,1,1202441,1204835,-,2394
71,NZ_CP072672,1,1083279,1085673,-,2394
71,NZ_CP069060,1,929351,931745,-,2394
71,NZ_CP072667,1,1083253,1085647,-,2394
71,NZ_CP072671,1,1083261,1085655,-,2394
71,NZ_CP072668,1,1083248,1085642,-,2394
71,NZ_CP072666,1,1083261,1085655,-,2394
71,NZ_CP090902,1,1083413,1085807,-,2394
71,NZ_CP090948,1,1083411,1085805,-,2394
71,NZ_CP069052,1,722883,725276,+,2393
71,NZ_CP076228,1,1046235,1048628,-,2393
71,NZ_CP042445,1,1083401,1085795,-,2394
71,NZ_CP042904,1,1101864,1104257,+,2393
71,NC_012416,1,1145911,1148304,+,2393
71,NZ_CP069053,1,929359,931753,-,2394
71,NZ_CP042446,1,1083411,1085805,-,2394
71,NZ_CP041215,1,93666,96030,+,2364
71,NZ_OX366353,1,128331,130696,-,2365
71,NZ_OX366387,1,1572335,1574728,+,2393
71,NZ_OX366368,1,96122,98516,-,2394
71,NZ_OX366379,1,96131,98525,-,2394
71,NZ_CP091195,1,1022055,1024427,+,2372
71,NZ_OX366375,1,84530,86923,+,2393
71,NZ_CP046925,1,1083261,1085655,-,2394
71,NZ_OX366318,1,93226,95620,-,2394
71,NZ_OX366319,1,1116423,1118817,-,2394
71,NZ_OX366332,1,80215,82579,+,2364
71,NZ_CP110359,1,371734,374128,-,2394
71,NZ_OU953855,1,787845,790238,+,2393
71,NZ_OX366272,1,194903,197296,+,2393
71,NZ_OX366347,1,23592,25986,-,2394
71,NZ_OU909470,1,466572,468945,-,2373
71,NZ_OX366363,1,906230,908594,+,2364
71,NZ_OX366364,1,45565,47937,+,2372
71,NZ_OX366359,1,79660,82024,+,2364
71,NZ_OX366349,1,411173,413566,+,2393
71,NZ_OX366380,1,1220571,1222944,-,2373
71,NZ_OX366344,1,1264289,1266682,+,2393
71,NZ_CP090900,1,1083413,1085807,-,2394
71,NZ_OX366352,1,1610019,1612384,-,2365
71,NZ_OX366362,1,15411,17776,-,2365
71,NZ_OX366400,1,79186,81579,+,2393
71,NZ_OX366327,1,79757,82150,+,2393
71,NZ_OX366367,1,1330079,1332451,+,2372
71,NZ_CP042444,1,1084767,1087161,-,2394
71,NZ_OX366326,1,96940,99334,-,2394
71,NZ_CP037426,1,1060743,1063137,-,2394
71,NZ_OX366339,1,877355,879728,-,2373
71,NZ_OX366355,1,1233533,1235927,-,2394
71,NZ_CP046922,1,1145225,1147619,-,2394
71,NZ_OX366370,1,1186436,1188801,-,2365
71,NZ_OX366385,1,63447,65820,-,2373
71,NZ_OX366399,1,95623,98017,-,2394
71,NZ_OX366395,1,233136,235530,-,2394
71,NZ_OX366396,1,454746,457118,+,2372
71,NZ_OX366351,1,104347,106741,-,2394
71,NZ_OX366381,1,1298460,1300854,-,2394
71,NZ_OX366342,1,472142,474536,-,2394
71,NZ_OX366369,1,94742,97136,-,2394
71,NZ_OX366356,1,92141,94535,-,2394
71,NZ_OX366377,1,95136,97530,-,2394
71,NZ_OX366388,1,75917,78298,-,2381
71,NZ_OX366357,1,902902,905295,+,2393
71,NZ_CP072012,1,908063,910456,+,2393
71,NZ_OX366398,1,566778,569172,-,2394
71,NC_002978,6,1083411,1085805,-,2394
71,NZ_OX366389,1,153164,155557,+,2393
71,NZ_OX366397,1,95975,98340,-,2365
71,NZ_OX366378,1,204785,207158,-,2373
71,NZ_CP090903,1,1083413,1085807,-,2394
71,NZ_OX366374,1,379543,381915,+,2372
71,NZ_CP090901,1,1083413,1085807,-,2394
71,NZ_CP046923,1,1061473,1063867,-,2394
71,NZ_CP069055,1,886099,888493,-,2394
71,NZ_CP072670,1,1083241,1085635,-,2394
71,NZ_CP090899,1,1083413,1085807,-,2394
71,NZ_CP046924,1,1082411,1084805,-,2394
71,NZ_OX366348,1,1135636,1138030,-,2394
71,NZ_CP046921,1,1145225,1147619,-,2394
71,NZ_OX366338,1,118928,121294,+,2366
71,NZ_CP054557,1,880760,883154,-,2394
71,NZ_CP072669,1,1083261,1085655,-,2394
71,NC_021089,1,1112311,1114676,-,2365
72,NZ_OX366376,1,256518,257557,+,1039
72,NZ_OX366393,1,1440670,1441709,+,1039
72,NZ_OX366372,1,1200689,1201728,-,1039
72,NZ_CP072672,1,456208,457255,+,1047
72,NZ_CP069060,1,443690,444737,+,1047
72,NZ_CP072667,1,456190,457237,+,1047
72,NZ_CP072671,1,456190,457237,+,1047
72,NZ_CP072668,1,456177,457224,+,1047
72,NZ_CP072666,1,456190,457237,+,1047
72,NZ_CP090902,1,456342,457389,+,1047
72,NZ_CP090948,1,456342,457389,+,1047
72,NZ_CP069052,1,426682,427729,-,1047
72,NZ_CP076228,1,255375,256422,-,1047
72,NZ_CP042445,1,456342,457389,+,1047
72,NZ_CP042904,1,305639,306686,+,1047
72,NC_012416,1,306732,307779,+,1047
72,NZ_CP069053,1,102532,103579,-,1047
72,NZ_CP042446,1,456342,457389,+,1047
72,NZ_CP041215,1,1215428,1216475,+,1047
72,NZ_OX366353,1,431169,432216,+,1047
72,NZ_OX366387,1,1055558,1056605,-,1047
72,NZ_OX366368,1,777159,778206,-,1047
72,NZ_OX366379,1,733364,734411,-,1047
72,NZ_CP091195,1,332372,333419,-,1047
72,NZ_OX366375,1,817891,818938,-,1047
72,NZ_CP046925,1,456190,457237,+,1047
72,NZ_OX366318,1,685314,686361,-,1047
72,NZ_OX366319,1,471016,472063,-,1047
72,NZ_OX366332,1,845550,846597,+,1047
72,NZ_CP110359,1,718468,719514,-,1046
72,NZ_OU953855,1,678863,679910,-,1047
72,NZ_OX366272,1,503360,504407,+,1047
72,NZ_OX366347,1,971436,972483,+,1047
72,NZ_OU909470,1,464820,465859,-,1039
72,NZ_OX366363,1,227152,228199,+,1047
72,NZ_OX366364,1,1291462,1292501,-,1039
72,NZ_OX366359,1,573221,574268,-,1047
72,NZ_OX366349,1,414280,415319,+,1039
72,NZ_OX366380,1,1218819,1219858,-,1039
72,NZ_OX366344,1,1267397,1268436,+,1039
72,NZ_CP090900,1,456342,457389,+,1047
72,NZ_OX366352,1,574657,575704,+,1047
72,NZ_OX366362,1,555594,556640,-,1046
72,NZ_OX366400,1,564788,565835,+,1047
72,NZ_OX366327,1,735035,736082,-,1047
72,NZ_OX366367,1,1356422,1357461,-,1039
72,NZ_CP042444,1,456843,457890,+,1047
72,NZ_OX366326,1,779287,780334,-,1047
72,NZ_CP037426,1,292482,293529,+,1047
72,NZ_OX366339,1,560349,561396,-,1047
72,NZ_OX366355,1,494041,495088,+,1047
72,NZ_CP046922,1,506143,507190,-,1047
72,NZ_OX366370,1,1184652,1185699,-,1047
72,NZ_OX366385,1,61695,62734,-,1039
72,NZ_OX366399,1,702947,703994,-,1047
72,NZ_OX366395,1,484113,485160,-,1047
72,NZ_OX366396,1,1044810,1045857,+,1047
72,NZ_OX366351,1,601119,602166,-,1047
72,NZ_OX366381,1,722811,723858,+,1047
72,NZ_OX366342,1,470390,471429,-,1039
72,NZ_OX366369,1,785657,786704,+,1047
72,NZ_OX366356,1,697474,698521,+,1047
72,NZ_OX366377,1,891667,892714,-,1047
72,NZ_OX366388,1,676931,677978,+,1047
72,NZ_OX366357,1,850692,851736,+,1044
72,NZ_CP072012,1,554250,555297,+,1047
72,NZ_OX366398,1,667339,668386,-,1047
72,NC_002978,6,456342,457389,+,1047
72,NZ_OX366389,1,763086,764133,-,1047
72,NZ_OX366397,1,863298,864345,+,1047
72,NZ_OX366378,1,463455,464502,+,1047
72,NZ_CP090903,1,456342,457389,+,1047
72,NZ_OX366374,1,817744,818791,-,1047
72,NZ_CP090901,1,456342,457389,+,1047
72,NZ_CP046923,1,422391,423438,-,1047
72,NZ_CP069055,1,494789,495836,+,1047
72,NZ_CP072670,1,456182,457229,+,1047
72,NZ_CP090899,1,456342,457389,+,1047
72,NZ_CP046924,1,443329,444376,-,1047
72,NZ_OX366348,1,468814,469861,-,1047
72,NZ_CP046921,1,506143,507190,-,1047
72,NZ_OX366338,1,665695,666742,-,1047
72,NZ_CP054557,1,215737,216784,+,1047
72,NZ_CP072669,1,456190,457237,+,1047
72,NC_021089,1,366731,367778,-,1047
73,NZ_OX366376,1,259030,260965,+,1935
73,NZ_OX366393,1,965852,967787,+,1935
73,NZ_OX366372,1,1197145,1199080,-,1935
73,NZ_CP072672,1,458301,460211,+,1910
73,NZ_CP069060,1,445938,447848,+,1910
73,NZ_CP072667,1,458283,460193,+,1910
73,NZ_CP072671,1,458283,460193,+,1910
73,NZ_CP072668,1,458270,460180,+,1910
73,NZ_CP072666,1,458283,460193,+,1910
73,NZ_CP090902,1,458435,460345,+,1910
73,NZ_CP090948,1,458435,460345,+,1910
73,NZ_CP069052,1,423571,425480,-,1909
73,NZ_CP076228,1,252420,254329,-,1909
73,NZ_CP042445,1,458435,460345,+,1910
73,NZ_CP042904,1,309369,311283,+,1914
73,NC_012416,1,310462,312376,+,1914
73,NZ_CP069053,1,99421,101330,-,1909
73,NZ_CP042446,1,458435,460345,+,1910
73,NZ_CP041215,1,1219780,1221694,+,1914
73,NZ_OX366353,1,1266119,1268032,-,1913
73,NZ_OX366387,1,1051348,1053279,-,1931
73,NZ_OX366368,1,774048,775957,-,1909
73,NZ_OX366379,1,730253,732162,-,1909
73,NZ_CP091195,1,328170,330079,-,1909
73,NZ_OX366375,1,813826,815735,-,1909
73,NZ_CP046925,1,458283,460193,+,1910
73,NZ_OX366318,1,681833,683742,-,1909
73,NZ_OX366319,1,467905,469814,-,1909
73,NZ_OX366332,1,849050,850964,+,1914
73,NZ_CP110359,1,715335,717249,-,1914
73,NZ_OU953855,1,675401,677332,-,1931
73,NZ_OX366272,1,507675,509590,+,1915
73,NZ_OX366347,1,975699,977609,+,1910
73,NZ_OU909470,1,976742,978648,+,1906
73,NZ_OX366363,1,229400,231310,+,1910
73,NZ_OX366364,1,1139204,1141120,-,1916
73,NZ_OX366359,1,569013,570926,-,1913
73,NZ_OX366349,1,1488509,1490418,-,1909
73,NZ_OX366380,1,161327,163233,+,1906
73,NZ_OX366344,1,1269727,1271662,+,1935
73,NZ_CP090900,1,458435,460345,+,1910
73,NZ_OX366352,1,578155,580069,+,1914
73,NZ_OX366362,1,736378,738286,-,1908
73,NZ_OX366400,1,567406,569316,+,1910
73,NZ_OX366327,1,731923,733832,-,1909
73,NZ_OX366367,1,165465,167381,+,1916
73,NZ_CP042444,1,458936,460846,+,1910
73,NZ_OX366326,1,775806,777715,-,1909
73,NZ_CP037426,1,295707,297617,+,1910
73,NZ_OX366339,1,556270,558179,-,1909
73,NZ_OX366355,1,497241,499151,+,1910
73,NZ_CP046922,1,503187,505096,-,1909
73,NZ_OX366370,1,1178477,1180386,+,1909
73,NZ_OX366385,1,982374,984280,+,1906
73,NZ_OX366399,1,699836,701745,-,1909
73,NZ_OX366395,1,480755,482679,-,1924
73,NZ_OX366396,1,1112165,1114075,+,1910
73,NZ_OX366351,1,597638,599547,-,1909
73,NZ_OX366381,1,725059,726969,+,1910
73,NZ_OX366342,1,467001,468936,-,1935
73,NZ_OX366369,1,787905,789815,+,1910
73,NZ_OX366356,1,699777,701687,+,1910
73,NZ_OX366377,1,888556,890465,-,1909
73,NZ_OX366388,1,679521,681431,+,1910
73,NZ_OX366357,1,852780,854703,+,1923
73,NZ_CP072012,1,556498,558408,+,1910
73,NZ_OX366398,1,664228,666137,-,1909
73,NC_002978,6,458435,460345,+,1910
73,NZ_OX366389,1,759975,761884,-,1909
73,NZ_OX366397,1,945002,946916,+,1914
73,NZ_OX366378,1,466788,468698,+,1910
73,NZ_CP090903,1,458435,460345,+,1910
73,NZ_OX366374,1,480723,482647,+,1924
73,NZ_CP090901,1,458435,460345,+,1910
73,NZ_CP046923,1,419435,421344,-,1909
73,NZ_CP069055,1,497037,498947,+,1910
73,NZ_CP072670,1,458275,460185,+,1910
73,NZ_CP090899,1,458435,460345,+,1910
73,NZ_CP046924,1,440373,442282,-,1909
73,NZ_OX366348,1,465703,467612,-,1909
73,NZ_CP046921,1,503187,505096,-,1909
73,NZ_OX366338,1,660666,662567,-,1901
73,NZ_CP054557,1,50112,52021,-,1909
73,NZ_CP072669,1,458283,460193,+,1910
73,NC_021089,1,362366,364279,-,1913
74,NZ_OX366376,1,260966,262407,+,1441
74,NZ_OX366393,1,967788,969229,+,1441
74,NZ_OX366372,1,1195703,1197143,-,1440
74,NZ_CP072672,1,460212,461644,+,1432
74,NZ_CP069060,1,447849,449281,+,1432
74,NZ_CP072667,1,460194,461626,+,1432
74,NZ_CP072671,1,460194,461626,+,1432
74,NZ_CP072668,1,460181,461613,+,1432
74,NZ_CP072666,1,460194,461626,+,1432
74,NZ_CP090902,1,460346,461778,+,1432
74,NZ_CP090948,1,460346,461778,+,1432
74,NZ_CP069052,1,422138,423569,-,1431
74,NZ_CP076228,1,250987,252418,-,1431
74,NZ_CP042445,1,460346,461778,+,1432
74,NZ_CP042904,1,311284,312725,+,1441
74,NC_012416,1,312377,313818,+,1441
74,NZ_CP069053,1,97988,99419,-,1431
74,NZ_CP042446,1,460346,461778,+,1432
74,NZ_CP041215,1,1221695,1223136,+,1441
74,NZ_OX366353,1,1264677,1266117,-,1440
74,NZ_OX366387,1,1049906,1051346,-,1440
74,NZ_OX366368,1,772615,774046,-,1431
74,NZ_OX366379,1,728820,730251,-,1431
74,NZ_CP091195,1,326728,328168,-,1440
74,NZ_OX366375,1,812384,813824,-,1440
74,NZ_CP046925,1,460194,461626,+,1432
74,NZ_OX366318,1,680400,681831,-,1431
74,NZ_OX366319,1,466463,467903,-,1440
74,NZ_OX366332,1,850965,852406,+,1441
74,NZ_CP110359,1,713893,715333,-,1440
74,NZ_OU953855,1,673968,675399,-,1431
74,NZ_OX366272,1,509591,511032,+,1441
74,NZ_OX366347,1,977610,979051,+,1441
74,NZ_OU909470,1,978649,980084,+,1435
74,NZ_OX366363,1,231311,232752,+,1441
74,NZ_OX366364,1,1137762,1139202,-,1440
74,NZ_OX366359,1,567571,569011,-,1440
74,NZ_OX366349,1,1485849,1487285,-,1436
74,NZ_OX366380,1,163234,164669,+,1435
74,NZ_OX366344,1,1271663,1273104,+,1441
74,NZ_CP090900,1,460346,461778,+,1432
74,NZ_OX366352,1,580070,581511,+,1441
74,NZ_OX366362,1,734945,736376,-,1431
74,NZ_OX366400,1,569317,570749,+,1432
74,NZ_OX366327,1,730490,731921,-,1431
74,NZ_OX366367,1,167382,168814,+,1432
74,NZ_CP042444,1,460847,462279,+,1432
74,NZ_OX366326,1,774373,775804,-,1431
74,NZ_CP037426,1,297618,299059,+,1441
74,NZ_OX366339,1,554828,556268,-,1440
74,NZ_OX366355,1,499152,500593,+,1441
74,NZ_CP046922,1,501754,503185,-,1431
74,NZ_OX366370,1,1180387,1181819,+,1432
74,NZ_OX366385,1,984281,985716,+,1435
74,NZ_OX366399,1,698403,699834,-,1431
74,NZ_OX366395,1,479313,480753,-,1440
74,NZ_OX366396,1,1114076,1115517,+,1441
74,NZ_OX366351,1,596205,597636,-,1431
74,NZ_OX366381,1,726970,728411,+,1441
74,NZ_OX366342,1,465559,466999,-,1440
74,NZ_OX366369,1,789816,791257,+,1441
74,NZ_OX366356,1,701688,703129,+,1441
74,NZ_OX366377,1,887114,888554,-,1440
74,NZ_OX366388,1,681432,682873,+,1441
74,NZ_OX366357,1,854704,856145,+,1441
74,NZ_CP072012,1,558409,559841,+,1432
74,NZ_OX366398,1,662786,664226,-,1440
74,NC_002978,6,460346,461778,+,1432
74,NZ_OX366389,1,758533,759973,-,1440
74,NZ_OX366397,1,946917,948358,+,1441
74,NZ_OX366378,1,468699,470140,+,1441
74,NZ_CP090903,1,460346,461778,+,1432
74,NZ_OX366374,1,482648,484079,+,1431
74,NZ_CP090901,1,460346,461778,+,1432
74,NZ_CP046923,1,418002,419433,-,1431
74,NZ_CP069055,1,498948,500380,+,1432
74,NZ_CP072670,1,460186,461618,+,1432
74,NZ_CP090899,1,460346,461778,+,1432
74,NZ_CP046924,1,438940,440371,-,1431
74,NZ_OX366348,1,464270,465701,-,1431
74,NZ_CP046921,1,501754,503185,-,1431
74,NZ_OX366338,1,658116,659542,-,1426
74,NZ_CP054557,1,48679,50110,-,1431
74,NZ_CP072669,1,460194,461626,+,1432
74,NC_021089,1,360924,362364,-,1440
75,NZ_OX366376,1,264734,266070,+,1336
75,NZ_OX366393,1,971744,973080,+,1336
75,NZ_OX366372,1,1192028,1193363,-,1335
75,NZ_CP072672,1,464020,465356,+,1336
75,NZ_CP069060,1,451649,452985,+,1336
75,NZ_CP072667,1,464002,465338,+,1336
75,NZ_CP072671,1,464002,465338,+,1336
75,NZ_CP072668,1,463989,465325,+,1336
75,NZ_CP072666,1,464002,465338,+,1336
75,NZ_CP090902,1,464154,465490,+,1336
75,NZ_CP090948,1,464154,465490,+,1336
75,NZ_CP069052,1,418434,419769,-,1335
75,NZ_CP076228,1,247278,248612,-,1334
75,NZ_CP042445,1,464154,465490,+,1336
75,NZ_CP042904,1,273103,274438,-,1335
75,NC_012416,1,275687,277022,-,1335
75,NZ_CP069053,1,94284,95619,-,1335
75,NZ_CP042446,1,464154,465490,+,1336
75,NZ_CP041215,1,1226814,1228150,+,1336
75,NZ_OX366353,1,1270063,1271399,+,1336
75,NZ_OX366387,1,1117847,1119181,-,1334
75,NZ_OX366368,1,768434,769769,-,1335
75,NZ_OX366379,1,724639,725974,-,1335
75,NZ_CP091195,1,442258,443594,+,1336
75,NZ_OX366375,1,809183,810584,-,1401
75,NZ_CP046925,1,464002,465338,+,1336
75,NZ_OX366318,1,675577,676912,-,1335
75,NZ_OX366319,1,614841,616243,+,1402
75,NZ_OX366332,1,856107,857443,+,1336
75,NZ_CP110359,1,710346,711681,-,1335
75,NZ_OU953855,1,185012,186347,-,1335
75,NZ_OX366272,1,513401,514737,+,1336
75,NZ_OX366347,1,981590,982926,+,1336
75,NZ_OU909470,1,982023,983359,+,1336
75,NZ_OX366363,1,235343,236679,+,1336
75,NZ_OX366364,1,1133934,1135335,-,1401
75,NZ_OX366359,1,562538,563873,-,1335
75,NZ_OX366349,1,1482018,1483353,-,1335
75,NZ_OX366380,1,166614,167950,+,1336
75,NZ_OX366344,1,1275537,1276873,+,1336
75,NZ_CP090900,1,464154,465490,+,1336
75,NZ_OX366352,1,585220,586556,+,1336
75,NZ_OX366362,1,731214,732549,-,1335
75,NZ_OX366400,1,575439,576775,+,1336
75,NZ_OX366327,1,725605,726940,-,1335
75,NZ_OX366367,1,171546,172877,+,1331
75,NZ_CP042444,1,464655,465991,+,1336
75,NZ_OX366326,1,770401,771736,-,1335
75,NZ_CP037426,1,300932,302334,+,1402
75,NZ_OX366339,1,549982,551317,-,1335
75,NZ_OX366355,1,680989,682391,+,1402
75,NZ_CP046922,1,498042,499377,-,1335
75,NZ_OX366370,1,1237887,1239223,+,1336
75,NZ_OX366385,1,988380,989716,+,1336
75,NZ_OX366399,1,694222,695557,-,1335
75,NZ_OX366395,1,667722,669057,-,1335
75,NZ_OX366396,1,1118056,1119392,+,1336
75,NZ_OX366351,1,592233,593568,-,1335
75,NZ_OX366381,1,889406,890808,+,1402
75,NZ_OX366342,1,462005,463340,-,1335
75,NZ_OX366369,1,793602,795003,+,1401
75,NZ_OX366356,1,705870,707205,+,1335
75,NZ_OX366377,1,883189,884524,-,1335
75,NZ_OX366388,1,685144,686480,+,1336
75,NZ_OX366357,1,858230,859566,+,1336
75,NZ_CP072012,1,562769,564105,+,1336
75,NZ_OX366398,1,658861,660196,-,1335
75,NC_002978,6,464154,465490,+,1336
75,NZ_OX366389,1,754472,755807,-,1335
75,NZ_OX366397,1,952054,953390,+,1336
75,NZ_OX366378,1,225312,226648,+,1336
75,NZ_CP090903,1,464154,465490,+,1336
75,NZ_OX366374,1,812626,813961,-,1335
75,NZ_CP090901,1,464154,465490,+,1336
75,NZ_CP046923,1,414290,415625,-,1335
75,NZ_CP069055,1,502755,504091,+,1336
75,NZ_CP072670,1,463994,465330,+,1336
75,NZ_CP090899,1,464154,465490,+,1336
75,NZ_CP046924,1,435228,436563,-,1335
75,NZ_OX366348,1,460285,461686,-,1401
75,NZ_CP046921,1,498042,499377,-,1335
75,NZ_OX366338,1,652511,653846,-,1335
75,NZ_CP054557,1,43822,45239,-,1417
75,NZ_CP072669,1,464002,465338,+,1336
75,NC_021089,1,355892,357227,-,1335
76,NZ_OX366376,1,266257,268077,+,1820
76,NZ_OX366393,1,973267,975087,+,1820
76,NZ_OX366372,1,1190021,1191841,-,1820
76,NZ_CP072672,1,465545,467370,+,1825
76,NZ_CP069060,1,453174,454999,+,1825
76,NZ_CP072667,1,465527,467352,+,1825
76,NZ_CP072671,1,465527,467352,+,1825
76,NZ_CP072668,1,465514,467339,+,1825
76,NZ_CP072666,1,465527,467352,+,1825
76,NZ_CP090902,1,465679,467504,+,1825
76,NZ_CP090948,1,465679,467504,+,1825
76,NZ_CP069052,1,416420,418245,-,1825
76,NZ_CP076228,1,245258,247089,-,1831
76,NZ_CP042445,1,465679,467504,+,1825
76,NZ_CP042904,1,271096,272916,-,1820
76,NC_012416,1,273680,275500,-,1820
76,NZ_CP069053,1,92270,94095,-,1825
76,NZ_CP042446,1,465679,467504,+,1825
76,NZ_CP041215,1,1228337,1230158,+,1821
76,NZ_OX366353,1,1271586,1273407,+,1821
76,NZ_OX366387,1,1115846,1117660,-,1814
76,NZ_OX366368,1,766420,768245,-,1825
76,NZ_OX366379,1,722625,724450,-,1825
76,NZ_CP091195,1,443741,445560,+,1819
76,NZ_OX366375,1,807182,808996,-,1814
76,NZ_CP046925,1,465527,467352,+,1825
76,NZ_OX366318,1,673569,675388,-,1819
76,NZ_OX366319,1,616432,618258,+,1826
76,NZ_OX366332,1,857630,859451,+,1821
76,NZ_CP110359,1,708090,709916,-,1826
76,NZ_OU953855,1,182762,184582,-,1820
76,NZ_OX366272,1,515167,516987,+,1820
76,NZ_OX366347,1,983115,984940,+,1825
76,NZ_OU909470,1,983548,985367,+,1819
76,NZ_OX366363,1,236868,238693,+,1825
76,NZ_OX366364,1,1131725,1133550,-,1825
76,NZ_OX366359,1,560530,562351,-,1821
76,NZ_OX366349,1,1480011,1481831,-,1820
76,NZ_OX366380,1,168139,169958,+,1819
76,NZ_OX366344,1,1277062,1278887,+,1825
76,NZ_CP090900,1,465679,467504,+,1825
76,NZ_OX366352,1,586743,588564,+,1821
76,NZ_OX366362,1,728813,730638,-,1825
76,NZ_OX366400,1,576964,578783,+,1819
76,NZ_OX366327,1,723598,725418,-,1820
76,NZ_OX366367,1,173294,175114,+,1820
76,NZ_CP042444,1,466180,468005,+,1825
76,NZ_OX366326,1,768393,770212,-,1819
76,NZ_CP037426,1,302521,304335,+,1814
76,NZ_OX366339,1,548010,549835,-,1825
76,NZ_OX366355,1,682580,684406,+,1826
76,NZ_CP046922,1,496028,497853,-,1825
76,NZ_OX366370,1,1239370,1241191,+,1821
76,NZ_OX366385,1,989905,991724,+,1819
76,NZ_OX366399,1,692208,694033,-,1825
76,NZ_OX366395,1,665750,667575,-,1825
76,NZ_OX366396,1,1119539,1121364,+,1825
76,NZ_OX366351,1,590225,592044,-,1819
76,NZ_OX366381,1,890997,892823,+,1826
76,NZ_OX366342,1,459998,461818,-,1820
76,NZ_OX366369,1,795192,797018,+,1826
76,NZ_OX366356,1,707392,709207,+,1815
76,NZ_OX366377,1,881180,883000,-,1820
76,NZ_OX366388,1,686627,688446,+,1819
76,NZ_OX366357,1,859950,861781,+,1831
76,NZ_CP072012,1,564294,566119,+,1825
76,NZ_OX366398,1,656852,658672,-,1820
76,NC_002978,6,465679,467504,+,1825
76,NZ_OX366389,1,752463,754283,-,1820
76,NZ_OX366397,1,953577,955398,+,1821
76,NZ_OX366378,1,226795,228614,+,1819
76,NZ_CP090903,1,465679,467504,+,1825
76,NZ_OX366374,1,810272,812098,-,1826
76,NZ_CP090901,1,465679,467504,+,1825
76,NZ_CP046923,1,412276,414101,-,1825
76,NZ_CP069055,1,504280,506105,+,1825
76,NZ_CP072670,1,465519,467344,+,1825
76,NZ_CP090899,1,465679,467504,+,1825
76,NZ_CP046924,1,433214,435039,-,1825
76,NZ_OX366348,1,458276,460096,-,1820
76,NZ_CP046921,1,496028,497853,-,1825
76,NZ_OX366338,1,650304,652130,-,1826
76,NZ_CP054557,1,41813,43633,-,1820
76,NZ_CP072669,1,465527,467352,+,1825
76,NC_021089,1,353884,355705,-,1821
77,NZ_OX366376,1,268926,270848,+,1922
77,NZ_OX366393,1,975936,977858,+,1922
77,NZ_OX366372,1,1187250,1189172,-,1922
77,NZ_CP072672,1,468174,470112,+,1938
77,NZ_CP069060,1,455803,457741,+,1938
77,NZ_CP072667,1,468156,470094,+,1938
77,NZ_CP072671,1,468156,470094,+,1938
77,NZ_CP072668,1,468143,470081,+,1938
77,NZ_CP072666,1,468156,470094,+,1938
77,NZ_CP090902,1,468308,470246,+,1938
77,NZ_CP090948,1,468308,470246,+,1938
77,NZ_CP069052,1,413678,415616,-,1938
77,NZ_CP076228,1,242514,244452,-,1938
77,NZ_CP042445,1,468308,470246,+,1938
77,NZ_CP042904,1,266864,268803,-,1939
77,NC_012416,1,269448,271387,-,1939
77,NZ_CP069053,1,89528,91466,-,1938
77,NZ_CP042446,1,468308,470246,+,1938
77,NZ_CP041215,1,1230968,1232907,+,1939
77,NZ_OX366353,1,1274210,1276149,+,1939
77,NZ_OX366387,1,1113104,1115043,-,1939
77,NZ_OX366368,1,763678,765616,-,1938
77,NZ_OX366379,1,719883,721821,-,1938
77,NZ_CP091195,1,446363,448302,+,1939
77,NZ_OX366375,1,804440,806379,-,1939
77,NZ_CP046925,1,468156,470094,+,1938
77,NZ_OX366318,1,670827,672765,-,1938
77,NZ_OX366319,1,619061,621000,+,1939
77,NZ_OX366332,1,860261,862200,+,1939
77,NZ_CP110359,1,705348,707287,-,1939
77,NZ_OU953855,1,180020,181959,-,1939
77,NZ_OX366272,1,517790,519729,+,1939
77,NZ_OX366347,1,985743,987682,+,1939
77,NZ_OU909470,1,986222,988153,+,1931
77,NZ_OX366363,1,239496,241435,+,1939
77,NZ_OX366364,1,1128983,1130921,-,1938
77,NZ_OX366359,1,557788,559727,-,1939
77,NZ_OX366349,1,1477240,1479162,-,1922
77,NZ_OX366380,1,170825,172747,+,1922
77,NZ_OX366344,1,1279736,1281658,+,1922
77,NZ_CP090900,1,468308,470246,+,1938
77,NZ_OX366352,1,589374,591313,+,1939
77,NZ_OX366362,1,726093,728032,-,1939
77,NZ_OX366400,1,579587,581525,+,1938
77,NZ_OX366327,1,720856,722795,-,1939
77,NZ_OX366367,1,175918,177856,+,1938
77,NZ_CP042444,1,468809,470747,+,1938
77,NZ_OX366326,1,765651,767589,-,1938
77,NZ_CP037426,1,305138,307077,+,1939
77,NZ_OX366339,1,545268,547196,-,1928
77,NZ_OX366355,1,685209,687148,+,1939
77,NZ_CP046922,1,493286,495224,-,1938
77,NZ_OX366370,1,1242036,1243967,+,1931
77,NZ_OX366385,1,992591,994513,+,1922
77,NZ_OX366399,1,689466,691404,-,1938
77,NZ_OX366395,1,663008,664947,-,1939
77,NZ_OX366396,1,1122178,1124106,+,1928
77,NZ_OX366351,1,587483,589421,-,1938
77,NZ_OX366381,1,893626,895565,+,1939
77,NZ_OX366342,1,457227,459149,-,1922
77,NZ_OX366369,1,797821,799760,+,1939
77,NZ_OX366356,1,710113,712052,+,1939
77,NZ_OX366377,1,878438,880376,-,1938
77,NZ_OX366388,1,689260,691188,+,1928
77,NZ_OX366357,1,862595,864534,+,1939
77,NZ_CP072012,1,566923,568861,+,1938
77,NZ_OX366398,1,654110,656048,-,1938
77,NC_002978,6,468308,470246,+,1938
77,NZ_OX366389,1,749721,751659,-,1938
77,NZ_OX366397,1,956201,958140,+,1939
77,NZ_OX366378,1,229417,231356,+,1939
77,NZ_CP090903,1,468308,470246,+,1938
77,NZ_OX366374,1,807334,809273,-,1939
77,NZ_CP090901,1,468308,470246,+,1938
77,NZ_CP046923,1,409534,411472,-,1938
77,NZ_CP069055,1,506909,508847,+,1938
77,NZ_CP072670,1,468148,470086,+,1938
77,NZ_CP090899,1,468308,470246,+,1938
77,NZ_CP046924,1,430472,432410,-,1938
77,NZ_OX366348,1,455534,457472,-,1938
77,NZ_CP046921,1,493286,495224,-,1938
77,NZ_OX366338,1,647562,649501,-,1939
77,NZ_CP054557,1,39071,41009,-,1938
77,NZ_CP072669,1,468156,470094,+,1938
77,NC_021089,1,351142,353081,-,1939
78,NZ_OX366376,1,272105,272729,+,624
78,NZ_OX366393,1,979115,979739,+,624
78,NZ_OX366372,1,1185368,1185992,-,624
78,NZ_CP072672,1,327194,327818,+,624
78,NZ_CP069060,1,316063,316687,+,624
78,NZ_CP072667,1,327176,327800,+,624
78,NZ_CP072671,1,327176,327800,+,624
78,NZ_CP072668,1,327176,327800,+,624
78,NZ_CP072666,1,327176,327800,+,624
78,NZ_CP090902,1,327328,327952,+,624
78,NZ_CP090948,1,327328,327952,+,624
78,NZ_CP069052,1,310736,311360,+,624
78,NZ_CP076228,1,408125,408749,-,624
78,NZ_CP042445,1,327328,327952,+,624
78,NZ_CP042904,1,471702,472326,-,624
78,NC_012416,1,475020,475644,-,624
78,NZ_CP069053,1,230590,231214,-,624
78,NZ_CP042446,1,327328,327952,+,624
78,NZ_CP041215,1,834974,835598,-,624
78,NZ_OX366353,1,92329,92952,-,623
78,NZ_OX366387,1,931552,932176,-,624
78,NZ_OX366368,1,682215,682839,+,624
78,NZ_OX366379,1,864348,864972,-,624
78,NZ_CP091195,1,349986,350610,-,624
78,NZ_CP046925,1,327176,327800,+,624
78,NZ_OX366318,1,814390,815014,-,624
78,NZ_OX366319,1,430745,431369,+,624
78,NZ_OX366332,1,950910,951534,-,624
78,NZ_CP110359,1,851852,852447,-,595
78,NZ_OU953855,1,365861,366485,+,624
78,NZ_OX366272,1,656970,657594,-,624
78,NZ_OX366347,1,1069222,1069846,-,624
78,NZ_OU909470,1,989367,989974,+,607
78,NZ_OX366363,1,95845,96469,+,624
78,NZ_OX366364,1,1210987,1211594,-,607
78,NZ_OX366359,1,781603,782227,-,624
78,NZ_OX366349,1,1475360,1475983,-,623
78,NZ_OX366380,1,182310,182934,+,624
78,NZ_OX366344,1,1282915,1283539,+,624
78,NZ_CP090900,1,327328,327952,+,624
78,NZ_OX366352,1,712005,712629,-,624
78,NZ_OX366362,1,723926,724550,-,624
78,NZ_OX366400,1,430428,431052,+,624
78,NZ_OX366327,1,862164,862788,-,624
78,NZ_OX366367,1,25487,26094,+,607
78,NZ_CP042444,1,327829,328453,+,624
78,NZ_OX366326,1,911696,912320,-,624
78,NZ_OX366339,1,628509,629133,-,624
78,NZ_OX366355,1,527139,527763,-,624
78,NZ_CP046922,1,326972,327596,+,624
78,NZ_OX366385,1,999358,999982,+,624
78,NZ_OX366399,1,855389,856013,-,624
78,NZ_OX366395,1,893880,894504,-,624
78,NZ_OX366351,1,738443,739067,-,624
78,NZ_OX366381,1,591107,591731,+,624
78,NZ_OX366342,1,455346,455970,-,624
78,NZ_OX366369,1,657633,658257,+,624
78,NZ_OX366356,1,567815,568439,+,624
78,NZ_OX366377,1,425927,426551,-,624
78,NZ_OX366388,1,485603,486227,-,624
78,NZ_OX366357,1,411470,412094,-,624
78,NZ_CP072012,1,649213,649837,-,624
78,NZ_OX366398,1,84283,84907,+,624
78,NC_002978,6,327328,327952,+,624
78,NZ_OX366389,1,487055,487679,+,624
78,NZ_OX366397,1,1032381,1033005,-,624
78,NZ_OX366378,1,447370,447994,+,624
78,NZ_CP090903,1,327328,327952,+,624
78,NZ_CP090901,1,327328,327952,+,624
78,NZ_CP046923,1,326972,327596,+,624
78,NZ_CP069055,1,364252,364876,+,624
78,NZ_CP072670,1,327168,327792,+,624
78,NZ_CP090899,1,327328,327952,+,624
78,NZ_CP046924,1,326972,327596,+,624
78,NZ_OX366348,1,674237,674861,+,624
78,NZ_CP046921,1,326972,327596,+,624
78,NZ_OX366338,1,743922,744546,-,624
78,NZ_CP054557,1,71203,71827,+,624
78,NZ_CP072669,1,327176,327800,+,624
78,NC_021089,1,599779,600404,-,625
79,NZ_OX366376,1,272883,274698,+,1815
79,NZ_OX366393,1,979893,981708,+,1815
79,NZ_OX366372,1,1183399,1185214,-,1815
79,NZ_CP072672,1,329309,331127,+,1818
79,NZ_CP069060,1,318178,319996,+,1818
79,NZ_CP072667,1,329291,331109,+,1818
79,NZ_CP072671,1,329291,331109,+,1818
79,NZ_CP072668,1,329291,331109,+,1818
79,NZ_CP072666,1,329291,331109,+,1818
79,NZ_CP090902,1,329443,331261,+,1818
79,NZ_CP090948,1,329443,331261,+,1818
79,NZ_CP069052,1,312851,314669,+,1818
79,NZ_CP076228,1,404816,406634,-,1818
79,NZ_CP042445,1,329443,331261,+,1818
79,NZ_CP042904,1,468385,470202,-,1817
79,NC_012416,1,471703,473520,-,1817
79,NZ_CP069053,1,227281,229099,-,1818
79,NZ_CP042446,1,329443,331261,+,1818
79,NZ_CP041215,1,831657,833475,-,1818
79,NZ_OX366353,1,89012,90830,-,1818
79,NZ_OX366387,1,928243,930061,-,1818
79,NZ_OX366368,1,684330,686148,+,1818
79,NZ_OX366379,1,861039,862857,-,1818
79,NZ_CP091195,1,346669,348487,-,1818
79,NZ_OX366375,1,879853,881662,+,1809
79,NZ_CP046925,1,329291,331109,+,1818
79,NZ_OX366318,1,811081,812899,-,1818
79,NZ_OX366319,1,432860,434678,+,1818
79,NZ_OX366332,1,947593,949411,-,1818
79,NZ_CP110359,1,848546,850364,-,1818
79,NZ_OU953855,1,367976,369794,+,1818
79,NZ_OX366272,1,653665,655483,-,1818
79,NZ_OX366347,1,1065906,1067724,-,1818
79,NZ_OU909470,1,991142,992961,+,1819
79,NZ_OX366363,1,97960,99765,+,1805
79,NZ_OX366364,1,1208990,1210808,-,1818
79,NZ_OX366359,1,778286,780104,-,1818
79,NZ_OX366349,1,1473390,1475205,-,1815
79,NZ_OX366380,1,183088,184903,+,1815
79,NZ_OX366344,1,1283693,1285508,+,1815
79,NZ_CP090900,1,329443,331261,+,1818
79,NZ_OX366352,1,708688,710506,-,1818
79,NZ_OX366362,1,589095,590888,-,1793
79,NZ_OX366400,1,433394,435212,+,1818
79,NZ_OX366327,1,858847,860665,-,1818
79,NZ_OX366367,1,26273,28091,+,1818
79,NZ_CP042444,1,329944,331762,+,1818
79,NZ_OX366326,1,908387,910205,-,1818
79,NZ_CP037426,1,125655,127463,+,1808
79,NZ_OX366339,1,625200,627018,-,1818
79,NZ_OX366355,1,521872,523690,-,1818
79,NZ_CP046922,1,329087,330905,+,1818
79,NZ_OX366370,1,1052678,1054493,+,1815
79,NZ_OX366385,1,1000136,1001951,+,1815
79,NZ_OX366399,1,852080,853898,-,1818
79,NZ_OX366395,1,890575,892381,-,1806
79,NZ_OX366396,1,54836,56654,+,1818
79,NZ_OX366351,1,735134,736952,-,1818
79,NZ_OX366381,1,593222,595040,+,1818
79,NZ_OX366342,1,453377,455192,-,1815
79,NZ_OX366369,1,659748,661566,+,1818
79,NZ_OX366356,1,569732,571550,+,1818
79,NZ_OX366377,1,422618,424436,-,1818
79,NZ_OX366388,1,482286,484104,-,1818
79,NZ_OX366357,1,80916,82731,+,1815
79,NZ_CP072012,1,645904,647722,-,1818
79,NZ_OX366398,1,86398,88216,+,1818
79,NC_002978,6,329443,331261,+,1818
79,NZ_OX366389,1,489170,490988,+,1818
79,NZ_OX366397,1,1029064,1030882,-,1818
79,NZ_OX366378,1,449493,451311,+,1818
79,NZ_CP090903,1,329443,331261,+,1818
79,NZ_OX366374,1,887573,889382,+,1809
79,NZ_CP090901,1,329443,331261,+,1818
79,NZ_CP046923,1,329087,330905,+,1818
79,NZ_CP069055,1,366367,368185,+,1818
79,NZ_CP072670,1,329283,331101,+,1818
79,NZ_CP090899,1,329443,331261,+,1818
79,NZ_CP046924,1,329087,330905,+,1818
79,NZ_OX366348,1,676352,678170,+,1818
79,NZ_CP046921,1,329087,330905,+,1818
79,NZ_OX366338,1,740605,742423,-,1818
79,NZ_CP054557,1,73318,75136,+,1818
79,NZ_CP072669,1,329291,331109,+,1818
79,NC_021089,1,596462,598280,-,1818
80,NZ_OX366376,1,274854,275922,+,1068
80,NZ_OX366393,1,981864,982932,+,1068
80,NZ_OX366372,1,1182175,1183243,-,1068
80,NZ_CP072672,1,332006,333073,+,1067
80,NZ_CP069060,1,320875,321942,+,1067
80,NZ_CP072667,1,331988,333055,+,1067
80,NZ_CP072671,1,331988,333055,+,1067
80,NZ_CP072668,1,331988,333055,+,1067
80,NZ_CP072666,1,331988,333055,+,1067
80,NZ_CP090902,1,332140,333207,+,1067
80,NZ_CP090948,1,332140,333207,+,1067
80,NZ_CP069052,1,315548,316615,+,1067
80,NZ_CP076228,1,402870,403937,-,1067
80,NZ_CP042445,1,332140,333207,+,1067
80,NZ_CP042904,1,466439,467506,-,1067
80,NC_012416,1,469757,470824,-,1067
80,NZ_CP069053,1,225335,226402,-,1067
80,NZ_CP042446,1,332140,333207,+,1067
80,NZ_CP041215,1,829711,830778,-,1067
80,NZ_OX366353,1,87076,88143,-,1067
80,NZ_OX366387,1,755099,756166,-,1067
80,NZ_OX366368,1,687027,688094,+,1067
80,NZ_OX366379,1,859093,860160,-,1067
80,NZ_CP091195,1,344723,345790,-,1067
80,NZ_OX366375,1,882540,883607,+,1067
80,NZ_CP046925,1,331988,333055,+,1067
80,NZ_OX366318,1,809135,810202,-,1067
80,NZ_OX366319,1,435557,436624,+,1067
80,NZ_OX366332,1,945647,946714,-,1067
80,NZ_CP110359,1,846600,847667,-,1067
80,NZ_OU953855,1,371770,372837,+,1067
80,NZ_OX366272,1,651727,652794,-,1067
80,NZ_OX366347,1,1063961,1065028,-,1067
80,NZ_OU909470,1,993456,994524,+,1068
80,NZ_OX366363,1,99884,100951,+,1067
80,NZ_OX366364,1,238750,239817,+,1067
80,NZ_OX366359,1,776340,777407,-,1067
80,NZ_OX366349,1,1472167,1473234,-,1067
80,NZ_OX366380,1,185398,186466,+,1068
80,NZ_OX366344,1,1285663,1286731,+,1068
80,NZ_CP090900,1,332140,333207,+,1067
80,NZ_OX366352,1,706742,707809,-,1067
80,NZ_OX366362,1,167425,168492,+,1067
80,NZ_OX366400,1,436091,437158,+,1067
80,NZ_OX366327,1,856902,857969,-,1067
80,NZ_OX366367,1,1249653,1250714,-,1061
80,NZ_CP042444,1,332641,333708,+,1067
80,NZ_OX366326,1,906441,907508,-,1067
80,NZ_CP037426,1,128341,129408,+,1067
80,NZ_OX366339,1,534660,535727,-,1067
80,NZ_OX366355,1,519926,520993,-,1067
80,NZ_CP046922,1,331784,332851,+,1067
80,NZ_OX366370,1,1054649,1055717,+,1068
80,NZ_OX366385,1,1002446,1003514,+,1068
80,NZ_OX366399,1,850134,851201,-,1067
80,NZ_OX366395,1,889012,890080,-,1068
80,NZ_OX366396,1,83683,84750,+,1067
80,NZ_OX366351,1,733188,734255,-,1067
80,NZ_OX366381,1,595919,596986,+,1067
80,NZ_OX366342,1,452153,453221,-,1068
80,NZ_OX366369,1,662445,663512,+,1067
80,NZ_OX366356,1,572533,573600,+,1067
80,NZ_OX366377,1,420672,421739,-,1067
80,NZ_OX366388,1,531415,532482,+,1067
80,NZ_OX366357,1,82887,83942,+,1055
80,NZ_CP072012,1,643958,645025,-,1067
80,NZ_OX366398,1,89095,90162,+,1067
80,NC_002978,6,332140,333207,+,1067
80,NZ_OX366389,1,491867,492934,+,1067
80,NZ_OX366397,1,1027118,1028185,-,1067
80,NZ_OX366378,1,452190,453257,+,1067
80,NZ_CP090903,1,332140,333207,+,1067
80,NZ_OX366374,1,890233,891300,+,1067
80,NZ_CP090901,1,332140,333207,+,1067
80,NZ_CP046923,1,331784,332851,+,1067
80,NZ_CP069055,1,369062,370129,+,1067
80,NZ_CP072670,1,331980,333047,+,1067
80,NZ_CP090899,1,332140,333207,+,1067
80,NZ_CP046924,1,331784,332851,+,1067
80,NZ_OX366348,1,679049,680116,+,1067
80,NZ_CP046921,1,331784,332851,+,1067
80,NZ_OX366338,1,739189,740256,-,1067
80,NZ_CP054557,1,76015,77082,+,1067
80,NZ_CP072669,1,331988,333055,+,1067
80,NC_021089,1,594516,595583,-,1067
81,NZ_OX366376,1,276630,278172,+,1542
81,NZ_OX366393,1,983640,985182,+,1542
81,NZ_OX366372,1,1179925,1181467,-,1542
81,NZ_CP072672,1,333743,335333,+,1590
81,NZ_CP069060,1,322612,324202,+,1590
81,NZ_CP072667,1,333725,335315,+,1590
81,NZ_CP072671,1,333725,335315,+,1590
81,NZ_CP072668,1,333725,335315,+,1590
81,NZ_CP072666,1,333725,335315,+,1590
81,NZ_CP090902,1,333877,335467,+,1590
81,NZ_CP090948,1,333877,335467,+,1590
81,NZ_CP069052,1,317285,318875,+,1590
81,NZ_CP076228,1,400610,402200,-,1590
81,NZ_CP042445,1,333877,335467,+,1590
81,NZ_CP042904,1,464171,465770,-,1599
81,NC_012416,1,467489,469088,-,1599
81,NZ_CP069053,1,223075,224665,-,1590
81,NZ_CP042446,1,333877,335467,+,1590
81,NZ_CP041215,1,827451,829041,-,1590
81,NZ_OX366353,1,84816,86406,-,1590
81,NZ_OX366387,1,752839,754429,-,1590
81,NZ_OX366368,1,688764,690354,+,1590
81,NZ_OX366379,1,856833,858423,-,1590
81,NZ_CP091195,1,436903,438493,-,1590
81,NZ_OX366375,1,884277,885867,+,1590
81,NZ_CP046925,1,333725,335315,+,1590
81,NZ_OX366318,1,806875,808465,-,1590
81,NZ_OX366319,1,437294,438884,+,1590
81,NZ_OX366332,1,943387,944977,-,1590
81,NZ_CP110359,1,844340,845930,-,1590
81,NZ_OU953855,1,685053,686643,-,1590
81,NZ_OX366272,1,649467,651057,-,1590
81,NZ_OX366347,1,1061715,1063215,-,1500
81,NZ_OU909470,1,1007309,1008899,+,1590
81,NZ_OX366363,1,101697,103287,+,1590
81,NZ_OX366364,1,279798,281298,+,1500
81,NZ_OX366359,1,774080,775670,-,1590
81,NZ_OX366349,1,1469908,1471450,-,1542
81,NZ_OX366380,1,187951,189493,+,1542
81,NZ_OX366344,1,1287441,1288983,+,1542
81,NZ_CP090900,1,333877,335467,+,1590
81,NZ_OX366352,1,704482,706072,-,1590
81,NZ_OX366362,1,168878,170378,+,1500
81,NZ_OX366400,1,437828,439418,+,1590
81,NZ_OX366327,1,854642,856232,-,1590
81,NZ_OX366367,1,85138,86631,+,1493
81,NZ_CP042444,1,334378,335968,+,1590
81,NZ_OX366326,1,904181,905771,-,1590
81,NZ_CP037426,1,130078,131668,+,1590
81,NZ_OX366339,1,532400,533990,-,1590
81,NZ_OX366355,1,517666,519256,-,1590
81,NZ_CP046922,1,333521,335111,+,1590
81,NZ_OX366370,1,80485,82027,+,1542
81,NZ_OX366385,1,1048253,1049795,-,1542
81,NZ_OX366399,1,847874,849464,-,1590
81,NZ_OX366395,1,886714,888304,-,1590
81,NZ_OX366396,1,1499181,1500771,+,1590
81,NZ_OX366351,1,728098,729688,-,1590
81,NZ_OX366381,1,597656,599246,+,1590
81,NZ_OX366342,1,449903,451445,-,1542
81,NZ_OX366369,1,664182,665772,+,1590
81,NZ_OX366356,1,574280,575822,+,1542
81,NZ_OX366377,1,418412,420002,-,1590
81,NZ_OX366388,1,533152,534742,+,1590
81,NZ_OX366357,1,563309,564899,-,1590
81,NZ_CP072012,1,641698,643288,-,1590
81,NZ_OX366398,1,90832,92422,+,1590
81,NC_002978,6,333877,335467,+,1590
81,NZ_OX366389,1,493604,495194,+,1590
81,NZ_OX366397,1,1024858,1026448,-,1590
81,NZ_OX366378,1,434088,435678,-,1590
81,NZ_CP090903,1,333877,335467,+,1590
81,NZ_OX366374,1,892947,894537,+,1590
81,NZ_CP090901,1,333877,335467,+,1590
81,NZ_CP046923,1,333521,335111,+,1590
81,NZ_CP069055,1,370799,372389,+,1590
81,NZ_CP072670,1,333717,335307,+,1590
81,NZ_CP090899,1,333877,335467,+,1590
81,NZ_CP046924,1,333521,335111,+,1590
81,NZ_OX366348,1,682413,684003,+,1590
81,NZ_CP046921,1,333521,335111,+,1590
81,NZ_OX366338,1,737261,738803,-,1542
81,NZ_CP054557,1,77752,79342,+,1590
81,NZ_CP072669,1,333725,335315,+,1590
81,NC_021089,1,592256,593846,-,1590
82,NZ_OX366376,1,279831,282052,+,2221
82,NZ_OX366393,1,986841,989062,+,2221
82,NZ_OX366372,1,1176049,1178270,-,2221
82,NZ_CP072672,1,336744,338999,+,2255
82,NZ_CP069060,1,325613,327868,+,2255
82,NZ_CP072667,1,336726,338981,+,2255
82,NZ_CP072671,1,336726,338981,+,2255
82,NZ_CP072668,1,336726,338981,+,2255
82,NZ_CP072666,1,336726,338981,+,2255
82,NZ_CP090902,1,336878,339133,+,2255
82,NZ_CP090948,1,336878,339133,+,2255
82,NZ_CP069052,1,320286,322541,+,2255
82,NZ_CP076228,1,397367,399622,-,2255
82,NZ_CP042445,1,336878,339133,+,2255
82,NZ_CP042904,1,460216,462463,-,2247
82,NC_012416,1,463599,465846,-,2247
82,NZ_CP069053,1,219409,221664,-,2255
82,NZ_CP042446,1,336878,339133,+,2255
82,NZ_CP041215,1,823487,825742,-,2255
82,NZ_OX366353,1,80853,83108,-,2255
82,NZ_OX366387,1,748884,751132,-,2248
82,NZ_OX366368,1,691765,694013,+,2248
82,NZ_OX366379,1,853167,855422,-,2255
82,NZ_CP091195,1,433074,435329,-,2255
82,NZ_OX366375,1,887393,889648,+,2255
82,NZ_CP046925,1,336726,338981,+,2255
82,NZ_OX366318,1,803152,805407,-,2255
82,NZ_OX366319,1,440446,442701,+,2255
82,NZ_OX366332,1,939423,941678,-,2255
82,NZ_CP110359,1,840694,842949,-,2255
82,NZ_OU953855,1,1351662,1353901,+,2239
82,NZ_OX366272,1,645777,648017,-,2240
82,NZ_OX366347,1,1058049,1060304,-,2255
82,NZ_OU909470,1,1010405,1012626,+,2221
82,NZ_OX366363,1,104704,106959,+,2255
82,NZ_OX366364,1,282282,284522,+,2240
82,NZ_OX366359,1,770116,772371,-,2255
82,NZ_OX366349,1,1466240,1468461,-,2221
82,NZ_OX366380,1,191019,193240,+,2221
82,NZ_OX366344,1,1178188,1180409,-,2221
82,NZ_CP090900,1,336878,339133,+,2255
82,NZ_OX366352,1,700518,702773,-,2255
82,NZ_OX366362,1,173158,175413,+,2255
82,NZ_OX366400,1,440886,443141,+,2255
82,NZ_OX366327,1,851018,853265,-,2247
82,NZ_OX366367,1,88208,90429,+,2221
82,NZ_CP042444,1,337379,339634,+,2255
82,NZ_OX366326,1,900458,902713,-,2255
82,NZ_CP037426,1,133194,135449,+,2255
82,NZ_OX366339,1,528735,530990,-,2255
82,NZ_OX366355,1,513849,516104,-,2255
82,NZ_CP046922,1,336522,338777,+,2255
82,NZ_OX366370,1,83383,85604,+,2221
82,NZ_OX366385,1,1044536,1046746,-,2210
82,NZ_OX366399,1,844208,846463,-,2255
82,NZ_OX366395,1,881971,884226,-,2255
82,NZ_OX366396,1,1502180,1504435,+,2255
82,NZ_OX366351,1,724375,726630,-,2255
82,NZ_OX366381,1,600808,603063,+,2255
82,NZ_OX366342,1,446023,448244,-,2221
82,NZ_OX366369,1,667333,669588,+,2255
82,NZ_OX366356,1,577510,579765,+,2255
82,NZ_OX366377,1,414688,416943,-,2255
82,NZ_OX366388,1,537798,540053,+,2255
82,NZ_OX366357,1,559587,561825,-,2238
82,NZ_CP072012,1,638032,640287,-,2255
82,NZ_OX366398,1,93891,96146,+,2255
82,NC_002978,6,336878,339133,+,2255
82,NZ_OX366389,1,496663,498918,+,2255
82,NZ_OX366397,1,1020894,1023149,-,2255
82,NZ_OX366378,1,430259,432514,-,2255
82,NZ_CP090903,1,336878,339133,+,2255
82,NZ_OX366374,1,895948,898196,+,2248
82,NZ_CP090901,1,336878,339133,+,2255
82,NZ_CP046923,1,336522,338777,+,2255
82,NZ_CP069055,1,373799,376054,+,2255
82,NZ_CP072670,1,336718,338973,+,2255
82,NZ_CP090899,1,336878,339133,+,2255
82,NZ_CP046924,1,336522,338777,+,2255
82,NZ_OX366348,1,685406,687661,+,2255
82,NZ_CP046921,1,336522,338777,+,2255
82,NZ_OX366338,1,564311,566566,-,2255
82,NZ_CP054557,1,80785,83040,-,2255
82,NZ_CP054557,1,448337,450592,+,2255
82,NZ_CP072669,1,336726,338981,+,2255
82,NC_021089,1,588297,590552,-,2255
83,NZ_OX366376,1,282659,289484,+,6825
83,NZ_OX366393,1,989669,996494,+,6825
83,NZ_OX366372,1,1168617,1175442,-,6825
83,NZ_CP072672,1,824783,831559,-,6776
83,NZ_CP069060,1,668471,675256,-,6785
83,NZ_CP072667,1,824765,831541,-,6776
83,NZ_CP072671,1,824765,831541,-,6776
83,NZ_CP072668,1,824752,831528,-,6776
83,NZ_CP072666,1,824765,831541,-,6776
83,NZ_CP090902,1,824917,831693,-,6776
83,NZ_CP090948,1,824917,831693,-,6776
83,NZ_CP069052,1,1219461,1226246,-,6785
83,NZ_CP076228,1,822816,829601,-,6785
83,NZ_CP042445,1,824905,831681,-,6776
83,NZ_CP042904,1,852530,859315,-,6785
83,NC_012416,1,889031,895816,-,6785
83,NZ_CP069053,1,668479,675264,-,6785
83,NZ_CP042446,1,824917,831693,-,6776
83,NZ_CP041215,1,1318193,1324978,-,6785
83,NZ_OX366353,1,319036,325821,-,6785
83,NZ_OX366387,1,1488351,1495136,-,6785
83,NZ_OX366368,1,1270828,1277613,-,6785
83,NZ_OX366379,1,1190345,1197130,-,6785
83,NZ_CP091195,1,100866,107643,+,6777
83,NZ_OX366375,1,1190694,1197479,-,6785
83,NZ_CP046925,1,824765,831541,-,6776
83,NZ_OX366318,1,1124205,1130963,-,6758
83,NZ_OX366319,1,95061,101846,-,6785
83,NZ_OX366332,1,1226828,1233613,-,6785
83,NZ_CP110359,1,314078,320863,-,6785
83,NZ_OU953855,1,847043,853819,-,6776
83,NZ_OX366272,1,1282576,1289361,-,6785
83,NZ_OX366347,1,104414,111199,+,6785
83,NZ_OU909470,1,1013386,1020135,+,6749
83,NZ_OX366363,1,821908,828666,-,6758
83,NZ_OX366364,1,258705,265463,-,6758
83,NZ_OX366359,1,1051468,1058253,+,6785
83,NZ_OX366349,1,1458796,1465633,-,6837
83,NZ_OX366380,1,193958,200673,+,6715
83,NZ_OX366344,1,1170738,1177581,-,6843
83,NZ_CP090900,1,824917,831693,-,6776
83,NZ_OX366352,1,224012,230797,+,6785
83,NZ_OX366362,1,330415,337220,+,6805
83,NZ_OX366400,1,987370,994128,-,6758
83,NZ_OX366327,1,1126239,1133024,-,6785
83,NZ_OX366367,1,1226052,1232789,+,6737
83,NZ_CP042444,1,825352,832128,-,6776
83,NZ_OX366326,1,1331848,1338606,-,6758
83,NZ_CP037426,1,927745,934530,+,6785
83,NZ_OX366339,1,1029482,1036265,-,6783
83,NZ_OX366355,1,99915,106700,-,6785
83,NZ_CP046922,1,886730,893506,-,6776
83,NZ_OX366370,1,86340,93139,+,6799
83,NZ_OX366385,1,1036245,1042960,-,6715
83,NZ_OX366399,1,1224973,1231758,-,6785
83,NZ_OX366395,1,1281973,1288705,+,6732
83,NZ_OX366396,1,1252210,1258993,-,6783
83,NZ_OX366351,1,1278274,1285032,-,6758
83,NZ_OX366381,1,206541,213326,-,6785
83,NZ_OX366342,1,438591,445416,-,6825
83,NZ_OX366369,1,1317663,1324448,-,6785
83,NZ_OX366356,1,1032812,1039574,-,6762
83,NZ_OX366377,1,1095970,1102755,+,6785
83,NZ_OX366388,1,310392,317169,-,6777
83,NZ_OX366357,1,696881,703631,-,6750
83,NZ_CP072012,1,1347806,1354591,+,6785
83,NZ_OX366398,1,305401,312186,-,6785
83,NC_002978,6,824917,831693,-,6776
83,NZ_OX366389,1,1198986,1205771,-,6785
83,NZ_OX366397,1,1445879,1452664,+,6785
83,NZ_OX366378,1,312780,319557,-,6777
83,NZ_CP090903,1,824917,831693,-,6776
83,NZ_OX366374,1,419810,426546,-,6736
83,NZ_CP090901,1,824917,831693,-,6776
83,NZ_CP046923,1,802978,809754,-,6776
83,NZ_CP069055,1,824056,830841,-,6785
83,NZ_CP072670,1,824757,831533,-,6776
83,NZ_CP090899,1,824917,831693,-,6776
83,NZ_CP046924,1,823916,830692,-,6776
83,NZ_OX366348,1,149250,156035,+,6785
83,NZ_CP046921,1,886730,893506,-,6776
83,NZ_OX366338,1,1307367,1314073,-,6706
83,NZ_CP054557,1,974205,980990,+,6785
83,NZ_CP072669,1,824765,831541,-,6776
83,NC_021089,1,877061,883846,-,6785
84,NZ_OX366376,1,290202,292258,+,2056
84,NZ_OX366393,1,997212,999268,+,2056
84,NZ_OX366372,1,1165843,1167899,-,2056
84,NZ_CP072672,1,821978,824051,-,2073
84,NZ_CP069060,1,665666,667739,-,2073
84,NZ_CP072667,1,821960,824033,-,2073
84,NZ_CP072671,1,821960,824033,-,2073
84,NZ_CP072668,1,821947,824020,-,2073
84,NZ_CP072666,1,821960,824033,-,2073
84,NZ_CP090902,1,822112,824185,-,2073
84,NZ_CP090948,1,822112,824185,-,2073
84,NZ_CP069052,1,1216656,1218729,-,2073
84,NZ_CP076228,1,820011,822084,-,2073
84,NZ_CP042445,1,822100,824173,-,2073
84,NZ_CP042904,1,849740,851798,-,2058
84,NC_012416,1,886241,888299,-,2058
84,NZ_CP069053,1,665674,667747,-,2073
84,NZ_CP042446,1,822112,824185,-,2073
84,NZ_CP041215,1,1315403,1317461,-,2058
84,NZ_OX366353,1,316246,318304,-,2058
84,NZ_OX366387,1,1485561,1487619,-,2058
84,NZ_OX366368,1,1268023,1270096,-,2073
84,NZ_OX366379,1,1187540,1189613,-,2073
84,NZ_CP091195,1,108374,110429,+,2055
84,NZ_OX366375,1,1187904,1189962,-,2058
84,NZ_CP046925,1,821960,824033,-,2073
84,NZ_OX366318,1,1121382,1123455,-,2073
84,NZ_OX366319,1,92262,94320,-,2058
84,NZ_OX366332,1,1224038,1226096,-,2058
84,NZ_CP110359,1,311291,313346,-,2055
84,NZ_OU953855,1,844229,846293,-,2064
84,NZ_OX366272,1,1279789,1281844,-,2055
84,NZ_OX366347,1,111931,113986,+,2055
84,NZ_OU909470,1,1020867,1022934,+,2067
84,NZ_OX366363,1,819112,821167,-,2055
84,NZ_OX366364,1,255850,257900,-,2050
84,NZ_OX366359,1,1058985,1061043,+,2058
84,NZ_OX366349,1,1456000,1458051,-,2051
84,NZ_OX366380,1,201410,203480,+,2070
84,NZ_OX366344,1,1167926,1169978,-,2052
84,NZ_CP090900,1,822112,824185,-,2073
84,NZ_OX366352,1,231529,233587,+,2058
84,NZ_OX366362,1,337966,340023,+,2057
84,NZ_OX366400,1,984547,986620,-,2073
84,NZ_OX366327,1,1123449,1125507,-,2058
84,NZ_OX366367,1,1233582,1235645,+,2063
84,NZ_CP042444,1,822547,824620,-,2073
84,NZ_OX366326,1,1329025,1331098,-,2073
84,NZ_CP037426,1,935262,937320,+,2058
84,NZ_OX366339,1,1026696,1028754,-,2058
84,NZ_OX366355,1,97116,99174,-,2058
84,NZ_CP046922,1,883925,885998,-,2073
84,NZ_OX366370,1,93885,95947,+,2062
84,NZ_OX366385,1,1033438,1035508,-,2070
84,NZ_OX366399,1,1222168,1224241,-,2073
84,NZ_OX366395,1,1289542,1291585,+,2043
84,NZ_OX366396,1,1249424,1251482,-,2058
84,NZ_OX366351,1,1275451,1277524,-,2073
84,NZ_OX366381,1,203742,205800,-,2058
84,NZ_OX366342,1,435817,437873,-,2056
84,NZ_OX366369,1,1314864,1316922,-,2058
84,NZ_OX366356,1,1030022,1032080,-,2058
84,NZ_OX366377,1,1103487,1105560,+,2073
84,NZ_OX366388,1,307606,309661,-,2055
84,NZ_OX366357,1,694097,696148,-,2051
84,NZ_CP072012,1,1355323,1357396,+,2073
84,NZ_OX366398,1,302596,304669,-,2073
84,NC_002978,6,822112,824185,-,2073
84,NZ_OX366389,1,1196181,1198254,-,2073
84,NZ_OX366397,1,1453396,1455454,+,2058
84,NZ_OX366378,1,309994,312049,-,2055
84,NZ_CP090903,1,822112,824185,-,2073
84,NZ_OX366374,1,416996,419060,-,2064
84,NZ_CP090901,1,822112,824185,-,2073
84,NZ_CP046923,1,800173,802246,-,2073
84,NZ_CP069055,1,821251,823324,-,2073
84,NZ_CP072670,1,821952,824025,-,2073
84,NZ_CP090899,1,822112,824185,-,2073
84,NZ_CP046924,1,821111,823184,-,2073
84,NZ_OX366348,1,156767,158840,+,2073
84,NZ_CP046921,1,883925,885998,-,2073
84,NZ_OX366338,1,1304551,1306624,-,2073
84,NZ_CP054557,1,981722,983795,+,2073
84,NZ_CP072669,1,821960,824033,-,2073
84,NC_021089,1,874271,876329,-,2058
85,NZ_OX366376,1,293232,294041,+,809
85,NZ_OX366393,1,1000242,1001051,+,809
85,NZ_OX366372,1,1164060,1164869,-,809
85,NZ_CP072672,1,820205,821021,-,816
85,NZ_CP069060,1,663923,664739,-,816
85,NZ_CP072667,1,820187,821003,-,816
85,NZ_CP072671,1,820187,821003,-,816
85,NZ_CP072668,1,820174,820990,-,816
85,NZ_CP072666,1,820187,821003,-,816
85,NZ_CP090902,1,820339,821155,-,816
85,NZ_CP090948,1,820339,821155,-,816
85,NZ_CP069052,1,1214913,1215729,-,816
85,NZ_CP076228,1,818238,819054,-,816
85,NZ_CP042445,1,820327,821143,-,816
85,NZ_CP042904,1,847985,848801,-,816
85,NC_012416,1,884486,885302,-,816
85,NZ_CP069053,1,663931,664747,-,816
85,NZ_CP042446,1,820339,821155,-,816
85,NZ_CP041215,1,1313648,1314464,-,816
85,NZ_OX366353,1,314491,315307,-,816
85,NZ_OX366387,1,1483785,1484601,-,816
85,NZ_OX366368,1,1266250,1267066,-,816
85,NZ_OX366379,1,1185767,1186583,-,816
85,NZ_CP091195,1,111404,112220,+,816
85,NZ_OX366375,1,1186149,1186965,-,816
85,NZ_CP046925,1,820187,821003,-,816
85,NZ_OX366318,1,1119609,1120425,-,816
85,NZ_OX366319,1,90507,91323,-,816
85,NZ_OX366332,1,1222283,1223099,-,816
85,NZ_CP110359,1,309500,310316,-,816
85,NZ_OU953855,1,842474,843290,-,816
85,NZ_OX366272,1,1277998,1278814,-,816
85,NZ_OX366347,1,114961,115777,+,816
85,NZ_OU909470,1,1023912,1024728,+,816
85,NZ_OX366363,1,817321,818137,-,816
85,NZ_OX366364,1,253998,254814,-,816
85,NZ_OX366359,1,1061982,1062798,+,816
85,NZ_OX366349,1,1454209,1455018,-,809
85,NZ_OX366380,1,204461,205277,+,816
85,NZ_OX366344,1,1166106,1166915,-,809
85,NZ_CP090900,1,820339,821155,-,816
85,NZ_OX366352,1,234526,235342,+,816
85,NZ_OX366362,1,341116,341932,+,816
85,NZ_OX366400,1,982774,983590,-,816
85,NZ_OX366327,1,1121694,1122510,-,816
85,NZ_OX366367,1,1236620,1237436,+,816
85,NZ_CP042444,1,820774,821590,-,816
85,NZ_OX366326,1,1327252,1328068,-,816
85,NZ_CP037426,1,938259,939075,+,816
85,NZ_OX366339,1,1024941,1025757,-,816
85,NZ_OX366355,1,95361,96177,-,816
85,NZ_CP046922,1,882152,882968,-,816
85,NZ_OX366370,1,96972,97788,+,816
85,NZ_OX366385,1,1031641,1032457,-,816
85,NZ_OX366399,1,1220395,1221211,-,816
85,NZ_OX366395,1,1292593,1293409,+,816
85,NZ_OX366396,1,1247669,1248485,-,816
85,NZ_OX366351,1,1273678,1274494,-,816
85,NZ_OX366381,1,201987,202803,-,816
85,NZ_OX366342,1,434034,434843,-,809
85,NZ_OX366369,1,1313109,1313925,-,816
85,NZ_OX366356,1,1028246,1029062,-,816
85,NZ_OX366377,1,1106517,1107333,+,816
85,NZ_OX366388,1,305815,306631,-,816
85,NZ_OX366357,1,692288,693104,-,816
85,NZ_CP072012,1,1358353,1359169,+,816
85,NZ_OX366398,1,300823,301639,-,816
85,NC_002978,6,820339,821155,-,816
85,NZ_OX366389,1,1194408,1195224,-,816
85,NZ_OX366397,1,1456393,1457209,+,816
85,NZ_OX366378,1,308203,309019,-,816
85,NZ_CP090903,1,820339,821155,-,816
85,NZ_OX366374,1,415191,416000,-,809
85,NZ_CP090901,1,820339,821155,-,816
85,NZ_CP046923,1,798400,799216,-,816
85,NZ_CP069055,1,819478,820294,-,816
85,NZ_CP072670,1,820179,820995,-,816
85,NZ_CP090899,1,820339,821155,-,816
85,NZ_CP046924,1,819338,820154,-,816
85,NZ_OX366348,1,159797,160613,+,816
85,NZ_CP046921,1,882152,882968,-,816
85,NZ_OX366338,1,1302742,1303558,-,816
85,NZ_CP054557,1,984752,985568,+,816
85,NZ_CP072669,1,820187,821003,-,816
85,NC_021089,1,872516,873332,-,816
86,NZ_OX366376,1,294391,296581,+,2190
86,NZ_OX366393,1,1001401,1003591,+,2190
86,NZ_OX366372,1,1161520,1163710,-,2190
86,NZ_CP072672,1,817658,819874,-,2216
86,NZ_CP069060,1,661376,663592,-,2216
86,NZ_CP072667,1,817640,819856,-,2216
86,NZ_CP072671,1,817640,819856,-,2216
86,NZ_CP072668,1,817627,819843,-,2216
86,NZ_CP072666,1,817640,819856,-,2216
86,NZ_CP090902,1,817792,820008,-,2216
86,NZ_CP090948,1,817792,820008,-,2216
86,NZ_CP069052,1,1212366,1214582,-,2216
86,NZ_CP076228,1,815692,817908,-,2216
86,NZ_CP042445,1,817780,819996,-,2216
86,NZ_CP042904,1,845432,847654,-,2222
86,NC_012416,1,881933,884155,-,2222
86,NZ_CP069053,1,661384,663600,-,2216
86,NZ_CP042446,1,817792,820008,-,2216
86,NZ_CP041215,1,1311116,1313317,-,2201
86,NZ_OX366353,1,311959,314160,-,2201
86,NZ_OX366387,1,1481232,1483454,-,2222
86,NZ_OX366368,1,1263703,1265919,-,2216
86,NZ_OX366379,1,1183220,1185436,-,2216
86,NZ_CP091195,1,112551,114746,+,2195
86,NZ_OX366375,1,1183617,1185818,-,2201
86,NZ_CP046925,1,817640,819856,-,2216
86,NZ_OX366318,1,1117083,1119278,-,2195
86,NZ_OX366319,1,87975,90176,-,2201
86,NZ_OX366332,1,1219751,1221952,-,2201
86,NZ_CP110359,1,306950,309169,-,2219
86,NZ_OU953855,1,839927,842143,-,2216
86,NZ_OX366272,1,1275448,1277667,-,2219
86,NZ_OX366347,1,116108,118309,+,2201
86,NZ_OU909470,1,1025053,1027270,+,2217
86,NZ_OX366363,1,814774,816990,-,2216
86,NZ_OX366364,1,251498,253650,-,2152
86,NZ_OX366359,1,1063129,1065330,+,2201
86,NZ_OX366349,1,1451669,1453859,-,2190
86,NZ_OX366380,1,205602,207819,+,2217
86,NZ_OX366344,1,1163545,1165756,-,2211
86,NZ_CP090900,1,817792,820008,-,2216
86,NZ_OX366352,1,235673,237874,+,2201
86,NZ_OX366362,1,342267,344471,+,2204
86,NZ_OX366400,1,980248,982443,-,2195
86,NZ_OX366327,1,1119141,1121363,-,2222
86,NZ_OX366367,1,1237784,1239957,+,2173
86,NZ_CP042444,1,818227,820443,-,2216
86,NZ_OX366326,1,1324726,1326921,-,2195
86,NZ_CP037426,1,939406,941607,+,2201
86,NZ_OX366339,1,1022373,1024610,-,2237
86,NZ_OX366355,1,92829,95030,-,2201
86,NZ_CP046922,1,879605,881821,-,2216
86,NZ_OX366370,1,98131,100336,+,2205
86,NZ_OX366385,1,1029099,1031316,-,2217
86,NZ_OX366399,1,1217848,1220064,-,2216
86,NZ_OX366395,1,1293752,1295969,+,2217
86,NZ_OX366396,1,1245101,1247338,-,2237
86,NZ_OX366351,1,1271152,1273347,-,2195
86,NZ_OX366381,1,199455,201656,-,2201
86,NZ_OX366342,1,431494,433684,-,2190
86,NZ_OX366369,1,1310577,1312778,-,2201
86,NZ_OX366356,1,1025717,1027915,-,2198
86,NZ_OX366377,1,1107664,1109880,+,2216
86,NZ_OX366388,1,303289,305484,-,2195
86,NZ_OX366357,1,689728,691945,-,2217
86,NZ_CP072012,1,1359500,1361716,+,2216
86,NZ_OX366398,1,298276,300492,-,2216
86,NC_002978,6,817792,820008,-,2216
86,NZ_OX366389,1,1191861,1194077,-,2216
86,NZ_OX366397,1,1457540,1459741,+,2201
86,NZ_OX366378,1,305677,307872,-,2195
86,NZ_CP090903,1,817792,820008,-,2216
86,NZ_OX366374,1,412619,414796,-,2177
86,NZ_CP090901,1,817792,820008,-,2216
86,NZ_CP046923,1,795853,798069,-,2216
86,NZ_CP069055,1,816931,819147,-,2216
86,NZ_CP072670,1,817632,819848,-,2216
86,NZ_CP090899,1,817792,820008,-,2216
86,NZ_CP046924,1,816791,819007,-,2216
86,NZ_OX366348,1,160944,163139,+,2195
86,NZ_CP046921,1,879605,881821,-,2216
86,NZ_OX366338,1,1300182,1302399,-,2217
86,NZ_CP054557,1,985899,988094,+,2195
86,NZ_CP072669,1,817640,819856,-,2216
86,NC_021089,1,869984,872185,-,2201
87,NZ_OX366376,1,296912,297640,+,728
87,NZ_OX366393,1,1003922,1004650,+,728
87,NZ_OX366372,1,1160461,1161189,-,728
87,NZ_CP072672,1,816674,817381,-,707
87,NZ_CP069060,1,660392,661099,-,707
87,NZ_CP072667,1,816656,817363,-,707
87,NZ_CP072671,1,816656,817363,-,707
87,NZ_CP072668,1,816643,817350,-,707
87,NZ_CP072666,1,816656,817363,-,707
87,NZ_CP090902,1,816808,817515,-,707
87,NZ_CP090948,1,816808,817515,-,707
87,NZ_CP069052,1,1211382,1212089,-,707
87,NZ_CP076228,1,814708,815415,-,707
87,NZ_CP042445,1,816796,817503,-,707
87,NZ_CP042904,1,844445,845155,-,710
87,NC_012416,1,880946,881656,-,710
87,NZ_CP069053,1,660400,661107,-,707
87,NZ_CP042446,1,816808,817515,-,707
87,NZ_CP041215,1,1310141,1310868,-,727
87,NZ_OX366353,1,310984,311711,-,727
87,NZ_OX366387,1,1480227,1480955,-,728
87,NZ_OX366368,1,1262719,1263426,-,707
87,NZ_OX366379,1,1182236,1182943,-,707
87,NZ_CP091195,1,115075,115820,+,745
87,NZ_OX366375,1,1182642,1183369,-,727
87,NZ_CP046925,1,816656,817363,-,707
87,NZ_OX366318,1,1116108,1116835,-,727
87,NZ_OX366319,1,87000,87727,-,727
87,NZ_OX366332,1,1218776,1219503,-,727
87,NZ_CP110359,1,305963,306673,-,710
87,NZ_OU953855,1,838943,839650,-,707
87,NZ_OX366272,1,1274461,1275171,-,710
87,NZ_OX366347,1,118557,119323,+,766
87,NZ_OU909470,1,1027547,1028275,+,728
87,NZ_OX366363,1,813787,814497,-,710
87,NZ_OX366364,1,250385,251167,-,782
87,NZ_OX366359,1,1065578,1066305,+,727
87,NZ_OX366349,1,1450661,1451389,-,728
87,NZ_OX366380,1,208096,208824,+,728
87,NZ_OX366344,1,1162486,1163214,-,728
87,NZ_CP090900,1,816808,817515,-,707
87,NZ_OX366352,1,238122,238849,+,727
87,NZ_OX366362,1,344790,345518,+,728
87,NZ_OX366400,1,979273,980000,-,727
87,NZ_OX366327,1,1118154,1118864,-,710
87,NZ_OX366367,1,1240285,1241067,+,782
87,NZ_CP042444,1,817243,817950,-,707
87,NZ_OX366326,1,1323751,1324478,-,727
87,NZ_CP037426,1,941855,942582,+,727
87,NZ_OX366339,1,1021368,1022096,-,728
87,NZ_OX366355,1,91854,92581,-,727
87,NZ_CP046922,1,878621,879328,-,707
87,NZ_OX366370,1,100616,101347,+,731
87,NZ_OX366385,1,1028094,1028822,-,728
87,NZ_OX366399,1,1216864,1217571,-,707
87,NZ_OX366395,1,1296246,1296956,+,710
87,NZ_OX366396,1,1244096,1244824,-,728
87,NZ_OX366351,1,1270177,1270904,-,727
87,NZ_OX366381,1,198480,199207,-,727
87,NZ_OX366342,1,430435,431163,-,728
87,NZ_OX366369,1,1309602,1310329,-,727
87,NZ_OX366356,1,1024724,1025469,-,745
87,NZ_OX366377,1,1110157,1110867,+,710
87,NZ_OX366388,1,302215,302960,-,745
87,NZ_OX366357,1,688741,689451,-,710
87,NZ_CP072012,1,1361993,1362700,+,707
87,NZ_OX366398,1,297289,297999,-,710
87,NC_002978,6,816808,817515,-,707
87,NZ_OX366389,1,1190874,1191584,-,710
87,NZ_OX366397,1,1459989,1460716,+,727
87,NZ_OX366378,1,304603,305348,-,745
87,NZ_CP090903,1,816808,817515,-,707
87,NZ_OX366374,1,411635,412342,-,707
87,NZ_CP090901,1,816808,817515,-,707
87,NZ_CP046923,1,794869,795576,-,707
87,NZ_CP069055,1,815947,816654,-,707
87,NZ_CP072670,1,816648,817355,-,707
87,NZ_CP090899,1,816808,817515,-,707
87,NZ_CP046924,1,815807,816514,-,707
87,NZ_OX366348,1,163416,164114,+,698
87,NZ_CP046921,1,878621,879328,-,707
87,NZ_OX366338,1,1299198,1299905,-,707
87,NZ_CP054557,1,988371,989078,+,707
87,NZ_CP072669,1,816656,817363,-,707
87,NC_021089,1,869009,869736,-,727
88,NZ_OX366376,1,297740,298455,+,715
88,NZ_OX366393,1,1004750,1005465,+,715
88,NZ_OX366372,1,1159646,1160361,-,715
88,NZ_CP072672,1,815448,816289,-,841
88,NZ_CP069060,1,659166,660007,-,841
88,NZ_CP072667,1,815430,816271,-,841
88,NZ_CP072671,1,815430,816271,-,841
88,NZ_CP072668,1,815417,816258,-,841
88,NZ_CP072666,1,815430,816271,-,841
88,NZ_CP090902,1,815582,816423,-,841
88,NZ_CP090948,1,815582,816423,-,841
88,NZ_CP069052,1,1210156,1210997,-,841
88,NZ_CP076228,1,813482,814323,-,841
88,NZ_CP042445,1,815570,816411,-,841
88,NZ_CP042904,1,843219,844060,-,841
88,NC_012416,1,879720,880561,-,841
88,NZ_CP069053,1,659174,660015,-,841
88,NZ_CP042446,1,815582,816423,-,841
88,NZ_CP041215,1,1309059,1309756,-,697
88,NZ_OX366353,1,309902,310599,-,697
88,NZ_OX366387,1,1479001,1479842,-,841
88,NZ_OX366368,1,1261493,1262334,-,841
88,NZ_OX366379,1,1181010,1181851,-,841
88,NZ_CP091195,1,116351,117046,+,695
88,NZ_OX366375,1,1181416,1182257,-,841
88,NZ_CP046925,1,815430,816271,-,841
88,NZ_OX366318,1,1115026,1115812,-,786
88,NZ_OX366319,1,85867,86615,-,748
88,NZ_OX366332,1,1217694,1218391,-,697
88,NZ_CP110359,1,304737,305578,-,841
88,NZ_OU953855,1,837717,838558,-,841
88,NZ_OX366272,1,1273235,1274076,-,841
88,NZ_OX366347,1,119854,120549,+,695
88,NZ_OU909470,1,1028358,1029004,+,646
88,NZ_OX366363,1,812561,813402,-,841
88,NZ_OX366364,1,249722,250365,-,643
88,NZ_OX366359,1,1066690,1067387,+,697
88,NZ_OX366349,1,1449846,1450561,-,715
88,NZ_OX366380,1,208907,209553,+,646
88,NZ_OX366344,1,1161671,1162386,-,715
88,NZ_CP090900,1,815582,816423,-,841
88,NZ_OX366352,1,239234,239931,+,697
88,NZ_OX366362,1,345938,346630,+,692
88,NZ_OX366400,1,978191,978977,-,786
88,NZ_OX366327,1,1116928,1117769,-,841
88,NZ_OX366367,1,1241087,1241730,+,643
88,NZ_CP042444,1,816017,816858,-,841
88,NZ_OX366326,1,1322670,1323455,-,785
88,NZ_CP037426,1,943113,943808,+,695
88,NZ_OX366339,1,1020142,1020983,-,841
88,NZ_OX366355,1,90772,91469,-,697
88,NZ_CP046922,1,877395,878236,-,841
88,NZ_OX366370,1,101432,102139,+,707
88,NZ_OX366385,1,1027365,1028011,-,646
88,NZ_OX366399,1,1215638,1216479,-,841
88,NZ_OX366395,1,1297487,1298179,+,692
88,NZ_OX366396,1,1242960,1243800,-,840
88,NZ_OX366351,1,1269095,1269881,-,786
88,NZ_OX366381,1,197347,198095,-,748
88,NZ_OX366342,1,429620,430335,-,715
88,NZ_OX366369,1,1308469,1309217,-,748
88,NZ_OX366356,1,1023498,1024339,-,841
88,NZ_OX366377,1,1111398,1112093,+,695
88,NZ_OX366388,1,300989,301830,-,841
88,NZ_OX366357,1,687515,688356,-,841
88,NZ_CP072012,1,1363231,1363926,+,695
88,NZ_OX366398,1,296063,296904,-,841
88,NC_002978,6,815582,816423,-,841
88,NZ_OX366389,1,1189648,1190489,-,841
88,NZ_OX366397,1,1461101,1461798,+,697
88,NZ_OX366378,1,303377,304218,-,841
88,NZ_CP090903,1,815582,816423,-,841
88,NZ_OX366374,1,410412,411250,-,838
88,NZ_CP090901,1,815582,816423,-,841
88,NZ_CP046923,1,793643,794484,-,841
88,NZ_CP069055,1,814721,815562,-,841
88,NZ_CP072670,1,815422,816263,-,841
88,NZ_CP090899,1,815582,816423,-,841
88,NZ_CP046924,1,814581,815422,-,841
88,NZ_OX366348,1,164654,165349,+,695
88,NZ_CP046921,1,877395,878236,-,841
88,NZ_OX366338,1,1297972,1298813,-,841
88,NZ_CP054557,1,989609,990304,+,695
88,NZ_CP072669,1,815430,816271,-,841
88,NC_021089,1,867927,868624,-,697
89,NZ_OX366376,1,298456,299073,+,617
89,NZ_OX366393,1,1005466,1006083,+,617
89,NZ_OX366372,1,1159028,1159644,-,616
89,NZ_CP072672,1,814831,815446,-,615
89,NZ_CP069060,1,658549,659164,-,615
89,NZ_CP072667,1,814813,815428,-,615
89,NZ_CP072671,1,814813,815428,-,615
89,NZ_CP072668,1,814800,815415,-,615
89,NZ_CP072666,1,814813,815428,-,615
89,NZ_CP090902,1,814965,815580,-,615
89,NZ_CP090948,1,814965,815580,-,615
89,NZ_CP069052,1,1209539,1210154,-,615
89,NZ_CP076228,1,812865,813480,-,615
89,NZ_CP042445,1,814953,815568,-,615
89,NZ_CP042904,1,842602,843217,-,615
89,NC_012416,1,879103,879718,-,615
89,NZ_CP069053,1,658557,659172,-,615
89,NZ_CP042446,1,814965,815580,-,615
89,NZ_CP041215,1,1308442,1309057,-,615
89,NZ_OX366353,1,309285,309900,-,615
89,NZ_OX366387,1,1478384,1478999,-,615
89,NZ_OX366368,1,1260876,1261491,-,615
89,NZ_OX366379,1,1180393,1181008,-,615
89,NZ_CP091195,1,117047,117663,+,616
89,NZ_OX366375,1,1180799,1181414,-,615
89,NZ_CP046925,1,814813,815428,-,615
89,NZ_OX366318,1,1114409,1115024,-,615
89,NZ_OX366319,1,85250,85865,-,615
89,NZ_OX366332,1,1217077,1217692,-,615
89,NZ_CP110359,1,304120,304735,-,615
89,NZ_OU953855,1,837100,837715,-,615
89,NZ_OX366272,1,1272618,1273233,-,615
89,NZ_OX366347,1,120550,121166,+,616
89,NZ_OU909470,1,1029005,1029621,+,616
89,NZ_OX366363,1,811944,812559,-,615
89,NZ_OX366364,1,249111,249720,-,609
89,NZ_OX366359,1,1067388,1068004,+,616
89,NZ_OX366349,1,1449229,1449844,-,615
89,NZ_OX366380,1,209554,210170,+,616
89,NZ_OX366344,1,1161053,1161669,-,616
89,NZ_CP090900,1,814965,815580,-,615
89,NZ_OX366352,1,239932,240548,+,616
89,NZ_OX366362,1,346631,347247,+,616
89,NZ_OX366400,1,977574,978189,-,615
89,NZ_OX366327,1,1116311,1116926,-,615
89,NZ_OX366367,1,1241731,1242347,+,616
89,NZ_CP042444,1,815400,816015,-,615
89,NZ_OX366326,1,1322053,1322668,-,615
89,NZ_CP037426,1,943809,944425,+,616
89,NZ_OX366339,1,1019525,1020140,-,615
89,NZ_OX366355,1,89126,89757,-,631
89,NZ_CP046922,1,876778,877393,-,615
89,NZ_OX366370,1,102140,102753,+,613
89,NZ_OX366385,1,1026748,1027363,-,615
89,NZ_OX366399,1,1215021,1215636,-,615
89,NZ_OX366395,1,1298180,1298796,+,616
89,NZ_OX366396,1,1242343,1242958,-,615
89,NZ_OX366351,1,1268478,1269093,-,615
89,NZ_OX366381,1,196730,197345,-,615
89,NZ_OX366342,1,429002,429618,-,616
89,NZ_OX366369,1,1307852,1308467,-,615
89,NZ_OX366356,1,1022881,1023496,-,615
89,NZ_OX366377,1,1112094,1112710,+,616
89,NZ_OX366388,1,300372,300987,-,615
89,NZ_OX366357,1,686898,687513,-,615
89,NZ_CP072012,1,1363927,1364543,+,616
89,NZ_OX366398,1,295446,296061,-,615
89,NC_002978,6,814965,815580,-,615
89,NZ_OX366389,1,1189031,1189646,-,615
89,NZ_OX366397,1,1461799,1462415,+,616
89,NZ_OX366378,1,302760,303375,-,615
89,NZ_CP090903,1,814965,815580,-,615
89,NZ_OX366374,1,409796,410410,-,614
89,NZ_CP090901,1,814965,815580,-,615
89,NZ_CP046923,1,793026,793641,-,615
89,NZ_CP069055,1,814104,814719,-,615
89,NZ_CP072670,1,814805,815420,-,615
89,NZ_CP090899,1,814965,815580,-,615
89,NZ_CP046924,1,813964,814579,-,615
89,NZ_OX366348,1,165350,165966,+,616
89,NZ_CP046921,1,876778,877393,-,615
89,NZ_OX366338,1,1297356,1297970,-,614
89,NZ_CP054557,1,990305,990921,+,616
89,NZ_CP072669,1,814813,815428,-,615
89,NC_021089,1,867310,867925,-,615
90,NZ_OX366376,1,300028,300613,+,585
90,NZ_OX366393,1,1007038,1007623,+,585
90,NZ_OX366372,1,1157486,1158073,-,587
90,NZ_OX366364,1,246187,246786,-,599
90,NZ_OX366349,1,1447705,1448297,-,592
90,NZ_OX366344,1,1159529,1160121,-,592
90,NZ_OX366362,1,348194,348772,+,578
90,NZ_OX366367,1,1243303,1243893,+,590
90,NZ_OX366370,1,18662,19257,+,595
90,NZ_OX366342,1,427464,428050,-,586
91,NZ_OX366376,1,300615,302614,+,1999
91,NZ_OX366393,1,1007625,1009624,+,1999
91,NZ_OX366372,1,1155486,1157485,-,1999
91,NZ_CP072672,1,812302,814439,-,2137
91,NZ_CP069060,1,656020,658157,-,2137
91,NZ_CP072667,1,812284,814421,-,2137
91,NZ_CP072671,1,812284,814421,-,2137
91,NZ_CP072668,1,812271,814408,-,2137
91,NZ_CP072666,1,812284,814421,-,2137
91,NZ_CP090902,1,812436,814573,-,2137
91,NZ_CP090948,1,812436,814573,-,2137
91,NZ_CP069052,1,1207010,1209147,-,2137
91,NZ_CP076228,1,810336,812473,-,2137
91,NZ_CP042445,1,812424,814561,-,2137
91,NZ_CP042904,1,838448,840585,-,2137
91,NC_012416,1,874947,877084,-,2137
91,NZ_CP069053,1,656028,658165,-,2137
91,NZ_CP042446,1,812436,814573,-,2137
91,NZ_CP041215,1,1305913,1308050,-,2137
91,NZ_OX366353,1,306756,308893,-,2137
91,NZ_OX366387,1,1475855,1477992,-,2137
91,NZ_OX366368,1,1258347,1260484,-,2137
91,NZ_OX366379,1,1177864,1180001,-,2137
91,NZ_CP091195,1,118055,120192,+,2137
91,NZ_OX366375,1,1178270,1180407,-,2137
91,NZ_CP046925,1,812284,814421,-,2137
91,NZ_OX366318,1,1111880,1114017,-,2137
91,NZ_OX366319,1,82730,84867,-,2137
91,NZ_OX366332,1,1214444,1216581,-,2137
91,NZ_CP110359,1,301591,303728,-,2137
91,NZ_OU953855,1,834571,836708,-,2137
91,NZ_OX366272,1,1270089,1272226,-,2137
91,NZ_OX366347,1,121558,123696,+,2138
91,NZ_OU909470,1,1030013,1032000,+,1987
91,NZ_OX366363,1,809415,811552,-,2137
91,NZ_OX366364,1,244206,246185,-,1979
91,NZ_OX366359,1,1068396,1070533,+,2137
91,NZ_OX366349,1,1445705,1447704,-,1999
91,NZ_OX366380,1,210562,212549,+,1987
91,NZ_OX366344,1,1157529,1159528,-,1999
91,NZ_CP090900,1,812436,814573,-,2137
91,NZ_OX366352,1,240940,243077,+,2137
91,NZ_OX366362,1,348774,350740,+,1966
91,NZ_OX366400,1,975045,977182,-,2137
91,NZ_OX366327,1,1113782,1115919,-,2137
91,NZ_OX366367,1,1243895,1245883,+,1988
91,NZ_CP042444,1,812871,815008,-,2137
91,NZ_OX366326,1,1319524,1321661,-,2137
91,NZ_CP037426,1,944817,946954,+,2137
91,NZ_OX366339,1,1016044,1018181,-,2137
91,NZ_OX366355,1,86606,88743,-,2137
91,NZ_CP046922,1,874249,876386,-,2137
91,NZ_OX366370,1,19259,21250,+,1991
91,NZ_OX366385,1,1023523,1025503,-,1980
91,NZ_OX366399,1,1212492,1214629,-,2137
91,NZ_OX366395,1,1299188,1301326,+,2138
91,NZ_OX366396,1,740043,742180,+,2137
91,NZ_OX366351,1,1265949,1268086,-,2137
91,NZ_OX366381,1,194210,196347,-,2137
91,NZ_OX366342,1,425464,427463,-,1999
91,NZ_OX366369,1,1305332,1307469,-,2137
91,NZ_OX366356,1,1020336,1022473,-,2137
91,NZ_OX366377,1,1113102,1115239,+,2137
91,NZ_OX366388,1,297843,299980,-,2137
91,NZ_OX366357,1,684369,686506,-,2137
91,NZ_CP072012,1,1364935,1367072,+,2137
91,NZ_OX366398,1,292917,295054,-,2137
91,NC_002978,6,812436,814573,-,2137
91,NZ_OX366389,1,1186502,1188639,-,2137
91,NZ_OX366397,1,1462807,1464944,+,2137
91,NZ_OX366378,1,300231,302368,-,2137
91,NZ_CP090903,1,812436,814573,-,2137
91,NZ_OX366374,1,406412,408550,-,2138
91,NZ_CP090901,1,812436,814573,-,2137
91,NZ_CP046923,1,790497,792634,-,2137
91,NZ_CP069055,1,811575,813712,-,2137
91,NZ_CP072670,1,812276,814413,-,2137
91,NZ_CP090899,1,812436,814573,-,2137
91,NZ_CP046924,1,811435,813572,-,2137
91,NZ_OX366348,1,166358,168495,+,2137
91,NZ_CP046921,1,874249,876386,-,2137
91,NZ_OX366338,1,1294833,1296963,-,2130
91,NZ_CP054557,1,991313,993450,+,2137
91,NZ_CP072669,1,812284,814421,-,2137
91,NC_021089,1,864781,866918,-,2137
92,NZ_OX366376,1,303521,305210,+,1689
92,NZ_OX366393,1,1012333,1014022,+,1689
92,NZ_OX366372,1,1152886,1154575,-,1689
92,NZ_CP072672,1,809636,811328,-,1692
92,NZ_CP069060,1,653354,655046,-,1692
92,NZ_CP072667,1,809618,811310,-,1692
92,NZ_CP072671,1,809618,811310,-,1692
92,NZ_CP072668,1,809605,811297,-,1692
92,NZ_CP072666,1,809618,811310,-,1692
92,NZ_CP090902,1,809770,811462,-,1692
92,NZ_CP090948,1,809770,811462,-,1692
92,NZ_CP069052,1,1204344,1206036,-,1692
92,NZ_CP076228,1,745854,747546,-,1692
92,NZ_CP042445,1,809758,811450,-,1692
92,NZ_CP042904,1,835899,837584,-,1685
92,NC_012416,1,872398,874083,-,1685
92,NZ_CP069053,1,653362,655054,-,1692
92,NZ_CP042446,1,809770,811462,-,1692
92,NZ_CP041215,1,1344090,1345775,+,1685
92,NZ_OX366353,1,255173,256858,-,1685
92,NZ_OX366387,1,1473206,1474891,-,1685
92,NZ_OX366368,1,1255681,1257373,-,1692
92,NZ_OX366379,1,1175198,1176890,-,1692
92,NZ_CP091195,1,121054,122739,+,1685
92,NZ_OX366375,1,1175615,1177307,-,1692
92,NZ_CP046925,1,809618,811310,-,1692
92,NZ_OX366318,1,1109234,1110917,-,1683
92,NZ_OX366319,1,80093,81778,-,1685
92,NZ_OX366332,1,1252879,1254564,+,1685
92,NZ_CP110359,1,298936,300628,-,1692
92,NZ_OU953855,1,810478,812152,+,1674
92,NZ_OX366272,1,1267509,1269201,-,1692
92,NZ_OX366347,1,124741,126433,+,1692
92,NZ_OU909470,1,704886,706567,+,1681
92,NZ_OX366363,1,806746,808420,-,1674
92,NZ_OX366364,1,240306,241998,-,1692
92,NZ_OX366359,1,1030645,1032330,-,1685
92,NZ_OX366349,1,1442949,1444638,-,1689
92,NZ_OX366380,1,786727,788408,+,1681
92,NZ_OX366344,1,1154727,1156416,-,1689
92,NZ_CP090900,1,809770,811462,-,1692
92,NZ_OX366352,1,201671,203356,-,1685
92,NZ_OX366362,1,1409184,1410869,+,1685
92,NZ_OX366400,1,972399,974082,-,1683
92,NZ_OX366327,1,1111127,1112819,-,1692
92,NZ_OX366367,1,1247471,1249154,+,1683
92,NZ_CP042444,1,810205,811897,-,1692
92,NZ_OX366326,1,1316878,1318561,-,1683
92,NZ_CP037426,1,947917,949609,+,1692
92,NZ_OX366339,1,1013375,1015060,-,1685
92,NZ_OX366355,1,83969,85654,-,1685
92,NZ_CP046922,1,871583,873275,-,1692
92,NZ_OX366370,1,22146,23835,+,1689
92,NZ_OX366385,1,392369,394050,+,1681
92,NZ_OX366399,1,1209826,1211518,-,1692
92,NZ_OX366395,1,1302253,1303929,+,1676
92,NZ_OX366396,1,743047,744732,+,1685
92,NZ_OX366351,1,1263303,1264986,-,1683
92,NZ_OX366381,1,191573,193258,-,1685
92,NZ_OX366342,1,422881,424570,-,1689
92,NZ_OX366369,1,1302695,1304380,-,1685
92,NZ_OX366356,1,1017408,1019093,-,1685
92,NZ_OX366377,1,1116224,1117907,+,1683
92,NZ_OX366388,1,295209,296882,-,1673
92,NZ_OX366357,1,681906,683595,-,1689
92,NZ_CP072012,1,1368024,1369716,+,1692
92,NZ_OX366398,1,290249,291932,-,1683
92,NC_002978,6,809770,811462,-,1692
92,NZ_OX366389,1,1183834,1185517,-,1683
92,NZ_OX366397,1,1424976,1426661,-,1685
92,NZ_OX366378,1,297684,299369,-,1685
92,NZ_CP090903,1,809770,811462,-,1692
92,NZ_OX366374,1,401292,402984,-,1692
92,NZ_CP090901,1,809770,811462,-,1692
92,NZ_CP046923,1,787831,789523,-,1692
92,NZ_CP069055,1,808890,810582,-,1692
92,NZ_CP072670,1,809610,811302,-,1692
92,NZ_CP090899,1,809770,811462,-,1692
92,NZ_CP046924,1,808769,810461,-,1692
92,NZ_OX366348,1,169372,171050,+,1678
92,NZ_CP046921,1,871583,873275,-,1692
92,NZ_OX366338,1,1291340,1293025,-,1685
92,NZ_CP054557,1,994397,996075,+,1678
92,NZ_CP072669,1,809618,811310,-,1692
92,NC_021089,1,902529,904214,+,1685
93,NZ_OX366376,1,306390,307798,+,1408
93,NZ_OX366393,1,1015166,1016574,+,1408
93,NZ_OX366372,1,1150298,1151706,-,1408
93,NZ_CP072672,1,751015,752408,-,1393
93,NZ_CP069060,1,593957,595350,-,1393
93,NZ_CP072667,1,750997,752390,-,1393
93,NZ_CP072671,1,750997,752390,-,1393
93,NZ_CP072668,1,750984,752377,-,1393
93,NZ_CP072666,1,750997,752390,-,1393
93,NZ_CP090902,1,751149,752542,-,1393
93,NZ_CP090948,1,751149,752542,-,1393
93,NZ_CP069052,1,1144947,1146340,-,1393
93,NZ_CP076228,1,787310,788703,+,1393
93,NZ_CP042445,1,751137,752530,-,1393
93,NZ_CP042904,1,632514,633907,-,1393
93,NC_012416,1,668167,669560,-,1393
93,NZ_CP069053,1,593965,595358,-,1393
93,NZ_CP042446,1,751149,752542,-,1393
93,NZ_CP041215,1,928085,929478,+,1393
93,NZ_OX366353,1,173451,174844,-,1393
93,NZ_OX366387,1,701861,703254,+,1393
93,NZ_OX366368,1,1196859,1198252,-,1393
93,NZ_OX366379,1,1116374,1117767,-,1393
93,NZ_CP091195,1,1502813,1504206,+,1393
93,NZ_OX366375,1,1043130,1044523,-,1393
93,NZ_CP046925,1,750997,752390,-,1393
93,NZ_OX366318,1,1048316,1049709,-,1393
93,NZ_OX366319,1,169993,171386,+,1393
93,NZ_OX366332,1,1134447,1135840,-,1393
93,NZ_CP110359,1,454288,455681,+,1393
93,NZ_OU953855,1,218272,219665,+,1393
93,NZ_OX366272,1,1202021,1203414,-,1393
93,NZ_OX366347,1,182467,183860,-,1393
93,NZ_OU909470,1,707000,708402,+,1402
93,NZ_OX366363,1,1190772,1192165,+,1393
93,NZ_OX366364,1,533331,534716,-,1385
93,NZ_OX366359,1,962239,963632,-,1393
93,NZ_OX366349,1,1671615,1673023,+,1408
93,NZ_OX366380,1,775083,776476,-,1393
93,NZ_OX366344,1,1152147,1153555,-,1408
93,NZ_CP090900,1,751149,752542,-,1393
93,NZ_OX366352,1,1252326,1253719,+,1393
93,NZ_OX366362,1,1411444,1412830,+,1386
93,NZ_OX366400,1,911566,912959,-,1393
93,NZ_OX366327,1,1047955,1049348,-,1393
93,NZ_OX366367,1,1221011,1222396,-,1385
93,NZ_CP042444,1,751584,752977,-,1393
93,NZ_OX366326,1,1255799,1257192,-,1393
93,NZ_CP037426,1,840843,842236,-,1393
93,NZ_OX366339,1,864634,866027,-,1393
93,NZ_OX366355,1,194363,195756,+,1393
93,NZ_CP046922,1,812962,814355,-,1393
93,NZ_OX366370,1,1207344,1208752,+,1408
93,NZ_OX366385,1,15202,16595,+,1393
93,NZ_OX366399,1,1151002,1152395,-,1393
93,NZ_OX366395,1,1328374,1329767,+,1393
93,NZ_OX366396,1,1324040,1325433,-,1393
93,NZ_OX366351,1,1202224,1203617,-,1393
93,NZ_OX366381,1,280854,282247,+,1393
93,NZ_OX366342,1,420293,421701,-,1408
93,NZ_OX366369,1,1238312,1239705,-,1393
93,NZ_OX366356,1,955599,956992,-,1393
93,NZ_OX366377,1,1178412,1179805,+,1393
93,NZ_OX366388,1,232080,233473,-,1393
93,NZ_OX366357,1,1034983,1036376,-,1393
93,NZ_CP072012,1,1429319,1430712,+,1393
93,NZ_OX366398,1,229602,230995,-,1393
93,NC_002978,6,751149,752542,-,1393
93,NZ_OX366389,1,1124941,1126334,+,1393
93,NZ_OX366397,1,1355948,1357341,-,1393
93,NZ_OX366378,1,557232,558625,+,1393
93,NZ_CP090903,1,751149,752542,-,1393
93,NZ_OX366374,1,34494,35887,+,1393
93,NZ_CP090901,1,751149,752542,-,1393
93,NZ_CP046923,1,729210,730603,-,1393
93,NZ_CP069055,1,750478,751871,-,1393
93,NZ_CP072670,1,750989,752382,-,1393
93,NZ_CP090899,1,751149,752542,-,1393
93,NZ_CP046924,1,750148,751541,-,1393
93,NZ_OX366348,1,229507,230900,+,1393
93,NZ_CP046921,1,812962,814355,-,1393
93,NZ_OX366338,1,1239355,1240748,+,1393
93,NZ_CP054557,1,1056241,1057634,+,1393
93,NZ_CP072669,1,750997,752390,-,1393
93,NC_021089,1,784675,786068,-,1393
94,NZ_OX366376,1,307929,309928,+,1999
94,NZ_OX366393,1,1016705,1018704,+,1999
94,NZ_OX366372,1,1148168,1150167,-,1999
94,NZ_CP072672,1,748892,750889,-,1997
94,NZ_CP069060,1,591834,593831,-,1997
94,NZ_CP072667,1,748874,750871,-,1997
94,NZ_CP072671,1,748874,750871,-,1997
94,NZ_CP072668,1,748861,750858,-,1997
94,NZ_CP072666,1,748874,750871,-,1997
94,NZ_CP090902,1,749026,751023,-,1997
94,NZ_CP090948,1,749026,751023,-,1997
94,NZ_CP069052,1,1142824,1144821,-,1997
94,NZ_CP076228,1,788829,790826,+,1997
94,NZ_CP042445,1,749014,751011,-,1997
94,NZ_CP042904,1,630391,632388,-,1997
94,NC_012416,1,666044,668041,-,1997
94,NZ_CP069053,1,591842,593839,-,1997
94,NZ_CP042446,1,749026,751023,-,1997
94,NZ_CP041215,1,929604,931601,+,1997
94,NZ_OX366353,1,171328,173325,-,1997
94,NZ_OX366387,1,703380,705377,+,1997
94,NZ_OX366368,1,1194736,1196733,-,1997
94,NZ_OX366379,1,1114251,1116248,-,1997
94,NZ_CP091195,1,1504332,1506329,+,1997
94,NZ_OX366375,1,1041015,1043012,-,1997
94,NZ_CP046925,1,748874,750871,-,1997
94,NZ_OX366318,1,1046184,1048190,-,2006
94,NZ_OX366319,1,171504,173501,+,1997
94,NZ_OX366332,1,1132324,1134321,-,1997
94,NZ_CP110359,1,455807,457804,+,1997
94,NZ_OU953855,1,219791,221788,+,1997
94,NZ_OX366272,1,1199898,1201895,-,1997
94,NZ_OX366347,1,180335,182341,-,2006
94,NZ_OU909470,1,708533,710525,+,1992
94,NZ_OX366363,1,1192291,1194288,+,1997
94,NZ_OX366364,1,531116,533114,-,1998
94,NZ_OX366359,1,960116,962113,-,1997
94,NZ_OX366349,1,1673154,1675155,+,2001
94,NZ_OX366380,1,772951,774952,-,2001
94,NZ_OX366344,1,1150015,1152016,-,2001
94,NZ_CP090900,1,749026,751023,-,1997
94,NZ_OX366352,1,1253845,1255842,+,1997
94,NZ_OX366362,1,521467,523464,+,1997
94,NZ_OX366400,1,909434,911440,-,2006
94,NZ_OX366327,1,1045823,1047824,-,2001
94,NZ_OX366367,1,1218796,1220794,-,1998
94,NZ_CP042444,1,749461,751458,-,1997
94,NZ_OX366326,1,1253667,1255673,-,2006
94,NZ_CP037426,1,838728,840725,-,1997
94,NZ_OX366339,1,862511,864508,-,1997
94,NZ_OX366355,1,195874,197871,+,1997
94,NZ_CP046922,1,810839,812836,-,1997
94,NZ_OX366370,1,1208883,1210884,+,2001
94,NZ_OX366385,1,16726,18727,+,2001
94,NZ_OX366399,1,1148879,1150876,-,1997
94,NZ_OX366395,1,1329893,1331899,+,2006
94,NZ_OX366396,1,1321917,1323914,-,1997
94,NZ_OX366351,1,1200092,1202098,-,2006
94,NZ_OX366381,1,282365,284362,+,1997
94,NZ_OX366342,1,418163,420162,-,1999
94,NZ_OX366369,1,1236197,1238194,-,1997
94,NZ_OX366356,1,953484,955481,-,1997
94,NZ_OX366377,1,1179931,1181928,+,1997
94,NZ_OX366388,1,229957,231954,-,1997
94,NZ_OX366357,1,1032851,1034857,-,2006
94,NZ_CP072012,1,1430838,1432835,+,1997
94,NZ_OX366398,1,227479,229476,-,1997
94,NC_002978,6,749026,751023,-,1997
94,NZ_OX366389,1,1126460,1128457,+,1997
94,NZ_OX366397,1,1353825,1355822,-,1997
94,NZ_OX366378,1,558751,560748,+,1997
94,NZ_CP090903,1,749026,751023,-,1997
94,NZ_OX366374,1,36013,38010,+,1997
94,NZ_CP090901,1,749026,751023,-,1997
94,NZ_CP046923,1,727087,729084,-,1997
94,NZ_CP069055,1,748355,750352,-,1997
94,NZ_CP072670,1,748866,750863,-,1997
94,NZ_CP090899,1,749026,751023,-,1997
94,NZ_CP046924,1,748025,750022,-,1997
94,NZ_OX366348,1,231026,233023,+,1997
94,NZ_CP046921,1,810839,812836,-,1997
94,NZ_OX366338,1,1240874,1242871,+,1997
94,NZ_CP054557,1,1057760,1059757,+,1997
94,NZ_CP072669,1,748874,750871,-,1997
94,NC_021089,1,782552,784549,-,1997
95,NZ_OX366376,1,311957,316259,+,4302
95,NZ_OX366393,1,1020747,1025049,+,4302
95,NZ_OX366372,1,1141810,1146113,-,4303
95,NZ_CP072672,1,744601,748765,-,4164
95,NZ_CP069060,1,587543,591707,-,4164
95,NZ_CP072667,1,744583,748747,-,4164
95,NZ_CP072671,1,744583,748747,-,4164
95,NZ_CP072668,1,744570,748734,-,4164
95,NZ_CP072666,1,744583,748747,-,4164
95,NZ_CP090902,1,744735,748899,-,4164
95,NZ_CP090948,1,744735,748899,-,4164
95,NZ_CP069052,1,1138533,1142697,-,4164
95,NZ_CP076228,1,790953,795116,+,4163
95,NZ_CP042445,1,744723,748887,-,4164
95,NZ_CP042904,1,626018,630264,-,4246
95,NC_012416,1,661671,665917,-,4246
95,NZ_CP069053,1,587551,591715,-,4164
95,NZ_CP042446,1,744735,748899,-,4164
95,NZ_CP041215,1,931728,935891,+,4163
95,NZ_OX366353,1,167037,171201,-,4164
95,NZ_OX366387,1,705504,709667,+,4163
95,NZ_OX366368,1,1190445,1194609,-,4164
95,NZ_OX366379,1,1109960,1114124,-,4164
95,NZ_CP091195,1,1506456,1510610,+,4154
95,NZ_OX366375,1,1036724,1040888,-,4164
95,NZ_CP046925,1,744583,748747,-,4164
95,NZ_OX366318,1,1041902,1046057,-,4155
95,NZ_OX366319,1,173628,177782,+,4154
95,NZ_OX366332,1,1128033,1132197,-,4164
95,NZ_CP110359,1,457931,462094,+,4163
95,NZ_OU953855,1,221915,226078,+,4163
95,NZ_OX366272,1,1368679,1372843,-,4164
95,NZ_OX366347,1,176044,180208,-,4164
95,NZ_OU909470,1,710720,714962,+,4242
95,NZ_OX366363,1,1194415,1198578,+,4163
95,NZ_OX366364,1,364653,368941,+,4288
95,NZ_OX366359,1,955834,959989,-,4155
95,NZ_OX366349,1,122038,126339,+,4301
95,NZ_OX366380,1,768512,772755,-,4243
95,NZ_OX366344,1,1144697,1149000,-,4303
95,NZ_CP090900,1,744735,748899,-,4164
95,NZ_OX366352,1,1255969,1260132,+,4163
95,NZ_OX366362,1,923529,928115,-,4586
95,NZ_OX366400,1,905152,909307,-,4155
95,NZ_OX366327,1,1041541,1045696,-,4155
95,NZ_OX366367,1,1048623,1052911,+,4288
95,NZ_CP042444,1,745170,749334,-,4164
95,NZ_OX366326,1,1249385,1253540,-,4155
95,NZ_CP037426,1,834437,838601,-,4164
95,NZ_OX366339,1,858220,862384,-,4164
95,NZ_OX366355,1,197998,202152,+,4154
95,NZ_CP046922,1,806548,810712,-,4164
95,NZ_OX366370,1,1211906,1216193,+,4287
95,NZ_OX366385,1,19776,24018,+,4242
95,NZ_OX366399,1,1144588,1148752,-,4164
95,NZ_OX366395,1,1332621,1336859,+,4238
95,NZ_OX366396,1,1317626,1321790,-,4164
95,NZ_OX366351,1,1195810,1199965,-,4155
95,NZ_OX366381,1,284489,288643,+,4154
95,NZ_OX366342,1,411817,416120,-,4303
95,NZ_OX366369,1,1231915,1236070,-,4155
95,NZ_OX366356,1,949193,953357,-,4164
95,NZ_OX366377,1,1182055,1186209,+,4154
95,NZ_OX366388,1,225675,229830,-,4155
95,NZ_OX366357,1,1028168,1032407,-,4239
95,NZ_CP072012,1,1432962,1437125,+,4163
95,NZ_OX366398,1,223197,227352,-,4155
95,NC_002978,6,744735,748899,-,4164
95,NZ_OX366389,1,1128584,1132738,+,4154
95,NZ_OX366397,1,1349534,1353698,-,4164
95,NZ_OX366378,1,560875,565029,+,4154
95,NZ_CP090903,1,744735,748899,-,4164
95,NZ_OX366374,1,38519,42757,+,4238
95,NZ_CP090901,1,744735,748899,-,4164
95,NZ_CP046923,1,722796,726960,-,4164
95,NZ_CP069055,1,744064,748228,-,4164
95,NZ_CP072670,1,744575,748739,-,4164
95,NZ_CP090899,1,744735,748899,-,4164
95,NZ_CP046924,1,743734,747898,-,4164
95,NZ_OX366348,1,233150,237388,+,4238
95,NZ_CP046921,1,806548,810712,-,4164
95,NZ_OX366338,1,1208858,1213226,-,4368
95,NZ_CP054557,1,1059884,1064122,+,4238
95,NZ_CP072669,1,744583,748747,-,4164
95,NC_021089,1,778270,782425,-,4155
96,NZ_OX366376,1,316732,318646,+,1914
96,NZ_OX366393,1,1025522,1027436,+,1914
96,NZ_OX366372,1,1139424,1141338,-,1914
96,NZ_CP072672,1,742146,744091,-,1945
96,NZ_CP069060,1,585087,587032,-,1945
96,NZ_CP072667,1,742128,744073,-,1945
96,NZ_CP072671,1,742128,744073,-,1945
96,NZ_CP072668,1,742115,744060,-,1945
96,NZ_CP072666,1,742128,744073,-,1945
96,NZ_CP090902,1,742280,744225,-,1945
96,NZ_CP090948,1,742280,744225,-,1945
96,NZ_CP069052,1,1136077,1138022,-,1945
96,NZ_CP076228,1,795627,797571,+,1944
96,NZ_CP042445,1,742268,744213,-,1945
96,NZ_CP042904,1,622089,624034,-,1945
96,NC_012416,1,657744,659689,-,1945
96,NZ_CP069053,1,585095,587040,-,1945
96,NZ_CP042446,1,742280,744225,-,1945
96,NZ_CP041215,1,936507,938451,+,1944
96,NZ_OX366353,1,164478,166423,-,1945
96,NZ_OX366387,1,710178,712122,+,1944
96,NZ_OX366368,1,1187990,1189935,-,1945
96,NZ_OX366379,1,1107505,1109450,-,1945
96,NZ_CP091195,1,1511121,1513065,+,1944
96,NZ_OX366375,1,1034269,1036214,-,1945
96,NZ_CP046925,1,742128,744073,-,1945
96,NZ_OX366318,1,1039447,1041392,-,1945
96,NZ_OX366319,1,178293,180237,+,1944
96,NZ_OX366332,1,1125473,1127418,-,1945
96,NZ_CP110359,1,462604,464548,+,1944
96,NZ_OU953855,1,226590,228534,+,1944
96,NZ_OX366272,1,1365272,1367217,-,1945
96,NZ_OX366347,1,173589,175534,-,1945
96,NZ_OU909470,1,715427,717311,+,1884
96,NZ_OX366363,1,1199090,1201034,+,1944
96,NZ_OX366364,1,369762,371658,+,1896
96,NZ_OX366359,1,953274,955219,-,1945
96,NZ_OX366349,1,126812,128736,+,1924
96,NZ_OX366380,1,766153,768049,-,1896
96,NZ_OX366344,1,1142311,1144225,-,1914
96,NZ_CP090900,1,742280,744225,-,1945
96,NZ_OX366352,1,1260748,1262692,+,1944
96,NZ_OX366362,1,920620,922561,-,1941
96,NZ_OX366400,1,902697,904642,-,1945
96,NZ_OX366327,1,1039086,1041031,-,1945
96,NZ_OX366367,1,1053499,1055403,+,1904
96,NZ_CP042444,1,742715,744660,-,1945
96,NZ_OX366326,1,1246930,1248875,-,1945
96,NZ_CP037426,1,831982,833927,-,1945
96,NZ_OX366339,1,855765,857710,-,1945
96,NZ_OX366355,1,202663,204607,+,1944
96,NZ_CP046922,1,804093,806038,-,1945
96,NZ_OX366370,1,1216666,1218561,+,1895
96,NZ_OX366385,1,25335,27231,+,1896
96,NZ_OX366399,1,1142133,1144078,-,1945
96,NZ_OX366395,1,1337371,1339315,+,1944
96,NZ_OX366396,1,1315171,1317116,-,1945
96,NZ_OX366351,1,1193355,1195300,-,1945
96,NZ_OX366381,1,289154,291098,+,1944
96,NZ_OX366342,1,409432,411346,-,1914
96,NZ_OX366369,1,1229460,1231405,-,1945
96,NZ_OX366356,1,946715,948683,-,1968
96,NZ_OX366377,1,1186720,1188664,+,1944
96,NZ_OX366388,1,223220,225165,-,1945
96,NZ_OX366357,1,1025714,1027640,-,1926
96,NZ_CP072012,1,1437636,1439580,+,1944
96,NZ_OX366398,1,220742,222687,-,1945
96,NC_002978,6,742280,744225,-,1945
96,NZ_OX366389,1,1133249,1135193,+,1944
96,NZ_OX366397,1,1346974,1348919,-,1945
96,NZ_OX366378,1,565540,567484,+,1944
96,NZ_CP090903,1,742280,744225,-,1945
96,NZ_OX366374,1,44120,46064,+,1944
96,NZ_CP090901,1,742280,744225,-,1945
96,NZ_CP046923,1,720341,722286,-,1945
96,NZ_CP069055,1,741610,743555,-,1945
96,NZ_CP072670,1,742120,744065,-,1945
96,NZ_CP090899,1,742280,744225,-,1945
96,NZ_CP046924,1,741279,743224,-,1945
96,NZ_OX366348,1,237899,239843,+,1944
96,NZ_CP046921,1,804093,806038,-,1945
96,NZ_OX366338,1,1205606,1207495,-,1889
96,NZ_CP054557,1,1064633,1066577,+,1944
96,NZ_CP072669,1,742128,744073,-,1945
96,NC_021089,1,775711,777656,-,1945
97,NZ_OX366376,1,319001,320050,+,1049
97,NZ_OX366393,1,1027791,1028840,+,1049
97,NZ_OX366372,1,1138020,1139069,-,1049
97,NZ_CP072672,1,676934,677966,+,1032
97,NZ_CP069060,1,518881,519913,+,1032
97,NZ_CP072667,1,676916,677948,+,1032
97,NZ_CP072671,1,676916,677948,+,1032
97,NZ_CP072668,1,676903,677935,+,1032
97,NZ_CP072666,1,676916,677948,+,1032
97,NZ_CP090902,1,677068,678100,+,1032
97,NZ_CP090948,1,677068,678100,+,1032
97,NZ_CP069052,1,1068032,1069064,+,1032
97,NZ_CP076228,1,670583,671615,+,1032
97,NZ_CP042445,1,677056,678088,+,1032
97,NZ_CP042904,1,742066,743097,-,1031
97,NC_012416,1,695219,696251,+,1032
97,NZ_CP069053,1,518889,519921,+,1032
97,NZ_CP042446,1,677068,678100,+,1032
97,NZ_CP041215,1,732723,733754,-,1031
97,NZ_OX366353,1,1151272,1152303,-,1031
97,NZ_OX366387,1,721519,722551,+,1032
97,NZ_OX366368,1,1042599,1043631,+,1032
97,NZ_OX366379,1,1041133,1042165,+,1032
97,NZ_CP091195,1,669936,670937,+,1001
97,NZ_OX366375,1,965363,966395,+,1032
97,NZ_CP046925,1,676916,677948,+,1032
97,NZ_OX366318,1,970224,971226,+,1002
97,NZ_OX366319,1,244670,245701,-,1031
97,NZ_OX366332,1,1057739,1058771,+,1032
97,NZ_CP110359,1,529241,530272,-,1031
97,NZ_OU953855,1,920651,921683,+,1032
97,NZ_OX366272,1,1041390,1042421,-,1031
97,NZ_OX366347,1,839605,840636,-,1031
97,NZ_OU909470,1,717323,718349,+,1026
97,NZ_OX366363,1,1266469,1267500,-,1031
97,NZ_OX366364,1,371670,372696,+,1026
97,NZ_OX366359,1,888367,889399,+,1032
97,NZ_OX366349,1,129122,130138,+,1016
97,NZ_OX366380,1,765115,766141,-,1026
97,NZ_OX366344,1,1141058,1142107,-,1049
97,NZ_CP090900,1,677068,678100,+,1032
97,NZ_OX366352,1,1158745,1159777,+,1032
97,NZ_OX366362,1,919232,920252,-,1020
97,NZ_OX366400,1,836203,837205,+,1002
97,NZ_OX366327,1,973759,974808,+,1049
97,NZ_OX366367,1,1055407,1056441,+,1034
97,NZ_CP042444,1,677605,678637,+,1032
97,NZ_OX366326,1,1100759,1101763,+,1004
97,NZ_CP037426,1,84410,85441,-,1031
97,NZ_OX366339,1,762417,763449,+,1032
97,NZ_OX366355,1,269764,270795,-,1031
97,NZ_CP046922,1,738782,739814,+,1032
97,NZ_OX366370,1,1218574,1219600,+,1026
97,NZ_OX366385,1,27243,28269,+,1026
97,NZ_OX366399,1,1075866,1076898,+,1032
97,NZ_OX366395,1,619982,621014,+,1032
97,NZ_OX366396,1,604540,605571,-,1031
97,NZ_OX366351,1,1048659,1049663,+,1004
97,NZ_OX366381,1,355531,356562,-,1031
97,NZ_OX366342,1,408028,409077,-,1049
97,NZ_OX366369,1,1162903,1163935,+,1032
97,NZ_OX366356,1,879837,880869,+,1032
97,NZ_OX366377,1,1254164,1255195,-,1031
97,NZ_OX366388,1,330511,331542,-,1031
97,NZ_OX366357,1,889723,890754,-,1031
97,NZ_CP072012,1,45376,46407,-,1031
97,NZ_OX366398,1,741170,742201,-,1031
97,NC_002978,6,677068,678100,+,1032
97,NZ_OX366389,1,805009,806040,-,1031
97,NZ_OX366397,1,1208905,1209937,+,1032
97,NZ_OX366378,1,1230380,1231381,+,1001
97,NZ_CP090903,1,677068,678100,+,1032
97,NZ_OX366374,1,718217,719249,+,1032
97,NZ_CP090901,1,677068,678100,+,1032
97,NZ_CP046923,1,655030,656062,+,1032
97,NZ_CP069055,1,676565,677597,+,1032
97,NZ_CP072670,1,676908,677940,+,1032
97,NZ_CP090899,1,677068,678100,+,1032
97,NZ_CP046924,1,675968,677000,+,1032
97,NZ_OX366348,1,304403,305434,-,1031
97,NZ_CP046921,1,738782,739814,+,1032
97,NZ_OX366338,1,1020300,1021331,-,1031
97,NZ_CP054557,1,376365,377397,+,1032
97,NZ_CP072669,1,676916,677948,+,1032
97,NC_021089,1,708526,709558,+,1032
98,NZ_OX366376,1,322405,324355,+,1950
98,NZ_OX366393,1,950883,952833,+,1950
98,NZ_OX366372,1,1133735,1135685,-,1950
98,NZ_CP072672,1,711641,713600,-,1959
98,NZ_CP069060,1,553095,555054,-,1959
98,NZ_CP072667,1,711623,713582,-,1959
98,NZ_CP072671,1,711623,713582,-,1959
98,NZ_CP072668,1,711610,713569,-,1959
98,NZ_CP072666,1,711623,713582,-,1959
98,NZ_CP090902,1,711775,713734,-,1959
98,NZ_CP090948,1,711775,713734,-,1959
98,NZ_CP069052,1,1104084,1106043,-,1959
98,NZ_CP076228,1,705634,707593,-,1959
98,NZ_CP042445,1,711763,713722,-,1959
98,NZ_CP042904,1,763098,765062,+,1964
98,NC_012416,1,797971,799935,+,1964
98,NZ_CP069053,1,553103,555062,-,1959
98,NZ_CP042446,1,711775,713734,-,1959
98,NZ_CP041215,1,968128,970087,+,1959
98,NZ_OX366353,1,829883,831842,+,1959
98,NZ_OX366387,1,967158,969126,-,1968
98,NZ_OX366368,1,1155118,1157077,-,1959
98,NZ_OX366379,1,1076503,1078462,-,1959
98,NZ_CP091195,1,1541651,1543612,+,1961
98,NZ_OX366375,1,1001866,1003825,-,1959
98,NZ_CP046925,1,711623,713582,-,1959
98,NZ_OX366318,1,1006893,1008852,-,1959
98,NZ_OX366319,1,209037,210996,+,1959
98,NZ_OX366332,1,1094230,1096189,-,1959
98,NZ_CP110359,1,493904,495863,+,1959
98,NZ_OU953855,1,619090,621052,-,1962
98,NZ_OX366272,1,409147,411106,-,1959
98,NZ_OX366347,1,750092,752044,+,1952
98,NZ_OU909470,1,701358,703304,-,1946
98,NZ_OX366363,1,1231124,1233083,+,1959
98,NZ_OX366364,1,309058,311009,+,1951
98,NZ_OX366359,1,923326,925285,-,1959
98,NZ_OX366349,1,397256,399211,-,1955
98,NZ_OX366380,1,719368,721320,+,1952
98,NZ_OX366344,1,1253135,1255087,-,1952
98,NZ_CP090900,1,711775,713734,-,1959
98,NZ_OX366352,1,1291241,1293200,+,1959
98,NZ_OX366362,1,914920,916879,-,1959
98,NZ_OX366400,1,869289,871248,-,1959
98,NZ_OX366327,1,1008390,1010349,-,1959
98,NZ_OX366367,1,924535,926484,+,1949
98,NZ_CP042444,1,712312,714271,-,1959
98,NZ_OX366326,1,1213525,1215484,-,1959
98,NZ_CP037426,1,748636,750595,-,1959
98,NZ_OX366339,1,969066,971025,-,1959
98,NZ_OX366355,1,233153,235112,+,1959
98,NZ_CP046922,1,773489,775448,-,1959
98,NZ_OX366370,1,1221387,1223339,+,1952
98,NZ_OX366385,1,389497,391449,-,1952
98,NZ_OX366399,1,1111131,1113090,-,1959
98,NZ_OX366395,1,1367921,1369880,+,1959
98,NZ_OX366396,1,447744,449703,+,1959
98,NZ_OX366351,1,1160774,1162733,-,1959
98,NZ_OX366381,1,319898,321857,+,1959
98,NZ_OX366342,1,403851,405801,-,1950
98,NZ_OX366369,1,1197714,1199673,-,1959
98,NZ_OX366356,1,915348,917307,-,1959
98,NZ_OX366377,1,1218924,1220883,+,1959
98,NZ_OX366388,1,139642,141601,+,1959
98,NZ_OX366357,1,292423,294384,-,1961
98,NZ_CP072012,1,1468792,1470751,+,1959
98,NZ_OX366398,1,703366,705325,+,1959
98,NC_002978,6,711775,713734,-,1959
98,NZ_OX366389,1,1080250,1082209,-,1959
98,NZ_OX366397,1,1315343,1317302,-,1959
98,NZ_OX366378,1,595971,597932,+,1961
98,NZ_CP090903,1,711775,713734,-,1959
98,NZ_OX366374,1,637279,639225,+,1946
98,NZ_CP090901,1,711775,713734,-,1959
98,NZ_CP046923,1,689737,691696,-,1959
98,NZ_CP069055,1,710829,712788,-,1959
98,NZ_CP072670,1,711615,713574,-,1959
98,NZ_CP090899,1,711775,713734,-,1959
98,NZ_CP046924,1,710675,712634,-,1959
98,NZ_OX366348,1,269324,271283,+,1959
98,NZ_CP046921,1,773489,775448,-,1959
98,NZ_OX366338,1,979733,981692,-,1959
98,NZ_CP054557,1,1096391,1098350,+,1959
98,NZ_CP072669,1,711623,713582,-,1959
98,NC_021089,1,744765,746724,-,1959
99,NZ_OX366376,1,327443,328397,+,954
99,NZ_OX366393,1,5419,6373,+,954
99,NZ_OX366372,1,435743,436697,+,954
99,NZ_CP072672,1,1152519,1153528,-,1009
99,NZ_CP069060,1,972789,973798,+,1009
99,NZ_CP072667,1,1152493,1153502,-,1009
99,NZ_CP072671,1,1152501,1153510,-,1009
99,NZ_CP072668,1,1152488,1153497,-,1009
99,NZ_CP072666,1,1152501,1153510,-,1009
99,NZ_CP090902,1,1152653,1153662,-,1009
99,NZ_CP090948,1,1152651,1153660,-,1009
99,NZ_CP069052,1,1023716,1024725,-,1009
99,NZ_CP076228,1,1140903,1141912,+,1009
99,NZ_CP042445,1,1152641,1153650,-,1009
99,NZ_CP042904,1,1229618,1230627,-,1009
99,NC_012416,1,1274834,1275843,-,1009
99,NZ_CP069053,1,972821,973830,+,1009
99,NZ_CP042446,1,1152651,1153660,-,1009
99,NZ_CP041215,1,176449,177458,-,1009
99,NZ_OX366353,1,659330,660339,+,1009
99,NZ_OX366387,1,192094,193059,-,965
99,NZ_OX366368,1,165697,166706,-,1009
99,NZ_OX366379,1,165795,166804,-,1009
99,NZ_CP091195,1,1207377,1208386,-,1009
99,NZ_OX366375,1,167787,168763,-,976
99,NZ_CP046925,1,1152501,1153510,-,1009
99,NZ_OX366318,1,161825,162834,-,1009
99,NZ_OX366319,1,1035419,1036395,+,976
99,NZ_OX366332,1,164037,165046,-,1009
99,NZ_CP110359,1,1190190,1191199,-,1009
99,NZ_OU953855,1,1715920,1716898,-,978
99,NZ_OX366272,1,262959,263968,-,1009
99,NZ_OX366347,1,276436,277445,-,1009
99,NZ_OU909470,1,972859,973813,-,954
99,NZ_OX366363,1,774142,775098,+,956
99,NZ_OX366364,1,228185,229194,-,1009
99,NZ_OX366359,1,163163,164172,-,1009
99,NZ_OX366349,1,320991,321945,-,954
99,NZ_OX366380,1,157393,158347,-,954
99,NZ_OX366344,1,979385,980339,-,954
99,NZ_CP090900,1,1152654,1153663,-,1009
99,NZ_OX366352,1,1526360,1527369,+,1009
99,NZ_OX366362,1,132594,133603,+,1009
99,NZ_OX366400,1,164944,165953,-,1009
99,NZ_OX366327,1,162291,163253,-,962
99,NZ_OX366367,1,1403789,1404798,-,1009
99,NZ_CP042444,1,1154007,1155016,-,1009
99,NZ_OX366326,1,165547,166556,-,1009
99,NZ_CP037426,1,978137,979113,+,976
99,NZ_OX366339,1,1188746,1189755,-,1009
99,NZ_OX366355,1,1152194,1153170,+,976
99,NZ_CP046922,1,1214456,1215465,-,1009
99,NZ_OX366370,1,1142914,1143868,+,954
99,NZ_OX366385,1,977625,978579,-,954
99,NZ_OX366399,1,165198,166207,-,1009
99,NZ_OX366395,1,306442,307397,-,955
99,NZ_OX366396,1,38817,39826,-,1009
99,NZ_OX366351,1,242908,243917,+,1009
99,NZ_OX366381,1,1219075,1220051,+,976
99,NZ_OX366342,1,330472,331426,+,954
99,NZ_OX366369,1,161249,162225,-,976
99,NZ_OX366356,1,197000,197965,-,965
99,NZ_OX366377,1,167476,168441,-,965
99,NZ_OX366388,1,1609195,1610204,-,1009
99,NZ_OX366357,1,393115,394124,-,1009
99,NZ_CP072012,1,1150241,1151250,+,1009
99,NZ_OX366398,1,814266,815231,-,965
99,NC_002978,6,1152651,1153660,-,1009
99,NZ_OX366389,1,84231,85195,+,964
99,NZ_OX366397,1,163735,164744,-,1009
99,NZ_OX366378,1,1149958,1150967,+,1009
99,NZ_CP090903,1,1152654,1153663,-,1009
99,NZ_OX366374,1,106771,107780,-,1009
99,NZ_CP090901,1,1152654,1153663,-,1009
99,NZ_CP046923,1,1130704,1131713,-,1009
99,NZ_CP069055,1,1152609,1153618,-,1009
99,NZ_CP072670,1,1152481,1153490,-,1009
99,NZ_CP090899,1,1152654,1153663,-,1009
99,NZ_CP046924,1,1151642,1152651,-,1009
99,NZ_OX366348,1,1087303,1088312,+,1009
99,NZ_CP046921,1,1214456,1215465,-,1009
99,NZ_OX366338,1,235502,236511,-,1009
99,NZ_CP054557,1,655157,656166,+,1009
99,NZ_CP072669,1,1152501,1153510,-,1009
99,NC_021089,1,1180270,1181279,-,1009
100,NZ_OX366376,1,328409,333472,+,5063
100,NZ_OX366393,1,6385,11448,+,5063
100,NZ_OX366372,1,436709,441772,+,5063
100,NZ_CP072672,1,1147066,1152168,-,5102
100,NZ_CP069060,1,974149,979251,+,5102
100,NZ_CP072667,1,1147040,1152142,-,5102
100,NZ_CP072671,1,1147048,1152150,-,5102
100,NZ_CP072668,1,1147035,1152137,-,5102
100,NZ_CP072666,1,1147048,1152150,-,5102
100,NZ_CP090902,1,1147200,1152302,-,5102
100,NZ_CP090948,1,1147198,1152300,-,5102
100,NZ_CP069052,1,1018263,1023365,-,5102
100,NZ_CP076228,1,1142263,1147365,+,5102
100,NZ_CP042445,1,1147188,1152290,-,5102
100,NZ_CP042904,1,1224174,1229267,-,5093
100,NC_012416,1,1269390,1274483,-,5093
100,NZ_CP069053,1,974181,979283,+,5102
100,NZ_CP042446,1,1147198,1152300,-,5102
100,NZ_CP041215,1,170670,175763,-,5093
100,NZ_OX366353,1,661023,666116,+,5093
100,NZ_OX366387,1,187030,192093,-,5063
100,NZ_OX366368,1,160244,165346,-,5102
100,NZ_OX366379,1,160342,165444,-,5102
100,NZ_CP091195,1,1201605,1206691,-,5086
100,NZ_OX366375,1,162531,167603,-,5072
100,NZ_CP046925,1,1147048,1152150,-,5102
100,NZ_OX366318,1,154972,160049,-,5077
100,NZ_OX366319,1,1036558,1041642,+,5084
100,NZ_OX366332,1,158258,163351,-,5093
100,NZ_CP110359,1,144348,149441,-,5093
100,NZ_OU953855,1,540431,545507,-,5076
100,NZ_OX366272,1,114195,119288,-,5093
100,NZ_OX366347,1,269530,274623,-,5093
100,NZ_OU909470,1,967800,972847,-,5047
100,NZ_OX366363,1,775100,780164,+,5064
100,NZ_OX366364,1,222368,227443,-,5075
100,NZ_OX366359,1,157384,162477,-,5093
100,NZ_OX366349,1,315916,320979,-,5063
100,NZ_OX366380,1,152325,157381,-,5056
100,NZ_OX366344,1,974310,979373,-,5063
100,NZ_CP090900,1,1147201,1152303,-,5102
100,NZ_OX366352,1,1528055,1533148,+,5093
100,NZ_OX366362,1,133906,138983,+,5077
100,NZ_OX366400,1,10907,15985,+,5078
100,NZ_OX366327,1,157227,162290,-,5063
100,NZ_OX366367,1,1398369,1403444,-,5075
100,NZ_CP042444,1,1148554,1153656,-,5102
100,NZ_OX366326,1,158694,163771,-,5077
100,NZ_CP037426,1,979297,984369,+,5072
100,NZ_OX366339,1,1180308,1185401,-,5093
100,NZ_OX366355,1,1153333,1158417,+,5084
100,NZ_CP046922,1,1209003,1214105,-,5102
100,NZ_OX366370,1,1143880,1148951,+,5071
100,NZ_OX366385,1,972557,977613,-,5056
100,NZ_OX366399,1,159745,164847,-,5102
100,NZ_OX366395,1,299752,304854,-,5102
100,NZ_OX366396,1,32283,37376,-,5093
100,NZ_OX366351,1,245692,250770,+,5078
100,NZ_OX366381,1,1220214,1225298,+,5084
100,NZ_OX366342,1,331438,336498,+,5060
100,NZ_OX366369,1,156002,161086,-,5084
100,NZ_OX366356,1,191936,196999,-,5063
100,NZ_OX366377,1,162403,167475,-,5072
100,NZ_OX366388,1,1602324,1607410,-,5086
100,NZ_OX366357,1,387671,392773,-,5102
100,NZ_CP072012,1,1151601,1156703,+,5102
100,NZ_OX366398,1,809193,814265,-,5072
100,NC_002978,6,1147198,1152300,-,5102
100,NZ_OX366389,1,85197,90269,+,5072
100,NZ_OX366397,1,157956,163049,-,5093
100,NZ_OX366378,1,1151653,1156739,+,5086
100,NZ_CP090903,1,1147201,1152303,-,5102
100,NZ_OX366374,1,101345,106420,-,5075
100,NZ_CP090901,1,1147201,1152303,-,5102
100,NZ_CP046923,1,1125251,1130353,-,5102
100,NZ_CP069055,1,1147156,1152258,-,5102
100,NZ_CP072670,1,1147028,1152130,-,5102
100,NZ_CP090899,1,1147201,1152303,-,5102
100,NZ_CP046924,1,1146189,1151291,-,5102
100,NZ_OX366348,1,1088663,1093765,+,5102
100,NZ_CP046921,1,1209003,1214105,-,5102
100,NZ_OX366338,1,229353,234455,-,5102
100,NZ_CP054557,1,657615,662690,+,5075
100,NZ_CP072669,1,1147048,1152150,-,5102
100,NC_021089,1,1174491,1179584,-,5093
101,NZ_OX366376,1,334298,335164,+,866
101,NZ_OX366393,1,12274,13138,+,864
101,NZ_OX366372,1,442598,443463,+,865
101,NZ_OX366349,1,314226,315088,-,862
101,NZ_OX366342,1,337324,338189,+,865
102,NZ_OX366376,1,337520,338322,+,802
102,NZ_OX366393,1,15409,16211,+,802
102,NZ_OX366372,1,445819,446621,+,802
102,NZ_CP072672,1,116467,117272,-,805
102,NZ_CP069060,1,126715,127520,-,805
102,NZ_CP072667,1,116449,117254,-,805
102,NZ_CP072671,1,116449,117254,-,805
102,NZ_CP072668,1,116449,117254,-,805
102,NZ_CP072666,1,116449,117254,-,805
102,NZ_CP090902,1,116601,117406,-,805
102,NZ_CP090948,1,116601,117406,-,805
102,NZ_CP069052,1,112611,113416,+,805
102,NZ_CP076228,1,120231,121036,-,805
102,NZ_CP042445,1,116601,117406,-,805
102,NZ_CP042904,1,123743,124540,+,797
102,NC_012416,1,126325,127122,+,797
102,NZ_CP069053,1,419757,420562,+,805
102,NZ_CP042446,1,116601,117406,-,805
102,NZ_CP041215,1,394725,395522,-,797
102,NZ_OX366353,1,540089,540886,-,797
102,NZ_OX366387,1,642988,643785,+,797
102,NZ_OX366368,1,396299,397104,-,805
102,NZ_OX366379,1,397317,398122,-,805
102,NZ_CP091195,1,702841,703638,-,797
102,NZ_OX366375,1,360314,361111,-,797
102,NZ_CP046925,1,116449,117254,-,805
102,NZ_OX366318,1,505056,505861,+,805
102,NZ_OX366319,1,758169,758966,-,797
102,NZ_OX366332,1,401509,402306,+,797
102,NZ_CP110359,1,1114899,1115703,-,804
102,NZ_OU953855,1,1026956,1027760,-,804
102,NZ_OX366272,1,568068,568872,+,804
102,NZ_OX366347,1,518722,519526,+,804
102,NZ_OU909470,1,473971,474773,-,802
102,NZ_OX366363,1,516080,516877,+,797
102,NZ_OX366364,1,1031870,1032673,+,803
102,NZ_OX366359,1,378859,379656,-,797
102,NZ_OX366349,1,311114,311916,-,802
102,NZ_OX366380,1,358966,359769,-,803
102,NZ_OX366344,1,969270,970072,-,802
102,NZ_CP090900,1,116601,117406,-,805
102,NZ_OX366352,1,297713,298510,-,797
102,NZ_OX366362,1,1391610,1392390,+,780
102,NZ_OX366400,1,757072,757877,-,805
102,NZ_OX366327,1,551496,552293,+,797
102,NZ_OX366367,1,1174671,1175474,+,803
102,NZ_CP042444,1,116539,117344,-,805
102,NZ_OX366326,1,387438,388243,-,805
102,NZ_CP037426,1,46367,47164,-,797
102,NZ_OX366339,1,199310,200107,-,797
102,NZ_OX366355,1,903444,904241,-,797
102,NZ_CP046922,1,116294,117099,-,805
102,NZ_OX366370,1,226972,227762,+,790
102,NZ_OX366385,1,944938,945741,-,803
102,NZ_OX366399,1,395801,396606,-,805
102,NZ_OX366395,1,598604,599401,+,797
102,NZ_OX366396,1,1086842,1087639,+,797
102,NZ_OX366351,1,419608,420413,+,805
102,NZ_OX366381,1,144719,145516,-,797
102,NZ_OX366342,1,340546,341348,+,802
102,NZ_OX366369,1,402047,402844,+,797
102,NZ_OX366356,1,421347,422144,-,797
102,NZ_OX366377,1,507182,507979,+,797
102,NZ_OX366388,1,1333412,1334209,+,797
102,NZ_OX366357,1,179562,180366,+,804
102,NZ_CP072012,1,316834,317639,-,805
102,NZ_OX366398,1,1052493,1053290,-,797
102,NC_002978,6,116601,117406,-,805
102,NZ_OX366389,1,560523,561320,-,797
102,NZ_OX366397,1,451058,451855,-,797
102,NZ_OX366378,1,220035,220832,+,797
102,NZ_CP090903,1,116601,117406,-,805
102,NZ_OX366374,1,1015961,1016758,+,797
102,NZ_CP090901,1,116601,117406,-,805
102,NZ_CP046923,1,116294,117099,-,805
102,NZ_CP069055,1,108758,109563,+,805
102,NZ_CP072670,1,116449,117254,-,805
102,NZ_CP090899,1,116601,117406,-,805
102,NZ_CP046924,1,116294,117099,-,805
102,NZ_OX366348,1,848536,849332,-,796
102,NZ_CP046921,1,116294,117099,-,805
102,NZ_OX366338,1,1145468,1146272,-,804
102,NZ_CP054557,1,1127461,1128257,+,796
102,NZ_CP072669,1,116449,117254,-,805
102,NC_021089,1,120994,121791,+,797
103,NZ_OX366376,1,339197,341526,+,2329
103,NZ_OX366393,1,17086,19415,+,2329
103,NZ_OX366372,1,447496,449825,+,2329
103,NZ_CP072672,1,112063,114415,-,2352
103,NZ_CP069060,1,122311,124663,-,2352
103,NZ_CP072667,1,112045,114397,-,2352
103,NZ_CP072671,1,112045,114397,-,2352
103,NZ_CP072668,1,112045,114397,-,2352
103,NZ_CP072666,1,112045,114397,-,2352
103,NZ_CP090902,1,112197,114549,-,2352
103,NZ_CP090948,1,112197,114549,-,2352
103,NZ_CP069052,1,115468,117820,+,2352
103,NZ_CP076228,1,115842,118194,-,2352
103,NZ_CP042445,1,112197,114549,-,2352
103,NZ_CP042904,1,125404,127758,+,2354
103,NC_012416,1,127986,130340,+,2354
103,NZ_CP069053,1,422614,424966,+,2352
103,NZ_CP042446,1,112197,114549,-,2352
103,NZ_CP041215,1,391536,393856,-,2320
103,NZ_OX366353,1,536900,539220,-,2320
103,NZ_OX366387,1,645239,647591,+,2352
103,NZ_OX366368,1,391891,394243,-,2352
103,NZ_OX366379,1,392909,395261,-,2352
103,NZ_CP091195,1,1180868,1183229,-,2361
103,NZ_OX366375,1,355894,358246,-,2352
103,NZ_CP046925,1,112045,114397,-,2352
103,NZ_OX366318,1,506730,509082,+,2352
103,NZ_OX366319,1,753761,756113,-,2352
103,NZ_OX366332,1,403175,405495,+,2320
103,NZ_CP110359,1,1111105,1113445,-,2340
103,NZ_OU953855,1,1022546,1024904,-,2358
103,NZ_OX366272,1,570932,573284,+,2352
103,NZ_OX366347,1,520988,523340,+,2352
103,NZ_OU909470,1,959001,961319,-,2318
103,NZ_OX366363,1,518933,521285,+,2352
103,NZ_OX366364,1,1216438,1218766,+,2328
103,NZ_OX366359,1,375670,377990,-,2320
103,NZ_OX366349,1,307915,310244,-,2329
103,NZ_OX366380,1,355791,358111,-,2320
103,NZ_OX366344,1,966071,968400,-,2329
103,NZ_CP090900,1,112197,114549,-,2352
103,NZ_OX366352,1,294524,296844,-,2320
103,NZ_OX366362,1,1395054,1397365,+,2311
103,NZ_OX366400,1,753851,756203,-,2352
103,NZ_OX366327,1,554358,556712,+,2354
103,NZ_OX366367,1,1503971,1506276,-,2305
103,NZ_CP042444,1,112135,114487,-,2352
103,NZ_OX366326,1,384217,386569,-,2352
103,NZ_CP037426,1,41951,44303,-,2352
103,NZ_OX366339,1,194934,197254,-,2320
103,NZ_OX366355,1,899036,901388,-,2352
103,NZ_CP046922,1,111890,114242,-,2352
103,NZ_OX366370,1,228649,230969,+,2320
103,NZ_OX366385,1,941763,944083,-,2320
103,NZ_OX366399,1,391393,393745,-,2352
103,NZ_OX366395,1,601457,603778,+,2321
103,NZ_OX366396,1,1089695,1092015,+,2320
103,NZ_OX366351,1,421282,423634,+,2352
103,NZ_OX366381,1,140311,142663,-,2352
103,NZ_OX366342,1,342223,344552,+,2329
103,NZ_OX366369,1,404298,406650,+,2352
103,NZ_OX366356,1,416823,419187,-,2364
103,NZ_OX366377,1,510031,512383,+,2352
103,NZ_OX366388,1,1335667,1338028,+,2361
103,NZ_OX366357,1,840185,842505,-,2320
103,NZ_CP072012,1,312430,314782,-,2352
103,NZ_OX366398,1,1048089,1050441,-,2352
103,NC_002978,6,112197,114549,-,2352
103,NZ_OX366389,1,556115,558467,-,2352
103,NZ_OX366397,1,447869,450189,-,2320
103,NZ_OX366378,1,832264,834625,-,2361
103,NZ_CP090903,1,112197,114549,-,2352
103,NZ_OX366374,1,1018210,1020571,+,2361
103,NZ_CP090901,1,112197,114549,-,2352
103,NZ_CP046923,1,111890,114242,-,2352
103,NZ_CP069055,1,111615,113967,+,2352
103,NZ_CP072670,1,112045,114397,-,2352
103,NZ_CP090899,1,112197,114549,-,2352
103,NZ_CP046924,1,111890,114242,-,2352
103,NZ_OX366348,1,845315,847667,-,2352
103,NZ_CP046921,1,111890,114242,-,2352
103,NZ_OX366338,1,1141085,1143408,-,2323
103,NZ_CP054557,1,1129126,1131478,+,2352
103,NZ_CP072669,1,112045,114397,-,2352
103,NC_021089,1,122660,124980,+,2320
104,NZ_OX366376,1,342383,343105,+,722
104,NZ_OX366393,1,20272,20994,+,722
104,NZ_OX366372,1,450682,451404,+,722
104,NZ_CP072672,1,110493,111220,-,727
104,NZ_CP069060,1,120740,121467,-,727
104,NZ_CP072667,1,110475,111202,-,727
104,NZ_CP072671,1,110475,111202,-,727
104,NZ_CP072668,1,110475,111202,-,727
104,NZ_CP072666,1,110475,111202,-,727
104,NZ_CP090902,1,110627,111354,-,727
104,NZ_CP090948,1,110627,111354,-,727
104,NZ_CP069052,1,118664,119390,+,726
104,NZ_CP076228,1,114271,114998,-,727
104,NZ_CP042445,1,110627,111354,-,727
104,NZ_CP042904,1,131971,132697,+,726
104,NC_012416,1,134553,135279,+,726
104,NZ_CP069053,1,425810,426536,+,726
104,NZ_CP042446,1,110627,111354,-,727
104,NZ_CP041215,1,388850,389577,-,727
104,NZ_OX366353,1,534277,535004,-,727
104,NZ_OX366387,1,648362,649088,+,726
104,NZ_OX366368,1,390320,391047,-,727
104,NZ_OX366379,1,391338,392065,-,727
104,NZ_CP091195,1,1356646,1357372,+,726
104,NZ_OX366375,1,354333,355060,-,727
104,NZ_CP046925,1,110475,111202,-,727
104,NZ_OX366318,1,509890,510616,+,726
104,NZ_OX366319,1,752200,752927,-,727
104,NZ_OX366332,1,407454,408180,+,726
104,NZ_CP110359,1,1109597,1110324,-,727
104,NZ_OU953855,1,1020985,1021712,-,727
104,NZ_OX366272,1,574055,574781,+,726
104,NZ_OX366347,1,524174,524906,+,732
104,NZ_OU909470,1,955295,956022,-,727
104,NZ_OX366363,1,522093,522819,+,726
104,NZ_OX366364,1,1219566,1220312,+,746
104,NZ_OX366359,1,372984,373711,-,727
104,NZ_OX366349,1,306334,307061,-,727
104,NZ_OX366380,1,133071,133798,-,727
104,NZ_OX366344,1,964490,965217,-,727
104,NZ_CP090900,1,110627,111354,-,727
104,NZ_OX366352,1,366953,367679,+,726
104,NZ_OX366362,1,1398171,1398890,+,719
104,NZ_OX366400,1,749911,750638,-,727
104,NZ_OX366327,1,558580,559306,+,726
104,NZ_OX366367,1,1502347,1503094,-,747
104,NZ_CP042444,1,110628,111355,-,727
104,NZ_OX366326,1,382682,383409,-,727
104,NZ_CP037426,1,40390,41117,-,727
104,NZ_OX366339,1,191297,192024,-,727
104,NZ_OX366355,1,897475,898202,-,727
104,NZ_CP046922,1,110320,111047,-,727
104,NZ_OX366370,1,231836,232567,+,731
104,NZ_OX366385,1,1107783,1108510,-,727
104,NZ_OX366399,1,389822,390549,-,727
104,NZ_OX366395,1,1148646,1149373,-,727
104,NZ_OX366396,1,1093973,1094699,+,726
104,NZ_OX366351,1,424442,425168,+,726
104,NZ_OX366381,1,138750,139477,-,727
104,NZ_OX366342,1,345409,346131,+,722
104,NZ_OX366369,1,407484,408210,+,726
104,NZ_OX366356,1,415263,415990,-,727
104,NZ_OX366377,1,513182,513904,+,722
104,NZ_OX366388,1,1338862,1339588,+,726
104,NZ_OX366357,1,837573,838306,-,733
104,NZ_CP072012,1,310859,311586,-,727
104,NZ_OX366398,1,1046567,1047290,-,723
104,NC_002978,6,110627,111354,-,727
104,NZ_OX366389,1,554593,555316,-,723
104,NZ_OX366397,1,445183,445910,-,727
104,NZ_OX366378,1,1094420,1095147,-,727
104,NZ_CP090903,1,110627,111354,-,727
104,NZ_OX366374,1,1023111,1023853,+,742
104,NZ_CP090901,1,110627,111354,-,727
104,NZ_CP046923,1,110320,111047,-,727
104,NZ_CP069055,1,114811,115537,+,726
104,NZ_CP072670,1,110475,111202,-,727
104,NZ_CP090899,1,110627,111354,-,727
104,NZ_CP046924,1,110320,111047,-,727
104,NZ_OX366348,1,843780,844507,-,727
104,NZ_CP046921,1,110320,111047,-,727
104,NZ_OX366338,1,1139438,1140161,-,723
104,NZ_CP054557,1,1133140,1133866,+,726
104,NZ_CP072669,1,110475,111202,-,727
104,NC_021089,1,126939,127665,+,726
105,NZ_OX366376,1,343107,344435,+,1328
105,NZ_OX366393,1,20996,22324,+,1328
105,NZ_OX366372,1,451406,452734,+,1328
105,NZ_CP072672,1,109164,110492,-,1328
105,NZ_CP069060,1,119411,120739,-,1328
105,NZ_CP072667,1,109146,110474,-,1328
105,NZ_CP072671,1,109146,110474,-,1328
105,NZ_CP072668,1,109146,110474,-,1328
105,NZ_CP072666,1,109146,110474,-,1328
105,NZ_CP090902,1,109298,110626,-,1328
105,NZ_CP090948,1,109298,110626,-,1328
105,NZ_CP069052,1,119392,120720,+,1328
105,NZ_CP076228,1,112942,114270,-,1328
105,NZ_CP042445,1,109298,110626,-,1328
105,NZ_CP042904,1,132699,134027,+,1328
105,NC_012416,1,135281,136609,+,1328
105,NZ_CP069053,1,426538,427866,+,1328
105,NZ_CP042446,1,109298,110626,-,1328
105,NZ_CP041215,1,387521,388849,-,1328
105,NZ_OX366353,1,532948,534276,-,1328
105,NZ_OX366387,1,649090,650418,+,1328
105,NZ_OX366368,1,388991,390319,-,1328
105,NZ_OX366379,1,390009,391337,-,1328
105,NZ_CP091195,1,1357374,1358693,+,1319
105,NZ_OX366375,1,353004,354332,-,1328
105,NZ_CP046925,1,109146,110474,-,1328
105,NZ_OX366318,1,510618,511946,+,1328
105,NZ_OX366319,1,750880,752199,-,1319
105,NZ_OX366332,1,408182,409510,+,1328
105,NZ_CP110359,1,1108277,1109596,-,1319
105,NZ_OU953855,1,1019656,1020984,-,1328
105,NZ_OX366272,1,574783,576102,+,1319
105,NZ_OX366347,1,524908,526236,+,1328
105,NZ_OU909470,1,953966,955294,-,1328
105,NZ_OX366363,1,522821,524149,+,1328
105,NZ_OX366364,1,1220314,1221633,+,1319
105,NZ_OX366359,1,371655,372983,-,1328
105,NZ_OX366349,1,305005,306333,-,1328
105,NZ_OX366380,1,131742,133070,-,1328
105,NZ_OX366344,1,963161,964489,-,1328
105,NZ_CP090900,1,109298,110626,-,1328
105,NZ_OX366352,1,367681,369009,+,1328
105,NZ_OX366362,1,1398892,1400220,+,1328
105,NZ_OX366400,1,748582,749910,-,1328
105,NZ_OX366327,1,559308,560636,+,1328
105,NZ_OX366367,1,1501027,1502346,-,1319
105,NZ_CP042444,1,109299,110627,-,1328
105,NZ_OX366326,1,381353,382681,-,1328
105,NZ_CP037426,1,39061,40389,-,1328
105,NZ_OX366339,1,189968,191296,-,1328
105,NZ_OX366355,1,896155,897474,-,1319
105,NZ_CP046922,1,108991,110319,-,1328
105,NZ_OX366370,1,232569,233895,+,1326
105,NZ_OX366385,1,1106454,1107782,-,1328
105,NZ_OX366399,1,388493,389821,-,1328
105,NZ_OX366395,1,1147317,1148645,-,1328
105,NZ_OX366396,1,1094701,1096029,+,1328
105,NZ_OX366351,1,425170,426498,+,1328
105,NZ_OX366381,1,137430,138749,-,1319
105,NZ_OX366342,1,346133,347453,+,1320
105,NZ_OX366369,1,408212,409531,+,1319
105,NZ_OX366356,1,413943,415262,-,1319
105,NZ_OX366377,1,513906,515234,+,1328
105,NZ_OX366388,1,1339590,1340909,+,1319
105,NZ_OX366357,1,836244,837572,-,1328
105,NZ_CP072012,1,309530,310858,-,1328
105,NZ_OX366398,1,1045238,1046566,-,1328
105,NC_002978,6,109298,110626,-,1328
105,NZ_OX366389,1,553264,554592,-,1328
105,NZ_OX366397,1,443854,445182,-,1328
105,NZ_OX366378,1,1093100,1094419,-,1319
105,NZ_CP090903,1,109298,110626,-,1328
105,NZ_OX366374,1,1024725,1026011,+,1286
105,NZ_CP090901,1,109298,110626,-,1328
105,NZ_CP046923,1,108991,110319,-,1328
105,NZ_CP069055,1,115539,116867,+,1328
105,NZ_CP072670,1,109146,110474,-,1328
105,NZ_CP090899,1,109298,110626,-,1328
105,NZ_CP046924,1,108991,110319,-,1328
105,NZ_OX366348,1,842451,843779,-,1328
105,NZ_CP046921,1,108991,110319,-,1328
105,NZ_OX366338,1,1138123,1139437,-,1314
105,NZ_CP054557,1,1133868,1135196,+,1328
105,NZ_CP072669,1,109146,110474,-,1328
105,NC_021089,1,127667,128995,+,1328
106,NZ_OX366376,1,345120,346611,+,1491
106,NZ_OX366393,1,23009,24500,+,1491
106,NZ_OX366372,1,453419,454910,+,1491
106,NZ_CP072672,1,471963,473453,-,1490
106,NZ_CP069060,1,459591,461081,-,1490
106,NZ_CP072667,1,471945,473435,-,1490
106,NZ_CP072671,1,471945,473435,-,1490
106,NZ_CP072668,1,471932,473422,-,1490
106,NZ_CP072666,1,471945,473435,-,1490
106,NZ_CP090902,1,472097,473587,-,1490
106,NZ_CP090948,1,472097,473587,-,1490
106,NZ_CP069052,1,410338,411828,+,1490
106,NZ_CP076228,1,239173,240663,+,1490
106,NZ_CP042445,1,472097,473587,-,1490
106,NZ_CP042904,1,263007,264488,+,1481
106,NC_012416,1,265590,267071,+,1481
106,NZ_CP069053,1,86188,87678,+,1490
106,NZ_CP042446,1,472097,473587,-,1490
106,NZ_CP041215,1,1234757,1236247,-,1490
106,NZ_OX366353,1,1277999,1279489,-,1490
106,NZ_OX366387,1,1109764,1111254,+,1490
106,NZ_OX366368,1,760337,761827,+,1490
106,NZ_OX366379,1,716542,718032,+,1490
106,NZ_CP091195,1,451635,453125,-,1490
106,NZ_OX366375,1,801100,802590,+,1490
106,NZ_CP046925,1,471945,473435,-,1490
106,NZ_OX366318,1,667486,668976,+,1490
106,NZ_OX366319,1,622850,624340,-,1490
106,NZ_OX366332,1,864050,865540,-,1490
106,NZ_CP110359,1,702007,703497,+,1490
106,NZ_OU953855,1,345636,347126,+,1490
106,NZ_OX366272,1,521349,522839,-,1490
106,NZ_OX366347,1,989533,991023,-,1490
106,NZ_OU909470,1,951760,953250,-,1490
106,NZ_OX366363,1,244688,246178,-,1490
106,NZ_OX366364,1,1223005,1224387,-,1382
106,NZ_OX366359,1,554448,555938,+,1490
106,NZ_OX366349,1,302828,304319,-,1491
106,NZ_OX366380,1,129530,131021,-,1491
106,NZ_OX366344,1,960970,962461,-,1491
106,NZ_CP090900,1,472097,473587,-,1490
106,NZ_OX366352,1,593163,594653,-,1490
106,NZ_OX366362,1,1401692,1403182,-,1490
106,NZ_OX366400,1,583376,584866,-,1490
106,NZ_OX366327,1,717517,719007,+,1490
106,NZ_OX366367,1,1498164,1499655,+,1491
106,NZ_CP042444,1,472598,474088,-,1490
106,NZ_OX366326,1,762310,763800,+,1490
106,NZ_CP037426,1,308927,310417,-,1490
106,NZ_OX366339,1,571041,572528,-,1487
106,NZ_OX366355,1,688998,690488,-,1490
106,NZ_CP046922,1,489945,491435,+,1490
106,NZ_OX366370,1,1004579,1006070,+,1491
106,NZ_OX366385,1,1104242,1105733,-,1491
106,NZ_OX366399,1,686125,687615,+,1490
106,NZ_OX366395,1,659659,661157,+,1498
106,NZ_OX366396,1,902820,904310,-,1490
106,NZ_OX366351,1,584142,585632,+,1490
106,NZ_OX366381,1,897415,898905,-,1490
106,NZ_OX366342,1,348146,349637,+,1491
106,NZ_OX366369,1,801610,803100,-,1490
106,NZ_OX366356,1,714109,715599,-,1490
106,NZ_OX366377,1,875097,876587,+,1490
106,NZ_OX366388,1,694585,696075,-,1490
106,NZ_OX366357,1,866382,867872,-,1490
106,NZ_CP072012,1,570712,572202,-,1490
106,NZ_OX366398,1,650769,652259,+,1490
106,NC_002978,6,472097,473587,-,1490
106,NZ_OX366389,1,746380,747870,+,1490
106,NZ_OX366397,1,959990,961480,-,1490
106,NZ_OX366378,1,1190486,1191976,-,1490
106,NZ_CP090903,1,472097,473587,-,1490
106,NZ_OX366374,1,829869,831359,-,1490
106,NZ_CP090901,1,472097,473587,-,1490
106,NZ_CP046923,1,406193,407683,+,1490
106,NZ_CP069055,1,510698,512188,-,1490
106,NZ_CP072670,1,471937,473427,-,1490
106,NZ_CP090899,1,472097,473587,-,1490
106,NZ_CP046924,1,427131,428621,+,1490
106,NZ_OX366348,1,452193,453683,+,1490
106,NZ_CP046921,1,489945,491435,+,1490
106,NZ_OX366338,1,639526,641016,+,1490
106,NZ_CP054557,1,35730,37220,+,1490
106,NZ_CP072669,1,471945,473435,-,1490
106,NC_021089,1,347802,349292,+,1490
107,NZ_OX366376,1,347717,353032,+,5315
107,NZ_OX366393,1,25606,30921,+,5315
107,NZ_OX366372,1,456016,461319,+,5303
107,NZ_CP072672,1,679718,685028,+,5310
107,NZ_CP069060,1,521665,526975,+,5310
107,NZ_CP072667,1,679700,685010,+,5310
107,NZ_CP072671,1,679700,685010,+,5310
107,NZ_CP072668,1,679687,684997,+,5310
107,NZ_CP072666,1,679700,685010,+,5310
107,NZ_CP090902,1,679852,685162,+,5310
107,NZ_CP090948,1,679852,685162,+,5310
107,NZ_CP069052,1,1070816,1076126,+,5310
107,NZ_CP076228,1,673367,678677,+,5310
107,NZ_CP042445,1,679840,685150,+,5310
107,NZ_CP042904,1,734621,739952,-,5331
107,NC_012416,1,698365,703696,+,5331
107,NZ_CP069053,1,521673,526983,+,5310
107,NZ_CP042446,1,679852,685162,+,5310
107,NZ_CP041215,1,725276,730601,-,5325
107,NZ_OX366353,1,1143858,1149150,-,5292
107,NZ_OX366387,1,1648568,1653893,+,5325
107,NZ_OX366368,1,1045383,1050693,+,5310
107,NZ_OX366379,1,1043917,1049227,+,5310
107,NZ_CP091195,1,674185,679659,+,5474
107,NZ_OX366375,1,968161,973471,+,5310
107,NZ_CP046925,1,679700,685010,+,5310
107,NZ_OX366318,1,972978,978288,+,5310
107,NZ_OX366319,1,237267,242592,-,5325
107,NZ_OX366332,1,1060893,1066218,+,5325
107,NZ_CP110359,1,522182,527491,-,5309
107,NZ_OU953855,1,923435,928744,+,5309
107,NZ_OX366272,1,919312,924622,+,5310
107,NZ_OX366347,1,832540,837855,-,5315
107,NZ_OU909470,1,767085,772678,+,5593
107,NZ_OX366363,1,1259410,1264719,-,5309
107,NZ_OX366364,1,1106534,1111835,-,5301
107,NZ_OX366359,1,890361,895686,+,5325
107,NZ_OX366349,1,296424,301739,-,5315
107,NZ_OX366380,1,138182,143775,+,5593
107,NZ_OX366344,1,954550,959864,-,5314
107,NZ_CP090900,1,679852,685162,+,5310
107,NZ_OX366352,1,1161899,1167224,+,5325
107,NZ_OX366362,1,34956,40555,-,5599
107,NZ_OX366400,1,838957,844267,+,5310
107,NZ_OX366327,1,976873,982198,+,5325
107,NZ_OX366367,1,193161,198468,+,5307
107,NZ_CP042444,1,680389,685699,+,5310
107,NZ_OX366326,1,1103515,1108825,+,5310
107,NZ_CP037426,1,77334,82643,-,5309
107,NZ_OX366339,1,766515,771846,+,5331
107,NZ_OX366355,1,262361,267686,-,5325
107,NZ_CP046922,1,741566,746876,+,5310
107,NZ_OX366370,1,1007175,1012508,+,5333
107,NZ_OX366385,1,362030,367623,-,5593
107,NZ_OX366399,1,1078650,1083960,+,5310
107,NZ_OX366395,1,622827,628412,+,5585
107,NZ_OX366396,1,953682,959013,+,5331
107,NZ_OX366351,1,1053570,1058880,+,5310
107,NZ_OX366381,1,348128,353453,-,5325
107,NZ_OX366342,1,350743,356058,+,5315
107,NZ_OX366369,1,1166013,1171338,+,5325
107,NZ_OX366356,1,883075,888400,+,5325
107,NZ_OX366377,1,1247243,1252552,-,5309
107,NZ_OX366388,1,167994,173462,-,5468
107,NZ_OX366357,1,757692,763275,-,5583
107,NZ_CP072012,1,38314,43623,-,5309
107,NZ_OX366398,1,731680,736989,-,5309
107,NC_002978,6,679852,685162,+,5310
107,NZ_OX366389,1,798088,803397,-,5309
107,NZ_OX366397,1,1212059,1217384,+,5325
107,NZ_OX366378,1,157226,162700,-,5474
107,NZ_CP090903,1,679852,685162,+,5310
107,NZ_OX366374,1,723255,728846,+,5591
107,NZ_CP090901,1,679852,685162,+,5310
107,NZ_CP046923,1,657814,663124,+,5310
107,NZ_CP069055,1,679349,684659,+,5310
107,NZ_CP072670,1,679692,685002,+,5310
107,NZ_CP090899,1,679852,685162,+,5310
107,NZ_CP046924,1,678752,684062,+,5310
107,NZ_OX366348,1,297341,302658,-,5317
107,NZ_CP046921,1,741566,746876,+,5310
107,NZ_OX366338,1,1011209,1016807,-,5598
107,NZ_CP054557,1,379149,384438,+,5289
107,NZ_CP072669,1,679700,685010,+,5310
107,NC_021089,1,711680,716972,+,5292
108,NZ_OX366376,1,355268,358013,+,2745
108,NZ_OX366393,1,33157,35902,+,2745
108,NZ_OX366372,1,463555,466300,+,2745
108,NZ_CP072672,1,869301,872114,+,2813
108,NZ_CP069060,1,754481,757294,-,2813
108,NZ_CP072667,1,869275,872088,+,2813
108,NZ_CP072671,1,869283,872096,+,2813
108,NZ_CP072668,1,869270,872083,+,2813
108,NZ_CP072666,1,869283,872096,+,2813
108,NZ_CP090902,1,869435,872248,+,2813
108,NZ_CP090948,1,869435,872248,+,2813
108,NZ_CP069052,1,940036,942849,-,2813
108,NZ_CP076228,1,1099420,1102233,+,2813
108,NZ_CP042445,1,869423,872236,+,2813
108,NZ_CP042904,1,875024,877837,-,2813
108,NC_012416,1,911525,914338,-,2813
108,NZ_CP069053,1,713230,716043,+,2813
108,NZ_CP042446,1,869435,872248,+,2813
108,NZ_CP041215,1,1340890,1343703,-,2813
108,NZ_OX366353,1,257241,260054,+,2813
108,NZ_OX366387,1,1705796,1708609,+,2813
108,NZ_OX366368,1,1315596,1318409,+,2813
108,NZ_OX366379,1,1237803,1240616,-,2813
108,NZ_CP091195,1,1286524,1289337,-,2813
108,NZ_OX366375,1,1108649,1111456,-,2807
108,NZ_CP046925,1,869283,872096,+,2813
108,NZ_OX366318,1,1168664,1171477,+,2813
108,NZ_OX366319,1,1242321,1245134,+,2813
108,NZ_OX366332,1,1249679,1252492,-,2813
108,NZ_CP110359,1,1171413,1174226,+,2813
108,NZ_OU953855,1,81115,83921,-,2806
108,NZ_OX366272,1,52499,55312,-,2813
108,NZ_OX366347,1,155584,158397,+,2813
108,NZ_OU909470,1,775308,778053,+,2745
108,NZ_OX366363,1,1052606,1055419,-,2813
108,NZ_OX366364,1,1080671,1083422,+,2751
108,NZ_OX366359,1,1032717,1035530,+,2813
108,NZ_OX366349,1,291693,294438,-,2745
108,NZ_OX366380,1,145789,148534,+,2745
108,NZ_OX366344,1,949855,952596,-,2741
108,NZ_CP090900,1,869435,872248,+,2813
108,NZ_OX366352,1,203743,206556,+,2813
108,NZ_OX366362,1,30006,32819,-,2813
108,NZ_OX366400,1,1032145,1034958,+,2813
108,NZ_OX366327,1,1166975,1169788,+,2813
108,NZ_OX366367,1,220131,222882,-,2751
108,NZ_CP042444,1,869870,872683,+,2813
108,NZ_OX366326,1,1377226,1380039,+,2813
108,NZ_CP037426,1,1141087,1143900,+,2813
108,NZ_OX366339,1,800609,803416,-,2807
108,NZ_OX366355,1,1347835,1350648,+,2813
108,NZ_CP046922,1,931330,934143,+,2813
108,NZ_OX366370,1,1014774,1017519,+,2745
108,NZ_OX366385,1,357343,360088,-,2745
108,NZ_OX366399,1,1269656,1272469,+,2813
108,NZ_OX366395,1,1252924,1255737,-,2813
108,NZ_OX366396,1,488739,491554,-,2815
108,NZ_OX366351,1,1322801,1325614,+,2813
108,NZ_OX366381,1,1402511,1405324,+,2813
108,NZ_OX366342,1,358294,361039,+,2745
108,NZ_OX366369,1,1463397,1466210,-,2813
108,NZ_OX366356,1,121073,123886,-,2813
108,NZ_OX366377,1,219984,222797,+,2813
108,NZ_OX366388,1,1735567,1738380,-,2813
108,NZ_OX366357,1,35183,37996,+,2813
108,NZ_CP072012,1,693884,696697,-,2813
108,NZ_OX366398,1,350316,353129,+,2813
108,NC_002978,6,869435,872248,+,2813
108,NZ_OX366389,1,1243139,1245952,+,2813
108,NZ_OX366397,1,1427048,1429861,+,2813
108,NZ_OX366378,1,87103,89916,-,2813
108,NZ_CP090903,1,869435,872248,+,2813
108,NZ_OX366374,1,1226743,1229501,-,2758
108,NZ_CP090901,1,869435,872248,+,2813
108,NZ_CP046923,1,847578,850391,+,2813
108,NZ_CP069055,1,959560,962373,-,2813
108,NZ_CP072670,1,869275,872088,+,2813
108,NZ_CP090899,1,869435,872248,+,2813
108,NZ_CP046924,1,868516,871329,+,2813
108,NZ_OX366348,1,1189873,1192686,-,2813
108,NZ_CP046921,1,931330,934143,+,2813
108,NZ_OX366338,1,1331055,1333862,-,2807
108,NZ_CP054557,1,905736,908549,-,2813
108,NZ_CP072669,1,869283,872096,+,2813
108,NC_021089,1,899332,902145,-,2813
109,NZ_OX366376,1,358246,359022,+,776
109,NZ_OX366393,1,36135,36911,+,776
109,NZ_OX366372,1,466533,467309,+,776
109,NZ_CP072672,1,687055,687808,+,753
109,NZ_CP069060,1,529002,529755,+,753
109,NZ_CP072667,1,687037,687790,+,753
109,NZ_CP072671,1,687037,687790,+,753
109,NZ_CP072668,1,687024,687777,+,753
109,NZ_CP072666,1,687037,687790,+,753
109,NZ_CP090902,1,687189,687942,+,753
109,NZ_CP090948,1,687189,687942,+,753
109,NZ_CP069052,1,1078153,1078906,+,753
109,NZ_CP076228,1,680704,681457,+,753
109,NZ_CP042445,1,687177,687930,+,753
109,NZ_CP042904,1,731815,732585,-,770
109,NC_012416,1,705732,706502,+,770
109,NZ_CP069053,1,529010,529763,+,753
109,NZ_CP042446,1,687189,687942,+,753
109,NZ_CP041215,1,1061998,1062759,-,761
109,NZ_OX366353,1,1141062,1141823,-,761
109,NZ_OX366387,1,1655912,1656665,+,753
109,NZ_OX366368,1,1052720,1053473,+,753
109,NZ_OX366379,1,1051254,1052007,+,753
109,NZ_CP091195,1,681711,682472,+,761
109,NZ_OX366375,1,975490,976243,+,753
109,NZ_CP046925,1,687037,687790,+,753
109,NZ_OX366318,1,981519,982272,+,753
109,NZ_OX366319,1,234486,235248,-,762
109,NZ_OX366332,1,1068237,1068998,+,761
109,NZ_CP110359,1,519386,520139,-,753
109,NZ_OU953855,1,130424,131202,+,778
109,NZ_OX366272,1,927999,928752,+,753
109,NZ_OX366347,1,829751,830512,-,761
109,NZ_OU909470,1,778286,779062,+,776
109,NZ_OX366363,1,1256612,1257382,-,770
109,NZ_OX366364,1,1085197,1085959,+,762
109,NZ_OX366359,1,897705,898464,+,759
109,NZ_OX366349,1,290684,291460,-,776
109,NZ_OX366380,1,148764,149540,+,776
109,NZ_OX366344,1,948842,949618,-,776
109,NZ_CP090900,1,687189,687942,+,753
109,NZ_OX366352,1,1169243,1170004,+,761
109,NZ_OX366362,1,28850,29603,-,753
109,NZ_OX366400,1,846457,847210,+,753
109,NZ_OX366327,1,984234,985004,+,770
109,NZ_OX366367,1,218348,219110,-,762
109,NZ_CP042444,1,687726,688479,+,753
109,NZ_OX366326,1,1110853,1111606,+,753
109,NZ_CP037426,1,74562,75315,-,753
109,NZ_OX366339,1,775780,776541,+,761
109,NZ_OX366355,1,259580,260342,-,762
109,NZ_CP046922,1,748903,749656,+,753
109,NZ_OX366370,1,1017752,1018528,+,776
109,NZ_OX366385,1,356366,357113,-,747
109,NZ_OX366399,1,1085987,1086740,+,753
109,NZ_OX366395,1,630471,631247,+,776
109,NZ_OX366396,1,961041,961802,+,761
109,NZ_OX366351,1,1060908,1061661,+,753
109,NZ_OX366381,1,345347,346109,-,762
109,NZ_OX366342,1,361272,362048,+,776
109,NZ_OX366369,1,1173357,1174119,+,762
109,NZ_OX366356,1,890533,891286,+,753
109,NZ_OX366377,1,1244471,1245224,-,753
109,NZ_OX366388,1,165181,165942,-,761
109,NZ_OX366357,1,754735,755488,-,753
109,NZ_CP072012,1,35534,36287,-,753
109,NZ_OX366398,1,728908,729661,-,753
109,NC_002978,6,687189,687942,+,753
109,NZ_OX366389,1,795316,796069,-,753
109,NZ_OX366397,1,1219402,1220163,+,761
109,NZ_OX366378,1,154413,155174,-,761
109,NZ_CP090903,1,687189,687942,+,753
109,NZ_OX366374,1,731753,732523,+,770
109,NZ_CP090901,1,687189,687942,+,753
109,NZ_CP046923,1,665151,665904,+,753
109,NZ_CP069055,1,686686,687439,+,753
109,NZ_CP072670,1,687029,687782,+,753
109,NZ_CP090899,1,687189,687942,+,753
109,NZ_CP046924,1,686089,686842,+,753
109,NZ_OX366348,1,294561,295314,-,753
109,NZ_CP046921,1,748903,749656,+,753
109,NZ_OX366338,1,1006144,1006897,-,753
109,NZ_CP054557,1,386474,387218,+,744
109,NZ_CP072669,1,687037,687790,+,753
109,NC_021089,1,718991,719752,+,761
110,NZ_OX366376,1,359023,360315,+,1292
110,NZ_OX366393,1,36912,38204,+,1292
110,NZ_OX366372,1,467310,468602,+,1292
110,NZ_CP072672,1,687809,689101,+,1292
110,NZ_CP069060,1,529756,531048,+,1292
110,NZ_CP072667,1,687791,689083,+,1292
110,NZ_CP072671,1,687791,689083,+,1292
110,NZ_CP072668,1,687778,689070,+,1292
110,NZ_CP072666,1,687791,689083,+,1292
110,NZ_CP090902,1,687943,689235,+,1292
110,NZ_CP090948,1,687943,689235,+,1292
110,NZ_CP069052,1,1078907,1080199,+,1292
110,NZ_CP076228,1,681458,682750,+,1292
110,NZ_CP042445,1,687931,689223,+,1292
110,NZ_CP042904,1,730520,731813,-,1293
110,NC_012416,1,706503,707797,+,1294
110,NZ_CP069053,1,529764,531056,+,1292
110,NZ_CP042446,1,687943,689235,+,1292
110,NZ_CP041215,1,1060705,1061996,-,1291
110,NZ_OX366353,1,1139769,1141060,-,1291
110,NZ_OX366387,1,1656666,1657958,+,1292
110,NZ_OX366368,1,1053474,1054766,+,1292
110,NZ_OX366379,1,1052008,1053300,+,1292
110,NZ_CP091195,1,682473,683767,+,1294
110,NZ_OX366375,1,976244,977537,+,1293
110,NZ_CP046925,1,687791,689083,+,1292
110,NZ_OX366318,1,982273,983565,+,1292
110,NZ_OX366319,1,233192,234484,-,1292
110,NZ_OX366332,1,1068999,1070291,+,1292
110,NZ_CP110359,1,518091,519384,-,1293
110,NZ_OU953855,1,131203,132497,+,1294
110,NZ_OX366272,1,928753,930047,+,1294
110,NZ_OX366347,1,828456,829749,-,1293
110,NZ_OU909470,1,779063,780355,+,1292
110,NZ_OX366363,1,1255317,1256610,-,1293
110,NZ_OX366364,1,1085960,1087252,+,1292
110,NZ_OX366359,1,898466,899759,+,1293
110,NZ_OX366349,1,289391,290682,-,1291
110,NZ_OX366380,1,149541,150833,+,1292
110,NZ_OX366344,1,947549,948840,-,1291
110,NZ_CP090900,1,687943,689235,+,1292
110,NZ_OX366352,1,1170005,1171297,+,1292
110,NZ_OX366362,1,27555,28848,-,1293
110,NZ_OX366400,1,847211,848503,+,1292
110,NZ_OX366327,1,985005,986299,+,1294
110,NZ_OX366367,1,217053,218346,-,1293
110,NZ_CP042444,1,688480,689772,+,1292
110,NZ_OX366326,1,1111607,1112899,+,1292
110,NZ_CP037426,1,73268,74560,-,1292
110,NZ_OX366339,1,776542,777836,+,1294
110,NZ_OX366355,1,258286,259578,-,1292
110,NZ_CP046922,1,749657,750949,+,1292
110,NZ_OX366370,1,1018529,1019821,+,1292
110,NZ_OX366385,1,969758,971065,+,1307
110,NZ_OX366399,1,1086741,1088033,+,1292
110,NZ_OX366395,1,631248,632540,+,1292
110,NZ_OX366396,1,961803,963097,+,1294
110,NZ_OX366351,1,1061662,1062954,+,1292
110,NZ_OX366381,1,344053,345345,-,1292
110,NZ_OX366342,1,362049,363341,+,1292
110,NZ_OX366369,1,1174120,1175413,+,1293
110,NZ_OX366356,1,891287,892580,+,1293
110,NZ_OX366377,1,1243178,1244469,-,1291
110,NZ_OX366388,1,163886,165179,-,1293
110,NZ_OX366357,1,753442,754733,-,1291
110,NZ_CP072012,1,34241,35532,-,1291
110,NZ_OX366398,1,727615,728906,-,1291
110,NC_002978,6,687943,689235,+,1292
110,NZ_OX366389,1,794023,795314,-,1291
110,NZ_OX366397,1,1220164,1221456,+,1292
110,NZ_OX366378,1,153118,154411,-,1293
110,NZ_CP090903,1,687943,689235,+,1292
110,NZ_OX366374,1,732524,733820,+,1296
110,NZ_CP090901,1,687943,689235,+,1292
110,NZ_CP046923,1,665905,667197,+,1292
110,NZ_CP069055,1,687440,688732,+,1292
110,NZ_CP072670,1,687783,689075,+,1292
110,NZ_CP090899,1,687943,689235,+,1292
110,NZ_CP046924,1,686843,688135,+,1292
110,NZ_OX366348,1,293266,294559,-,1293
110,NZ_CP046921,1,749657,750949,+,1292
110,NZ_OX366338,1,1004856,1006142,-,1286
110,NZ_CP054557,1,387219,388513,+,1294
110,NZ_CP072669,1,687791,689083,+,1292
110,NC_021089,1,719753,721045,+,1292
111,NZ_OX366376,1,360344,362133,+,1789
111,NZ_OX366393,1,38233,40022,+,1789
111,NZ_OX366372,1,468631,470420,+,1789
111,NZ_CP072672,1,689130,690937,+,1807
111,NZ_CP069060,1,531077,532884,+,1807
111,NZ_CP072667,1,689112,690919,+,1807
111,NZ_CP072671,1,689112,690919,+,1807
111,NZ_CP072668,1,689099,690906,+,1807
111,NZ_CP072666,1,689112,690919,+,1807
111,NZ_CP090902,1,689264,691071,+,1807
111,NZ_CP090948,1,689264,691071,+,1807
111,NZ_CP069052,1,1080228,1082035,+,1807
111,NZ_CP076228,1,682779,684586,+,1807
111,NZ_CP042445,1,689252,691059,+,1807
111,NZ_CP042904,1,728684,730491,-,1807
111,NC_012416,1,707826,709633,+,1807
111,NZ_CP069053,1,531085,532892,+,1807
111,NZ_CP042446,1,689264,691071,+,1807
111,NZ_CP041215,1,1058869,1060676,-,1807
111,NZ_OX366353,1,1137933,1139740,-,1807
111,NZ_OX366387,1,1657987,1659794,+,1807
111,NZ_OX366368,1,1054795,1056602,+,1807
111,NZ_OX366379,1,1053329,1055136,+,1807
111,NZ_CP091195,1,683796,685603,+,1807
111,NZ_OX366375,1,977566,979356,+,1790
111,NZ_CP046925,1,689112,690919,+,1807
111,NZ_OX366318,1,983594,985401,+,1807
111,NZ_OX366319,1,231356,233163,-,1807
111,NZ_OX366332,1,1070320,1072127,+,1807
111,NZ_CP110359,1,516271,518062,-,1791
111,NZ_OU953855,1,132819,134625,+,1806
111,NZ_OX366272,1,930076,931866,+,1790
111,NZ_OX366347,1,826636,828427,-,1791
111,NZ_OU909470,1,477315,479094,+,1779
111,NZ_OX366363,1,1253481,1255288,-,1807
111,NZ_OX366364,1,1087281,1089070,+,1789
111,NZ_OX366359,1,899788,901595,+,1807
111,NZ_OX366349,1,287579,289362,-,1783
111,NZ_OX366380,1,363243,365226,+,1983
111,NZ_OX366344,1,945737,947520,-,1783
111,NZ_CP090900,1,689264,691071,+,1807
111,NZ_OX366352,1,1171326,1173133,+,1807
111,NZ_OX366362,1,25313,27233,-,1920
111,NZ_OX366400,1,848532,850339,+,1807
111,NZ_OX366327,1,986328,988130,+,1802
111,NZ_OX366367,1,215103,217024,-,1921
111,NZ_CP042444,1,689801,691608,+,1807
111,NZ_OX366326,1,1112928,1114735,+,1807
111,NZ_CP037426,1,71448,73239,-,1791
111,NZ_OX366339,1,777865,779655,+,1790
111,NZ_OX366355,1,256450,258257,-,1807
111,NZ_CP046922,1,750978,752785,+,1807
111,NZ_OX366370,1,1019850,1021633,+,1783
111,NZ_OX366385,1,948486,950469,+,1983
111,NZ_OX366399,1,1088062,1089869,+,1807
111,NZ_OX366395,1,632862,634653,+,1791
111,NZ_OX366396,1,963126,964916,+,1790
111,NZ_OX366351,1,1062983,1064790,+,1807
111,NZ_OX366381,1,342217,344024,-,1807
111,NZ_OX366342,1,363382,365156,+,1774
111,NZ_OX366369,1,1175442,1177249,+,1807
111,NZ_OX366356,1,892609,894399,+,1790
111,NZ_OX366377,1,1241342,1243149,-,1807
111,NZ_OX366388,1,162066,163857,-,1791
111,NZ_OX366357,1,751630,753413,-,1783
111,NZ_CP072012,1,32405,34212,-,1807
111,NZ_OX366398,1,725779,727586,-,1807
111,NC_002978,6,689264,691071,+,1807
111,NZ_OX366389,1,792187,793994,-,1807
111,NZ_OX366397,1,1221485,1223292,+,1807
111,NZ_OX366378,1,151282,153089,-,1807
111,NZ_CP090903,1,689264,691071,+,1807
111,NZ_OX366374,1,734995,736784,+,1789
111,NZ_CP090901,1,689264,691071,+,1807
111,NZ_CP046923,1,667226,669033,+,1807
111,NZ_CP069055,1,688761,690568,+,1807
111,NZ_CP072670,1,689104,690911,+,1807
111,NZ_CP090899,1,689264,691071,+,1807
111,NZ_CP046924,1,688164,689971,+,1807
111,NZ_OX366348,1,291430,293237,-,1807
111,NZ_CP046921,1,750978,752785,+,1807
111,NZ_OX366338,1,123201,124992,+,1791
111,NZ_OX366338,1,1001689,1003480,-,1791
111,NZ_CP054557,1,388542,390349,+,1807
111,NZ_CP072669,1,689112,690919,+,1807
111,NC_021089,1,721074,722881,+,1807
112,NZ_OX366376,1,363902,364956,+,1054
112,NZ_OX366393,1,41791,42845,+,1054
112,NZ_OX366372,1,472189,473243,+,1054
112,NZ_CP072672,1,720072,721114,-,1042
112,NZ_CP069060,1,561526,562568,-,1042
112,NZ_CP072667,1,720054,721096,-,1042
112,NZ_CP072671,1,720054,721096,-,1042
112,NZ_CP072668,1,720041,721083,-,1042
112,NZ_CP072666,1,720054,721096,-,1042
112,NZ_CP090902,1,720206,721248,-,1042
112,NZ_CP090948,1,720206,721248,-,1042
112,NZ_CP069052,1,1112515,1113557,-,1042
112,NZ_CP076228,1,714980,716022,-,1042
112,NZ_CP042445,1,720194,721236,-,1042
112,NZ_CP042904,1,755686,756728,+,1042
112,NC_012416,1,790559,791601,+,1042
112,NZ_CP069053,1,561534,562576,-,1042
112,NZ_CP042446,1,720206,721248,-,1042
112,NZ_CP041215,1,960674,961716,+,1042
112,NZ_OX366353,1,822583,823625,+,1042
112,NZ_OX366387,1,975537,976567,-,1030
112,NZ_OX366368,1,1163476,1164518,-,1042
112,NZ_OX366379,1,1084861,1085903,-,1042
112,NZ_CP091195,1,1534207,1535239,+,1032
112,NZ_OX366375,1,1010333,1011387,-,1054
112,NZ_CP046925,1,720054,721096,-,1042
112,NZ_OX366318,1,1015251,1016293,-,1042
112,NZ_OX366319,1,201508,202552,+,1044
112,NZ_OX366332,1,1102601,1103643,-,1042
112,NZ_CP110359,1,485525,486569,+,1044
112,NZ_OU953855,1,252514,253558,+,1044
112,NZ_OX366272,1,1341484,1342526,-,1042
112,NZ_OX366347,1,742020,743058,+,1038
112,NZ_OU909470,1,480739,481779,+,1040
112,NZ_OX366363,1,1223646,1224723,+,1077
112,NZ_OX366364,1,1090912,1091920,+,1008
112,NZ_OX366359,1,931697,932739,-,1042
112,NZ_OX366349,1,283393,284447,-,1054
112,NZ_OX366380,1,366935,367923,+,988
112,NZ_OX366344,1,943048,944102,-,1054
112,NZ_CP090900,1,720206,721248,-,1042
112,NZ_OX366352,1,1283943,1284985,+,1042
112,NZ_OX366362,1,371532,372569,+,1037
112,NZ_OX366400,1,877647,878689,-,1042
112,NZ_OX366327,1,1016678,1017720,-,1042
112,NZ_OX366367,1,212344,213401,-,1057
112,NZ_CP042444,1,720743,721785,-,1042
112,NZ_OX366326,1,1221883,1222925,-,1042
112,NZ_CP037426,1,757104,758158,-,1054
112,NZ_OX366339,1,977448,978478,-,1030
112,NZ_OX366355,1,225779,226823,+,1044
112,NZ_CP046922,1,781920,782962,-,1042
112,NZ_OX366370,1,1023282,1024244,+,962
112,NZ_OX366385,1,953031,954019,+,988
112,NZ_OX366399,1,1119489,1120531,-,1042
112,NZ_OX366395,1,1360370,1361429,+,1059
112,NZ_OX366396,1,440411,441443,+,1032
112,NZ_OX366351,1,1169132,1170174,-,1042
112,NZ_OX366381,1,312369,313413,+,1044
112,NZ_OX366342,1,366925,367979,+,1054
112,NZ_OX366369,1,1206181,1207223,-,1042
112,NZ_OX366356,1,923806,924817,-,1011
112,NZ_OX366377,1,1211372,1212416,+,1044
112,NZ_OX366388,1,132110,133154,+,1044
112,NZ_OX366357,1,594601,595607,+,1006
112,NZ_CP072012,1,1461268,1462312,+,1044
112,NZ_OX366398,1,695814,696858,+,1044
112,NC_002978,6,720206,721248,-,1042
112,NZ_OX366389,1,1156694,1157738,+,1044
112,NZ_OX366397,1,1323714,1324756,-,1042
112,NZ_OX366378,1,588527,589559,+,1032
112,NZ_CP090903,1,720206,721248,-,1042
112,NZ_OX366374,1,628847,629910,+,1063
112,NZ_CP090901,1,720206,721248,-,1042
112,NZ_CP046923,1,698168,699210,-,1042
112,NZ_CP069055,1,719252,720294,-,1042
112,NZ_CP072670,1,720046,721088,-,1042
112,NZ_CP090899,1,720206,721248,-,1042
112,NZ_CP046924,1,719106,720148,-,1042
112,NZ_OX366348,1,261868,262912,+,1044
112,NZ_CP046921,1,781920,782962,-,1042
112,NZ_OX366338,1,989060,990133,-,1073
112,NZ_CP054557,1,1088958,1090002,+,1044
112,NZ_CP072669,1,720054,721096,-,1042
112,NC_021089,1,753136,754178,-,1042
113,NZ_OX366376,1,365344,366154,+,810
113,NZ_OX366393,1,43233,44043,+,810
113,NZ_OX366372,1,473631,474441,+,810
113,NZ_CP072672,1,718847,719688,-,841
113,NZ_CP069060,1,560301,561142,-,841
113,NZ_CP072667,1,718829,719670,-,841
113,NZ_CP072671,1,718829,719670,-,841
113,NZ_CP072668,1,718816,719657,-,841
113,NZ_CP072666,1,718829,719670,-,841
113,NZ_CP090902,1,718981,719822,-,841
113,NZ_CP090948,1,718981,719822,-,841
113,NZ_CP069052,1,1111290,1112131,-,841
113,NZ_CP076228,1,713757,714596,-,839
113,NZ_CP042445,1,718969,719810,-,841
113,NZ_CP042904,1,757112,757953,+,841
113,NC_012416,1,791985,792826,+,841
113,NZ_CP069053,1,560309,561150,-,841
113,NZ_CP042446,1,718981,719822,-,841
113,NZ_CP041215,1,962100,962941,+,841
113,NZ_OX366353,1,824009,824850,+,841
113,NZ_OX366387,1,974312,975153,-,841
113,NZ_OX366368,1,1162251,1163092,-,841
113,NZ_OX366379,1,1083636,1084477,-,841
113,NZ_CP091195,1,1535623,1536464,+,841
113,NZ_OX366375,1,1009108,1009949,-,841
113,NZ_CP046925,1,718829,719670,-,841
113,NZ_OX366318,1,1014026,1014867,-,841
113,NZ_OX366319,1,202936,203777,+,841
113,NZ_OX366332,1,1101376,1102217,-,841
113,NZ_CP110359,1,486953,487757,+,804
113,NZ_OU953855,1,253942,254783,+,841
113,NZ_OX366272,1,1340295,1341100,-,805
113,NZ_OX366347,1,743446,744279,+,833
113,NZ_OU909470,1,482174,482978,+,804
113,NZ_OX366363,1,1225107,1225948,+,841
113,NZ_OX366364,1,1092306,1093108,+,802
113,NZ_OX366359,1,930472,931313,-,841
113,NZ_OX366349,1,282195,283005,-,810
113,NZ_OX366380,1,368303,369107,+,804
113,NZ_OX366344,1,941850,942660,-,810
113,NZ_CP090900,1,718981,719822,-,841
113,NZ_OX366352,1,1285369,1286210,+,841
113,NZ_OX366362,1,372956,373797,+,841
113,NZ_OX366400,1,876422,877263,-,841
113,NZ_OX366327,1,1015453,1016294,-,841
113,NZ_OX366367,1,211156,211958,-,802
113,NZ_CP042444,1,719518,720359,-,841
113,NZ_OX366326,1,1220658,1221499,-,841
113,NZ_CP037426,1,755879,756720,-,841
113,NZ_OX366339,1,976223,977064,-,841
113,NZ_OX366355,1,227207,228048,+,841
113,NZ_CP046922,1,780695,781536,-,841
113,NZ_OX366370,1,1024632,1025427,+,795
113,NZ_OX366385,1,954399,955203,+,804
113,NZ_OX366399,1,1118264,1119105,-,841
113,NZ_OX366395,1,1361815,1362656,+,841
113,NZ_OX366396,1,441827,442668,+,841
113,NZ_OX366351,1,1167907,1168748,-,841
113,NZ_OX366381,1,313797,314638,+,841
113,NZ_OX366342,1,368367,369177,+,810
113,NZ_OX366369,1,1204956,1205797,-,841
113,NZ_OX366356,1,922581,923422,-,841
113,NZ_OX366377,1,1212800,1213641,+,841
113,NZ_OX366388,1,133538,134379,+,841
113,NZ_OX366357,1,595989,596813,+,824
113,NZ_CP072012,1,1462696,1463537,+,841
113,NZ_OX366398,1,697242,698083,+,841
113,NC_002978,6,718981,719822,-,841
113,NZ_OX366389,1,1158122,1158963,+,841
113,NZ_OX366397,1,1322489,1323330,-,841
113,NZ_OX366378,1,589943,590784,+,841
113,NZ_CP090903,1,718981,719822,-,841
113,NZ_OX366374,1,630296,631137,+,841
113,NZ_CP090901,1,718981,719822,-,841
113,NZ_CP046923,1,696943,697784,-,841
113,NZ_CP069055,1,718027,718868,-,841
113,NZ_CP072670,1,718821,719662,-,841
113,NZ_CP090899,1,718981,719822,-,841
113,NZ_CP046924,1,717881,718722,-,841
113,NZ_OX366348,1,263296,264137,+,841
113,NZ_CP046921,1,780695,781536,-,841
113,NZ_OX366338,1,987833,988674,-,841
113,NZ_CP054557,1,1090386,1091227,+,841
113,NZ_CP072669,1,718829,719670,-,841
113,NC_021089,1,751911,752752,-,841
114,NZ_OX366376,1,366935,367479,+,544
114,NZ_OX366393,1,44824,45368,+,544
114,NZ_OX366372,1,475222,475766,+,544
114,NZ_OU909470,1,483773,484305,+,532
114,NZ_OX366364,1,1093883,1094424,+,541
114,NZ_OX366349,1,280909,281441,-,532
114,NZ_OX366380,1,369831,370346,+,515
114,NZ_OX366344,1,940531,941075,-,544
114,NZ_OX366367,1,209840,210381,-,541
114,NZ_OX366370,1,1026214,1026746,+,532
114,NZ_OX366385,1,955927,956444,+,517
114,NZ_OX366342,1,369958,370502,+,544
115,NZ_OX366376,1,367702,369357,+,1655
115,NZ_OX366393,1,45591,47246,+,1655
115,NZ_OX366372,1,475989,477644,+,1655
115,NZ_CP072672,1,717185,718845,-,1660
115,NZ_CP069060,1,558639,560299,-,1660
115,NZ_CP072667,1,717167,718827,-,1660
115,NZ_CP072671,1,717167,718827,-,1660
115,NZ_CP072668,1,717154,718814,-,1660
115,NZ_CP072666,1,717167,718827,-,1660
115,NZ_CP090902,1,717319,718979,-,1660
115,NZ_CP090948,1,717319,718979,-,1660
115,NZ_CP069052,1,1109628,1111288,-,1660
115,NZ_CP076228,1,712095,713755,-,1660
115,NZ_CP042445,1,717307,718967,-,1660
115,NZ_CP042904,1,757954,759615,+,1661
115,NC_012416,1,792827,794488,+,1661
115,NZ_CP069053,1,558647,560307,-,1660
115,NZ_CP042446,1,717319,718979,-,1660
115,NZ_CP041215,1,962942,964603,+,1661
115,NZ_OX366353,1,824851,826512,+,1661
115,NZ_OX366387,1,972650,974310,-,1660
115,NZ_OX366368,1,1160589,1162249,-,1660
115,NZ_OX366379,1,1081974,1083634,-,1660
115,NZ_CP091195,1,1536465,1538126,+,1661
115,NZ_OX366375,1,1007446,1009106,-,1660
115,NZ_CP046925,1,717167,718827,-,1660
115,NZ_OX366318,1,1012364,1014024,-,1660
115,NZ_OX366319,1,203778,205439,+,1661
115,NZ_OX366332,1,1099714,1101374,-,1660
115,NZ_CP110359,1,487758,489419,+,1661
115,NZ_OU953855,1,254784,256445,+,1661
115,NZ_OX366272,1,1338633,1340293,-,1660
115,NZ_OX366347,1,744280,745941,+,1661
115,NZ_OU909470,1,484517,486144,+,1627
115,NZ_OX366363,1,1225949,1227610,+,1661
115,NZ_OX366364,1,1096323,1097968,+,1645
115,NZ_OX366359,1,928810,930470,-,1660
115,NZ_OX366349,1,279031,280686,-,1655
115,NZ_OX366380,1,370596,372245,+,1649
115,NZ_OX366344,1,938665,940320,-,1655
115,NZ_CP090900,1,717319,718979,-,1660
115,NZ_OX366352,1,1286211,1287872,+,1661
115,NZ_OX366362,1,373798,375459,+,1661
115,NZ_OX366400,1,874760,876420,-,1660
115,NZ_OX366327,1,1013791,1015451,-,1660
115,NZ_OX366367,1,207390,209045,-,1655
115,NZ_CP042444,1,717856,719516,-,1660
115,NZ_OX366326,1,1218996,1220656,-,1660
115,NZ_CP037426,1,754217,755877,-,1660
115,NZ_OX366339,1,974561,976221,-,1660
115,NZ_OX366355,1,228049,229710,+,1661
115,NZ_CP046922,1,779033,780693,-,1660
115,NZ_OX366370,1,1026950,1028607,+,1657
115,NZ_OX366385,1,956694,958343,+,1649
115,NZ_OX366399,1,1116602,1118262,-,1660
115,NZ_OX366395,1,1362657,1364318,+,1661
115,NZ_OX366396,1,442669,444330,+,1661
115,NZ_OX366351,1,1166245,1167905,-,1660
115,NZ_OX366381,1,314639,316300,+,1661
115,NZ_OX366342,1,370725,372380,+,1655
115,NZ_OX366369,1,1203294,1204954,-,1660
115,NZ_OX366356,1,920919,922579,-,1660
115,NZ_OX366377,1,1213642,1215303,+,1661
115,NZ_OX366388,1,134380,136041,+,1661
115,NZ_OX366357,1,596814,598475,+,1661
115,NZ_CP072012,1,1463538,1465199,+,1661
115,NZ_OX366398,1,698084,699745,+,1661
115,NC_002978,6,717319,718979,-,1660
115,NZ_OX366389,1,1158964,1160625,+,1661
115,NZ_OX366397,1,1320827,1322487,-,1660
115,NZ_OX366378,1,590785,592446,+,1661
115,NZ_CP090903,1,717319,718979,-,1660
115,NZ_OX366374,1,631138,632799,+,1661
115,NZ_CP090901,1,717319,718979,-,1660
115,NZ_CP046923,1,695281,696941,-,1660
115,NZ_CP069055,1,716365,718025,-,1660
115,NZ_CP072670,1,717159,718819,-,1660
115,NZ_CP090899,1,717319,718979,-,1660
115,NZ_CP046924,1,716219,717879,-,1660
115,NZ_OX366348,1,264138,265799,+,1661
115,NZ_CP046921,1,779033,780693,-,1660
115,NZ_OX366338,1,986171,987831,-,1660
115,NZ_CP054557,1,1091228,1092889,+,1661
115,NZ_CP072669,1,717167,718827,-,1660
115,NC_021089,1,750249,751909,-,1660
116,NZ_OX366376,1,369829,370451,+,622
116,NZ_OX366393,1,47943,48565,+,622
116,NZ_OX366372,1,478116,478738,+,622
116,NZ_OX366342,1,372852,373473,+,621
117,NZ_OX366376,1,371535,372169,+,634
117,NZ_OX366349,1,277277,277913,-,636
117,NZ_OX366370,1,1002082,1002822,-,740
118,NZ_OX366376,1,373384,374129,+,745
118,NZ_OX366393,1,49792,50537,+,745
118,NZ_OX366372,1,480030,480775,+,745
118,NZ_CP072672,1,849185,849922,+,737
118,NZ_CP069060,1,693010,693747,+,737
118,NZ_CP072667,1,849159,849896,+,737
118,NZ_CP072671,1,849167,849904,+,737
118,NZ_CP072668,1,849154,849891,+,737
118,NZ_CP072666,1,849167,849904,+,737
118,NZ_CP090902,1,849319,850056,+,737
118,NZ_CP090948,1,849319,850056,+,737
118,NZ_CP069052,1,1244000,1244737,+,737
118,NZ_CP076228,1,847198,847935,+,737
118,NZ_CP042445,1,849307,850044,+,737
118,NZ_CP042904,1,899819,900547,-,728
118,NC_012416,1,935401,936129,-,728
118,NZ_CP069053,1,693018,693755,+,737
118,NZ_CP042446,1,849319,850056,+,737
118,NZ_CP041215,1,1352229,1352957,-,728
118,NZ_OX366353,1,248845,249574,+,729
118,NZ_OX366387,1,1750922,1751651,+,729
118,NZ_OX366368,1,1295384,1296121,+,737
118,NZ_OX366379,1,1260091,1260827,-,736
118,NZ_CP091195,1,1056275,1057011,-,736
118,NZ_OX366375,1,1214859,1215588,+,729
118,NZ_CP046925,1,849167,849904,+,737
118,NZ_OX366318,1,1148360,1149097,+,737
118,NZ_OX366319,1,119786,120515,+,729
118,NZ_OX366332,1,1260164,1260892,-,728
118,NZ_CP110359,1,338732,339457,+,725
118,NZ_OU953855,1,388483,389219,-,736
118,NZ_OX366272,1,144020,144756,-,736
118,NZ_OX366347,1,1229950,1230678,-,728
118,NZ_OU909470,1,486823,487566,+,743
118,NZ_OX366363,1,1043973,1044702,+,729
118,NZ_OX366364,1,1078669,1079413,-,744
118,NZ_OX366359,1,1090259,1090987,-,728
118,NZ_OX366349,1,275005,275765,-,760
118,NZ_OX366380,1,372924,373667,+,743
118,NZ_OX366344,1,937021,937765,-,744
118,NZ_CP090900,1,849319,850056,+,737
118,NZ_OX366352,1,195342,196071,+,729
118,NZ_OX366362,1,1045274,1046010,-,736
118,NZ_OX366400,1,1011397,1012134,+,737
118,NZ_OX366327,1,1148034,1148763,+,729
118,NZ_OX366367,1,224564,225309,+,745
118,NZ_CP042444,1,849754,850491,+,737
118,NZ_OX366326,1,1355985,1356722,+,737
118,NZ_CP037426,1,906861,907589,-,728
118,NZ_OX366339,1,832449,833177,-,728
118,NZ_OX366355,1,126597,127326,+,729
118,NZ_CP046922,1,911132,911869,+,737
118,NZ_OX366370,1,969974,970718,-,744
118,NZ_OX366385,1,959022,959765,+,743
118,NZ_OX366399,1,1249529,1250266,+,737
118,NZ_OX366395,1,1245714,1246451,+,737
118,NZ_OX366396,1,59871,60600,+,729
118,NZ_OX366351,1,1302411,1303148,+,737
118,NZ_OX366381,1,231274,232003,+,729
118,NZ_OX366342,1,374678,375423,+,745
118,NZ_OX366369,1,1342363,1343092,+,729
118,NZ_OX366356,1,1086780,1087507,-,727
118,NZ_OX366377,1,1078111,1078847,-,736
118,NZ_OX366388,1,40726,41463,+,737
118,NZ_OX366357,1,1080647,1081369,-,722
118,NZ_CP072012,1,716172,716908,-,736
118,NZ_OX366398,1,330070,330807,+,737
118,NC_002978,6,849319,850056,+,737
118,NZ_OX366389,1,1222893,1223630,+,737
118,NZ_OX366397,1,1484853,1485581,-,728
118,NZ_OX366378,1,52865,53602,+,737
118,NZ_CP090903,1,849319,850056,+,737
118,NZ_OX366374,1,214955,215671,-,716
118,NZ_CP090901,1,849319,850056,+,737
118,NZ_CP046923,1,827380,828117,+,737
118,NZ_CP069055,1,955824,956560,-,736
118,NZ_CP072670,1,849159,849896,+,737
118,NZ_CP090899,1,849319,850056,+,737
118,NZ_CP046924,1,848318,849055,+,737
118,NZ_OX366348,1,131183,131919,-,736
118,NZ_CP046921,1,911132,911869,+,737
118,NZ_OX366338,1,730974,731711,+,737
118,NZ_CP054557,1,954298,955034,-,736
118,NZ_CP072669,1,849167,849904,+,737
118,NC_021089,1,909818,910546,-,728
119,NZ_OX366376,1,374130,374681,+,551
119,NZ_OX366393,1,50538,51089,+,551
119,NZ_OX366372,1,480776,481327,+,551
119,NZ_CP072672,1,849923,850510,+,587
119,NZ_CP069060,1,693748,694335,+,587
119,NZ_CP072667,1,849897,850484,+,587
119,NZ_CP072671,1,849905,850492,+,587
119,NZ_CP072668,1,849892,850479,+,587
119,NZ_CP072666,1,849905,850492,+,587
119,NZ_CP090902,1,850057,850644,+,587
119,NZ_CP090948,1,850057,850644,+,587
119,NZ_CP069052,1,1244738,1245325,+,587
119,NZ_CP076228,1,847936,848523,+,587
119,NZ_CP042445,1,850045,850632,+,587
119,NZ_CP042904,1,899276,899817,-,541
119,NC_012416,1,934858,935399,-,541
119,NZ_CP069053,1,693756,694343,+,587
119,NZ_CP042446,1,850057,850644,+,587
119,NZ_CP041215,1,1351665,1352227,-,562
119,NZ_OX366353,1,249575,250138,+,563
119,NZ_OX366387,1,1751652,1752236,+,584
119,NZ_OX366368,1,1296122,1296709,+,587
119,NZ_OX366379,1,1259503,1260089,-,586
119,NZ_CP091195,1,1055690,1056273,-,583
119,NZ_OX366375,1,1215589,1216173,+,584
119,NZ_CP046925,1,849905,850492,+,587
119,NZ_OX366318,1,1149098,1149674,+,576
119,NZ_OX366319,1,120516,121087,+,571
119,NZ_OX366332,1,1259600,1260162,-,562
119,NZ_CP110359,1,341114,341699,+,585
119,NZ_OU953855,1,387911,388481,-,570
119,NZ_OX366272,1,143448,144018,-,570
119,NZ_OX366347,1,1229407,1229948,-,541
119,NZ_OU909470,1,487570,488108,+,538
119,NZ_OX366363,1,1044703,1045274,+,571
119,NZ_OX366364,1,1078097,1078667,-,570
119,NZ_OX366359,1,1089695,1090257,-,562
119,NZ_OX366349,1,274453,275003,-,550
119,NZ_OX366380,1,373671,374201,+,530
119,NZ_OX366344,1,936469,937019,-,550
119,NZ_CP090900,1,850057,850644,+,587
119,NZ_OX366352,1,196072,196635,+,563
119,NZ_OX366362,1,1044701,1045272,-,571
119,NZ_OX366400,1,1012135,1012711,+,576
119,NZ_OX366327,1,1148764,1149348,+,584
119,NZ_OX366367,1,225310,225860,+,550
119,NZ_CP042444,1,850492,851079,+,587
119,NZ_OX366326,1,1356723,1357299,+,576
119,NZ_CP037426,1,906276,906859,-,583
119,NZ_OX366339,1,831864,832447,-,583
119,NZ_OX366355,1,127327,127898,+,571
119,NZ_CP046922,1,911870,912457,+,587
119,NZ_OX366370,1,969422,969972,-,550
119,NZ_OX366385,1,959769,960299,+,530
119,NZ_OX366399,1,1250267,1250854,+,587
119,NZ_OX366395,1,1246452,1247013,+,561
119,NZ_OX366396,1,60601,61185,+,584
119,NZ_OX366351,1,1303149,1303725,+,576
119,NZ_OX366381,1,232004,232575,+,571
119,NZ_OX366342,1,375424,375975,+,551
119,NZ_OX366369,1,1343093,1343664,+,571
119,NZ_OX366356,1,1086195,1086778,-,583
119,NZ_OX366377,1,1077534,1078109,-,575
119,NZ_OX366388,1,41464,42048,+,584
119,NZ_OX366357,1,1080048,1080631,-,583
119,NZ_CP072012,1,715584,716170,-,586
119,NZ_OX366398,1,330808,331384,+,576
119,NC_002978,6,850057,850644,+,587
119,NZ_OX366389,1,1223631,1224207,+,576
119,NZ_OX366397,1,1484289,1484851,-,562
119,NZ_OX366378,1,53603,54187,+,584
119,NZ_CP090903,1,850057,850644,+,587
119,NZ_OX366374,1,213255,213853,-,598
119,NZ_CP090901,1,850057,850644,+,587
119,NZ_CP046923,1,828118,828705,+,587
119,NZ_CP069055,1,955236,955822,-,586
119,NZ_CP072670,1,849897,850484,+,587
119,NZ_CP090899,1,850057,850644,+,587
119,NZ_CP046924,1,849056,849643,+,587
119,NZ_OX366348,1,130606,131181,-,575
119,NZ_CP046921,1,911870,912457,+,587
119,NZ_OX366338,1,731712,732296,+,584
119,NZ_CP054557,1,953721,954296,-,575
119,NZ_CP072669,1,849905,850492,+,587
119,NC_021089,1,909254,909816,-,562
120,NZ_OX366376,1,379926,384551,+,4625
120,NZ_OX366393,1,56391,61016,+,4625
120,NZ_OX366372,1,486203,490828,+,4625
120,NZ_CP072672,1,1045660,1050277,-,4617
120,NZ_CP069060,1,891628,896245,-,4617
120,NZ_CP072667,1,1045634,1050251,-,4617
120,NZ_CP072671,1,1045642,1050259,-,4617
120,NZ_CP072668,1,1045629,1050246,-,4617
120,NZ_CP072666,1,1045642,1050259,-,4617
120,NZ_CP090902,1,1045794,1050411,-,4617
120,NZ_CP090948,1,1045792,1050409,-,4617
120,NZ_CP069052,1,758383,763000,+,4617
120,NZ_CP076228,1,907290,911906,-,4616
120,NZ_CP042445,1,1045782,1050399,-,4617
120,NZ_CP042904,1,1167738,1172355,-,4617
120,NC_012416,1,1212953,1217570,-,4617
120,NZ_CP069053,1,891636,896253,-,4617
120,NZ_CP042446,1,1045792,1050409,-,4617
120,NZ_CP041215,1,1389382,1393999,+,4617
120,NZ_OX366353,1,1067660,1072277,+,4617
120,NZ_OX366387,1,436489,441106,+,4617
120,NZ_OX366368,1,58094,62711,-,4617
120,NZ_OX366379,1,58112,62729,-,4617
120,NZ_CP091195,1,483625,488242,-,4617
120,NZ_OX366375,1,57873,62490,-,4617
120,NZ_CP046925,1,1045642,1050259,-,4617
120,NZ_OX366318,1,56182,60799,-,4617
120,NZ_OX366319,1,1135863,1140480,+,4617
120,NZ_OX366332,1,57588,62205,-,4617
120,NZ_CP110359,1,407560,412177,+,4617
120,NZ_OU953855,1,95845,100462,+,4617
120,NZ_OX366272,1,1192047,1196664,-,4617
120,NZ_OX366347,1,58640,63257,+,4617
120,NZ_OU909470,1,389534,394158,-,4624
120,NZ_OX366363,1,867241,871858,-,4617
120,NZ_OX366364,1,1067289,1071897,-,4608
120,NZ_OX366359,1,57491,62108,-,4617
120,NZ_OX366349,1,228385,233010,+,4625
120,NZ_OX366380,1,380404,384991,+,4587
120,NZ_OX366344,1,927692,932317,-,4625
120,NZ_CP090900,1,1045794,1050411,-,4617
120,NZ_OX366352,1,1637313,1641930,+,4617
120,NZ_OX366362,1,115150,119773,-,4623
120,NZ_OX366400,1,113310,117927,+,4617
120,NZ_OX366327,1,57996,62613,-,4617
120,NZ_OX366367,1,230987,235595,+,4608
120,NZ_CP042444,1,1047148,1051765,-,4617
120,NZ_OX366326,1,59511,64128,-,4617
120,NZ_CP037426,1,1306007,1310624,-,4617
120,NZ_OX366339,1,1092085,1096702,+,4617
120,NZ_OX366355,1,1253953,1258570,+,4617
120,NZ_CP046922,1,1107711,1112328,-,4617
120,NZ_OX366370,1,960732,965351,-,4619
120,NZ_OX366385,1,762978,767593,-,4615
120,NZ_OX366399,1,57603,62220,-,4617
120,NZ_OX366395,1,29334,33958,+,4624
120,NZ_OX366396,1,1421851,1426468,+,4617
120,NZ_OX366351,1,64424,69040,-,4616
120,NZ_OX366381,1,1317900,1322517,+,4617
120,NZ_OX366342,1,380959,385584,+,4625
120,NZ_OX366369,1,58545,63162,-,4617
120,NZ_OX366356,1,55761,60375,-,4614
120,NZ_OX366377,1,56713,61330,-,4617
120,NZ_OX366388,1,208210,212827,-,4617
120,NZ_OX366357,1,127756,132373,+,4617
120,NZ_CP072012,1,1310885,1315502,-,4617
120,NZ_OX366398,1,528072,532689,-,4617
120,NC_002978,6,1045792,1050409,-,4617
120,NZ_OX366389,1,190107,194724,+,4617
120,NZ_OX366397,1,40999,45616,+,4617
120,NZ_OX366378,1,1222475,1227092,-,4617
120,NZ_CP090903,1,1045794,1050411,-,4617
120,NZ_OX366374,1,474977,479592,-,4615
120,NZ_CP090901,1,1045794,1050411,-,4617
120,NZ_CP046923,1,1023959,1028576,-,4617
120,NZ_CP069055,1,996962,1001579,-,4617
120,NZ_CP072670,1,1045634,1050251,-,4617
120,NZ_CP090899,1,1045794,1050411,-,4617
120,NZ_CP046924,1,1044897,1049514,-,4617
120,NZ_OX366348,1,57029,61645,-,4616
120,NZ_CP046921,1,1107711,1112328,-,4617
120,NZ_OX366338,1,67130,71745,+,4615
120,NZ_CP054557,1,838784,843401,-,4617
120,NZ_CP072669,1,1045642,1050259,-,4617
120,NC_021089,1,1073895,1078512,-,4617
121,NZ_OX366376,1,384650,387476,+,2826
121,NZ_OX366393,1,61115,63941,+,2826
121,NZ_OX366372,1,490927,493753,+,2826
121,NZ_CP072672,1,1042744,1045561,-,2817
121,NZ_CP069060,1,888712,891529,-,2817
121,NZ_CP072667,1,1042718,1045535,-,2817
121,NZ_CP072671,1,1042726,1045543,-,2817
121,NZ_CP072668,1,1042713,1045530,-,2817
121,NZ_CP072666,1,1042726,1045543,-,2817
121,NZ_CP090902,1,1042878,1045695,-,2817
121,NZ_CP090948,1,1042876,1045693,-,2817
121,NZ_CP069052,1,763099,765916,+,2817
121,NZ_CP076228,1,904374,907191,-,2817
121,NZ_CP042445,1,1042866,1045683,-,2817
121,NZ_CP042904,1,1164822,1167639,-,2817
121,NC_012416,1,1210037,1212854,-,2817
121,NZ_CP069053,1,888720,891537,-,2817
121,NZ_CP042446,1,1042876,1045693,-,2817
121,NZ_CP041215,1,1394098,1396915,+,2817
121,NZ_OX366353,1,1072376,1075193,+,2817
121,NZ_OX366387,1,441205,444022,+,2817
121,NZ_OX366368,1,55178,57995,-,2817
121,NZ_OX366379,1,55196,58013,-,2817
121,NZ_CP091195,1,480709,483526,-,2817
121,NZ_OX366375,1,54957,57774,-,2817
121,NZ_CP046925,1,1042726,1045543,-,2817
121,NZ_OX366318,1,53266,56083,-,2817
121,NZ_OX366319,1,1140579,1143396,+,2817
121,NZ_OX366332,1,54672,57489,-,2817
121,NZ_CP110359,1,412276,415093,+,2817
121,NZ_OU953855,1,100561,103378,+,2817
121,NZ_OX366272,1,1189131,1191948,-,2817
121,NZ_OX366347,1,63356,66173,+,2817
121,NZ_OU909470,1,380549,383369,-,2820
121,NZ_OX366363,1,864325,867142,-,2817
121,NZ_OX366364,1,1064362,1067188,-,2826
121,NZ_OX366359,1,54575,57392,-,2817
121,NZ_OX366349,1,233109,235935,+,2826
121,NZ_OX366380,1,385090,387916,+,2826
121,NZ_OX366344,1,924767,927593,-,2826
121,NZ_CP090900,1,1042878,1045695,-,2817
121,NZ_OX366352,1,1642029,1644846,+,2817
121,NZ_OX366362,1,112281,115049,-,2768
121,NZ_OX366400,1,118026,120843,+,2817
121,NZ_OX366327,1,55080,57897,-,2817
121,NZ_OX366367,1,235696,238522,+,2826
121,NZ_CP042444,1,1044232,1047049,-,2817
121,NZ_OX366326,1,56595,59412,-,2817
121,NZ_CP037426,1,1303091,1305908,-,2817
121,NZ_OX366339,1,1096801,1099618,+,2817
121,NZ_OX366355,1,1258669,1261486,+,2817
121,NZ_CP046922,1,1104795,1107612,-,2817
121,NZ_OX366370,1,957807,960633,-,2826
121,NZ_OX366385,1,760053,762879,-,2826
121,NZ_OX366399,1,54687,57504,-,2817
121,NZ_OX366395,1,34057,36874,+,2817
121,NZ_OX366396,1,1426567,1429384,+,2817
121,NZ_OX366351,1,61508,64325,-,2817
121,NZ_OX366381,1,1322616,1325433,+,2817
121,NZ_OX366342,1,385683,388509,+,2826
121,NZ_OX366369,1,55629,58446,-,2817
121,NZ_OX366356,1,52845,55662,-,2817
121,NZ_OX366377,1,53797,56614,-,2817
121,NZ_OX366388,1,205294,208111,-,2817
121,NZ_OX366357,1,132472,135289,+,2817
121,NZ_CP072012,1,1307969,1310786,-,2817
121,NZ_OX366398,1,525156,527973,-,2817
121,NC_002978,6,1042876,1045693,-,2817
121,NZ_OX366389,1,194823,197640,+,2817
121,NZ_OX366397,1,45715,48532,+,2817
121,NZ_OX366378,1,1219559,1222376,-,2817
121,NZ_CP090903,1,1042878,1045695,-,2817
121,NZ_OX366374,1,472061,474878,-,2817
121,NZ_CP090901,1,1042878,1045695,-,2817
121,NZ_CP046923,1,1021043,1023860,-,2817
121,NZ_CP069055,1,994046,996863,-,2817
121,NZ_CP072670,1,1042718,1045535,-,2817
121,NZ_CP090899,1,1042878,1045695,-,2817
121,NZ_CP046924,1,1041981,1044798,-,2817
121,NZ_OX366348,1,54113,56922,-,2809
121,NZ_CP046921,1,1104795,1107612,-,2817
121,NZ_OX366338,1,71844,74661,+,2817
121,NZ_CP054557,1,835868,838685,-,2817
121,NZ_CP072669,1,1042726,1045543,-,2817
121,NC_021089,1,1070979,1073796,-,2817
122,NZ_OX366376,1,388091,390375,+,2284
122,NZ_OX366393,1,64556,66840,+,2284
122,NZ_OX366372,1,494368,496652,+,2284
122,NZ_CP072672,1,1039790,1041993,-,2203
122,NZ_CP069060,1,885758,887961,-,2203
122,NZ_CP072667,1,1039764,1041967,-,2203
122,NZ_CP072671,1,1039772,1041975,-,2203
122,NZ_CP072668,1,1039759,1041962,-,2203
122,NZ_CP072666,1,1039772,1041975,-,2203
122,NZ_CP090902,1,1039924,1042127,-,2203
122,NZ_CP090948,1,1039922,1042125,-,2203
122,NZ_CP069052,1,766667,768870,+,2203
122,NZ_CP076228,1,901420,903623,-,2203
122,NZ_CP042445,1,1039912,1042115,-,2203
122,NZ_CP042904,1,1161991,1164185,-,2194
122,NC_012416,1,1207206,1209400,-,2194
122,NZ_CP069053,1,885766,887969,-,2203
122,NZ_CP042446,1,1039922,1042125,-,2203
122,NZ_CP041215,1,1397666,1399869,+,2203
122,NZ_OX366353,1,1075944,1078147,+,2203
122,NZ_OX366387,1,444752,446946,+,2194
122,NZ_OX366368,1,52224,54427,-,2203
122,NZ_OX366379,1,52242,54445,-,2203
122,NZ_CP091195,1,477755,479958,-,2203
122,NZ_OX366375,1,52012,54206,-,2194
122,NZ_CP046925,1,1039772,1041975,-,2203
122,NZ_OX366318,1,50312,52515,-,2203
122,NZ_OX366319,1,1144147,1146341,+,2194
122,NZ_OX366332,1,51718,53921,-,2203
122,NZ_CP110359,1,415823,418026,+,2203
122,NZ_OU953855,1,104129,106332,+,2203
122,NZ_OX366272,1,1186177,1188380,-,2203
122,NZ_OX366347,1,66924,69124,+,2200
122,NZ_OU909470,1,377570,379773,-,2203
122,NZ_OX366363,1,861371,863574,-,2203
122,NZ_OX366364,1,1061472,1063747,-,2275
122,NZ_OX366359,1,51621,53824,-,2203
122,NZ_OX366349,1,236550,238834,+,2284
122,NZ_OX366380,1,388692,390895,+,2203
122,NZ_OX366344,1,921868,924152,-,2284
122,NZ_CP090900,1,1039924,1042127,-,2203
122,NZ_OX366352,1,1645597,1647800,+,2203
122,NZ_OX366362,1,109281,111484,-,2203
122,NZ_OX366400,1,121594,123797,+,2203
122,NZ_OX366327,1,52126,54329,-,2203
122,NZ_OX366367,1,239137,241412,+,2275
122,NZ_CP042444,1,1041278,1043481,-,2203
122,NZ_OX366326,1,53641,55844,-,2203
122,NZ_CP037426,1,1300146,1302340,-,2194
122,NZ_OX366339,1,1100373,1102572,+,2199
122,NZ_OX366355,1,1262237,1264431,+,2194
122,NZ_CP046922,1,1101841,1104044,-,2203
122,NZ_OX366370,1,954782,957192,-,2410
122,NZ_OX366385,1,757074,759277,-,2203
122,NZ_OX366399,1,51733,53936,-,2203
122,NZ_OX366395,1,37604,39799,+,2195
122,NZ_OX366396,1,1430135,1432338,+,2203
122,NZ_OX366351,1,58554,60757,-,2203
122,NZ_OX366381,1,1326184,1328378,+,2194
122,NZ_OX366342,1,389124,391408,+,2284
122,NZ_OX366369,1,52684,54878,-,2194
122,NZ_OX366356,1,49921,52115,-,2194
122,NZ_OX366377,1,50843,53040,-,2197
122,NZ_OX366388,1,202319,204522,-,2203
122,NZ_OX366357,1,136040,138235,+,2195
122,NZ_CP072012,1,1305015,1307218,-,2203
122,NZ_OX366398,1,522202,524399,-,2197
122,NC_002978,6,1039922,1042125,-,2203
122,NZ_OX366389,1,198397,200594,+,2197
122,NZ_OX366397,1,49262,51465,+,2203
122,NZ_OX366378,1,1216584,1218787,-,2203
122,NZ_CP090903,1,1039924,1042127,-,2203
122,NZ_OX366374,1,469107,471310,-,2203
122,NZ_CP090901,1,1039924,1042127,-,2203
122,NZ_CP046923,1,1018089,1020292,-,2203
122,NZ_CP069055,1,991092,993295,-,2203
122,NZ_CP072670,1,1039764,1041967,-,2203
122,NZ_CP090899,1,1039924,1042127,-,2203
122,NZ_CP046924,1,1039027,1041230,-,2203
122,NZ_OX366348,1,51159,53314,-,2155
122,NZ_CP046921,1,1101841,1104044,-,2203
122,NZ_OX366338,1,75391,77594,+,2203
122,NZ_CP054557,1,832935,835090,-,2155
122,NZ_CP072669,1,1039772,1041975,-,2203
122,NC_021089,1,1068046,1070249,-,2203
123,NZ_OX366376,1,390458,393750,+,3292
123,NZ_OX366393,1,66923,70215,+,3292
123,NZ_OX366372,1,496735,500027,+,3292
123,NZ_CP072672,1,1036414,1039707,-,3293
123,NZ_CP069060,1,882382,885675,-,3293
123,NZ_CP072667,1,1036388,1039681,-,3293
123,NZ_CP072671,1,1036396,1039689,-,3293
123,NZ_CP072668,1,1036383,1039676,-,3293
123,NZ_CP072666,1,1036396,1039689,-,3293
123,NZ_CP090902,1,1036548,1039841,-,3293
123,NZ_CP090948,1,1036546,1039839,-,3293
123,NZ_CP069052,1,768953,772246,+,3293
123,NZ_CP076228,1,898044,901337,-,3293
123,NZ_CP042445,1,1036536,1039829,-,3293
123,NZ_CP042904,1,1158615,1161908,-,3293
123,NC_012416,1,1203830,1207123,-,3293
123,NZ_CP069053,1,882390,885683,-,3293
123,NZ_CP042446,1,1036546,1039839,-,3293
123,NZ_CP041215,1,1400819,1404099,+,3280
123,NZ_OX366353,1,1078230,1081523,+,3293
123,NZ_OX366387,1,447029,450317,+,3288
123,NZ_OX366368,1,48848,52141,-,3293
123,NZ_OX366379,1,48866,52159,-,3293
123,NZ_CP091195,1,474406,477672,-,3266
123,NZ_OX366375,1,48636,51929,-,3293
123,NZ_CP046925,1,1036396,1039689,-,3293
123,NZ_OX366318,1,46936,50229,-,3293
123,NZ_OX366319,1,48575,51852,-,3277
123,NZ_OX366332,1,48342,51635,-,3293
123,NZ_CP110359,1,418109,421375,+,3266
123,NZ_OU953855,1,106415,109681,+,3266
123,NZ_OX366272,1,1182829,1186094,-,3265
123,NZ_OX366347,1,69210,72503,+,3293
123,NZ_OU909470,1,374253,377487,-,3234
123,NZ_OX366363,1,857995,861288,-,3293
123,NZ_OX366364,1,1058097,1061389,-,3292
123,NZ_OX366359,1,48245,51538,-,3293
123,NZ_OX366349,1,238917,242209,+,3292
123,NZ_OX366380,1,390978,394243,+,3265
123,NZ_OX366344,1,918493,921785,-,3292
123,NZ_CP090900,1,1036548,1039841,-,3293
123,NZ_OX366352,1,1647883,1651158,+,3275
123,NZ_OX366362,1,105905,109198,-,3293
123,NZ_OX366400,1,123880,127173,+,3293
123,NZ_OX366327,1,48750,52043,-,3293
123,NZ_OX366367,1,241495,244787,+,3292
123,NZ_CP042444,1,1037902,1041195,-,3293
123,NZ_OX366326,1,50265,53558,-,3293
123,NZ_CP037426,1,1296770,1300063,-,3293
123,NZ_OX366339,1,1102655,1105948,+,3293
123,NZ_OX366355,1,52450,55727,-,3277
123,NZ_CP046922,1,1098465,1101758,-,3293
123,NZ_OX366370,1,893371,896642,-,3271
123,NZ_OX366385,1,753726,756991,-,3265
123,NZ_OX366399,1,48357,51650,-,3293
123,NZ_OX366395,1,39890,43144,+,3254
123,NZ_OX366396,1,1432421,1435714,+,3293
123,NZ_OX366351,1,55178,58471,-,3293
123,NZ_OX366381,1,50476,53753,-,3277
123,NZ_OX366342,1,391491,394783,+,3292
123,NZ_OX366369,1,49308,52601,-,3293
123,NZ_OX366356,1,46545,49838,-,3293
123,NZ_OX366377,1,47467,50760,-,3293
123,NZ_OX366388,1,198970,202236,-,3266
123,NZ_OX366357,1,138326,141619,+,3293
123,NZ_CP072012,1,1301639,1304932,-,3293
123,NZ_OX366398,1,518826,522119,-,3293
123,NC_002978,6,1036546,1039839,-,3293
123,NZ_OX366389,1,200677,203970,+,3293
123,NZ_OX366397,1,51548,54841,+,3293
123,NZ_OX366378,1,1213235,1216501,-,3266
123,NZ_CP090903,1,1036548,1039841,-,3293
123,NZ_OX366374,1,465758,469024,-,3266
123,NZ_CP090901,1,1036548,1039841,-,3293
123,NZ_CP046923,1,1014713,1018006,-,3293
123,NZ_CP069055,1,987716,991009,-,3293
123,NZ_CP072670,1,1036388,1039681,-,3293
123,NZ_CP090899,1,1036548,1039841,-,3293
123,NZ_CP046924,1,1035651,1038944,-,3293
123,NZ_OX366348,1,47783,51076,-,3293
123,NZ_CP046921,1,1098465,1101758,-,3293
123,NZ_OX366338,1,77677,80931,+,3254
123,NZ_CP054557,1,829559,832852,-,3293
123,NZ_CP072669,1,1036396,1039689,-,3293
123,NC_021089,1,1064670,1067963,-,3293
124,NZ_OX366376,1,394699,395556,+,857
124,NZ_OX366393,1,71607,72464,+,857
124,NZ_OX366372,1,501089,501942,+,853
124,NZ_CP072672,1,1034338,1035200,-,862
124,NZ_CP069060,1,880074,880936,-,862
124,NZ_CP072667,1,1034312,1035174,-,862
124,NZ_CP072671,1,1034320,1035182,-,862
124,NZ_CP072668,1,1034307,1035169,-,862
124,NZ_CP072666,1,1034320,1035182,-,862
124,NZ_CP090902,1,1034472,1035334,-,862
124,NZ_CP090948,1,1034470,1035332,-,862
124,NZ_CP069052,1,775135,775997,+,862
124,NZ_CP076228,1,896287,897149,-,862
124,NZ_CP042445,1,1034460,1035322,-,862
124,NZ_CP042904,1,1156801,1157663,-,862
124,NC_012416,1,1202016,1202878,-,862
124,NZ_CP069053,1,880082,880944,-,862
124,NZ_CP042446,1,1034470,1035332,-,862
124,NZ_CP041215,1,1405224,1406086,+,862
124,NZ_OX366353,1,1082530,1083392,+,862
124,NZ_OX366387,1,50590,51452,-,862
124,NZ_OX366368,1,45876,46738,-,862
124,NZ_OX366379,1,45894,46756,-,862
124,NZ_CP091195,1,472433,473295,-,862
124,NZ_OX366375,1,46810,47672,-,862
124,NZ_CP046925,1,1034320,1035182,-,862
124,NZ_OX366318,1,45049,45911,-,862
124,NZ_OX366319,1,46634,47496,-,862
124,NZ_OX366332,1,46355,47217,-,862
124,NZ_CP110359,1,422448,423297,+,849
124,NZ_OU953855,1,110792,111654,+,862
124,NZ_OX366272,1,1180752,1181614,-,862
124,NZ_OX366347,1,74152,75013,+,861
124,NZ_OU909470,1,831784,832646,+,862
124,NZ_OX366363,1,855856,856718,-,862
124,NZ_OX366364,1,1057121,1057983,-,862
124,NZ_OX366359,1,46338,47200,-,862
124,NZ_OX366349,1,243696,244558,+,862
124,NZ_OX366380,1,394317,395168,+,851
124,NZ_OX366344,1,916484,917346,-,862
124,NZ_CP090900,1,1034472,1035334,-,862
124,NZ_OX366352,1,48927,49783,-,856
124,NZ_OX366362,1,104980,105842,-,862
124,NZ_OX366400,1,128198,129060,+,862
124,NZ_OX366327,1,47141,48003,-,862
124,NZ_OX366367,1,245615,246477,+,862
124,NZ_CP042444,1,1035826,1036688,-,862
124,NZ_OX366326,1,48378,49240,-,862
124,NZ_CP037426,1,1295147,1296009,-,862
124,NZ_OX366339,1,1107058,1107920,+,862
124,NZ_OX366355,1,50414,51276,-,862
124,NZ_CP046922,1,1096389,1097251,-,862
124,NZ_OX366370,1,948565,949427,-,862
124,NZ_OX366385,1,752801,753652,-,851
124,NZ_OX366399,1,45872,46734,-,862
124,NZ_OX366395,1,43226,44081,+,855
124,NZ_OX366396,1,1436732,1437594,+,862
124,NZ_OX366351,1,53291,54153,-,862
124,NZ_OX366381,1,48440,49302,-,862
124,NZ_OX366342,1,395852,396709,+,857
124,NZ_OX366369,1,47430,48292,-,862
124,NZ_OX366356,1,44914,45766,-,852
124,NZ_OX366377,1,45482,46344,-,862
124,NZ_OX366388,1,197008,197870,-,862
124,NZ_OX366357,1,142337,143199,+,862
124,NZ_CP072012,1,1298399,1299261,-,862
124,NZ_OX366398,1,516841,517703,-,862
124,NC_002978,6,1034470,1035332,-,862
124,NZ_OX366389,1,205093,205955,+,862
124,NZ_OX366397,1,55966,56828,+,862
124,NZ_OX366378,1,1211262,1212124,-,862
124,NZ_CP090903,1,1034472,1035334,-,862
124,NZ_OX366374,1,463789,464651,-,862
124,NZ_CP090901,1,1034472,1035334,-,862
124,NZ_CP046923,1,1012637,1013499,-,862
124,NZ_CP069055,1,985719,986581,-,862
124,NZ_CP072670,1,1034312,1035174,-,862
124,NZ_CP090899,1,1034472,1035334,-,862
124,NZ_CP046924,1,1033575,1034437,-,862
124,NZ_OX366348,1,45644,46506,-,862
124,NZ_CP046921,1,1096389,1097251,-,862
124,NZ_OX366338,1,81006,81868,+,862
124,NZ_CP054557,1,827671,828533,-,862
124,NZ_CP072669,1,1034320,1035182,-,862
124,NC_021089,1,1062683,1063545,-,862
125,NZ_OX366376,1,395575,397430,+,1855
125,NZ_OX366393,1,72483,74338,+,1855
125,NZ_OX366372,1,501961,503816,+,1855
125,NZ_CP072672,1,1032478,1034324,-,1846
125,NZ_CP069060,1,878214,880060,-,1846
125,NZ_CP072667,1,1032452,1034298,-,1846
125,NZ_CP072671,1,1032460,1034306,-,1846
125,NZ_CP072668,1,1032447,1034293,-,1846
125,NZ_CP072666,1,1032460,1034306,-,1846
125,NZ_CP090902,1,1032612,1034458,-,1846
125,NZ_CP090948,1,1032610,1034456,-,1846
125,NZ_CP069052,1,776011,777857,+,1846
125,NZ_CP076228,1,894427,896273,-,1846
125,NZ_CP042445,1,1032600,1034446,-,1846
125,NZ_CP042904,1,1154932,1156787,-,1855
125,NC_012416,1,1200147,1202002,-,1855
125,NZ_CP069053,1,878222,880068,-,1846
125,NZ_CP042446,1,1032610,1034456,-,1846
125,NZ_CP041215,1,1406101,1407956,+,1855
125,NZ_OX366353,1,1083407,1085262,+,1855
125,NZ_OX366387,1,48721,50576,-,1855
125,NZ_OX366368,1,44016,45862,-,1846
125,NZ_OX366379,1,44034,45880,-,1846
125,NZ_CP091195,1,470563,472418,-,1855
125,NZ_OX366375,1,44941,46796,-,1855
125,NZ_CP046925,1,1032460,1034306,-,1846
125,NZ_OX366318,1,43189,45035,-,1846
125,NZ_OX366319,1,44765,46620,-,1855
125,NZ_OX366332,1,44485,46340,-,1855
125,NZ_CP110359,1,423311,425166,+,1855
125,NZ_OU953855,1,111668,113514,+,1846
125,NZ_OX366272,1,1178883,1180738,-,1855
125,NZ_OX366347,1,75045,76884,+,1839
125,NZ_OU909470,1,881369,883222,-,1853
125,NZ_OX366363,1,853987,855842,-,1855
125,NZ_OX366364,1,1055251,1057106,-,1855
125,NZ_OX366359,1,44468,46323,-,1855
125,NZ_OX366349,1,244572,246427,+,1855
125,NZ_OX366380,1,33966,35821,+,1855
125,NZ_OX366344,1,914615,916470,-,1855
125,NZ_CP090900,1,1032612,1034458,-,1846
125,NZ_OX366352,1,47057,48912,-,1855
125,NZ_OX366362,1,216529,218384,+,1855
125,NZ_OX366400,1,129074,130920,+,1846
125,NZ_OX366327,1,45272,47127,-,1855
125,NZ_OX366367,1,247325,249170,+,1845
125,NZ_CP042444,1,1033966,1035812,-,1846
125,NZ_OX366326,1,46518,48364,-,1846
125,NZ_CP037426,1,1293278,1295133,-,1855
125,NZ_OX366339,1,1107935,1109790,+,1855
125,NZ_OX366355,1,48545,50400,-,1855
125,NZ_CP046922,1,1094529,1096375,-,1846
125,NZ_OX366370,1,946696,948551,-,1855
125,NZ_OX366385,1,1189657,1191512,-,1855
125,NZ_OX366399,1,44012,45858,-,1846
125,NZ_OX366395,1,44096,45942,+,1846
125,NZ_OX366396,1,1437609,1439464,+,1855
125,NZ_OX366351,1,51431,53277,-,1846
125,NZ_OX366381,1,46571,48426,-,1855
125,NZ_OX366342,1,396728,398583,+,1855
125,NZ_OX366369,1,45561,47416,-,1855
125,NZ_OX366356,1,43045,44900,-,1855
125,NZ_OX366377,1,43622,45468,-,1846
125,NZ_OX366388,1,195139,196994,-,1855
125,NZ_OX366357,1,143213,145058,+,1845
125,NZ_CP072012,1,1296539,1298385,-,1846
125,NZ_OX366398,1,514981,516827,-,1846
125,NC_002978,6,1032610,1034456,-,1846
125,NZ_OX366389,1,205969,207815,+,1846
125,NZ_OX366397,1,56843,58698,+,1855
125,NZ_OX366378,1,1209392,1211247,-,1855
125,NZ_CP090903,1,1032612,1034458,-,1846
125,NZ_OX366374,1,461928,463774,-,1846
125,NZ_CP090901,1,1032612,1034458,-,1846
125,NZ_CP046923,1,1010777,1012623,-,1846
125,NZ_CP069055,1,983859,985705,-,1846
125,NZ_CP072670,1,1032452,1034298,-,1846
125,NZ_CP090899,1,1032612,1034458,-,1846
125,NZ_CP046924,1,1031715,1033561,-,1846
125,NZ_OX366348,1,43784,45630,-,1846
125,NZ_CP046921,1,1094529,1096375,-,1846
125,NZ_OX366338,1,81883,83729,+,1846
125,NZ_CP054557,1,825811,827657,-,1846
125,NZ_CP072669,1,1032460,1034306,-,1846
125,NC_021089,1,1060813,1062668,-,1855
126,NZ_OX366376,1,397887,399080,+,1193
126,NZ_OX366393,1,74792,75984,+,1192
126,NZ_OX366372,1,504271,505464,+,1193
126,NZ_CP072672,1,1029018,1030211,-,1193
126,NZ_CP069060,1,874754,875947,-,1193
126,NZ_CP072667,1,1028992,1030185,-,1193
126,NZ_CP072671,1,1029000,1030193,-,1193
126,NZ_CP072668,1,1028987,1030180,-,1193
126,NZ_CP072666,1,1029000,1030193,-,1193
126,NZ_CP090902,1,1029152,1030345,-,1193
126,NZ_CP090948,1,1029150,1030343,-,1193
126,NZ_CP069052,1,780124,781317,+,1193
126,NZ_CP076228,1,890967,892160,-,1193
126,NZ_CP042445,1,1029140,1030333,-,1193
126,NZ_CP042904,1,1151472,1152665,-,1193
126,NC_012416,1,1196687,1197880,-,1193
126,NZ_CP069053,1,874762,875955,-,1193
126,NZ_CP042446,1,1029150,1030343,-,1193
126,NZ_CP041215,1,1410222,1411415,+,1193
126,NZ_OX366353,1,1087528,1088721,+,1193
126,NZ_OX366387,1,45261,46454,-,1193
126,NZ_OX366368,1,40556,41749,-,1193
126,NZ_OX366379,1,40574,41767,-,1193
126,NZ_CP091195,1,468906,470100,-,1194
126,NZ_OX366375,1,41481,42674,-,1193
126,NZ_CP046925,1,1029000,1030193,-,1193
126,NZ_OX366318,1,39729,40922,-,1193
126,NZ_OX366319,1,41288,42481,-,1193
126,NZ_OX366332,1,41026,42219,-,1193
126,NZ_CP110359,1,427432,428625,+,1193
126,NZ_OU953855,1,114218,115411,+,1193
126,NZ_OX366272,1,1175423,1176616,-,1193
126,NZ_OX366347,1,77363,78556,+,1193
126,NZ_OU909470,1,879721,880909,-,1188
126,NZ_OX366363,1,852331,853524,-,1193
126,NZ_OX366364,1,1053588,1054781,-,1193
126,NZ_OX366359,1,41009,42202,-,1193
126,NZ_OX366349,1,246884,248077,+,1193
126,NZ_OX366380,1,36292,37480,+,1188
126,NZ_OX366344,1,911180,912372,-,1192
126,NZ_CP090900,1,1029152,1030345,-,1193
126,NZ_OX366352,1,43598,44791,-,1193
126,NZ_OX366362,1,220651,221844,+,1193
126,NZ_OX366400,1,133187,134380,+,1193
126,NZ_OX366327,1,41812,43005,-,1193
126,NZ_OX366367,1,249640,250833,+,1193
126,NZ_CP042444,1,1030506,1031699,-,1193
126,NZ_OX366326,1,43058,44251,-,1193
126,NZ_CP037426,1,1289818,1291011,-,1193
126,NZ_OX366339,1,1112057,1113250,+,1193
126,NZ_OX366355,1,45085,46278,-,1193
126,NZ_CP046922,1,1091069,1092262,-,1193
126,NZ_OX366370,1,945046,946234,-,1188
126,NZ_OX366385,1,1187998,1189186,-,1188
126,NZ_OX366399,1,40552,41745,-,1193
126,NZ_OX366395,1,48451,49644,+,1193
126,NZ_OX366396,1,1441731,1442924,+,1193
126,NZ_OX366351,1,47971,49164,-,1193
126,NZ_OX366381,1,43111,44304,-,1193
126,NZ_OX366342,1,399040,400233,+,1193
126,NZ_OX366369,1,42101,43294,-,1193
126,NZ_OX366356,1,39481,40674,-,1193
126,NZ_OX366377,1,40162,41355,-,1193
126,NZ_OX366388,1,193483,194676,-,1193
126,NZ_OX366357,1,804733,805926,+,1193
126,NZ_CP072012,1,1293079,1294272,-,1193
126,NZ_OX366398,1,511521,512714,-,1193
126,NC_002978,6,1029150,1030343,-,1193
126,NZ_OX366389,1,210082,211275,+,1193
126,NZ_OX366397,1,60964,62157,+,1193
126,NZ_OX366378,1,1207736,1208929,-,1193
126,NZ_CP090903,1,1029152,1030345,-,1193
126,NZ_OX366374,1,458467,459660,-,1193
126,NZ_CP090901,1,1029152,1030345,-,1193
126,NZ_CP046923,1,1007317,1008510,-,1193
126,NZ_CP069055,1,980399,981592,-,1193
126,NZ_CP072670,1,1028992,1030185,-,1193
126,NZ_CP090899,1,1029152,1030345,-,1193
126,NZ_CP046924,1,1028255,1029448,-,1193
126,NZ_OX366348,1,40324,41517,-,1193
126,NZ_CP046921,1,1091069,1092262,-,1193
126,NZ_OX366338,1,85245,86438,+,1193
126,NZ_CP054557,1,822351,823544,-,1193
126,NZ_CP072669,1,1029000,1030193,-,1193
126,NC_021089,1,1057354,1058547,-,1193
127,NZ_OX366376,1,399253,399888,+,635
127,NZ_OX366393,1,76157,76792,+,635
127,NZ_OX366372,1,505637,506272,+,635
127,NZ_CP072672,1,1027871,1028500,-,629
127,NZ_CP069060,1,873607,874236,-,629
127,NZ_CP072667,1,1027845,1028474,-,629
127,NZ_CP072671,1,1027853,1028482,-,629
127,NZ_CP072668,1,1027840,1028469,-,629
127,NZ_CP072666,1,1027853,1028482,-,629
127,NZ_CP090902,1,1028005,1028634,-,629
127,NZ_CP090948,1,1028003,1028632,-,629
127,NZ_CP069052,1,781835,782479,+,644
127,NZ_CP076228,1,889799,890428,-,629
127,NZ_CP042445,1,1027993,1028622,-,629
127,NZ_CP042904,1,1150304,1150933,-,629
127,NC_012416,1,1195519,1196148,-,629
127,NZ_CP069053,1,873615,874244,-,629
127,NZ_CP042446,1,1028003,1028632,-,629
127,NZ_CP041215,1,1411954,1412598,+,644
127,NZ_OX366353,1,1089239,1089883,+,644
127,NZ_OX366387,1,44114,44743,-,629
127,NZ_OX366368,1,39388,40017,-,629
127,NZ_OX366379,1,39406,40035,-,629
127,NZ_CP091195,1,467722,468367,-,645
127,NZ_OX366375,1,40313,40942,-,629
127,NZ_CP046925,1,1027853,1028482,-,629
127,NZ_OX366318,1,38561,39190,-,629
127,NZ_OX366319,1,40141,40770,-,629
127,NZ_OX366332,1,39858,40487,-,629
127,NZ_CP110359,1,429143,429787,+,644
127,NZ_OU953855,1,115854,116499,+,645
127,NZ_OX366272,1,1174276,1174905,-,629
127,NZ_OX366347,1,79053,79697,+,644
127,NZ_OU909470,1,878525,879170,-,645
127,NZ_OX366363,1,851163,851792,-,629
127,NZ_OX366364,1,1052856,1053415,-,559
127,NZ_OX366359,1,39862,40491,-,629
127,NZ_OX366349,1,248250,248885,+,635
127,NZ_OX366380,1,38031,38676,+,645
127,NZ_OX366344,1,910362,911007,-,645
127,NZ_CP090900,1,1028005,1028634,-,629
127,NZ_OX366352,1,42430,43059,-,629
127,NZ_OX366362,1,222017,222635,+,618
127,NZ_OX366400,1,134919,135563,+,644
127,NZ_OX366327,1,40644,41273,-,629
127,NZ_OX366367,1,251006,251565,+,559
127,NZ_CP042444,1,1029359,1029988,-,629
127,NZ_OX366326,1,41890,42519,-,629
127,NZ_CP037426,1,1288650,1289279,-,629
127,NZ_OX366339,1,1113789,1114433,+,644
127,NZ_OX366355,1,43938,44567,-,629
127,NZ_CP046922,1,1089901,1090530,-,629
127,NZ_OX366370,1,944238,944873,-,635
127,NZ_OX366385,1,1186802,1187447,-,645
127,NZ_OX366399,1,39384,40013,-,629
127,NZ_OX366395,1,50288,50932,+,644
127,NZ_OX366396,1,1443442,1444086,+,644
127,NZ_OX366351,1,46803,47432,-,629
127,NZ_OX366381,1,41964,42593,-,629
127,NZ_OX366342,1,400406,401041,+,635
127,NZ_OX366369,1,40954,41583,-,629
127,NZ_OX366356,1,38364,38984,-,620
127,NZ_OX366377,1,38994,39623,-,629
127,NZ_OX366388,1,192299,192944,-,645
127,NZ_OX366357,1,806465,807109,+,644
127,NZ_CP072012,1,1291911,1292540,-,629
127,NZ_OX366398,1,510353,510982,-,629
127,NC_002978,6,1028003,1028632,-,629
127,NZ_OX366389,1,211814,212458,+,644
127,NZ_OX366397,1,62696,63340,+,644
127,NZ_OX366378,1,1206573,1207218,-,645
127,NZ_CP090903,1,1028005,1028634,-,629
127,NZ_OX366374,1,457395,458024,-,629
127,NZ_CP090901,1,1028005,1028634,-,629
127,NZ_CP046923,1,1006149,1006778,-,629
127,NZ_CP069055,1,979231,979860,-,629
127,NZ_CP072670,1,1027845,1028474,-,629
127,NZ_CP090899,1,1028005,1028634,-,629
127,NZ_CP046924,1,1027087,1027716,-,629
127,NZ_OX366348,1,39156,39785,-,629
127,NZ_CP046921,1,1089901,1090530,-,629
127,NZ_OX366338,1,87019,87663,+,644
127,NZ_CP054557,1,821204,821833,-,629
127,NZ_CP072669,1,1027853,1028482,-,629
127,NC_021089,1,1056207,1056836,-,629
258,NZ_OX366376,1,758331,764180,+,5849
258,NZ_OX366393,1,166297,172143,-,5846
258,NZ_OX366372,1,796135,801981,-,5846
258,NZ_CP072672,1,516096,521826,+,5730
258,NZ_CP069060,1,1240370,1246100,+,5730
258,NZ_CP072667,1,516078,521808,+,5730
258,NZ_CP072671,1,516078,521808,+,5730
258,NZ_CP072668,1,516065,521795,+,5730
258,NZ_CP072666,1,516078,521808,+,5730
258,NZ_CP090902,1,516230,521960,+,5730
258,NZ_CP090948,1,516230,521960,+,5730
258,NZ_CP069052,1,378463,384192,-,5729
258,NZ_CP076228,1,471840,477570,+,5730
258,NZ_CP042445,1,516230,521960,+,5730
258,NZ_CP042904,1,367639,373360,+,5721
258,NC_012416,1,368729,374450,+,5721
258,NZ_CP069053,1,1187380,1193109,-,5729
258,NZ_CP042446,1,516230,521960,+,5730
258,NZ_CP041215,1,1132687,1138399,-,5712
258,NZ_OX366353,1,47887,53611,-,5724
258,NZ_OX366387,1,1069543,1075264,+,5721
258,NZ_OX366368,1,735656,741385,-,5729
258,NZ_OX366379,1,691861,697590,-,5729
258,NZ_CP091195,1,634932,640662,+,5730
258,NZ_OX366375,1,911481,917211,+,5730
258,NZ_CP046925,1,516078,521808,+,5730
258,NZ_OX366318,1,642780,648509,-,5729
258,NZ_OX366319,1,643225,648982,+,5757
258,NZ_OX366332,1,763369,769081,-,5712
258,NZ_CP110359,1,974373,980104,+,5731
258,NZ_OU953855,1,1427539,1433269,+,5730
258,NZ_OX366272,1,545151,550881,+,5730
258,NZ_OX366347,1,1010965,1016710,+,5745
258,NZ_OU909470,1,272998,278844,-,5846
258,NZ_OX366363,1,266839,272569,+,5730
258,NZ_OX366364,1,900304,906134,+,5830
258,NZ_OX366359,1,530128,535840,-,5712
258,NZ_OX366349,1,1135104,1140950,-,5846
258,NZ_OX366380,1,622458,628299,+,5841
258,NZ_OX366344,1,400072,405918,+,5846
258,NZ_CP090900,1,516230,521960,+,5730
258,NZ_OX366352,1,433001,438713,-,5712
258,NZ_OX366362,1,577999,583698,-,5699
258,NZ_OX366400,1,603842,609572,+,5730
258,NZ_OX366327,1,692755,698598,-,5843
258,NZ_OX366367,1,649147,654977,-,5830
258,NZ_CP042444,1,516731,522461,+,5730
258,NZ_OX366326,1,737604,743333,-,5729
258,NZ_CP037426,1,331563,337292,-,5729
258,NZ_OX366339,1,367835,373564,-,5729
258,NZ_OX366355,1,710351,716108,+,5757
258,NZ_CP046922,1,379677,385406,-,5729
258,NZ_OX366370,1,656149,661848,+,5699
258,NZ_OX366385,1,1304351,1310197,+,5846
258,NZ_OX366399,1,661444,667173,-,5729
258,NZ_OX366395,1,681416,687244,-,5828
258,NZ_OX366396,1,808773,814503,+,5730
258,NZ_OX366351,1,559437,565166,-,5729
258,NZ_OX366381,1,917790,923547,+,5757
258,NZ_OX366342,1,1026811,1032658,+,5847
258,NZ_OX366369,1,821910,827667,+,5757
258,NZ_OX366356,1,733957,739678,+,5721
258,NZ_OX366377,1,849564,855284,-,5720
258,NZ_OX366388,1,717172,722902,+,5730
258,NZ_OX366357,1,793726,799448,+,5722
258,NZ_CP072012,1,591153,596883,+,5730
258,NZ_OX366398,1,626079,631799,-,5720
258,NC_002978,6,516230,521960,+,5730
258,NZ_OX366389,1,720779,726499,-,5720
258,NZ_OX366397,1,781067,786779,-,5712
258,NZ_OX366378,1,290860,296590,+,5730
258,NZ_CP090903,1,516230,521960,+,5730
258,NZ_OX366374,1,854851,860529,+,5678
258,NZ_CP090901,1,516230,521960,+,5730
258,NZ_CP046923,1,379677,385406,-,5729
258,NZ_CP069055,1,532981,538711,+,5730
258,NZ_CP072670,1,516070,521800,+,5730
258,NZ_CP090899,1,516230,521960,+,5730
258,NZ_CP046924,1,379677,385406,-,5729
258,NZ_OX366348,1,425676,431405,-,5729
258,NZ_CP046921,1,379677,385406,-,5729
258,NZ_OX366338,1,1176610,1182347,-,5737
258,NZ_CP054557,1,644,6371,-,5727
258,NZ_CP054557,1,1268109,1273838,-,5729
258,NZ_CP072669,1,516078,521808,+,5730
258,NC_021089,1,509487,515200,+,5713
259,NZ_OX366376,1,765704,766359,+,655
259,NZ_OX366393,1,164108,164772,-,664
259,NZ_OX366372,1,793946,794610,-,664
259,NZ_OX366342,1,1034182,1034847,+,665
260,NZ_OX366376,1,766552,767060,+,508
260,NZ_OX366393,1,163416,163925,-,509
260,NZ_OX366372,1,793254,793763,-,509
260,NZ_OX366344,1,491103,491611,+,508
260,NZ_OX366342,1,1035030,1035538,+,508
261,NZ_OX366376,1,772959,773690,+,731
261,NZ_OX366393,1,878282,879013,-,731
261,NZ_OX366372,1,786625,787356,-,731
261,NZ_OX366367,1,533324,534055,-,731
261,NZ_OX366367,1,696784,697515,+,731
261,NZ_OX366367,1,799287,800018,+,731
261,NZ_OX366367,1,1179303,1180034,+,731
261,NZ_OX366367,1,1485716,1486447,+,731
261,NZ_OX366342,1,800175,800906,+,731
261,NZ_OX366374,1,573239,573917,-,678
262,NZ_OX366376,1,778045,780809,+,2764
262,NZ_OX366393,1,870635,873399,-,2764
262,NZ_OX366372,1,778991,781755,-,2764
262,NZ_CP072672,1,151596,154375,+,2779
262,NZ_CP069060,1,161833,164612,+,2779
262,NZ_CP072667,1,151578,154357,+,2779
262,NZ_CP072671,1,151578,154357,+,2779
262,NZ_CP072668,1,151578,154357,+,2779
262,NZ_CP072666,1,151578,154357,+,2779
262,NZ_CP090902,1,151730,154509,+,2779
262,NZ_CP090948,1,151730,154509,+,2779
262,NZ_CP069052,1,75519,78298,-,2779
262,NZ_CP076228,1,154838,157617,+,2779
262,NZ_CP042445,1,151730,154509,+,2779
262,NZ_CP042904,1,84110,86841,-,2731
262,NC_012416,1,86691,89422,-,2731
262,NZ_CP069053,1,382665,385444,-,2779
262,NZ_CP042446,1,151730,154509,+,2779
262,NZ_CP041215,1,423854,426633,-,2779
262,NZ_OX366353,1,156991,159769,+,2778
262,NZ_OX366387,1,1288425,1291181,-,2756
262,NZ_OX366368,1,430509,433288,+,2779
262,NZ_OX366379,1,431527,434306,+,2779
262,NZ_CP091195,1,737009,739781,+,2772
262,NZ_OX366375,1,394527,397298,+,2771
262,NZ_CP046925,1,151578,154357,+,2779
262,NZ_OX366318,1,467400,470179,-,2779
262,NZ_OX366319,1,793012,795794,+,2782
262,NZ_OX366332,1,372604,375383,+,2779
262,NZ_CP110359,1,1149450,1152191,+,2741
262,NZ_OU953855,1,334176,336925,+,2749
262,NZ_OX366272,1,800762,803518,-,2756
262,NZ_OX366347,1,475544,478328,-,2784
262,NZ_OU909470,1,1298647,1301400,+,2753
262,NZ_OX366363,1,555965,558744,+,2779
262,NZ_OX366364,1,28373,31148,+,2775
262,NZ_OX366359,1,405503,408272,-,2769
262,NZ_OX366349,1,495583,498347,+,2764
262,NZ_OX366380,1,708028,710775,-,2747
262,NZ_OX366344,1,500226,502990,-,2764
262,NZ_CP090900,1,151730,154509,+,2779
262,NZ_OX366352,1,346346,349125,+,2779
262,NZ_OX366362,1,749326,752084,+,2758
262,NZ_OX366400,1,337142,339921,-,2779
262,NZ_OX366327,1,514510,517292,-,2782
262,NZ_OX366367,1,1313473,1316246,+,2773
262,NZ_CP042444,1,151668,154447,+,2779
262,NZ_OX366326,1,425051,427830,+,2779
262,NZ_CP037426,1,510900,513666,+,2766
262,NZ_OX366339,1,182594,185355,+,2761
262,NZ_OX366355,1,939267,942049,+,2782
262,NZ_CP046922,1,151423,154202,+,2779
262,NZ_OX366370,1,423051,425826,+,2775
262,NZ_OX366385,1,1065445,1068192,+,2747
262,NZ_OX366399,1,430011,432790,+,2779
262,NZ_OX366395,1,1065485,1068256,+,2771
262,NZ_OX366396,1,990359,993120,+,2761
262,NZ_OX366351,1,381256,384035,-,2779
262,NZ_OX366381,1,70821,73603,+,2782
262,NZ_OX366342,1,805340,808103,+,2763
262,NZ_OX366369,1,365220,368001,-,2781
262,NZ_OX366356,1,400675,403454,+,2779
262,NZ_OX366377,1,802678,805457,+,2779
262,NZ_OX366388,1,1294257,1297028,-,2771
262,NZ_OX366357,1,59968,62668,-,2700
262,NZ_CP072012,1,352913,355692,+,2779
262,NZ_OX366398,1,1089537,1092316,+,2779
262,NC_002978,6,151730,154509,+,2779
262,NZ_OX366389,1,599695,602474,+,2779
262,NZ_OX366397,1,375238,378017,+,2779
262,NZ_OX366378,1,1063305,1066077,+,2772
262,NZ_CP090903,1,151730,154509,+,2779
262,NZ_OX366374,1,1061610,1064345,+,2735
262,NZ_CP090901,1,151730,154509,+,2779
262,NZ_CP046923,1,151423,154202,+,2779
262,NZ_CP069055,1,71654,74433,-,2779
262,NZ_CP072670,1,151578,154357,+,2779
262,NZ_CP090899,1,151730,154509,+,2779
262,NZ_CP046924,1,151423,154202,+,2779
262,NZ_OX366348,1,885563,888342,+,2779
262,NZ_CP046921,1,151423,154202,+,2779
262,NZ_OX366338,1,127281,129992,+,2711
262,NZ_CP054557,1,490363,493142,-,2779
262,NZ_CP072669,1,151578,154357,+,2779
262,NC_021089,1,91093,93872,+,2779
263,NZ_OX366376,1,781307,782236,+,929
263,NZ_OX366393,1,869208,870137,-,929
263,NZ_OX366372,1,777564,778493,-,929
263,NZ_CP072672,1,154412,155371,+,959
263,NZ_CP069060,1,164649,165608,+,959
263,NZ_CP072667,1,154394,155353,+,959
263,NZ_CP072671,1,154394,155353,+,959
263,NZ_CP072668,1,154394,155353,+,959
263,NZ_CP072666,1,154394,155353,+,959
263,NZ_CP090902,1,154546,155505,+,959
263,NZ_CP090948,1,154546,155505,+,959
263,NZ_CP069052,1,74523,75482,-,959
263,NZ_CP076228,1,157654,158613,+,959
263,NZ_CP042445,1,154546,155505,+,959
263,NZ_CP042904,1,83114,84073,-,959
263,NC_012416,1,85695,86654,-,959
263,NZ_CP069053,1,381669,382628,-,959
263,NZ_CP042446,1,154546,155505,+,959
263,NZ_CP041215,1,422398,423356,-,958
263,NZ_OX366353,1,160267,161224,+,957
263,NZ_OX366387,1,1287429,1288388,-,959
263,NZ_OX366368,1,433325,434284,+,959
263,NZ_OX366379,1,434343,435302,+,959
263,NZ_CP091195,1,739818,740777,+,959
263,NZ_OX366375,1,397335,398294,+,959
263,NZ_CP046925,1,154394,155353,+,959
263,NZ_OX366318,1,466404,467363,-,959
263,NZ_OX366319,1,795831,796790,+,959
263,NZ_OX366332,1,375881,376839,+,958
263,NZ_CP110359,1,1152228,1153187,+,959
263,NZ_OU953855,1,336962,337903,+,941
263,NZ_OX366272,1,799766,800725,-,959
263,NZ_OX366347,1,474548,475507,-,959
263,NZ_OU909470,1,1301440,1302399,+,959
263,NZ_OX366363,1,558781,559740,+,959
263,NZ_OX366364,1,31185,32152,+,967
263,NZ_OX366359,1,404047,405005,-,958
263,NZ_OX366349,1,498384,499313,+,929
263,NZ_OX366380,1,707032,707991,-,959
263,NZ_OX366344,1,498799,499728,-,929
263,NZ_CP090900,1,154546,155505,+,959
263,NZ_OX366352,1,349623,350581,+,958
263,NZ_OX366362,1,752121,753008,+,887
263,NZ_OX366400,1,336146,337105,-,959
263,NZ_OX366327,1,513511,514470,-,959
263,NZ_OX366367,1,1316283,1317250,+,967
263,NZ_CP042444,1,154484,155443,+,959
263,NZ_OX366326,1,427867,428826,+,959
263,NZ_CP037426,1,513703,514662,+,959
263,NZ_OX366339,1,185392,186351,+,959
263,NZ_OX366355,1,942086,943045,+,959
263,NZ_CP046922,1,154239,155198,+,959
263,NZ_OX366370,1,426324,427281,+,957
263,NZ_OX366385,1,1068229,1069188,+,959
263,NZ_OX366399,1,432827,433786,+,959
263,NZ_OX366395,1,1068747,1069676,+,929
263,NZ_OX366396,1,993157,994116,+,959
263,NZ_OX366351,1,380260,381219,-,959
263,NZ_OX366381,1,73640,74599,+,959
263,NZ_OX366342,1,808601,809530,+,929
263,NZ_OX366369,1,364224,365183,-,959
263,NZ_OX366356,1,403491,404450,+,959
263,NZ_OX366377,1,805494,806453,+,959
263,NZ_OX366388,1,1293261,1294220,-,959
263,NZ_OX366357,1,58973,59931,-,958
263,NZ_CP072012,1,355729,356688,+,959
263,NZ_OX366398,1,1092353,1093312,+,959
263,NC_002978,6,154546,155505,+,959
263,NZ_OX366389,1,602511,603470,+,959
263,NZ_OX366397,1,378515,379473,+,958
263,NZ_OX366378,1,1066114,1067073,+,959
263,NZ_CP090903,1,154546,155505,+,959
263,NZ_OX366374,1,1067964,1068861,+,897
263,NZ_CP090901,1,154546,155505,+,959
263,NZ_CP046923,1,154239,155198,+,959
263,NZ_CP069055,1,70658,71617,-,959
263,NZ_CP072670,1,154394,155353,+,959
263,NZ_CP090899,1,154546,155505,+,959
263,NZ_CP046924,1,154239,155198,+,959
263,NZ_OX366348,1,888379,889338,+,959
263,NZ_CP046921,1,154239,155198,+,959
263,NZ_OX366338,1,130490,131390,+,900
263,NZ_CP054557,1,489367,490326,-,959
263,NZ_CP072669,1,154394,155353,+,959
263,NC_021089,1,94370,95328,+,958
264,NZ_OX366376,1,782867,784926,+,2059
264,NZ_OX366393,1,866518,868577,-,2059
264,NZ_OX366372,1,774874,776933,-,2059
264,NZ_CP072672,1,155985,158028,+,2043
264,NZ_CP069060,1,166222,168265,+,2043
264,NZ_CP072667,1,155967,158010,+,2043
264,NZ_CP072671,1,155967,158010,+,2043
264,NZ_CP072668,1,155967,158010,+,2043
264,NZ_CP072666,1,155967,158010,+,2043
264,NZ_CP090902,1,156119,158162,+,2043
264,NZ_CP090948,1,156119,158162,+,2043
264,NZ_CP069052,1,71861,73909,-,2048
264,NZ_CP076228,1,159227,161275,+,2048
264,NZ_CP042445,1,156119,158162,+,2043
264,NZ_CP042904,1,80515,82500,-,1985
264,NC_012416,1,83096,85081,-,1985
264,NZ_CP069053,1,379012,381055,-,2043
264,NZ_CP042446,1,156119,158162,+,2043
264,NZ_CP041215,1,419797,421784,-,1987
264,NZ_OX366353,1,161838,163825,+,1987
264,NZ_OX366387,1,1284767,1286815,-,2048
264,NZ_OX366368,1,434898,436946,+,2048
264,NZ_OX366379,1,435916,437964,+,2048
264,NZ_CP091195,1,741391,743441,+,2050
264,NZ_OX366375,1,398908,400893,+,1985
264,NZ_CP046925,1,155967,158010,+,2043
264,NZ_OX366318,1,463742,465790,-,2048
264,NZ_OX366319,1,797404,799389,+,1985
264,NZ_OX366332,1,377453,379440,+,1987
264,NZ_CP110359,1,1153801,1155849,+,2048
264,NZ_OU953855,1,22893,24936,-,2043
264,NZ_OX366272,1,797109,799152,-,2043
264,NZ_OX366347,1,471886,473934,-,2048
264,NZ_OU909470,1,1303022,1304996,+,1974
264,NZ_OX366363,1,560354,562402,+,2048
264,NZ_OX366364,1,32775,34833,+,2058
264,NZ_OX366359,1,401446,403433,-,1987
264,NZ_OX366349,1,499944,502003,+,2059
264,NZ_OX366380,1,704359,706409,-,2050
264,NZ_OX366344,1,496109,498168,-,2059
264,NZ_CP090900,1,156119,158162,+,2043
264,NZ_OX366352,1,351195,353182,+,1987
264,NZ_OX366362,1,989640,991674,-,2034
264,NZ_OX366400,1,333484,335532,-,2048
264,NZ_OX366327,1,510849,512897,-,2048
264,NZ_OX366367,1,1317873,1319923,+,2050
264,NZ_CP042444,1,156057,158100,+,2043
264,NZ_OX366326,1,429440,431493,+,2053
264,NZ_CP037426,1,515276,517261,+,1985
264,NZ_OX366339,1,223239,225224,-,1985
264,NZ_OX366355,1,943659,945644,+,1985
264,NZ_CP046922,1,155812,157860,+,2048
264,NZ_OX366370,1,427897,429962,+,2065
264,NZ_OX366385,1,1069811,1071861,+,2050
264,NZ_OX366399,1,434400,436448,+,2048
264,NZ_OX366395,1,1070305,1072292,+,1987
264,NZ_OX366396,1,996600,998585,+,1985
264,NZ_OX366351,1,377598,379646,-,2048
264,NZ_OX366381,1,75212,77197,+,1985
264,NZ_OX366342,1,810161,812219,+,2058
264,NZ_OX366369,1,361625,363610,-,1985
264,NZ_OX366356,1,405169,407152,+,1983
264,NZ_OX366377,1,807067,809115,+,2048
264,NZ_OX366388,1,1290597,1292647,-,2050
264,NZ_OX366357,1,56301,58359,-,2058
264,NZ_CP072012,1,357302,359350,+,2048
264,NZ_OX366398,1,1093926,1095974,+,2048
264,NC_002978,6,156119,158162,+,2043
264,NZ_OX366389,1,604084,606132,+,2048
264,NZ_OX366397,1,380087,382074,+,1987
264,NZ_OX366378,1,1067687,1069737,+,2050
264,NZ_CP090903,1,156119,158162,+,2043
264,NZ_OX366374,1,1086471,1088412,-,1941
264,NZ_CP090901,1,156119,158162,+,2043
264,NZ_CP046923,1,155812,157860,+,2048
264,NZ_CP069055,1,67996,70044,-,2048
264,NZ_CP072670,1,155967,158010,+,2043
264,NZ_CP090899,1,156119,158162,+,2043
264,NZ_CP046924,1,155812,157860,+,2048
264,NZ_OX366348,1,889978,892000,+,2022
264,NZ_CP046921,1,155812,157860,+,2048
264,NZ_OX366338,1,132040,134088,+,2048
264,NZ_CP054557,1,486706,488754,-,2048
264,NZ_CP072669,1,155967,158010,+,2043
264,NC_021089,1,95942,97929,+,1987
265,NZ_OX366376,1,785504,786090,+,586
265,NZ_OX366393,1,865034,865620,-,586
265,NZ_OX366372,1,773615,774201,-,586
265,NZ_CP072672,1,452415,453005,+,590
265,NZ_CP069060,1,439897,440487,+,590
265,NZ_CP072667,1,452397,452987,+,590
265,NZ_CP072671,1,452397,452987,+,590
265,NZ_CP072668,1,452384,452974,+,590
265,NZ_CP072666,1,452397,452987,+,590
265,NZ_CP090902,1,452549,453139,+,590
265,NZ_CP090948,1,452549,453139,+,590
265,NZ_CP069052,1,430932,431522,-,590
265,NZ_CP076228,1,259625,260215,-,590
265,NZ_CP042445,1,452549,453139,+,590
265,NZ_CP042904,1,302208,302744,+,536
265,NC_012416,1,303301,303837,+,536
265,NZ_CP069053,1,106782,107372,-,590
265,NZ_CP042446,1,452549,453139,+,590
265,NZ_CP041215,1,1211632,1212222,+,590
265,NZ_OX366353,1,427374,427964,+,590
265,NZ_OX366387,1,1061279,1061815,-,536
265,NZ_OX366368,1,781409,781999,-,590
265,NZ_OX366379,1,737614,738204,-,590
265,NZ_CP091195,1,336344,336934,-,590
265,NZ_OX366375,1,821862,822398,-,536
265,NZ_CP046925,1,452397,452987,+,590
265,NZ_OX366318,1,689490,690080,-,590
265,NZ_OX366319,1,474989,475579,-,590
265,NZ_OX366332,1,841754,842344,+,590
265,NZ_CP110359,1,722416,723006,-,590
265,NZ_OU953855,1,1377892,1378482,+,590
265,NZ_OX366272,1,499894,500484,+,590
265,NZ_OX366347,1,967950,968540,+,590
265,NZ_OU909470,1,116216,116792,-,576
265,NZ_OX366363,1,223355,223945,+,590
265,NZ_OX366364,1,824082,824661,+,579
265,NZ_OX366359,1,577474,578064,-,590
265,NZ_OX366349,1,1265828,1266418,-,590
265,NZ_OX366380,1,503388,503978,+,590
265,NZ_OX366344,1,605360,605946,-,586
265,NZ_CP090900,1,452549,453139,+,590
265,NZ_OX366352,1,570861,571451,+,590
265,NZ_OX366362,1,1022243,1022833,-,590
265,NZ_OX366400,1,560218,560808,+,590
265,NZ_OX366327,1,739006,739542,-,536
265,NZ_OX366367,1,738729,739308,-,579
265,NZ_CP042444,1,453050,453640,+,590
265,NZ_OX366326,1,783463,784053,-,590
265,NZ_CP037426,1,289021,289557,+,536
265,NZ_OX366339,1,564323,564913,-,590
265,NZ_OX366355,1,490524,491114,+,590
265,NZ_CP046922,1,510393,510983,-,590
265,NZ_OX366370,1,481596,482186,+,590
265,NZ_OX366385,1,730026,730616,-,590
265,NZ_OX366399,1,707197,707787,-,590
265,NZ_OX366395,1,695903,696493,-,590
265,NZ_OX366396,1,850384,850974,-,590
265,NZ_OX366351,1,17866,18456,-,590
265,NZ_OX366351,1,606146,606736,-,590
265,NZ_OX366381,1,719294,719884,+,590
265,NZ_OX366342,1,812914,813500,+,586
265,NZ_OX366369,1,782140,782730,+,590
265,NZ_OX366356,1,693679,694269,+,590
265,NZ_OX366377,1,895909,896499,-,590
265,NZ_OX366388,1,673416,674006,+,590
265,NZ_OX366357,1,1359633,1360223,-,590
265,NZ_CP072012,1,550457,551047,+,590
265,NZ_OX366398,1,671581,672171,-,590
265,NC_002978,6,452549,453139,+,590
265,NZ_OX366389,1,767328,767918,-,590
265,NZ_OX366397,1,859502,860092,+,590
265,NZ_OX366378,1,459940,460530,+,590
265,NZ_CP090903,1,452549,453139,+,590
265,NZ_OX366374,1,825522,826058,-,536
265,NZ_CP090901,1,452549,453139,+,590
265,NZ_CP046923,1,426641,427231,-,590
265,NZ_CP069055,1,490996,491586,+,590
265,NZ_CP072670,1,452389,452979,+,590
265,NZ_CP090899,1,452549,453139,+,590
265,NZ_CP046924,1,447579,448169,-,590
265,NZ_OX366348,1,473047,473637,-,590
265,NZ_CP046921,1,510393,510983,-,590
265,NZ_OX366338,1,766723,767313,-,590
265,NZ_CP054557,1,211107,211697,+,590
265,NZ_CP072669,1,452397,452987,+,590
265,NC_021089,1,370963,371553,-,590
266,NZ_OX366376,1,786092,786679,+,587
266,NZ_OX366393,1,864445,865032,-,587
266,NZ_OX366372,1,773026,773613,-,587
266,NZ_CP072672,1,453006,453581,+,575
266,NZ_CP069060,1,440488,441063,+,575
266,NZ_CP072667,1,452988,453563,+,575
266,NZ_CP072671,1,452988,453563,+,575
266,NZ_CP072668,1,452975,453550,+,575
266,NZ_CP072666,1,452988,453563,+,575
266,NZ_CP090902,1,453140,453715,+,575
266,NZ_CP090948,1,453140,453715,+,575
266,NZ_CP069052,1,430356,430930,-,574
266,NZ_CP076228,1,259049,259623,-,574
266,NZ_CP042445,1,453140,453715,+,575
266,NZ_CP069053,1,106206,106780,-,574
266,NZ_CP042446,1,453140,453715,+,575
266,NZ_CP041215,1,1212223,1212798,+,575
266,NZ_OX366353,1,427965,428540,+,575
266,NZ_OX366368,1,780833,781407,-,574
266,NZ_OX366379,1,737038,737612,-,574
266,NZ_CP091195,1,335768,336342,-,574
266,NZ_CP046925,1,452988,453563,+,575
266,NZ_OX366318,1,688914,689488,-,574
266,NZ_OX366319,1,474413,474987,-,574
266,NZ_OX366332,1,842345,842920,+,575
266,NZ_CP110359,1,721840,722414,-,574
266,NZ_OU953855,1,1378483,1379058,+,575
266,NZ_OX366272,1,500485,501060,+,575
266,NZ_OX366347,1,968541,969116,+,575
266,NZ_OU909470,1,115635,116214,-,579
266,NZ_OX366363,1,223946,224521,+,575
266,NZ_OX366364,1,824663,825232,+,569
266,NZ_OX366359,1,576898,577472,-,574
266,NZ_OX366349,1,1265261,1265826,-,565
266,NZ_OX366380,1,503979,504545,+,566
266,NZ_OX366344,1,604771,605358,-,587
266,NZ_CP090900,1,453140,453715,+,575
266,NZ_OX366352,1,571452,572027,+,575
266,NZ_OX366362,1,1021676,1022241,-,565
266,NZ_OX366400,1,560809,561384,+,575
266,NZ_OX366367,1,738149,738727,-,578
266,NZ_CP042444,1,453641,454216,+,575
266,NZ_OX366326,1,782887,783461,-,574
266,NZ_OX366339,1,563747,564321,-,574
266,NZ_OX366355,1,491115,491690,+,575
266,NZ_CP046922,1,509817,510391,-,574
266,NZ_OX366370,1,482187,482762,+,575
266,NZ_OX366385,1,729459,730024,-,565
266,NZ_OX366399,1,706621,707195,-,574
266,NZ_OX366395,1,695327,695901,-,574
266,NZ_OX366396,1,849808,850382,-,574
266,NZ_OX366351,1,17290,17864,-,574
266,NZ_OX366351,1,605570,606144,-,574
266,NZ_OX366381,1,719885,720460,+,575
266,NZ_OX366342,1,813502,814089,+,587
266,NZ_OX366369,1,782731,783306,+,575
266,NZ_OX366356,1,694270,694845,+,575
266,NZ_OX366377,1,895333,895907,-,574
266,NZ_OX366388,1,674007,674582,+,575
266,NZ_OX366357,1,1359057,1359631,-,574
266,NZ_CP072012,1,551048,551623,+,575
266,NZ_OX366398,1,671005,671579,-,574
266,NC_002978,6,453140,453715,+,575
266,NZ_OX366389,1,766752,767326,-,574
266,NZ_OX366397,1,860093,860668,+,575
266,NZ_OX366378,1,460531,461106,+,575
266,NZ_CP090903,1,453140,453715,+,575
266,NZ_CP090901,1,453140,453715,+,575
266,NZ_CP046923,1,426065,426639,-,574
266,NZ_CP069055,1,491587,492162,+,575
266,NZ_CP072670,1,452980,453555,+,575
266,NZ_CP090899,1,453140,453715,+,575
266,NZ_CP046924,1,447003,447577,-,574
266,NZ_OX366348,1,472471,473045,-,574
266,NZ_CP046921,1,509817,510391,-,574
266,NZ_OX366338,1,766156,766721,-,565
266,NZ_CP054557,1,211698,212273,+,575
266,NZ_CP072669,1,452988,453563,+,575
266,NC_021089,1,370387,370961,-,574
267,NZ_OX366376,1,788525,790990,+,2465
267,NZ_OX366393,1,860288,862753,-,2465
267,NZ_OX366372,1,768673,771138,-,2465
267,NZ_CP072672,1,445429,447840,-,2411
267,NZ_CP069060,1,432953,435364,-,2411
267,NZ_CP072667,1,445411,447822,-,2411
267,NZ_CP072671,1,445411,447822,-,2411
267,NZ_CP072668,1,445398,447809,-,2411
267,NZ_CP072666,1,445411,447822,-,2411
267,NZ_CP090902,1,445563,447974,-,2411
267,NZ_CP090948,1,445563,447974,-,2411
267,NZ_CP069052,1,436055,438466,+,2411
267,NZ_CP076228,1,264432,266843,+,2411
267,NZ_CP042445,1,445563,447974,-,2411
267,NZ_CP042904,1,290652,292940,-,2288
267,NC_012416,1,293235,295523,-,2288
267,NZ_CP069053,1,111905,114316,+,2411
267,NZ_CP042446,1,445563,447974,-,2411
267,NZ_CP041215,1,1204494,1206779,-,2285
267,NZ_OX366353,1,420309,422594,-,2285
267,NZ_OX366387,1,1087988,1090465,-,2477
267,NZ_OX366368,1,786772,789183,+,2411
267,NZ_OX366379,1,742977,745388,+,2411
267,NZ_CP091195,1,223606,225903,-,2297
267,NZ_OX366375,1,827553,829922,+,2369
267,NZ_CP046925,1,445411,447822,-,2411
267,NZ_OX366318,1,695259,697571,+,2312
267,NZ_OX366319,1,480668,482947,+,2279
267,NZ_OX366332,1,834532,836817,-,2285
267,NZ_CP110359,1,730232,732508,+,2276
267,NZ_OU953855,1,1554146,1556533,-,2387
267,NZ_OX366272,1,490445,492730,-,2285
267,NZ_OX366347,1,958225,960528,-,2303
267,NZ_OU909470,1,109553,112027,-,2474
267,NZ_OX366363,1,215537,217915,-,2378
267,NZ_OX366364,1,814552,817017,-,2465
267,NZ_OX366359,1,582839,585124,+,2285
267,NZ_OX366349,1,1260850,1263315,-,2465
267,NZ_OX366380,1,506355,508742,+,2387
267,NZ_OX366344,1,599843,602308,-,2465
267,NZ_CP090900,1,445563,447974,-,2411
267,NZ_OX366352,1,563561,565846,-,2285
267,NZ_OX366362,1,178243,180672,+,2429
267,NZ_OX366400,1,551704,554016,-,2312
267,NZ_OX366327,1,747279,749555,+,2276
267,NZ_OX366367,1,745746,748253,+,2507
267,NZ_CP042444,1,446064,448475,-,2411
267,NZ_OX366326,1,789233,791545,+,2312
267,NZ_CP037426,1,281503,283872,-,2369
267,NZ_OX366339,1,398778,401255,-,2477
267,NZ_OX366355,1,483086,485365,-,2279
267,NZ_CP046922,1,515558,517969,+,2411
267,NZ_OX366370,1,485711,488065,+,2354
267,NZ_OX366385,1,724995,727382,-,2387
267,NZ_OX366399,1,712560,714971,+,2411
267,NZ_OX366395,1,701132,703501,+,2369
267,NZ_OX366396,1,707325,709802,-,2477
267,NZ_OX366351,1,612767,615079,+,2312
267,NZ_OX366381,1,711856,714135,-,2279
267,NZ_OX366342,1,815793,818192,+,2399
267,NZ_OX366369,1,774655,776934,-,2279
267,NZ_OX366356,1,683832,686201,-,2369
267,NZ_OX366377,1,906402,908693,+,2291
267,NZ_OX366388,1,663570,665882,-,2312
267,NZ_OX366357,1,169067,171529,-,2462
267,NZ_CP072012,1,543273,545684,-,2411
267,NZ_OX366398,1,209484,211775,-,2291
267,NC_002978,6,445563,447974,-,2411
267,NZ_OX366389,1,812953,815244,+,2291
267,NZ_OX366397,1,852202,854487,-,2285
267,NZ_OX366378,1,359208,361505,-,2297
267,NZ_CP090903,1,445563,447974,-,2411
267,NZ_OX366374,1,796967,799444,-,2477
267,NZ_CP090901,1,445563,447974,-,2411
267,NZ_CP046923,1,431806,434217,+,2411
267,NZ_CP069055,1,483890,486301,-,2411
267,NZ_CP072670,1,445403,447814,-,2411
267,NZ_CP090899,1,445563,447974,-,2411
267,NZ_CP046924,1,452744,455155,+,2411
267,NZ_OX366348,1,481398,483665,+,2267
267,NZ_CP046921,1,515558,517969,+,2411
267,NZ_OX366338,1,774540,776894,+,2354
267,NZ_CP054557,1,199936,202203,-,2267
267,NZ_CP072669,1,445411,447822,-,2411
267,NC_021089,1,376406,378691,+,2285
268,NZ_OX366376,1,796663,797281,+,618
268,NZ_OX366393,1,652452,653070,-,618
268,NZ_OX366372,1,566748,567366,+,618
268,NZ_CP072672,1,441524,442142,-,618
268,NZ_CP069060,1,429250,429868,-,618
268,NZ_CP072667,1,441506,442124,-,618
268,NZ_CP072671,1,441506,442124,-,618
268,NZ_CP072668,1,441493,442111,-,618
268,NZ_CP072666,1,441506,442124,-,618
268,NZ_CP090902,1,441658,442276,-,618
268,NZ_CP090948,1,441658,442276,-,618
268,NZ_CP069052,1,441551,442169,+,618
268,NZ_CP076228,1,271574,272192,+,618
268,NZ_CP042445,1,441658,442276,-,618
268,NZ_CP042904,1,285409,286027,-,618
268,NC_012416,1,287993,288611,-,618
268,NZ_CP069053,1,117401,118019,+,618
268,NZ_CP042446,1,441658,442276,-,618
268,NZ_CP041215,1,1200674,1201292,-,618
268,NZ_OX366353,1,416488,417106,-,618
268,NZ_OX366387,1,1084049,1084667,-,618
268,NZ_OX366368,1,792477,793095,+,618
268,NZ_OX366379,1,749968,750586,+,618
268,NZ_CP091195,1,219838,220456,-,618
268,NZ_OX366375,1,835007,835625,+,618
268,NZ_CP046925,1,441506,442124,-,618
268,NZ_OX366318,1,700541,701159,+,618
268,NZ_OX366319,1,488688,489306,+,618
268,NZ_OX366332,1,830641,831259,-,618
268,NZ_CP110359,1,735821,736439,+,618
268,NZ_OU953855,1,1550243,1550861,-,618
268,NZ_OX366272,1,485571,486189,-,618
268,NZ_OX366347,1,954397,955015,-,618
268,NZ_OU909470,1,105652,106270,-,618
268,NZ_OX366363,1,211083,211701,-,618
268,NZ_OX366364,1,810675,811293,-,618
268,NZ_OX366359,1,588348,588966,+,618
268,NZ_OX366349,1,1256952,1257570,-,618
268,NZ_OX366380,1,511805,512423,+,618
268,NZ_OX366344,1,596396,597014,-,618
268,NZ_CP090900,1,441658,442276,-,618
268,NZ_OX366352,1,559695,560313,-,618
268,NZ_OX366362,1,183393,184011,+,618
268,NZ_OX366400,1,546651,547269,-,618
268,NZ_OX366327,1,754139,754757,+,618
268,NZ_OX366367,1,751546,752151,+,605
268,NZ_CP042444,1,442159,442777,-,618
268,NZ_OX366326,1,794515,795133,+,618
268,NZ_CP037426,1,274884,275502,-,618
268,NZ_OX366339,1,396389,397007,-,618
268,NZ_OX366355,1,478142,478760,-,618
268,NZ_CP046922,1,521256,521874,+,618
268,NZ_OX366370,1,747490,748108,-,618
268,NZ_OX366385,1,720463,721081,-,618
268,NZ_OX366399,1,719552,720170,+,618
268,NZ_OX366395,1,475029,475643,+,614
268,NZ_OX366396,1,704987,705598,-,611
268,NZ_OX366351,1,619852,620470,+,618
268,NZ_OX366381,1,647242,647860,+,618
268,NZ_OX366342,1,821412,822030,+,618
268,NZ_OX366369,1,770003,770621,-,618
268,NZ_OX366356,1,678703,679321,-,618
268,NZ_OX366377,1,911757,912375,+,618
268,NZ_OX366388,1,659841,660459,-,618
268,NZ_OX366357,1,287470,288088,-,618
268,NZ_CP072012,1,539723,540341,-,618
268,NZ_OX366398,1,205798,206416,-,618
268,NC_002978,6,441658,442276,-,618
268,NZ_OX366389,1,818307,818925,+,618
268,NZ_OX366397,1,848336,848954,-,618
268,NZ_OX366378,1,355443,356061,-,618
268,NZ_CP090903,1,441658,442276,-,618
268,NZ_OX366374,1,141994,142605,+,611
268,NZ_CP090901,1,441658,442276,-,618
268,NZ_CP046923,1,437504,438122,+,618
268,NZ_CP069055,1,478536,479154,-,618
268,NZ_CP072670,1,441498,442116,-,618
268,NZ_CP090899,1,441658,442276,-,618
268,NZ_CP046924,1,458442,459060,+,618
268,NZ_OX366348,1,487976,488594,+,618
268,NZ_CP046921,1,521256,521874,+,618
268,NZ_OX366338,1,813439,814053,-,614
268,NZ_CP054557,1,193832,194450,-,618
268,NZ_CP072669,1,441506,442124,-,618
268,NC_021089,1,382040,382658,+,618
269,NZ_OX366376,1,799497,800830,+,1333
269,NZ_OX366393,1,648903,650236,-,1333
269,NZ_OX366372,1,569561,570894,+,1333
269,NZ_CP072672,1,236192,237524,+,1332
269,NZ_CP069060,1,245625,246957,+,1332
269,NZ_CP072667,1,236174,237506,+,1332
269,NZ_CP072671,1,236174,237506,+,1332
269,NZ_CP072668,1,236174,237506,+,1332
269,NZ_CP072666,1,236174,237506,+,1332
269,NZ_CP090902,1,236326,237658,+,1332
269,NZ_CP090948,1,236326,237658,+,1332
269,NZ_CP069052,1,240290,241622,+,1332
269,NZ_CP076228,1,510477,511810,-,1333
269,NZ_CP042445,1,236326,237658,+,1332
269,NZ_CP042904,1,244918,246250,+,1332
269,NC_012416,1,247500,248832,+,1332
269,NZ_CP069053,1,300320,301652,-,1332
269,NZ_CP042446,1,236326,237658,+,1332
269,NZ_CP041215,1,681916,683248,+,1332
269,NZ_OX366353,1,460917,462249,-,1332
269,NZ_OX366387,1,1013622,1014954,+,1332
269,NZ_OX366368,1,514427,515760,+,1333
269,NZ_OX366379,1,515472,516805,+,1333
269,NZ_CP091195,1,665550,666883,-,1333
269,NZ_OX366375,1,618594,619926,+,1332
269,NZ_CP046925,1,236174,237506,+,1332
269,NZ_OX366318,1,618000,619333,+,1333
269,NZ_OX366319,1,673911,675243,-,1332
269,NZ_OX366332,1,511893,513225,+,1332
269,NZ_CP110359,1,1005473,1006805,-,1332
269,NZ_OU953855,1,1571672,1573005,-,1333
269,NZ_OX366272,1,708841,710173,-,1332
269,NZ_OX366347,1,628029,629361,+,1332
269,NZ_OU909470,1,102031,103364,-,1333
269,NZ_OX366363,1,402378,403710,-,1332
269,NZ_OX366364,1,806832,808160,-,1328
269,NZ_OX366359,1,509975,511307,+,1332
269,NZ_OX366349,1,1252089,1253422,-,1333
269,NZ_OX366380,1,514542,515875,+,1333
269,NZ_OX366344,1,593354,594687,-,1333
269,NZ_CP090900,1,236326,237658,+,1332
269,NZ_OX366352,1,610784,612116,-,1332
269,NZ_OX366362,1,1038775,1040102,-,1327
269,NZ_OX366400,1,632095,633428,-,1333
269,NZ_OX366327,1,666565,667898,+,1333
269,NZ_OX366367,1,754696,756024,+,1328
269,NZ_CP042444,1,236264,237596,+,1332
269,NZ_OX366326,1,711021,712354,+,1333
269,NZ_CP037426,1,1084182,1085514,+,1332
269,NZ_OX366339,1,442433,443765,-,1332
269,NZ_OX366355,1,785691,787023,-,1332
269,NZ_CP046922,1,236023,237355,+,1332
269,NZ_OX366370,1,599660,600986,-,1326
269,NZ_OX366385,1,716164,717497,-,1333
269,NZ_OX366399,1,513964,515297,+,1333
269,NZ_OX366395,1,760902,762235,+,1333
269,NZ_OX366396,1,945191,946523,-,1332
269,NZ_OX366351,1,533806,535139,+,1333
269,NZ_OX366381,1,948476,949808,-,1332
269,NZ_OX366342,1,824246,825579,+,1333
269,NZ_OX366369,1,516871,518204,+,1333
269,NZ_OX366356,1,762561,763893,-,1332
269,NZ_OX366377,1,623380,624713,+,1333
269,NZ_OX366388,1,748400,749724,-,1324
269,NZ_OX366357,1,546414,547747,+,1333
269,NZ_CP072012,1,436736,438069,+,1333
269,NZ_OX366398,1,1175057,1176390,+,1333
269,NC_002978,6,236326,237658,+,1332
269,NZ_OX366389,1,691539,692872,+,1333
269,NZ_OX366397,1,723200,724532,+,1332
269,NZ_OX366378,1,756162,757495,-,1333
269,NZ_CP090903,1,236326,237658,+,1332
269,NZ_OX366374,1,705265,706598,-,1333
269,NZ_CP090901,1,236326,237658,+,1332
269,NZ_CP046923,1,236023,237355,+,1332
269,NZ_CP069055,1,232499,233831,+,1332
269,NZ_CP072670,1,236174,237506,+,1332
269,NZ_CP090899,1,236326,237658,+,1332
269,NZ_CP046924,1,236023,237355,+,1332
269,NZ_OX366348,1,736560,737893,-,1333
269,NZ_CP046921,1,236023,237355,+,1332
269,NZ_OX366338,1,677644,678977,+,1333
269,NZ_CP054557,1,1240409,1241742,+,1333
269,NZ_CP072669,1,236174,237506,+,1332
269,NC_021089,1,231166,232498,+,1332
270,NZ_OX366376,1,802999,804036,+,1037
270,NZ_OX366393,1,647614,648651,-,1037
270,NZ_OX366372,1,571146,572183,+,1037
270,NZ_OX366349,1,1250811,1251874,-,1063
270,NZ_OX366344,1,592103,593139,-,1036
270,NZ_OX366362,1,722470,723447,+,977
270,NZ_OX366342,1,825831,826868,+,1037
271,NZ_OX366376,1,804037,804584,+,547
271,NZ_OX366393,1,647066,647612,-,546
271,NZ_OX366372,1,572184,572731,+,547
271,NZ_OX366349,1,1250263,1250809,-,546
271,NZ_OX366344,1,591555,592101,-,546
271,NZ_OX366342,1,826869,827416,+,547
272,NZ_OX366376,1,804599,806229,+,1630
272,NZ_OX366393,1,645421,647051,-,1630
272,NZ_OX366372,1,572746,574376,+,1630
272,NZ_CP072672,1,349759,351366,-,1607
272,NZ_CP069060,1,338554,340161,-,1607
272,NZ_CP072667,1,349741,351348,-,1607
272,NZ_CP072671,1,349741,351348,-,1607
272,NZ_CP072668,1,349741,351348,-,1607
272,NZ_CP072666,1,349741,351348,-,1607
272,NZ_CP090902,1,349893,351500,-,1607
272,NZ_CP090948,1,349893,351500,-,1607
272,NZ_CP069052,1,333227,334834,-,1607
272,NZ_CP076228,1,384951,386557,+,1606
272,NZ_CP042445,1,349893,351500,-,1607
272,NZ_CP042904,1,448208,449814,+,1606
272,NC_012416,1,451591,453197,+,1606
272,NZ_CP069053,1,207116,208722,+,1606
272,NZ_CP042446,1,349893,351500,-,1607
272,NZ_CP041215,1,867560,869167,-,1607
272,NZ_OX366353,1,69618,71224,+,1606
272,NZ_OX366387,1,1201422,1203028,+,1606
272,NZ_OX366368,1,704809,706416,-,1607
272,NZ_OX366379,1,840764,842370,+,1606
272,NZ_CP091195,1,352339,353952,+,1613
272,NZ_OX366375,1,900634,902241,-,1607
272,NZ_CP046925,1,349741,351348,-,1607
272,NZ_OX366318,1,790744,792350,+,1606
272,NZ_OX366319,1,452635,454242,-,1607
272,NZ_OX366332,1,928187,929793,+,1606
272,NZ_CP110359,1,828615,830221,+,1606
272,NZ_OU953855,1,1417698,1419281,+,1583
272,NZ_OX366272,1,634054,635660,+,1606
272,NZ_OX366347,1,1046420,1048026,+,1606
272,NZ_OU909470,1,99333,100943,-,1610
272,NZ_OX366363,1,117965,119572,-,1607
272,NZ_OX366364,1,804799,806438,-,1639
272,NZ_OX366359,1,758863,760469,+,1606
272,NZ_OX366349,1,1248617,1250248,-,1631
272,NZ_OX366380,1,518504,520117,+,1613
272,NZ_OX366344,1,589910,591540,-,1630
272,NZ_CP090900,1,349893,351500,-,1607
272,NZ_OX366352,1,687669,689275,+,1606
272,NZ_OX366362,1,934704,936311,+,1607
272,NZ_OX366400,1,453396,455003,-,1607
272,NZ_OX366327,1,839337,840943,+,1606
272,NZ_OX366367,1,756508,758123,+,1615
272,NZ_CP042444,1,350394,352001,-,1607
272,NZ_OX366326,1,887199,888805,+,1606
272,NZ_CP037426,1,616390,617997,-,1607
272,NZ_OX366339,1,325663,327270,-,1607
272,NZ_OX366355,1,502308,503914,+,1606
272,NZ_CP046922,1,349537,351144,-,1607
272,NZ_OX366370,1,560779,562410,-,1631
272,NZ_OX366385,1,398350,399963,+,1613
272,NZ_OX366399,1,831823,833429,+,1606
272,NZ_OX366395,1,764959,766565,+,1606
272,NZ_OX366396,1,1391486,1393093,-,1607
272,NZ_OX366351,1,709988,711594,+,1606
272,NZ_OX366381,1,613039,614646,-,1607
272,NZ_OX366342,1,827431,829061,+,1630
272,NZ_OX366369,1,679500,681107,-,1607
272,NZ_OX366356,1,589852,591459,-,1607
272,NZ_OX366377,1,402177,403783,+,1606
272,NZ_OX366388,1,550128,551741,-,1613
272,NZ_OX366357,1,548231,549838,+,1607
272,NZ_CP072012,1,625605,627211,+,1606
272,NZ_OX366398,1,107050,108657,-,1607
272,NC_002978,6,349893,351500,-,1607
272,NZ_OX366389,1,483735,485342,-,1607
272,NZ_OX366397,1,1009658,1011264,+,1606
272,NZ_OX366378,1,418387,420000,+,1613
272,NZ_CP090903,1,349893,351500,-,1607
272,NZ_OX366374,1,913128,914675,-,1547
272,NZ_CP090901,1,349893,351500,-,1607
272,NZ_CP046923,1,349537,351144,-,1607
272,NZ_CP069055,1,386874,388481,-,1607
272,NZ_CP072670,1,349733,351340,-,1607
272,NZ_CP090899,1,349893,351500,-,1607
272,NZ_CP046924,1,349537,351144,-,1607
272,NZ_OX366348,1,698272,699879,-,1607
272,NZ_CP046921,1,349537,351144,-,1607
272,NZ_OX366338,1,549144,550751,+,1607
272,NZ_CP054557,1,94948,96555,-,1607
272,NZ_CP072669,1,349741,351348,-,1607
272,NC_021089,1,577061,578667,+,1606
273,NZ_OX366376,1,808043,808946,+,903
273,NZ_OX366393,1,642740,643643,-,903
273,NZ_OX366372,1,576178,577081,+,903
273,NZ_CP072672,1,346937,347833,-,896
273,NZ_CP069060,1,335732,336628,-,896
273,NZ_CP072667,1,346919,347815,-,896
273,NZ_CP072671,1,346919,347815,-,896
273,NZ_CP072668,1,346919,347815,-,896
273,NZ_CP072666,1,346919,347815,-,896
273,NZ_CP090902,1,347071,347967,-,896
273,NZ_CP090948,1,347071,347967,-,896
273,NZ_CP069052,1,330405,331301,-,896
273,NZ_CP076228,1,388472,389368,+,896
273,NZ_CP042445,1,347071,347967,-,896
273,NZ_CP042904,1,451511,452407,+,896
273,NC_012416,1,454894,455790,+,896
273,NZ_CP069053,1,210649,211545,+,896
273,NZ_CP042446,1,347071,347967,-,896
273,NZ_CP041215,1,864968,865864,-,896
273,NZ_OX366353,1,72921,73817,+,896
273,NZ_OX366387,1,1204950,1205846,+,896
273,NZ_OX366368,1,701987,702883,-,896
273,NZ_OX366379,1,844297,845193,+,896
273,NZ_CP091195,1,355616,356519,+,903
273,NZ_OX366375,1,897180,898076,-,896
273,NZ_CP046925,1,346919,347815,-,896
273,NZ_OX366318,1,794294,795190,+,896
273,NZ_OX366319,1,450039,450935,-,896
273,NZ_OX366332,1,931490,932386,+,896
273,NZ_CP110359,1,832252,833148,+,896
273,NZ_OU953855,1,1361027,1361923,-,896
273,NZ_OX366272,1,637369,638265,+,896
273,NZ_OX366347,1,1049714,1050610,+,896
273,NZ_OU909470,1,96511,97407,-,896
273,NZ_OX366363,1,114429,115325,-,896
273,NZ_OX366364,1,802140,803043,-,903
273,NZ_OX366359,1,762166,763062,+,896
273,NZ_OX366349,1,1432530,1433433,+,903
273,NZ_OX366380,1,521516,522412,+,896
273,NZ_OX366344,1,587197,588100,-,903
273,NZ_CP090900,1,347071,347967,-,896
273,NZ_OX366352,1,690972,691802,+,830
273,NZ_OX366362,1,937093,937992,+,899
273,NZ_OX366400,1,450557,451453,-,896
273,NZ_OX366327,1,842652,843548,+,896
273,NZ_OX366367,1,760079,760975,+,896
273,NZ_CP042444,1,347572,348468,-,896
273,NZ_OX366326,1,890749,891645,+,896
273,NZ_CP037426,1,142981,143877,-,896
273,NZ_OX366339,1,321167,322063,-,896
273,NZ_OX366355,1,505615,506511,+,896
273,NZ_CP046922,1,346715,347611,-,896
273,NZ_OX366370,1,558271,559174,-,903
273,NZ_OX366385,1,403121,404017,+,896
273,NZ_OX366399,1,835356,836252,+,896
273,NZ_OX366395,1,873789,874681,+,892
273,NZ_OX366396,1,1388882,1389778,-,896
273,NZ_OX366351,1,714389,715285,+,896
273,NZ_OX366381,1,610443,611339,-,896
273,NZ_OX366342,1,829505,830408,+,903
273,NZ_OX366369,1,676926,677822,-,896
273,NZ_OX366356,1,586969,587865,-,896
273,NZ_OX366377,1,405731,406627,+,896
273,NZ_OX366388,1,547561,548464,-,903
273,NZ_OX366357,1,551506,552402,+,896
273,NZ_CP072012,1,629138,630034,+,896
273,NZ_OX366398,1,104207,105103,-,896
273,NC_002978,6,347071,347967,-,896
273,NZ_OX366389,1,506850,507746,-,896
273,NZ_OX366397,1,1012961,1013857,+,896
273,NZ_OX366378,1,421664,422567,+,903
273,NZ_CP090903,1,347071,347967,-,896
273,NZ_OX366374,1,911070,911966,-,896
273,NZ_CP090901,1,347071,347967,-,896
273,NZ_CP046923,1,346715,347611,-,896
273,NZ_CP069055,1,384052,384948,-,896
273,NZ_CP072670,1,346911,347807,-,896
273,NZ_CP090899,1,347071,347967,-,896
273,NZ_CP046924,1,346715,347611,-,896
273,NZ_OX366348,1,695590,696486,-,896
273,NZ_CP046921,1,346715,347611,-,896
273,NZ_OX366338,1,552543,553435,+,892
273,NZ_CP054557,1,92050,92946,-,896
273,NZ_CP072669,1,346919,347815,-,896
273,NC_021089,1,580364,581260,+,896
274,NZ_OX366376,1,809144,814186,+,5042
274,NZ_OX366393,1,637521,642542,-,5021
274,NZ_OX366372,1,577279,582321,+,5042
274,NZ_CP072672,1,341905,346748,-,4843
274,NZ_CP069060,1,330658,335543,-,4885
274,NZ_CP072667,1,341887,346730,-,4843
274,NZ_CP072671,1,341887,346730,-,4843
274,NZ_CP072668,1,341887,346730,-,4843
274,NZ_CP072666,1,341887,346730,-,4843
274,NZ_CP090902,1,342039,346882,-,4843
274,NZ_CP090948,1,342039,346882,-,4843
274,NZ_CP069052,1,325331,330216,-,4885
274,NZ_CP076228,1,389559,394444,+,4885
274,NZ_CP042445,1,342039,346882,-,4843
274,NZ_CP042904,1,452596,457511,+,4915
274,NC_012416,1,455979,460894,+,4915
274,NZ_CP069053,1,211734,216619,+,4885
274,NZ_CP042446,1,342039,346882,-,4843
274,NZ_CP041215,1,815798,820652,+,4854
274,NZ_OX366353,1,74006,78873,+,4867
274,NZ_OX366387,1,1206035,1210899,+,4864
274,NZ_OX366368,1,696955,701798,-,4843
274,NZ_OX366379,1,845382,850225,+,4843
274,NZ_CP091195,1,356708,361671,+,4963
274,NZ_OX366375,1,892019,896991,-,4972
274,NZ_CP046925,1,341887,346730,-,4843
274,NZ_OX366318,1,795379,800222,+,4843
274,NZ_OX366319,1,444827,449850,-,5023
274,NZ_OX366332,1,932575,937442,+,4867
274,NZ_CP110359,1,833337,838253,+,4916
274,NZ_OU953855,1,1355875,1360838,-,4963
274,NZ_OX366272,1,638454,643327,+,4873
274,NZ_OX366347,1,1050799,1055705,+,4906
274,NZ_OU909470,1,91408,96322,-,4914
274,NZ_OX366363,1,109268,114240,-,4972
274,NZ_OX366364,1,796882,801942,-,5060
274,NZ_OX366359,1,763268,768135,+,4867
274,NZ_OX366349,1,1433631,1438760,+,5129
274,NZ_OX366380,1,522601,527522,+,4921
274,NZ_OX366344,1,582110,586999,-,4889
274,NZ_CP090900,1,342039,346882,-,4843
274,NZ_OX366352,1,693670,698537,+,4867
274,NZ_OX366362,1,938190,943224,+,5034
274,NZ_OX366400,1,445525,450368,-,4843
274,NZ_OX366327,1,843737,848724,+,4987
274,NZ_OX366367,1,761173,766287,+,5114
274,NZ_CP042444,1,342540,347383,-,4843
274,NZ_OX366326,1,892698,897528,+,4830
274,NZ_CP037426,1,137820,142792,-,4972
274,NZ_OX366339,1,316003,320978,-,4975
274,NZ_OX366355,1,506700,511723,+,5023
274,NZ_CP046922,1,341683,346526,-,4843
274,NZ_OX366370,1,553127,558057,-,4930
274,NZ_OX366385,1,404206,409127,+,4921
274,NZ_OX366399,1,836441,841284,+,4843
274,NZ_OX366395,1,874879,879822,+,4943
274,NZ_OX366396,1,1383718,1388693,-,4975
274,NZ_OX366351,1,715474,720317,+,4843
274,NZ_OX366381,1,605189,610254,-,5065
274,NZ_OX366342,1,830606,835627,+,5021
274,NZ_OX366369,1,671714,676737,-,5023
274,NZ_OX366356,1,581835,586780,-,4945
274,NZ_OX366377,1,406816,411758,+,4942
274,NZ_OX366388,1,542397,547372,-,4975
274,NZ_OX366357,1,552591,557497,+,4906
274,NZ_CP072012,1,630223,635108,+,4885
274,NZ_OX366398,1,99076,104018,-,4942
274,NC_002978,6,342039,346882,-,4843
274,NZ_OX366389,1,501707,506632,-,4925
274,NZ_OX366397,1,1014046,1018905,+,4859
274,NZ_OX366378,1,422756,427719,+,4963
274,NZ_CP090903,1,342039,346882,-,4843
274,NZ_OX366374,1,905930,910882,-,4952
274,NZ_CP090901,1,342039,346882,-,4843
274,NZ_CP046923,1,341683,346526,-,4843
274,NZ_CP069055,1,378978,383863,-,4885
274,NZ_CP072670,1,341879,346722,-,4843
274,NZ_CP090899,1,342039,346882,-,4843
274,NZ_CP046924,1,341683,346526,-,4843
274,NZ_OX366348,1,690567,695401,-,4834
274,NZ_CP046921,1,341683,346526,-,4843
274,NZ_OX366338,1,553634,558499,+,4865
274,NZ_CP054557,1,87027,91861,-,4834
274,NZ_CP072669,1,341887,346730,-,4843
274,NC_021089,1,581449,586316,+,4867
275,NZ_OX366376,1,817665,819443,+,1778
275,NZ_OX366393,1,634586,636364,-,1778
275,NZ_OX366372,1,586067,587845,+,1778
275,NZ_CP072672,1,90511,92280,+,1769
275,NZ_CP069060,1,100741,102510,+,1769
275,NZ_CP072667,1,90493,92262,+,1769
275,NZ_CP072671,1,90493,92262,+,1769
275,NZ_CP072668,1,90493,92262,+,1769
275,NZ_CP072666,1,90493,92262,+,1769
275,NZ_CP090902,1,90645,92414,+,1769
275,NZ_CP090948,1,90645,92414,+,1769
275,NZ_CP069052,1,137621,139390,-,1769
275,NZ_CP076228,1,94144,95913,+,1769
275,NZ_CP042445,1,90645,92414,+,1769
275,NZ_CP042904,1,150719,152487,-,1768
275,NC_012416,1,153301,155069,-,1768
275,NZ_CP069053,1,444767,446536,-,1769
275,NZ_CP042446,1,90645,92414,+,1769
275,NZ_CP041215,1,504431,506200,-,1769
275,NZ_OX366353,1,440132,441901,-,1769
275,NZ_OX366387,1,668720,670488,-,1768
275,NZ_OX366368,1,371764,373533,+,1769
275,NZ_OX366379,1,372782,374551,+,1769
275,NZ_CP091195,1,998857,1000626,+,1769
275,NZ_OX366375,1,441093,442862,-,1769
275,NZ_CP046925,1,90493,92262,+,1769
275,NZ_OX366318,1,527464,529233,-,1769
275,NZ_OX366319,1,731870,733639,+,1769
275,NZ_OX366332,1,426186,427955,-,1769
275,NZ_CP110359,1,1090388,1092156,+,1768
275,NZ_OU953855,1,1582788,1584557,+,1769
275,NZ_OX366272,1,593406,595174,-,1768
275,NZ_OX366347,1,540119,541888,-,1769
275,NZ_OU909470,1,1237393,1239170,+,1777
275,NZ_OX366363,1,490285,492053,+,1768
275,NZ_OX366364,1,792272,794041,-,1769
275,NZ_OX366359,1,353235,355004,+,1769
275,NZ_OX366349,1,1425227,1427005,-,1778
275,NZ_OX366380,1,692563,694341,+,1778
275,NZ_OX366344,1,576888,578666,-,1778
275,NZ_CP090900,1,90645,92414,+,1769
275,NZ_OX366352,1,385684,387453,-,1769
275,NZ_OX366362,1,1014738,1016507,-,1769
275,NZ_OX366400,1,731295,733064,+,1769
275,NZ_OX366327,1,576286,578055,-,1769
275,NZ_OX366367,1,768188,769957,+,1769
275,NZ_CP042444,1,90646,92415,+,1769
275,NZ_OX366326,1,363123,364892,+,1769
275,NZ_CP037426,1,724798,726567,+,1769
275,NZ_OX366339,1,240062,241786,-,1724
275,NZ_OX366355,1,877117,878886,+,1769
275,NZ_CP046922,1,90338,92107,+,1769
275,NZ_OX366370,1,549426,551204,-,1778
275,NZ_OX366385,1,1083193,1084971,-,1778
275,NZ_OX366399,1,371266,373035,+,1769
275,NZ_OX366395,1,1470941,1472710,-,1769
275,NZ_OX366396,1,1287032,1288801,-,1769
275,NZ_OX366351,1,442016,443785,-,1769
275,NZ_OX366381,1,1038586,1040355,+,1769
275,NZ_OX366342,1,839277,841055,+,1778
275,NZ_OX366369,1,426526,428295,-,1769
275,NZ_OX366356,1,449258,451026,-,1768
275,NZ_OX366377,1,530700,532469,-,1769
275,NZ_OX366388,1,1357588,1359357,-,1769
275,NZ_OX366357,1,455715,457484,+,1769
275,NZ_CP072012,1,944719,946488,-,1769
275,NZ_OX366398,1,1027995,1029764,+,1769
275,NC_002978,6,90645,92414,+,1769
275,NZ_OX366389,1,536026,537795,+,1769
275,NZ_OX366397,1,425410,427179,+,1769
275,NZ_OX366378,1,838464,840233,-,1769
275,NZ_CP090903,1,90645,92414,+,1769
275,NZ_OX366374,1,996474,998242,-,1768
275,NZ_CP090901,1,90645,92414,+,1769
275,NZ_CP046923,1,90338,92107,+,1769
275,NZ_CP069055,1,133752,135521,-,1769
275,NZ_CP072670,1,90493,92262,+,1769
275,NZ_CP090899,1,90645,92414,+,1769
275,NZ_CP046924,1,90338,92107,+,1769
275,NZ_OX366348,1,825216,826985,+,1769
275,NZ_CP046921,1,90338,92107,+,1769
275,NZ_OX366338,1,1401317,1403086,-,1769
275,NZ_CP054557,1,1150646,1152415,-,1769
275,NZ_CP072669,1,90493,92262,+,1769
275,NC_021089,1,145670,147439,-,1769
276,NZ_OX366376,1,821239,823852,+,2613
276,NZ_OX366393,1,630176,632789,-,2613
276,NZ_OX366372,1,589543,592156,+,2613
276,NZ_CP072672,1,352706,355319,+,2613
276,NZ_CP069060,1,341492,344105,+,2613
276,NZ_CP072667,1,352688,355301,+,2613
276,NZ_CP072671,1,352688,355301,+,2613
276,NZ_CP072668,1,352688,355301,+,2613
276,NZ_CP072666,1,352688,355301,+,2613
276,NZ_CP090902,1,352840,355453,+,2613
276,NZ_CP090948,1,352840,355453,+,2613
276,NZ_CP069052,1,336165,338778,+,2613
276,NZ_CP076228,1,381009,383622,-,2613
276,NZ_CP042445,1,352840,355453,+,2613
276,NZ_CP042904,1,444269,446877,-,2608
276,NC_012416,1,447652,450260,-,2608
276,NZ_CP069053,1,203172,205785,-,2613
276,NZ_CP042446,1,352840,355453,+,2613
276,NZ_CP041215,1,870507,873120,+,2613
276,NZ_OX366353,1,1294241,1296854,+,2613
276,NZ_OX366387,1,1197253,1199866,-,2613
276,NZ_OX366368,1,707756,710369,+,2613
276,NZ_OX366379,1,836811,839424,-,2613
276,NZ_CP091195,1,313146,315759,-,2613
276,NZ_OX366375,1,903581,906170,+,2589
276,NZ_CP046925,1,352688,355301,+,2613
276,NZ_OX366318,1,786800,789413,-,2613
276,NZ_OX366319,1,367968,370581,+,2613
276,NZ_OX366332,1,924243,926856,-,2613
276,NZ_CP110359,1,824616,827229,-,2613
276,NZ_OU953855,1,441488,444101,-,2613
276,NZ_OX366272,1,630063,632676,-,2613
276,NZ_OX366347,1,1042363,1044976,-,2613
276,NZ_OU909470,1,1391501,1394108,+,2607
276,NZ_OX366363,1,121861,124474,+,2613
276,NZ_OX366364,1,788169,790743,-,2574
276,NZ_OX366359,1,754910,757523,-,2613
276,NZ_OX366349,1,1421042,1423655,-,2613
276,NZ_OX366380,1,534552,537150,+,2598
276,NZ_OX366344,1,572710,575317,-,2607
276,NZ_CP090900,1,352840,355453,+,2613
276,NZ_OX366352,1,403405,406018,+,2613
276,NZ_OX366362,1,739082,741693,-,2611
276,NZ_OX366400,1,457537,460150,+,2613
276,NZ_OX366327,1,835242,837855,-,2613
276,NZ_OX366367,1,771158,773769,+,2611
276,NZ_CP042444,1,353341,355954,+,2613
276,NZ_OX366326,1,883255,885868,-,2613
276,NZ_CP037426,1,619330,621919,+,2589
276,NZ_OX366339,1,329666,332279,+,2613
276,NZ_OX366355,1,389868,392481,+,2613
276,NZ_CP046922,1,352484,355097,+,2613
276,NZ_OX366370,1,543227,545797,-,2570
276,NZ_OX366385,1,418225,420823,+,2598
276,NZ_OX366399,1,827870,830483,-,2613
276,NZ_OX366395,1,743434,746047,+,2613
276,NZ_OX366396,1,8935,11524,-,2589
276,NZ_OX366396,1,1395472,1398061,+,2589
276,NZ_OX366351,1,706044,708657,-,2613
276,NZ_OX366381,1,616815,619428,+,2613
276,NZ_OX366342,1,842852,845465,+,2613
276,NZ_OX366369,1,682438,685051,+,2613
276,NZ_OX366356,1,593320,595933,+,2613
276,NZ_OX366377,1,817972,820585,+,2613
276,NZ_OX366388,1,553158,555771,+,2613
276,NZ_OX366357,1,1314109,1316721,+,2612
276,NZ_CP072012,1,621661,624274,-,2613
276,NZ_OX366398,1,109997,112610,+,2613
276,NC_002978,6,352840,355453,+,2613
276,NZ_OX366389,1,920964,923577,-,2613
276,NZ_OX366397,1,1005705,1008318,-,2613
276,NZ_OX366378,1,414380,416993,-,2613
276,NZ_CP090903,1,352840,355453,+,2613
276,NZ_OX366374,1,918086,920699,+,2613
276,NZ_CP090901,1,352840,355453,+,2613
276,NZ_CP046923,1,352484,355097,+,2613
276,NZ_CP069055,1,389812,392425,+,2613
276,NZ_CP072670,1,352680,355293,+,2613
276,NZ_CP090899,1,352840,355453,+,2613
276,NZ_CP046924,1,352484,355097,+,2613
276,NZ_OX366348,1,701210,703823,+,2613
276,NZ_CP046921,1,352484,355097,+,2613
276,NZ_OX366338,1,1031004,1033616,+,2612
276,NZ_OX366338,1,1187433,1190045,+,2612
276,NZ_CP054557,1,97886,100499,+,2613
276,NZ_CP072669,1,352688,355301,+,2613
276,NC_021089,1,573109,575722,-,2613
277,NZ_OX366376,1,824351,825494,+,1143
277,NZ_OX366393,1,628534,629677,-,1143
277,NZ_OX366372,1,592655,593798,+,1143
277,NZ_CP072672,1,355719,356870,+,1151
277,NZ_CP069060,1,344505,345656,+,1151
277,NZ_CP072667,1,355701,356852,+,1151
277,NZ_CP072671,1,355701,356852,+,1151
277,NZ_CP072668,1,355701,356852,+,1151
277,NZ_CP072666,1,355701,356852,+,1151
277,NZ_CP090902,1,355853,357004,+,1151
277,NZ_CP090948,1,355853,357004,+,1151
277,NZ_CP069052,1,339178,340329,+,1151
277,NZ_CP076228,1,379457,380609,-,1152
277,NZ_CP042445,1,355853,357004,+,1151
277,NZ_CP042904,1,442720,443872,-,1152
277,NC_012416,1,446103,447255,-,1152
277,NZ_CP069053,1,201621,202772,-,1151
277,NZ_CP042446,1,355853,357004,+,1151
277,NZ_CP041215,1,873520,874672,+,1152
277,NZ_OX366353,1,1297254,1298406,+,1152
277,NZ_OX366387,1,1195701,1196853,-,1152
277,NZ_OX366368,1,710769,711921,+,1152
277,NZ_OX366379,1,835259,836411,-,1152
277,NZ_CP091195,1,311586,312738,-,1152
277,NZ_CP046925,1,355701,356852,+,1151
277,NZ_OX366318,1,785240,786392,-,1152
277,NZ_OX366319,1,370981,372133,+,1152
277,NZ_OX366332,1,922691,923843,-,1152
277,NZ_CP110359,1,823064,824216,-,1152
277,NZ_OU953855,1,1566069,1567202,-,1133
277,NZ_OX366272,1,628511,629663,-,1152
277,NZ_OX366347,1,1040811,1041963,-,1152
277,NZ_OU909470,1,75740,76883,+,1143
277,NZ_OX366363,1,124874,126026,+,1152
277,NZ_OX366364,1,786474,787626,-,1152
277,NZ_OX366359,1,753366,754518,-,1152
277,NZ_OX366349,1,1417969,1419112,-,1143
277,NZ_OX366380,1,537663,538806,+,1143
277,NZ_OX366344,1,571054,572197,-,1143
277,NZ_CP090900,1,355853,357004,+,1151
277,NZ_OX366352,1,406418,407570,+,1152
277,NZ_OX366362,1,694173,695272,-,1099
277,NZ_OX366400,1,460558,461710,+,1152
277,NZ_OX366327,1,833682,834834,-,1152
277,NZ_OX366367,1,774268,775420,+,1152
277,NZ_CP042444,1,356354,357505,+,1151
277,NZ_OX366326,1,881695,882847,-,1152
277,NZ_OX366339,1,332687,333829,+,1142
277,NZ_OX366355,1,392881,394033,+,1152
277,NZ_CP046922,1,355497,356648,+,1151
277,NZ_OX366370,1,541874,543026,-,1152
277,NZ_OX366385,1,695841,696984,+,1143
277,NZ_OX366399,1,826318,827470,-,1152
277,NZ_OX366395,1,746580,747732,+,1152
277,NZ_OX366396,1,1399445,1400597,+,1152
277,NZ_OX366351,1,704484,705636,-,1152
277,NZ_OX366381,1,619828,620980,+,1152
277,NZ_OX366342,1,729285,730430,+,1145
277,NZ_OX366369,1,685451,686603,+,1152
277,NZ_OX366356,1,596445,597597,+,1152
277,NZ_OX366377,1,820985,822137,+,1152
277,NZ_OX366388,1,556179,557331,+,1152
277,NZ_OX366357,1,1317246,1318398,+,1152
277,NZ_CP072012,1,620109,621261,-,1152
277,NZ_OX366398,1,113010,114162,+,1152
277,NC_002978,6,355853,357004,+,1151
277,NZ_OX366389,1,919412,920564,-,1152
277,NZ_OX366397,1,1004153,1005305,-,1152
277,NZ_OX366378,1,412820,413972,-,1152
277,NZ_CP090903,1,355853,357004,+,1151
277,NZ_CP090901,1,355853,357004,+,1151
277,NZ_CP046923,1,355497,356648,+,1151
277,NZ_CP069055,1,392825,393977,+,1152
277,NZ_CP072670,1,355693,356844,+,1151
277,NZ_CP090899,1,355853,357004,+,1151
277,NZ_CP046924,1,355497,356648,+,1151
277,NZ_OX366348,1,704231,705383,+,1152
277,NZ_CP046921,1,355497,356648,+,1151
277,NZ_OX366338,1,904126,905278,+,1152
277,NZ_CP054557,1,100907,102059,+,1152
277,NZ_CP072669,1,355701,356852,+,1151
277,NC_021089,1,571557,572709,-,1152
278,NZ_OX366376,1,827474,828454,+,980
278,NZ_OX366393,1,625575,626555,-,980
278,NZ_OX366372,1,595783,596763,+,980
278,NZ_CP072672,1,358384,359364,+,980
278,NZ_CP069060,1,347170,348150,+,980
278,NZ_CP072667,1,358366,359346,+,980
278,NZ_CP072671,1,358366,359346,+,980
278,NZ_CP072668,1,358366,359346,+,980
278,NZ_CP072666,1,358366,359346,+,980
278,NZ_CP090902,1,358518,359498,+,980
278,NZ_CP090948,1,358518,359498,+,980
278,NZ_CP069052,1,341843,342823,+,980
278,NZ_CP076228,1,376964,377944,-,980
278,NZ_CP042445,1,358518,359498,+,980
278,NZ_CP042904,1,440224,441204,-,980
278,NC_012416,1,443607,444587,-,980
278,NZ_CP069053,1,199127,200107,-,980
278,NZ_CP042446,1,358518,359498,+,980
278,NZ_CP041215,1,876388,877368,+,980
278,NZ_OX366353,1,1300122,1301102,+,980
278,NZ_OX366387,1,1193020,1193999,-,979
278,NZ_OX366368,1,713436,714416,+,980
278,NZ_OX366379,1,832764,833744,-,980
278,NZ_CP091195,1,309702,310682,-,980
278,NZ_OX366375,1,692217,693197,+,980
278,NZ_CP046925,1,358366,359346,+,980
278,NZ_OX366318,1,782703,783683,-,980
278,NZ_OX366319,1,373796,374775,+,979
278,NZ_OX366332,1,919995,920975,-,980
278,NZ_CP110359,1,820368,821348,-,980
278,NZ_OU953855,1,1562399,1563379,-,980
278,NZ_OX366272,1,605416,606396,+,980
278,NZ_OX366347,1,1036754,1037734,-,980
278,NZ_OU909470,1,84011,84991,+,980
278,NZ_OX366363,1,127145,128125,+,980
278,NZ_OX366364,1,783098,784078,-,980
278,NZ_OX366359,1,750670,751650,-,980
278,NZ_OX366349,1,1414080,1415060,-,980
278,NZ_OX366380,1,540131,541111,+,980
278,NZ_OX366344,1,568099,569079,-,980
278,NZ_CP090900,1,358518,359498,+,980
278,NZ_OX366352,1,409286,410266,+,980
278,NZ_OX366362,1,691501,692480,-,979
278,NZ_OX366400,1,463267,464247,+,980
278,NZ_OX366327,1,830982,831962,-,980
278,NZ_OX366367,1,776820,777800,+,980
278,NZ_CP042444,1,359019,359999,+,980
278,NZ_OX366326,1,879158,880138,-,980
278,NZ_CP037426,1,610806,611786,-,980
278,NZ_OX366339,1,336469,337449,+,980
278,NZ_OX366355,1,395696,396675,+,979
278,NZ_CP046922,1,358162,359142,+,980
278,NZ_OX366370,1,741746,742726,+,980
278,NZ_OX366385,1,698309,699289,+,980
278,NZ_OX366399,1,823823,824803,-,980
278,NZ_OX366395,1,749590,750570,+,980
278,NZ_OX366396,1,1402264,1403244,+,980
278,NZ_OX366351,1,701947,702927,-,980
278,NZ_OX366381,1,622634,623613,+,979
278,NZ_OX366342,1,732409,733389,+,980
278,NZ_OX366369,1,688266,689245,+,979
278,NZ_OX366356,1,598652,599632,+,980
278,NZ_OX366377,1,823643,824623,+,980
278,NZ_OX366388,1,559048,560028,+,980
278,NZ_OX366357,1,606497,607477,+,980
278,NZ_CP072012,1,617614,618594,-,980
278,NZ_OX366398,1,116884,117864,+,980
278,NC_002978,6,358518,359498,+,980
278,NZ_OX366389,1,916917,917897,-,980
278,NZ_OX366397,1,1001456,1002436,-,980
278,NZ_OX366378,1,410116,411096,-,980
278,NZ_CP090903,1,358518,359498,+,980
278,NZ_OX366374,1,922329,923309,+,980
278,NZ_CP090901,1,358518,359498,+,980
278,NZ_CP046923,1,358162,359142,+,980
278,NZ_CP069055,1,395491,396471,+,980
278,NZ_CP072670,1,358358,359338,+,980
278,NZ_CP090899,1,358518,359498,+,980
278,NZ_CP046924,1,358162,359142,+,980
278,NZ_OX366348,1,707030,708010,+,980
278,NZ_CP046921,1,358162,359142,+,980
278,NZ_OX366338,1,906694,907674,+,980
278,NZ_CP054557,1,103706,104686,+,980
278,NZ_CP072669,1,358366,359346,+,980
278,NC_021089,1,568861,569841,-,980
279,NZ_OX366376,1,828774,829370,+,596
279,NZ_OX366393,1,624659,625254,-,595
279,NZ_OX366372,1,597073,597679,+,606
279,NZ_CP072672,1,359365,359969,+,604
279,NZ_CP069060,1,348151,348755,+,604
279,NZ_CP072667,1,359347,359951,+,604
279,NZ_CP072671,1,359347,359951,+,604
279,NZ_CP072668,1,359347,359951,+,604
279,NZ_CP072666,1,359347,359951,+,604
279,NZ_CP090902,1,359499,360103,+,604
279,NZ_CP090948,1,359499,360103,+,604
279,NZ_CP069052,1,342824,343428,+,604
279,NZ_CP076228,1,376359,376962,-,603
279,NZ_CP042445,1,359499,360103,+,604
279,NZ_CP042904,1,439619,440222,-,603
279,NC_012416,1,443002,443605,-,603
279,NZ_CP069053,1,198522,199125,-,603
279,NZ_CP042446,1,359499,360103,+,604
279,NZ_CP041215,1,877369,877963,+,594
279,NZ_OX366353,1,1301103,1301697,+,594
279,NZ_OX366387,1,1192415,1193018,-,603
279,NZ_OX366368,1,714417,715021,+,604
279,NZ_OX366379,1,832159,832762,-,603
279,NZ_CP091195,1,309097,309700,-,603
279,NZ_OX366375,1,693198,693802,+,604
279,NZ_CP046925,1,359347,359951,+,604
279,NZ_OX366318,1,782098,782701,-,603
279,NZ_OX366319,1,374776,375380,+,604
279,NZ_OX366332,1,919400,919993,-,593
279,NZ_CP110359,1,819763,820366,-,603
279,NZ_OU953855,1,1561794,1562397,-,603
279,NZ_OX366272,1,606397,607001,+,604
279,NZ_OX366347,1,1036149,1036752,-,603
279,NZ_OU909470,1,84992,85596,+,604
279,NZ_OX366363,1,128126,128730,+,604
279,NZ_OX366364,1,782493,783096,-,603
279,NZ_OX366359,1,750075,750668,-,593
279,NZ_OX366349,1,1413475,1414078,-,603
279,NZ_OX366380,1,541414,542020,+,606
279,NZ_OX366344,1,567183,567778,-,595
279,NZ_CP090900,1,359499,360103,+,604
279,NZ_OX366352,1,410267,410861,+,594
279,NZ_OX366362,1,690896,691499,-,603
279,NZ_OX366400,1,464248,464852,+,604
279,NZ_OX366327,1,830377,830980,-,603
279,NZ_OX366367,1,777801,778405,+,604
279,NZ_CP042444,1,360000,360604,+,604
279,NZ_OX366326,1,878553,879156,-,603
279,NZ_CP037426,1,610201,610804,-,603
279,NZ_OX366339,1,337450,338054,+,604
279,NZ_OX366355,1,396676,397280,+,604
279,NZ_CP046922,1,359143,359747,+,604
279,NZ_OX366370,1,742727,743331,+,604
279,NZ_OX366385,1,699592,700198,+,606
279,NZ_OX366399,1,823218,823821,-,603
279,NZ_OX366395,1,750872,751478,+,606
279,NZ_OX366396,1,1403245,1403849,+,604
279,NZ_OX366351,1,701342,701945,-,603
279,NZ_OX366381,1,623614,624218,+,604
279,NZ_OX366342,1,733699,734305,+,606
279,NZ_OX366369,1,689246,689850,+,604
279,NZ_OX366356,1,599633,600237,+,604
279,NZ_OX366377,1,824624,825228,+,604
279,NZ_OX366388,1,560029,560633,+,604
279,NZ_OX366357,1,607478,608082,+,604
279,NZ_CP072012,1,617009,617612,-,603
279,NZ_OX366398,1,117865,118469,+,604
279,NC_002978,6,359499,360103,+,604
279,NZ_OX366389,1,916312,916915,-,603
279,NZ_OX366397,1,1000861,1001454,-,593
279,NZ_OX366378,1,409511,410114,-,603
279,NZ_CP090903,1,359499,360103,+,604
279,NZ_OX366374,1,926302,926908,+,606
279,NZ_CP090901,1,359499,360103,+,604
279,NZ_CP046923,1,359143,359747,+,604
279,NZ_CP069055,1,396472,397076,+,604
279,NZ_CP072670,1,359339,359943,+,604
279,NZ_CP090899,1,359499,360103,+,604
279,NZ_CP046924,1,359143,359747,+,604
279,NZ_OX366348,1,708011,708615,+,604
279,NZ_CP046921,1,359143,359747,+,604
279,NZ_OX366338,1,910434,911040,+,606
279,NZ_CP054557,1,104687,105291,+,604
279,NZ_CP072669,1,359347,359951,+,604
279,NC_021089,1,568266,568859,-,593
280,NZ_OX366376,1,829371,830318,+,947
280,NZ_OX366393,1,623711,624657,-,946
280,NZ_OX366372,1,597680,598627,+,947
280,NZ_CP041215,1,877967,878933,+,966
280,NZ_OX366353,1,1301701,1302668,+,967
280,NZ_OX366332,1,918429,919396,-,967
280,NZ_CP110359,1,818802,819761,-,959
280,NZ_OU953855,1,1560818,1561792,-,974
280,NZ_OX366272,1,607002,607961,+,959
280,NZ_OX366347,1,1035188,1036147,-,959
280,NZ_OX366363,1,128731,129690,+,959
280,NZ_OX366359,1,749104,750071,-,967
280,NZ_OX366352,1,410865,411831,+,966
280,NZ_OX366342,1,734306,735253,+,947
280,NZ_OX366397,1,999890,1000857,-,967
280,NZ_OX366374,1,926909,927868,+,959
280,NC_021089,1,567295,568262,-,967
281,NZ_OX366376,1,831243,832066,+,823
281,NZ_OX366393,1,621964,622787,-,823
281,NZ_OX366372,1,599552,600375,+,823
281,NZ_CP072672,1,361684,362514,+,830
281,NZ_CP069060,1,350470,351300,+,830
281,NZ_CP072667,1,361666,362496,+,830
281,NZ_CP072671,1,361666,362496,+,830
281,NZ_CP072668,1,361666,362496,+,830
281,NZ_CP072666,1,361666,362496,+,830
281,NZ_CP090902,1,361818,362648,+,830
281,NZ_CP090948,1,361818,362648,+,830
281,NZ_CP069052,1,345143,345973,+,830
281,NZ_CP076228,1,373814,374644,-,830
281,NZ_CP042445,1,361818,362648,+,830
281,NZ_CP042904,1,437608,438438,-,830
281,NC_012416,1,440991,441821,-,830
281,NZ_CP069053,1,195977,196807,-,830
281,NZ_CP042446,1,361818,362648,+,830
281,NZ_CP041215,1,879862,880692,+,830
281,NZ_OX366353,1,1303597,1304427,+,830
281,NZ_OX366368,1,716736,717566,+,830
281,NZ_OX366379,1,829614,830444,-,830
281,NZ_CP091195,1,307427,308257,-,830
281,NZ_OX366375,1,694578,695408,+,830
281,NZ_CP046925,1,361666,362496,+,830
281,NZ_OX366318,1,780613,781443,-,830
281,NZ_OX366319,1,377921,378751,+,830
281,NZ_OX366332,1,916671,917501,-,830
281,NZ_CP110359,1,817075,817905,-,830
281,NZ_OU953855,1,1741836,1742666,-,830
281,NZ_OX366272,1,608859,609689,+,830
281,NZ_OX366347,1,1033461,1034291,-,830
281,NZ_OU909470,1,1407085,1407906,+,821
281,NZ_OX366363,1,130588,131418,+,830
281,NZ_OX366364,1,779941,780762,-,821
281,NZ_OX366359,1,747346,748176,-,830
281,NZ_OX366349,1,1410877,1411698,-,821
281,NZ_OX366380,1,544011,544832,+,821
281,NZ_OX366344,1,564631,565452,-,821
281,NZ_CP090900,1,361818,362648,+,830
281,NZ_OX366352,1,412760,413590,+,830
281,NZ_OX366400,1,466370,467188,+,818
281,NZ_OX366327,1,828701,829531,-,830
281,NZ_OX366367,1,780286,781116,+,830
281,NZ_CP042444,1,362319,363149,+,830
281,NZ_OX366326,1,877068,877898,-,830
281,NZ_CP037426,1,608595,609425,-,830
281,NZ_OX366355,1,398056,398886,+,830
281,NZ_CP046922,1,361462,362292,+,830
281,NZ_OX366385,1,703027,703848,+,821
281,NZ_OX366399,1,820673,821503,-,830
281,NZ_OX366395,1,752326,753156,+,830
281,NZ_OX366351,1,699857,700687,-,830
281,NZ_OX366381,1,624994,625824,+,830
281,NZ_OX366342,1,736087,736910,+,823
281,NZ_OX366369,1,690626,691453,+,827
281,NZ_OX366356,1,602072,602902,+,830
281,NZ_OX366377,1,825986,826817,+,831
281,NZ_OX366388,1,561808,562638,+,830
281,NZ_OX366357,1,609821,610647,+,826
281,NZ_CP072012,1,614464,615294,-,830
281,NZ_OX366398,1,119227,120057,+,830
281,NC_002978,6,361818,362648,+,830
281,NZ_OX366389,1,914724,915554,-,830
281,NZ_OX366397,1,998132,998962,-,830
281,NZ_OX366378,1,407841,408671,-,830
281,NZ_CP090903,1,361818,362648,+,830
281,NZ_CP090901,1,361818,362648,+,830
281,NZ_CP046923,1,361462,362292,+,830
281,NZ_CP069055,1,398811,399641,+,830
281,NZ_CP072670,1,361658,362488,+,830
281,NZ_CP090899,1,361818,362648,+,830
281,NZ_CP046924,1,361462,362292,+,830
281,NZ_OX366348,1,710330,711160,+,830
281,NZ_CP046921,1,361462,362292,+,830
281,NZ_OX366338,1,1074290,1075120,-,830
281,NZ_CP054557,1,107864,108682,+,818
281,NZ_CP072669,1,361666,362496,+,830
281,NC_021089,1,565537,566367,-,830
282,NZ_OX366376,1,834365,835663,+,1298
282,NZ_OX366393,1,618367,619665,-,1298
282,NZ_OX366372,1,602674,603972,+,1298
282,NZ_CP072672,1,365799,367151,+,1352
282,NZ_CP069060,1,354585,355937,+,1352
282,NZ_CP072667,1,365781,367133,+,1352
282,NZ_CP072671,1,365781,367133,+,1352
282,NZ_CP072668,1,365781,367133,+,1352
282,NZ_CP072666,1,365781,367133,+,1352
282,NZ_CP090902,1,365933,367285,+,1352
282,NZ_CP090948,1,365933,367285,+,1352
282,NZ_CP069052,1,349258,350610,+,1352
282,NZ_CP076228,1,368261,369613,-,1352
282,NZ_CP042445,1,365933,367285,+,1352
282,NZ_CP042904,1,434151,435503,-,1352
282,NC_012416,1,437534,438886,-,1352
282,NZ_CP069053,1,191340,192692,-,1352
282,NZ_CP042446,1,365933,367285,+,1352
282,NZ_CP041215,1,883810,885162,+,1352
282,NZ_OX366353,1,1307543,1308895,+,1352
282,NZ_OX366387,1,1187995,1189345,-,1350
282,NZ_OX366368,1,720851,722203,+,1352
282,NZ_OX366379,1,824977,826329,-,1352
282,NZ_CP091195,1,303070,304420,-,1350
282,NZ_OX366375,1,697513,698865,+,1352
282,NZ_CP046925,1,365781,367133,+,1352
282,NZ_OX366318,1,776087,777439,-,1352
282,NZ_OX366319,1,381767,383117,+,1350
282,NZ_OX366332,1,912218,913570,-,1352
282,NZ_CP110359,1,812768,814120,-,1352
282,NZ_OU953855,1,1736902,1738259,-,1357
282,NZ_OX366272,1,613932,615284,+,1352
282,NZ_OX366347,1,1029155,1030505,-,1350
282,NZ_OU909470,1,1410305,1411594,+,1289
282,NZ_OX366363,1,134374,135724,+,1350
282,NZ_OX366364,1,774974,776326,-,1352
282,NZ_OX366359,1,742876,744228,-,1352
282,NZ_OX366349,1,1407288,1408586,-,1298
282,NZ_OX366380,1,547003,548292,+,1289
282,NZ_OX366344,1,561034,562332,-,1298
282,NZ_CP090900,1,365933,367285,+,1352
282,NZ_OX366352,1,416708,418060,+,1352
282,NZ_OX366362,1,714672,716016,+,1344
282,NZ_OX366400,1,468640,469992,+,1352
282,NZ_OX366327,1,825246,826596,-,1350
282,NZ_OX366367,1,784683,786035,+,1352
282,NZ_CP042444,1,366434,367786,+,1352
282,NZ_OX366326,1,871691,873043,-,1352
282,NZ_CP037426,1,603296,604648,-,1352
282,NZ_OX366339,1,341255,342607,+,1352
282,NZ_OX366355,1,401902,403252,+,1350
282,NZ_CP046922,1,365577,366929,+,1352
282,NZ_OX366370,1,498486,499756,-,1270
282,NZ_OX366385,1,706019,707308,+,1289
282,NZ_OX366399,1,816036,817388,-,1352
282,NZ_OX366395,1,755467,756819,+,1352
282,NZ_OX366396,1,1231796,1233148,-,1352
282,NZ_OX366351,1,695331,696683,-,1352
282,NZ_OX366381,1,628840,630190,+,1350
282,NZ_OX366342,1,739209,740507,+,1298
282,NZ_OX366369,1,694469,695819,+,1350
282,NZ_OX366356,1,605854,607197,+,1343
282,NZ_OX366377,1,831231,832583,+,1352
282,NZ_OX366388,1,565645,566995,+,1350
282,NZ_OX366357,1,845298,846604,+,1306
282,NZ_CP072012,1,609827,611179,-,1352
282,NZ_OX366398,1,123264,124616,+,1352
282,NC_002978,6,365933,367285,+,1352
282,NZ_OX366389,1,910165,911517,-,1352
282,NZ_OX366397,1,993662,995014,-,1352
282,NZ_OX366378,1,403484,404834,-,1350
282,NZ_CP090903,1,365933,367285,+,1352
282,NZ_OX366374,1,880171,881450,-,1279
282,NZ_CP090901,1,365933,367285,+,1352
282,NZ_CP046923,1,365577,366929,+,1352
282,NZ_CP069055,1,402927,404279,+,1352
282,NZ_CP072670,1,365773,367125,+,1352
282,NZ_CP090899,1,365933,367285,+,1352
282,NZ_CP046924,1,365577,366929,+,1352
282,NZ_OX366348,1,562137,563489,-,1352
282,NZ_CP046921,1,365577,366929,+,1352
282,NZ_OX366338,1,1071061,1072419,-,1358
282,NZ_CP054557,1,111976,113328,+,1352
282,NZ_CP072669,1,365781,367133,+,1352
282,NC_021089,1,561067,562419,-,1352
283,NZ_OX366376,1,838333,839048,+,715
283,NZ_OX366393,1,614982,615697,-,715
283,NZ_OX366372,1,606643,607358,+,715
283,NZ_CP072672,1,369057,369812,+,755
283,NZ_CP069060,1,357843,358598,+,755
283,NZ_CP072667,1,369039,369794,+,755
283,NZ_CP072671,1,369039,369794,+,755
283,NZ_CP072668,1,369039,369794,+,755
283,NZ_CP072666,1,369039,369794,+,755
283,NZ_CP090902,1,369191,369946,+,755
283,NZ_CP090948,1,369191,369946,+,755
283,NZ_CP069052,1,352516,353271,+,755
283,NZ_CP076228,1,365747,366502,-,755
283,NZ_CP042445,1,369191,369946,+,755
283,NZ_CP042904,1,427748,428496,-,748
283,NC_012416,1,430486,431234,-,748
283,NZ_CP069053,1,188679,189434,-,755
283,NZ_CP042446,1,369191,369946,+,755
283,NZ_CP041215,1,886796,887551,+,755
283,NZ_OX366353,1,1310325,1311080,+,755
283,NZ_OX366387,1,1184205,1184960,-,755
283,NZ_OX366368,1,724806,725561,+,755
283,NZ_OX366379,1,821619,822374,-,755
283,NZ_CP091195,1,144032,144780,+,748
283,NZ_OX366375,1,752689,753444,-,755
283,NZ_CP046925,1,369039,369794,+,755
283,NZ_OX366318,1,770937,771692,-,755
283,NZ_OX366319,1,386932,387687,+,755
283,NZ_OX366332,1,909412,910167,-,755
283,NZ_CP110359,1,807651,808406,-,755
283,NZ_OU953855,1,886234,886989,-,755
283,NZ_OX366272,1,849270,850025,-,755
283,NZ_OX366347,1,1024512,1025267,-,755
283,NZ_OU909470,1,40089,40782,+,693
283,NZ_OX366363,1,138228,138983,+,755
283,NZ_OX366364,1,769235,769981,-,746
283,NZ_OX366359,1,740590,741345,-,755
283,NZ_OX366349,1,1402822,1403537,-,715
283,NZ_OX366380,1,652444,653192,+,748
283,NZ_OX366344,1,556051,556766,-,715
283,NZ_CP090900,1,369191,369946,+,755
283,NZ_OX366352,1,420111,420866,+,755
283,NZ_OX366362,1,978440,979146,+,706
283,NZ_OX366400,1,473184,473939,+,755
283,NZ_OX366327,1,821808,822554,-,746
283,NZ_OX366367,1,789239,789985,+,746
283,NZ_CP042444,1,369692,370447,+,755
283,NZ_OX366326,1,866608,867363,-,755
283,NZ_CP037426,1,326664,327419,-,755
283,NZ_OX366339,1,433285,434040,-,755
283,NZ_OX366355,1,406852,407607,+,755
283,NZ_CP046922,1,368835,369590,+,755
283,NZ_OX366370,1,588409,589124,-,715
283,NZ_OX366385,1,674142,674890,+,748
283,NZ_OX366399,1,812678,813433,-,755
283,NZ_OX366395,1,1090922,1091677,-,755
283,NZ_OX366396,1,89892,90647,+,755
283,NZ_OX366351,1,690248,691003,-,755
283,NZ_OX366381,1,634113,634868,+,755
283,NZ_OX366342,1,742972,743687,+,715
283,NZ_OX366369,1,699619,700374,+,755
283,NZ_OX366356,1,607813,608559,+,746
283,NZ_OX366377,1,835819,836574,+,755
283,NZ_OX366388,1,569353,570101,+,748
283,NZ_OX366357,1,1051591,1052346,-,755
283,NZ_CP072012,1,606961,607716,-,755
283,NZ_OX366398,1,127852,128607,+,755
283,NC_002978,6,369191,369946,+,755
283,NZ_OX366389,1,906174,906929,-,755
283,NZ_OX366397,1,990856,991611,-,755
283,NZ_OX366378,1,729563,730311,+,748
283,NZ_CP090903,1,369191,369946,+,755
283,NZ_OX366374,1,678559,679305,+,746
283,NZ_CP090901,1,369191,369946,+,755
283,NZ_CP046923,1,368835,369590,+,755
283,NZ_CP069055,1,407104,407859,+,755
283,NZ_CP072670,1,369031,369786,+,755
283,NZ_CP090899,1,369191,369946,+,755
283,NZ_CP046924,1,368835,369590,+,755
283,NZ_OX366348,1,558191,558946,-,755
283,NZ_CP046921,1,368835,369590,+,755
283,NZ_OX366338,1,1067087,1067833,-,746
283,NZ_CP054557,1,118772,119527,+,755
283,NZ_CP072669,1,369039,369794,+,755
283,NC_021089,1,558363,559118,-,755
284,NZ_OX366376,1,839567,841446,+,1879
284,NZ_OX366393,1,612583,614463,-,1880
284,NZ_OX366372,1,607877,609757,+,1880
284,NZ_CP072672,1,370257,372147,+,1890
284,NZ_CP069060,1,359043,360933,+,1890
284,NZ_CP072667,1,370239,372129,+,1890
284,NZ_CP072671,1,370239,372129,+,1890
284,NZ_CP072668,1,370239,372129,+,1890
284,NZ_CP072666,1,370239,372129,+,1890
284,NZ_CP090902,1,370391,372281,+,1890
284,NZ_CP090948,1,370391,372281,+,1890
284,NZ_CP069052,1,353716,355606,+,1890
284,NZ_CP076228,1,363412,365301,-,1889
284,NZ_CP042445,1,370391,372281,+,1890
284,NZ_CP042904,1,425413,427329,-,1916
284,NC_012416,1,428151,430067,-,1916
284,NZ_CP069053,1,186344,188233,-,1889
284,NZ_CP042446,1,370391,372281,+,1890
284,NZ_CP041215,1,887916,889802,+,1886
284,NZ_OX366353,1,1311445,1313331,+,1886
284,NZ_OX366387,1,1181891,1183791,-,1900
284,NZ_OX366368,1,726006,727896,+,1890
284,NZ_OX366379,1,819284,821173,-,1889
284,NZ_CP091195,1,145225,147115,+,1890
284,NZ_OX366375,1,750384,752291,-,1907
284,NZ_CP046925,1,370239,372129,+,1890
284,NZ_OX366318,1,768602,770491,-,1889
284,NZ_OX366319,1,388085,390001,+,1916
284,NZ_OX366332,1,907161,909047,-,1886
284,NZ_CP110359,1,805343,807234,-,1891
284,NZ_OU953855,1,883926,885817,-,1891
284,NZ_OX366272,1,846962,848853,-,1891
284,NZ_OX366347,1,1022183,1024074,-,1891
284,NZ_OU909470,1,46937,48834,+,1897
284,NZ_OX366363,1,139324,141231,+,1907
284,NZ_OX366364,1,766929,768810,-,1881
284,NZ_OX366359,1,738339,740225,-,1886
284,NZ_OX366349,1,1400381,1402261,-,1880
284,NZ_OX366380,1,653543,655414,+,1871
284,NZ_OX366344,1,553631,555518,-,1887
284,NZ_CP090900,1,370391,372281,+,1890
284,NZ_OX366352,1,421231,423117,+,1886
284,NZ_OX366362,1,979570,981452,+,1882
284,NZ_OX366400,1,474384,476274,+,1890
284,NZ_OX366327,1,819494,821410,-,1916
284,NZ_OX366367,1,790409,792291,+,1882
284,NZ_CP042444,1,370892,372782,+,1890
284,NZ_OX366326,1,864273,866162,-,1889
284,NZ_CP037426,1,324359,326266,-,1907
284,NZ_OX366339,1,430980,432887,-,1907
284,NZ_OX366355,1,408005,409921,+,1916
284,NZ_CP046922,1,370035,371925,+,1890
284,NZ_OX366370,1,585943,587753,-,1810
284,NZ_OX366385,1,675241,677112,+,1871
284,NZ_OX366399,1,810343,812232,-,1889
284,NZ_OX366395,1,1088608,1090497,-,1889
284,NZ_OX366396,1,91045,92952,+,1907
284,NZ_OX366351,1,687913,689802,-,1889
284,NZ_OX366381,1,635266,637182,+,1916
284,NZ_OX366342,1,744206,746086,+,1880
284,NZ_OX366369,1,700772,702688,+,1916
284,NZ_OX366356,1,608957,610864,+,1907
284,NZ_OX366377,1,837019,838909,+,1890
284,NZ_OX366388,1,570546,572436,+,1890
284,NZ_OX366357,1,1049208,1051097,-,1889
284,NZ_CP072012,1,604626,606515,-,1889
284,NZ_OX366398,1,129052,130942,+,1890
284,NC_002978,6,370391,372281,+,1890
284,NZ_OX366389,1,903839,905728,-,1889
284,NZ_OX366397,1,988605,990491,-,1886
284,NZ_OX366378,1,730756,732646,+,1890
284,NZ_CP090903,1,370391,372281,+,1890
284,NZ_OX366374,1,679804,681718,+,1914
284,NZ_CP090901,1,370391,372281,+,1890
284,NZ_CP046923,1,370035,371925,+,1890
284,NZ_CP069055,1,408304,410194,+,1890
284,NZ_CP072670,1,370231,372121,+,1890
284,NZ_CP090899,1,370391,372281,+,1890
284,NZ_CP046924,1,370035,371925,+,1890
284,NZ_OX366348,1,555856,557745,-,1889
284,NZ_CP046921,1,370035,371925,+,1890
284,NZ_OX366338,1,1064743,1066641,-,1898
284,NZ_CP054557,1,119972,121862,+,1890
284,NZ_CP072669,1,370239,372129,+,1890
284,NC_021089,1,556112,557998,-,1886
285,NZ_OX366376,1,841967,845379,+,3412
285,NZ_OX366393,1,608650,612062,-,3412
285,NZ_OX366372,1,610278,613690,+,3412
285,NZ_CP072672,1,372642,376047,+,3405
285,NZ_CP069060,1,361428,364833,+,3405
285,NZ_CP072667,1,372624,376029,+,3405
285,NZ_CP072671,1,372624,376029,+,3405
285,NZ_CP072668,1,372624,376029,+,3405
285,NZ_CP072666,1,372624,376029,+,3405
285,NZ_CP090902,1,372776,376181,+,3405
285,NZ_CP090948,1,372776,376181,+,3405
285,NZ_CP069052,1,356101,359506,+,3405
285,NZ_CP076228,1,359512,362917,-,3405
285,NZ_CP042445,1,372776,376181,+,3405
285,NZ_CP042904,1,421621,425019,-,3398
285,NC_012416,1,424359,427757,-,3398
285,NZ_CP069053,1,182444,185849,-,3405
285,NZ_CP042446,1,372776,376181,+,3405
285,NZ_CP041215,1,890298,893703,+,3405
285,NZ_OX366353,1,1313827,1317232,+,3405
285,NZ_OX366387,1,1177999,1181404,-,3405
285,NZ_OX366368,1,728391,731796,+,3405
285,NZ_OX366379,1,815384,818789,-,3405
285,NZ_CP091195,1,147941,151346,+,3405
285,NZ_OX366375,1,746475,749880,-,3405
285,NZ_CP046925,1,372624,376029,+,3405
285,NZ_OX366318,1,764703,768107,-,3404
285,NZ_OX366319,1,390480,393885,+,3405
285,NZ_OX366332,1,903260,906665,-,3405
285,NZ_CP110359,1,801427,804839,-,3412
285,NZ_OU953855,1,880019,883431,-,3412
285,NZ_OX366272,1,843046,846458,-,3412
285,NZ_OX366347,1,1018267,1021679,-,3412
285,NZ_OU909470,1,49645,53051,+,3406
285,NZ_OX366363,1,141726,145138,+,3412
285,NZ_OX366364,1,761924,765336,-,3412
285,NZ_OX366359,1,734438,737843,-,3405
285,NZ_OX366349,1,1396112,1399524,-,3412
285,NZ_OX366380,1,656207,659613,+,3406
285,NZ_OX366344,1,549698,553110,-,3412
285,NZ_CP090900,1,372776,376181,+,3405
285,NZ_OX366352,1,423613,427018,+,3405
285,NZ_OX366362,1,743166,746578,-,3412
285,NZ_OX366400,1,476769,480174,+,3405
285,NZ_OX366327,1,815578,818990,-,3412
285,NZ_OX366367,1,792785,796197,+,3412
285,NZ_CP042444,1,373277,376682,+,3405
285,NZ_OX366326,1,860373,863778,-,3405
285,NZ_CP037426,1,320450,323855,-,3405
285,NZ_OX366339,1,426734,430139,-,3405
285,NZ_OX366355,1,410400,413805,+,3405
285,NZ_CP046922,1,372420,375825,+,3405
285,NZ_OX366370,1,582015,585427,-,3412
285,NZ_OX366385,1,677905,681311,+,3406
285,NZ_OX366399,1,806443,809848,-,3405
285,NZ_OX366395,1,1084340,1087745,-,3405
285,NZ_OX366396,1,93793,97198,+,3405
285,NZ_OX366351,1,684013,687418,-,3405
285,NZ_OX366381,1,637661,641066,+,3405
285,NZ_OX366342,1,746608,750020,+,3412
285,NZ_OX366369,1,703167,706572,+,3405
285,NZ_OX366356,1,611352,614764,+,3412
285,NZ_OX366377,1,839396,842801,+,3405
285,NZ_OX366388,1,573262,576667,+,3405
285,NZ_OX366357,1,1044967,1048372,-,3405
285,NZ_CP072012,1,600726,604131,-,3405
285,NZ_OX366398,1,131429,134834,+,3405
285,NC_002978,6,372776,376181,+,3405
285,NZ_OX366389,1,899028,902433,-,3405
285,NZ_OX366397,1,984704,988109,-,3405
285,NZ_OX366378,1,733472,736877,+,3405
285,NZ_CP090903,1,372776,376181,+,3405
285,NZ_OX366374,1,683571,686974,+,3403
285,NZ_CP090901,1,372776,376181,+,3405
285,NZ_CP046923,1,372420,375825,+,3405
285,NZ_CP069055,1,410689,414094,+,3405
285,NZ_CP072670,1,372616,376021,+,3405
285,NZ_CP090899,1,372776,376181,+,3405
285,NZ_CP046924,1,372420,375825,+,3405
285,NZ_OX366348,1,551947,555352,-,3405
285,NZ_CP046921,1,372420,375825,+,3405
285,NZ_OX366338,1,1059515,1062929,-,3414
285,NZ_CP054557,1,122366,125771,+,3405
285,NZ_CP072669,1,372624,376029,+,3405
285,NC_021089,1,552211,555616,-,3405
286,NZ_OX366376,1,847305,848703,+,1398
286,NZ_OX366393,1,605216,606614,-,1398
286,NZ_OX366372,1,615529,616927,+,1398
286,NZ_CP072672,1,383072,384470,-,1398
286,NZ_CP069060,1,371608,373006,-,1398
286,NZ_CP072667,1,383054,384452,-,1398
286,NZ_CP072671,1,383054,384452,-,1398
286,NZ_CP072668,1,383041,384439,-,1398
286,NZ_CP072666,1,383054,384452,-,1398
286,NZ_CP090902,1,383206,384604,-,1398
286,NZ_CP090948,1,383206,384604,-,1398
286,NZ_CP069052,1,498413,499811,+,1398
286,NZ_CP076228,1,327854,329252,+,1398
286,NZ_CP042445,1,383206,384604,-,1398
286,NZ_CP042904,1,405330,406728,-,1398
286,NC_012416,1,410411,411809,+,1398
286,NZ_CP069053,1,174271,175669,+,1398
286,NZ_CP042446,1,383206,384604,-,1398
286,NZ_CP041215,1,686220,687618,-,1398
286,NZ_OX366353,1,31414,32812,-,1398
286,NZ_OX366387,1,1172166,1173564,+,1398
286,NZ_OX366368,1,849469,850867,+,1398
286,NZ_OX366379,1,806908,808306,+,1398
286,NZ_CP091195,1,158299,159697,-,1398
286,NZ_OX366375,1,700102,701500,+,1398
286,NZ_CP046925,1,383054,384452,-,1398
286,NZ_OX366318,1,758594,759992,+,1398
286,NZ_OX366319,1,544610,546008,+,1398
286,NZ_OX366332,1,893245,894643,+,1398
286,NZ_CP110359,1,795494,796892,+,1398
286,NZ_OU953855,1,1498796,1500194,-,1398
286,NZ_OX366272,1,837111,838509,+,1398
286,NZ_OX366347,1,896401,897799,-,1398
286,NZ_OU909470,1,28521,29912,-,1391
286,NZ_OX366363,1,149711,151109,-,1398
286,NZ_OX366364,1,756685,758077,-,1392
286,NZ_OX366359,1,725014,726412,+,1398
286,NZ_OX366349,1,1393196,1394594,-,1398
286,NZ_OX366380,1,662766,664157,+,1391
286,NZ_OX366344,1,545678,547076,-,1398
286,NZ_CP090900,1,383206,384604,-,1398
286,NZ_OX366352,1,956304,957702,+,1398
286,NZ_OX366362,1,657722,659120,+,1398
286,NZ_OX366400,1,484878,486276,-,1398
286,NZ_OX366327,1,811630,813028,+,1398
286,NZ_OX366367,1,802605,803997,+,1392
286,NZ_CP042444,1,383707,385105,-,1398
286,NZ_OX366326,1,854264,855662,+,1398
286,NZ_CP037426,1,312409,313807,+,1398
286,NZ_OX366339,1,421836,423234,+,1398
286,NZ_OX366355,1,419174,420572,-,1398
286,NZ_CP046922,1,578929,580327,+,1398
286,NZ_OX366370,1,576976,578374,-,1398
286,NZ_OX366385,1,684356,685747,+,1391
286,NZ_OX366399,1,776492,777890,+,1398
286,NZ_OX366395,1,1094050,1095448,+,1398
286,NZ_OX366396,1,99746,101144,-,1398
286,NZ_OX366351,1,677904,679302,+,1398
286,NZ_OX366381,1,705443,706841,+,1398
286,NZ_OX366342,1,751748,753146,+,1398
286,NZ_OX366369,1,711103,712501,-,1398
286,NZ_OX366356,1,619389,620787,-,1398
286,NZ_OX366377,1,970928,972326,+,1398
286,NZ_OX366388,1,581032,582430,-,1398
286,NZ_OX366357,1,922887,924285,-,1398
286,NZ_CP072012,1,481918,483316,-,1398
286,NZ_OX366398,1,144596,145994,-,1398
286,NC_002978,6,383206,384604,-,1398
286,NZ_OX366389,1,877145,878543,+,1398
286,NZ_OX366397,1,727990,729388,-,1398
286,NZ_OX366378,1,741348,742746,-,1398
286,NZ_CP090903,1,383206,384604,-,1398
286,NZ_OX366374,1,689587,690985,-,1398
286,NZ_CP090901,1,383206,384604,-,1398
286,NZ_CP046923,1,495177,496575,+,1398
286,NZ_CP069055,1,420818,422216,-,1398
286,NZ_CP072670,1,383046,384444,-,1398
286,NZ_CP090899,1,383206,384604,-,1398
286,NZ_CP046924,1,516115,517513,+,1398
286,NZ_OX366348,1,546094,547492,+,1398
286,NZ_CP046921,1,578929,580327,+,1398
286,NZ_OX366338,1,1052123,1053521,+,1398
286,NZ_CP054557,1,130421,131819,-,1398
286,NZ_CP072669,1,383054,384452,-,1398
286,NC_021089,1,542866,544264,+,1398
287,NZ_OX366376,1,849171,851196,+,2025
287,NZ_OX366393,1,602579,604747,-,2168
287,NZ_OX366372,1,617395,619477,+,2082
287,NZ_OX366342,1,753614,755546,+,1932
288,NZ_OX366376,1,852007,853752,+,1745
288,NZ_OX366393,1,600023,601767,-,1744
288,NZ_OX366372,1,620288,622033,+,1745
288,NZ_CP072672,1,380573,382308,-,1735
288,NZ_CP069060,1,369139,370874,-,1735
288,NZ_CP072667,1,380555,382290,-,1735
288,NZ_CP072671,1,380555,382290,-,1735
288,NZ_CP072668,1,380542,382277,-,1735
288,NZ_CP072666,1,380555,382290,-,1735
288,NZ_CP090902,1,380707,382442,-,1735
288,NZ_CP090948,1,380707,382442,-,1735
288,NZ_CP069052,1,500544,502280,+,1736
288,NZ_CP076228,1,330015,331751,+,1736
288,NZ_CP042445,1,380707,382442,-,1735
288,NZ_CP042904,1,398897,400639,-,1742
288,NC_012416,1,416646,418389,+,1743
288,NZ_CP069053,1,176402,178138,+,1736
288,NZ_CP042446,1,380707,382442,-,1735
288,NZ_CP041215,1,895834,897586,-,1752
288,NZ_OX366353,1,24061,25813,-,1752
288,NZ_OX366387,1,1174329,1176065,+,1736
288,NZ_OX366368,1,851630,853366,+,1736
288,NZ_OX366379,1,809069,810805,+,1736
288,NZ_CP091195,1,155789,157533,-,1744
288,NZ_OX366375,1,702281,704026,+,1745
288,NZ_CP046925,1,380555,382290,-,1735
288,NZ_OX366318,1,760755,762491,+,1736
288,NZ_OX366319,1,546771,548516,+,1745
288,NZ_OX366332,1,899377,901129,+,1752
288,NZ_CP110359,1,797655,799400,+,1745
288,NZ_OU953855,1,1728556,1730337,-,1781
288,NZ_OX366272,1,839272,841017,+,1745
288,NZ_OX366347,1,893875,895619,-,1744
288,NZ_OU909470,1,24868,26611,-,1743
288,NZ_OX366363,1,147212,148947,-,1735
288,NZ_OX366364,1,751669,753404,-,1735
288,NZ_OX366359,1,730630,732382,+,1752
288,NZ_OX366349,1,1388044,1389788,-,1744
288,NZ_OX366380,1,666112,667856,+,1744
288,NZ_OX366344,1,541553,543297,-,1744
288,NZ_CP090900,1,380707,382442,-,1735
288,NZ_OX366352,1,963894,965646,+,1752
288,NZ_OX366362,1,663601,665338,+,1737
288,NZ_OX366400,1,482381,484114,-,1733
288,NZ_OX366327,1,813793,815528,+,1735
288,NZ_OX366367,1,807286,808992,+,1706
288,NZ_CP042444,1,381208,382943,-,1735
288,NZ_OX366326,1,856425,858161,+,1736
288,NZ_CP037426,1,314588,316333,+,1745
288,NZ_OX366339,1,424949,426684,+,1735
288,NZ_OX366355,1,416666,418410,-,1744
288,NZ_CP046922,1,581090,582826,+,1736
288,NZ_OX366370,1,573231,574975,-,1744
288,NZ_OX366385,1,687774,689518,+,1744
288,NZ_OX366399,1,778653,780389,+,1736
288,NZ_OX366395,1,1082547,1084290,+,1743
288,NZ_OX366396,1,97248,98982,-,1734
288,NZ_OX366351,1,680065,681801,+,1736
288,NZ_OX366381,1,707604,709349,+,1745
288,NZ_OX366342,1,756357,758102,+,1745
288,NZ_OX366369,1,708595,710339,-,1744
288,NZ_OX366356,1,616775,618519,-,1744
288,NZ_OX366377,1,973089,974832,+,1743
288,NZ_OX366388,1,578488,580232,-,1744
288,NZ_OX366357,1,1233417,1235153,+,1736
288,NZ_CP072012,1,479419,481154,-,1735
288,NZ_OX366398,1,142090,143832,-,1742
288,NC_002978,6,380707,382442,-,1735
288,NZ_OX366389,1,879306,881051,+,1745
288,NZ_OX366397,1,980627,982379,+,1752
288,NZ_OX366378,1,738838,740582,-,1744
288,NZ_CP090903,1,380707,382442,-,1735
288,NZ_OX366374,1,687025,688778,-,1753
288,NZ_CP090901,1,380707,382442,-,1735
288,NZ_CP046923,1,497338,499074,+,1736
288,NZ_CP069055,1,418319,420054,-,1735
288,NZ_CP072670,1,380547,382282,-,1735
288,NZ_CP090899,1,380707,382442,-,1735
288,NZ_CP046924,1,518276,520012,+,1736
288,NZ_OX366348,1,548255,549991,+,1736
288,NZ_CP046921,1,581090,582826,+,1736
288,NZ_OX366338,1,1057730,1059465,+,1735
288,NZ_CP054557,1,127929,129657,-,1728
288,NZ_CP072669,1,380555,382290,-,1735
288,NC_021089,1,548419,550171,+,1752
289,NZ_OX366376,1,854596,857277,+,2681
289,NZ_OX366393,1,596612,599293,-,2681
289,NZ_OX366372,1,622930,625611,+,2681
289,NZ_CP072672,1,229555,232280,+,2725
289,NZ_CP069060,1,204071,206796,-,2725
289,NZ_CP072667,1,229537,232262,+,2725
289,NZ_CP072671,1,229537,232262,+,2725
289,NZ_CP072668,1,229537,232262,+,2725
289,NZ_CP072666,1,229537,232262,+,2725
289,NZ_CP090902,1,229689,232414,+,2725
289,NZ_CP090948,1,229689,232414,+,2725
289,NZ_CP069052,1,198736,201461,-,2725
289,NZ_CP076228,1,515724,518449,-,2725
289,NZ_CP042445,1,229689,232414,+,2725
289,NZ_CP042904,1,238280,241005,+,2725
289,NC_012416,1,240862,243587,+,2725
289,NZ_CP069053,1,340481,343206,+,2725
289,NZ_CP042446,1,229689,232414,+,2725
289,NZ_CP041215,1,640297,643022,-,2725
289,NZ_OX366353,1,499415,502140,+,2725
289,NZ_OX366387,1,1006985,1009710,+,2725
289,NZ_OX366368,1,507790,510515,+,2725
289,NZ_OX366379,1,508835,511560,+,2725
289,NZ_CP091195,1,1469879,1472604,-,2725
289,NZ_OX366375,1,611035,613760,+,2725
289,NZ_CP046925,1,229537,232262,+,2725
289,NZ_OX366318,1,611364,614089,+,2725
289,NZ_OX366319,1,679994,682719,-,2725
289,NZ_OX366332,1,505245,507970,+,2725
289,NZ_CP110359,1,1011735,1014460,-,2725
289,NZ_OU953855,1,893639,896364,+,2725
289,NZ_OX366272,1,751173,753898,+,2725
289,NZ_OX366347,1,620381,623106,+,2725
289,NZ_OU909470,1,21171,24132,-,2961
289,NZ_OX366363,1,407623,410348,-,2725
289,NZ_OX366364,1,873784,876457,-,2673
289,NZ_OX366359,1,470094,472819,-,2725
289,NZ_OX366349,1,1608833,1611514,-,2681
289,NZ_OX366380,1,668918,671591,+,2673
289,NZ_OX366344,1,538051,540732,-,2681
289,NZ_CP090900,1,229689,232414,+,2725
289,NZ_OX366352,1,616076,618801,-,2725
289,NZ_OX366362,1,157413,160126,+,2713
289,NZ_OX366400,1,637845,640570,-,2725
289,NZ_OX366327,1,659548,662273,+,2725
289,NZ_OX366367,1,684595,687268,-,2673
289,NZ_CP042444,1,229627,232352,+,2725
289,NZ_OX366326,1,704385,707110,+,2725
289,NZ_CP037426,1,875257,877982,+,2725
289,NZ_OX366339,1,485059,487784,+,2725
289,NZ_OX366355,1,790936,793661,-,2725
289,NZ_CP046922,1,229386,232111,+,2725
289,NZ_OX366370,1,644527,647208,-,2681
289,NZ_OX366385,1,691433,694106,+,2673
289,NZ_OX366399,1,507327,510052,+,2725
289,NZ_OX366395,1,1019548,1022273,+,2725
289,NZ_OX366396,1,1491350,1494075,+,2725
289,NZ_OX366351,1,526319,529044,+,2725
289,NZ_OX366381,1,953721,956446,-,2725
289,NZ_OX366342,1,758930,761611,+,2681
289,NZ_OX366369,1,510233,512958,+,2725
289,NZ_OX366356,1,767909,770634,-,2725
289,NZ_OX366377,1,616743,619468,+,2725
289,NZ_OX366388,1,782709,785434,+,2725
289,NZ_OX366357,1,746527,749252,+,2725
289,NZ_CP072012,1,430099,432824,+,2725
289,NZ_OX366398,1,1168420,1171145,+,2725
289,NC_002978,6,229689,232414,+,2725
289,NZ_OX366389,1,647709,650434,-,2725
289,NZ_OX366397,1,716552,719277,+,2725
289,NZ_OX366378,1,472226,474951,-,2725
289,NZ_CP090903,1,229689,232414,+,2725
289,NZ_OX366374,1,774864,777587,+,2723
289,NZ_CP090901,1,229689,232414,+,2725
289,NZ_CP046923,1,229386,232111,+,2725
289,NZ_CP069055,1,190909,193634,-,2725
289,NZ_CP072670,1,229537,232262,+,2725
289,NZ_CP090899,1,229689,232414,+,2725
289,NZ_CP046924,1,229386,232111,+,2725
289,NZ_OX366348,1,741638,744363,-,2725
289,NZ_CP046921,1,229386,232111,+,2725
289,NZ_OX366338,1,512686,515405,+,2719
289,NZ_CP054557,1,1233776,1236501,+,2725
289,NZ_CP072669,1,229537,232262,+,2725
289,NC_021089,1,191242,193967,-,2725
290,NZ_OX366376,1,858841,859866,+,1025
290,NZ_OX366393,1,594023,595048,-,1025
290,NZ_OX366372,1,627175,628200,+,1025
290,NZ_CP072672,1,233840,234887,+,1047
290,NZ_CP069060,1,201464,202511,-,1047
290,NZ_CP072667,1,233822,234869,+,1047
290,NZ_CP072671,1,233822,234869,+,1047
290,NZ_CP072668,1,233822,234869,+,1047
290,NZ_CP072666,1,233822,234869,+,1047
290,NZ_CP090902,1,233974,235021,+,1047
290,NZ_CP090948,1,233974,235021,+,1047
290,NZ_CP069052,1,196129,197176,-,1047
290,NZ_CP076228,1,513117,514164,-,1047
290,NZ_CP042445,1,233974,235021,+,1047
290,NZ_CP042904,1,242566,243613,+,1047
290,NC_012416,1,245148,246195,+,1047
290,NZ_CP069053,1,344766,345813,+,1047
290,NZ_CP042446,1,233974,235021,+,1047
290,NZ_CP041215,1,548263,549310,-,1047
290,NZ_OX366353,1,503709,504756,+,1047
290,NZ_OX366387,1,1011270,1012317,+,1047
290,NZ_OX366368,1,512075,513122,+,1047
290,NZ_OX366379,1,513120,514167,+,1047
290,NZ_CP091195,1,1465247,1466294,-,1047
290,NZ_OX366375,1,616258,617289,+,1031
290,NZ_CP046925,1,233822,234869,+,1047
290,NZ_OX366318,1,615649,616696,+,1047
290,NZ_OX366319,1,676548,677579,-,1031
290,NZ_OX366332,1,509540,510587,+,1047
290,NZ_CP110359,1,1008111,1009158,-,1047
290,NZ_OU953855,1,898149,899196,+,1047
290,NZ_OX366272,1,757427,758474,+,1047
290,NZ_OX366347,1,625676,626723,+,1047
290,NZ_OU909470,1,1218974,1220021,+,1047
290,NZ_OX366363,1,405016,406063,-,1047
290,NZ_OX366364,1,849137,850155,-,1018
290,NZ_OX366359,1,467477,468524,-,1047
290,NZ_OX366349,1,1606244,1607269,-,1025
290,NZ_OX366380,1,673514,674561,+,1047
290,NZ_OX366344,1,535462,536487,-,1025
290,NZ_CP090900,1,233974,235021,+,1047
290,NZ_OX366352,1,613459,614506,-,1047
290,NZ_OX366362,1,850343,851390,+,1047
290,NZ_OX366400,1,634732,635779,-,1047
290,NZ_OX366327,1,664212,665259,+,1047
290,NZ_OX366367,1,714003,715021,+,1018
290,NZ_CP042444,1,233912,234959,+,1047
290,NZ_OX366326,1,708670,709717,+,1047
290,NZ_CP037426,1,1081846,1082877,+,1031
290,NZ_OX366339,1,490296,491343,+,1047
290,NZ_OX366355,1,788328,789359,-,1031
290,NZ_CP046922,1,233671,234718,+,1047
290,NZ_OX366370,1,641557,642601,-,1044
290,NZ_OX366385,1,351730,352777,-,1047
290,NZ_OX366399,1,511612,512659,+,1047
290,NZ_OX366395,1,1023700,1024747,+,1047
290,NZ_OX366396,1,1495635,1496682,+,1047
290,NZ_OX366351,1,530604,531651,+,1047
290,NZ_OX366381,1,951113,952144,-,1031
290,NZ_OX366342,1,763175,764200,+,1025
290,NZ_OX366369,1,514535,515566,+,1031
290,NZ_OX366356,1,765302,766349,-,1047
290,NZ_OX366377,1,621029,622076,+,1047
290,NZ_OX366388,1,1270775,1271822,+,1047
290,NZ_OX366357,1,246444,247491,-,1047
290,NZ_CP072012,1,434384,435431,+,1047
290,NZ_OX366398,1,1172706,1173753,+,1047
290,NC_002978,6,233974,235021,+,1047
290,NZ_OX366389,1,645101,646148,-,1047
290,NZ_OX366397,1,720847,721894,+,1047
290,NZ_OX366378,1,278844,279891,-,1047
290,NZ_CP090903,1,233974,235021,+,1047
290,NZ_OX366374,1,780503,781547,+,1044
290,NZ_CP090901,1,233974,235021,+,1047
290,NZ_CP046923,1,233671,234718,+,1047
290,NZ_CP069055,1,188302,189349,-,1047
290,NZ_CP072670,1,233822,234869,+,1047
290,NZ_CP090899,1,233974,235021,+,1047
290,NZ_CP046924,1,233671,234718,+,1047
290,NZ_OX366348,1,739198,740245,-,1047
290,NZ_CP046921,1,233671,234718,+,1047
290,NZ_OX366338,1,518571,519618,+,1047
290,NZ_CP054557,1,1238057,1239104,+,1047
290,NZ_CP072669,1,233822,234869,+,1047
290,NC_021089,1,188625,189672,-,1047
291,NZ_OX366376,1,860180,861583,+,1403
291,NZ_OX366393,1,592306,593709,-,1403
291,NZ_OX366372,1,628514,629917,+,1403
291,NZ_CP072672,1,324041,325421,-,1380
291,NZ_CP069060,1,312973,314347,-,1374
291,NZ_CP072667,1,324023,325403,-,1380
291,NZ_CP072671,1,324023,325403,-,1380
291,NZ_CP072668,1,324023,325403,-,1380
291,NZ_CP072666,1,324023,325403,-,1380
291,NZ_CP090902,1,324175,325555,-,1380
291,NZ_CP090948,1,324175,325555,-,1380
291,NZ_CP069052,1,307646,309020,-,1374
291,NZ_CP076228,1,410459,411839,+,1380
291,NZ_CP042445,1,324175,325555,-,1380
291,NZ_CP042904,1,474045,475425,+,1380
291,NC_012416,1,477364,478744,+,1380
291,NZ_CP069053,1,232930,234304,+,1374
291,NZ_CP042446,1,324175,325555,-,1380
291,NZ_CP041215,1,837530,838910,+,1380
291,NZ_OX366353,1,293871,295251,-,1380
291,NZ_OX366387,1,1625713,1627093,-,1380
291,NZ_OX366368,1,679125,680505,-,1380
291,NZ_OX366379,1,866682,868062,+,1380
291,NZ_CP091195,1,317159,318554,+,1395
291,NZ_OX366375,1,779320,780700,+,1380
291,NZ_CP046925,1,324023,325403,-,1380
291,NZ_OX366318,1,816733,818113,+,1380
291,NZ_OX366319,1,427655,429035,-,1380
291,NZ_OX366332,1,953452,954832,+,1380
291,NZ_CP110359,1,853870,855265,+,1395
291,NZ_OU953855,1,362540,363935,-,1395
291,NZ_OX366272,1,659528,660923,+,1395
291,NZ_OX366347,1,1071773,1073168,+,1395
291,NZ_OU909470,1,1220978,1222361,+,1383
291,NZ_OX366363,1,92009,93404,-,1395
291,NZ_OX366364,1,846459,847847,-,1388
291,NZ_OX366359,1,784154,785534,+,1380
291,NZ_OX366349,1,1603095,1604498,-,1403
291,NZ_OX366380,1,675441,676817,+,1376
291,NZ_OX366344,1,532692,534063,-,1371
291,NZ_CP090900,1,324175,325555,-,1380
291,NZ_OX366352,1,714547,715927,+,1380
291,NZ_OX366362,1,851449,852844,+,1395
291,NZ_OX366400,1,427329,428709,-,1380
291,NZ_OX366327,1,864507,865887,+,1380
291,NZ_OX366367,1,716288,717676,+,1388
291,NZ_CP042444,1,324676,326056,-,1380
291,NZ_OX366326,1,914030,915410,+,1380
291,NZ_CP037426,1,213672,215052,+,1380
291,NZ_OX366339,1,631060,632455,+,1395
291,NZ_OX366355,1,529473,530853,+,1380
291,NZ_CP046922,1,323873,325253,-,1380
291,NZ_OX366370,1,639932,641320,-,1388
291,NZ_OX366385,1,347995,349371,-,1376
291,NZ_OX366399,1,857723,859103,+,1380
291,NZ_OX366395,1,898000,899395,+,1395
291,NZ_OX366396,1,1202196,1203591,-,1395
291,NZ_OX366351,1,741752,743132,+,1380
291,NZ_OX366381,1,588017,589397,-,1380
291,NZ_OX366342,1,764514,765917,+,1403
291,NZ_OX366369,1,654543,655923,-,1380
291,NZ_OX366356,1,563721,565101,-,1380
291,NZ_OX366377,1,428270,429650,+,1380
291,NZ_OX366388,1,489499,490894,+,1395
291,NZ_OX366357,1,602586,603980,+,1394
291,NZ_CP072012,1,651547,652927,+,1380
291,NZ_OX366398,1,81184,82564,-,1380
291,NC_002978,6,324175,325555,-,1380
291,NZ_OX366389,1,924923,926303,+,1380
291,NZ_OX366397,1,1034932,1036312,+,1380
291,NZ_OX366378,1,444240,445635,-,1395
291,NZ_CP090903,1,324175,325555,-,1380
291,NZ_OX366374,1,884870,886265,-,1395
291,NZ_CP090901,1,324175,325555,-,1380
291,NZ_CP046923,1,323873,325253,-,1380
291,NZ_CP069055,1,361171,362551,-,1380
291,NZ_CP072670,1,324015,325395,-,1380
291,NZ_CP090899,1,324175,325555,-,1380
291,NZ_CP046924,1,323873,325253,-,1380
291,NZ_OX366348,1,671138,672518,-,1380
291,NZ_CP046921,1,323873,325253,-,1380
291,NZ_OX366338,1,745693,747088,+,1395
291,NZ_CP054557,1,67200,68580,-,1380
291,NZ_CP072669,1,324023,325403,-,1380
291,NC_021089,1,602339,603719,+,1380
292,NZ_OX366376,1,861584,862401,+,817
292,NZ_OX366393,1,591488,592304,-,816
292,NZ_OX366372,1,629918,630735,+,817
292,NZ_CP072672,1,323223,324039,-,816
292,NZ_CP069060,1,312155,312971,-,816
292,NZ_CP072667,1,323205,324021,-,816
292,NZ_CP072671,1,323205,324021,-,816
292,NZ_CP072668,1,323205,324021,-,816
292,NZ_CP072666,1,323205,324021,-,816
292,NZ_CP090902,1,323357,324173,-,816
292,NZ_CP090948,1,323357,324173,-,816
292,NZ_CP069052,1,306828,307644,-,816
292,NZ_CP076228,1,411840,412657,+,817
292,NZ_CP042445,1,323357,324173,-,816
292,NZ_CP042904,1,475426,476241,+,815
292,NC_012416,1,478745,479560,+,815
292,NZ_CP069053,1,234305,235122,+,817
292,NZ_CP042446,1,323357,324173,-,816
292,NZ_CP041215,1,838911,839728,+,817
292,NZ_OX366353,1,293053,293869,-,816
292,NZ_OX366387,1,1624895,1625711,-,816
292,NZ_OX366368,1,678307,679123,-,816
292,NZ_OX366379,1,868063,868880,+,817
292,NZ_CP091195,1,318555,319372,+,817
292,NZ_OX366375,1,780701,781518,+,817
292,NZ_CP046925,1,323205,324021,-,816
292,NZ_OX366318,1,818114,818931,+,817
292,NZ_OX366319,1,426837,427653,-,816
292,NZ_OX366332,1,954833,955650,+,817
292,NZ_CP110359,1,855266,856083,+,817
292,NZ_OU953855,1,361722,362538,-,816
292,NZ_OX366272,1,660924,661741,+,817
292,NZ_OX366347,1,1073169,1073986,+,817
292,NZ_OU909470,1,1222362,1223177,+,815
292,NZ_OX366363,1,91191,92007,-,816
292,NZ_OX366364,1,845641,846457,-,816
292,NZ_OX366359,1,785535,786352,+,817
292,NZ_OX366349,1,1602277,1603093,-,816
292,NZ_OX366380,1,676818,677633,+,815
292,NZ_OX366344,1,531846,532611,-,765
292,NZ_CP090900,1,323357,324173,-,816
292,NZ_OX366352,1,715928,716745,+,817
292,NZ_OX366362,1,852845,853654,+,809
292,NZ_OX366400,1,426511,427327,-,816
292,NZ_OX366327,1,865888,866703,+,815
292,NZ_OX366367,1,717677,718494,+,817
292,NZ_CP042444,1,323858,324674,-,816
292,NZ_OX366326,1,915411,916228,+,817
292,NZ_CP037426,1,215053,215870,+,817
292,NZ_OX366339,1,632456,633273,+,817
292,NZ_OX366355,1,530854,531671,+,817
292,NZ_CP046922,1,323055,323871,-,816
292,NZ_OX366370,1,639116,639930,-,814
292,NZ_OX366385,1,347179,347993,-,814
292,NZ_OX366399,1,859104,859921,+,817
292,NZ_OX366395,1,899396,900211,+,815
292,NZ_OX366396,1,1201378,1202194,-,816
292,NZ_OX366351,1,743133,743950,+,817
292,NZ_OX366381,1,587199,588015,-,816
292,NZ_OX366342,1,765918,766735,+,817
292,NZ_OX366369,1,653725,654541,-,816
292,NZ_OX366356,1,562903,563719,-,816
292,NZ_OX366377,1,429651,430468,+,817
292,NZ_OX366388,1,490895,491712,+,817
292,NZ_OX366357,1,603981,604798,+,817
292,NZ_CP072012,1,652928,653745,+,817
292,NZ_OX366398,1,80366,81182,-,816
292,NC_002978,6,323357,324173,-,816
292,NZ_OX366389,1,926304,927121,+,817
292,NZ_OX366397,1,1036313,1037130,+,817
292,NZ_OX366378,1,443422,444238,-,816
292,NZ_CP090903,1,323357,324173,-,816
292,NZ_OX366374,1,883199,884009,-,810
292,NZ_CP090901,1,323357,324173,-,816
292,NZ_CP046923,1,323055,323871,-,816
292,NZ_CP069055,1,360353,361169,-,816
292,NZ_CP072670,1,323197,324013,-,816
292,NZ_CP090899,1,323357,324173,-,816
292,NZ_CP046924,1,323055,323871,-,816
292,NZ_OX366348,1,670320,671136,-,816
292,NZ_CP046921,1,323055,323871,-,816
292,NZ_OX366338,1,747948,748757,+,809
292,NZ_CP054557,1,66382,67198,-,816
292,NZ_CP072669,1,323205,324021,-,816
292,NC_021089,1,603720,604537,+,817
293,NZ_OX366376,1,864520,865857,+,1337
293,NZ_OX366393,1,588032,589369,-,1337
293,NZ_OX366372,1,632854,634191,+,1337
293,NZ_CP072672,1,319665,321006,-,1341
293,NZ_CP069060,1,308588,309929,-,1341
293,NZ_CP072667,1,319647,320988,-,1341
293,NZ_CP072671,1,319647,320988,-,1341
293,NZ_CP072668,1,319647,320988,-,1341
293,NZ_CP072666,1,319647,320988,-,1341
293,NZ_CP090902,1,319799,321140,-,1341
293,NZ_CP090948,1,319799,321140,-,1341
293,NZ_CP069052,1,303261,304602,-,1341
293,NZ_CP076228,1,414874,416215,+,1341
293,NZ_CP042445,1,319799,321140,-,1341
293,NZ_CP042904,1,476483,477824,+,1341
293,NC_012416,1,479802,481143,+,1341
293,NZ_CP069053,1,237348,238689,+,1341
293,NZ_CP042446,1,319799,321140,-,1341
293,NZ_CP041215,1,841775,843116,+,1341
293,NZ_OX366353,1,289656,290997,-,1341
293,NZ_OX366387,1,1621328,1622669,-,1341
293,NZ_OX366368,1,674740,676081,-,1341
293,NZ_OX366379,1,871106,872447,+,1341
293,NZ_CP091195,1,321598,322939,+,1341
293,NZ_OX366375,1,760620,761961,+,1341
293,NZ_CP046925,1,319647,320988,-,1341
293,NZ_OX366318,1,821157,822498,+,1341
293,NZ_OX366319,1,423270,424611,-,1341
293,NZ_OX366332,1,957697,959038,+,1341
293,NZ_CP110359,1,858309,859650,+,1341
293,NZ_OU953855,1,358155,359496,-,1341
293,NZ_OX366272,1,974295,975636,-,1341
293,NZ_OX366347,1,1076075,1077416,+,1341
293,NZ_OU909470,1,1225236,1226556,+,1320
293,NZ_OX366363,1,87624,88965,-,1341
293,NZ_OX366364,1,842189,843525,-,1336
293,NZ_OX366359,1,788408,789749,+,1341
293,NZ_OX366349,1,1598821,1600158,-,1337
293,NZ_OX366380,1,679679,681012,+,1333
293,NZ_OX366344,1,528390,529727,-,1337
293,NZ_CP090900,1,319799,321140,-,1341
293,NZ_OX366352,1,718801,720142,+,1341
293,NZ_OX366362,1,853767,855107,+,1340
293,NZ_OX366400,1,422944,424285,-,1341
293,NZ_OX366327,1,866945,868286,+,1341
293,NZ_OX366367,1,720601,721937,+,1336
293,NZ_CP042444,1,320300,321641,-,1341
293,NZ_OX366326,1,918454,919795,+,1341
293,NZ_CP037426,1,146341,147682,+,1341
293,NZ_OX366339,1,635499,636840,+,1341
293,NZ_OX366355,1,533897,535238,+,1341
293,NZ_CP046922,1,319497,320838,-,1341
293,NZ_OX366370,1,635648,636989,-,1341
293,NZ_OX366385,1,343800,345133,-,1333
293,NZ_OX366399,1,862147,863488,+,1341
293,NZ_OX366395,1,903696,905020,+,1324
293,NZ_OX366396,1,1198260,1199601,+,1341
293,NZ_OX366351,1,746176,747517,+,1341
293,NZ_OX366381,1,583632,584973,-,1341
293,NZ_OX366342,1,768854,770191,+,1337
293,NZ_OX366369,1,650158,651499,-,1341
293,NZ_OX366356,1,559336,560677,-,1341
293,NZ_OX366377,1,432584,433925,+,1341
293,NZ_OX366388,1,493938,495279,+,1341
293,NZ_OX366357,1,914285,915622,+,1337
293,NZ_CP072012,1,655971,657312,+,1341
293,NZ_OX366398,1,76909,78250,-,1341
293,NC_002978,6,319799,321140,-,1341
293,NZ_OX366389,1,929237,930578,+,1341
293,NZ_OX366397,1,1039177,1040518,+,1341
293,NZ_OX366378,1,439855,441196,-,1341
293,NZ_CP090903,1,319799,321140,-,1341
293,NZ_OX366374,1,189835,191134,-,1299
293,NZ_CP090901,1,319799,321140,-,1341
293,NZ_CP046923,1,319497,320838,-,1341
293,NZ_CP069055,1,356795,358136,-,1341
293,NZ_CP072670,1,319639,320980,-,1341
293,NZ_CP090899,1,319799,321140,-,1341
293,NZ_CP046924,1,319497,320838,-,1341
293,NZ_OX366348,1,396223,397564,+,1341
293,NZ_CP046921,1,319497,320838,-,1341
293,NZ_OX366338,1,751472,752813,+,1341
293,NZ_CP054557,1,62815,64156,-,1341
293,NZ_CP072669,1,319647,320988,-,1341
293,NC_021089,1,606584,607925,+,1341
294,NZ_OX366376,1,869097,869976,+,879
294,NZ_OX366393,1,583907,584786,-,879
294,NZ_OX366372,1,637446,638325,+,879
294,NZ_CP072672,1,315196,316083,-,887
294,NZ_CP069060,1,304119,305006,-,887
294,NZ_CP072667,1,315178,316065,-,887
294,NZ_CP072671,1,315178,316065,-,887
294,NZ_CP072668,1,315178,316065,-,887
294,NZ_CP072666,1,315178,316065,-,887
294,NZ_CP090902,1,315330,316217,-,887
294,NZ_CP090948,1,315330,316217,-,887
294,NZ_CP069052,1,298792,299679,-,887
294,NZ_CP076228,1,419755,420642,+,887
294,NZ_CP042445,1,315330,316217,-,887
294,NZ_CP042904,1,481367,482254,+,887
294,NC_012416,1,484686,485573,+,887
294,NZ_CP069053,1,242271,243158,+,887
294,NZ_CP042446,1,315330,316217,-,887
294,NZ_CP041215,1,847561,848448,+,887
294,NZ_OX366353,1,285245,286132,-,887
294,NZ_OX366387,1,1616859,1617746,-,887
294,NZ_OX366368,1,670271,671158,-,887
294,NZ_OX366379,1,876029,876916,+,887
294,NZ_CP091195,1,231847,232734,+,887
294,NZ_OX366375,1,765543,766430,+,887
294,NZ_CP046925,1,315178,316065,-,887
294,NZ_OX366318,1,827244,828131,+,887
294,NZ_OX366319,1,418843,419730,-,887
294,NZ_OX366332,1,962629,963516,+,887
294,NZ_CP110359,1,863192,864079,+,887
294,NZ_OU953855,1,339960,340847,-,887
294,NZ_OX366272,1,624529,625416,-,887
294,NZ_OX366347,1,1080959,1081846,+,887
294,NZ_OU909470,1,1229292,1230179,+,887
294,NZ_OX366363,1,83155,84042,-,887
294,NZ_OX366364,1,838070,838949,-,879
294,NZ_OX366359,1,793337,794224,+,887
294,NZ_OX366349,1,1594706,1595585,-,879
294,NZ_OX366380,1,684209,685096,+,887
294,NZ_OX366344,1,524251,525130,-,879
294,NZ_CP090900,1,315330,316217,-,887
294,NZ_OX366352,1,723733,724620,+,887
294,NZ_OX366362,1,976833,977720,-,887
294,NZ_OX366400,1,420690,421577,-,887
294,NZ_OX366327,1,871910,872797,+,887
294,NZ_OX366367,1,725189,726068,+,879
294,NZ_CP042444,1,315831,316718,-,887
294,NZ_OX366326,1,923338,924225,+,887
294,NZ_CP037426,1,151264,152151,+,887
294,NZ_OX366339,1,641386,642273,+,887
294,NZ_OX366355,1,538820,539707,+,887
294,NZ_CP046922,1,315028,315915,-,887
294,NZ_OX366370,1,631840,632726,-,886
294,NZ_OX366385,1,1093441,1094328,-,887
294,NZ_OX366399,1,867070,867957,+,887
294,NZ_OX366395,1,860262,861149,-,887
294,NZ_OX366396,1,1082726,1083613,-,887
294,NZ_OX366351,1,751060,751947,+,887
294,NZ_OX366381,1,579163,580050,-,887
294,NZ_OX366342,1,773436,774315,+,879
294,NZ_OX366369,1,644851,645738,-,887
294,NZ_OX366356,1,556219,557106,-,887
294,NZ_OX366377,1,437468,438355,+,887
294,NZ_OX366388,1,498822,499709,+,887
294,NZ_OX366357,1,917081,917968,+,887
294,NZ_CP072012,1,660894,661781,+,887
294,NZ_OX366398,1,72479,73366,-,887
294,NC_002978,6,315330,316217,-,887
294,NZ_OX366389,1,934121,935008,+,887
294,NZ_OX366397,1,1044109,1044996,+,887
294,NZ_OX366378,1,629094,629981,+,887
294,NZ_CP090903,1,315330,316217,-,887
294,NZ_OX366374,1,608485,609372,-,887
294,NZ_CP090901,1,315330,316217,-,887
294,NZ_CP046923,1,315028,315915,-,887
294,NZ_CP069055,1,352326,353213,-,887
294,NZ_CP072670,1,315170,316057,-,887
294,NZ_CP090899,1,315330,316217,-,887
294,NZ_CP046924,1,315028,315915,-,887
294,NZ_OX366348,1,401146,402033,+,887
294,NZ_CP046921,1,315028,315915,-,887
294,NZ_OX366338,1,756428,757315,+,887
294,NZ_CP054557,1,58346,59233,-,887
294,NZ_CP072669,1,315178,316065,-,887
294,NC_021089,1,611516,612403,+,887
295,NZ_OX366376,1,871931,873154,+,1223
295,NZ_OX366393,1,532757,533980,+,1223
295,NZ_OX366372,1,640280,641503,+,1223
295,NZ_CP072672,1,40003,41228,+,1225
295,NZ_CP069060,1,66470,67695,-,1225
295,NZ_CP072667,1,40003,41228,+,1225
295,NZ_CP072671,1,40003,41228,+,1225
295,NZ_CP072668,1,40003,41228,+,1225
295,NZ_CP072666,1,40003,41228,+,1225
295,NZ_CP090902,1,40155,41380,+,1225
295,NZ_CP090948,1,40155,41380,+,1225
295,NZ_CP069052,1,42962,44187,+,1225
295,NZ_CP076228,1,40946,42171,+,1225
295,NZ_CP042445,1,40155,41380,+,1225
295,NZ_CP042904,1,40655,41880,+,1225
295,NC_012416,1,40656,41881,+,1225
295,NZ_CP069053,1,66470,67695,-,1225
295,NZ_CP042446,1,40155,41380,+,1225
295,NZ_CP041215,1,477851,479076,-,1225
295,NZ_OX366353,1,779493,780718,+,1225
295,NZ_OX366387,1,543108,544333,+,1225
295,NZ_OX366368,1,322139,323364,+,1225
295,NZ_OX366379,1,323157,324382,+,1225
295,NZ_CP091195,1,952947,954172,+,1225
295,NZ_OX366375,1,237549,238774,-,1225
295,NZ_CP046925,1,40003,41228,+,1225
295,NZ_OX366318,1,415452,416677,+,1225
295,NZ_OX366319,1,870178,871403,+,1225
295,NZ_OX366332,1,321120,322345,+,1225
295,NZ_CP110359,1,39704,40929,+,1225
295,NZ_OU953855,1,433327,434552,+,1225
295,NZ_OX366272,1,876485,877710,-,1225
295,NZ_OX366347,1,430732,431957,+,1225
295,NZ_OU909470,1,1230481,1231704,+,1223
295,NZ_OX366363,1,612652,613877,-,1225
295,NZ_OX366364,1,460437,461660,-,1223
295,NZ_OX366359,1,320029,321254,+,1225
295,NZ_OX366349,1,1592874,1594097,-,1223
295,NZ_OX366380,1,685398,686621,+,1223
295,NZ_OX366344,1,522418,523641,-,1223
295,NZ_CP090900,1,40155,41380,+,1225
295,NZ_OX366352,1,1012275,1013500,-,1225
295,NZ_OX366362,1,995152,996376,+,1224
295,NZ_OX366400,1,320902,322127,+,1225
295,NZ_OX366327,1,470045,471270,+,1225
295,NZ_OX366367,1,1286197,1287422,-,1225
295,NZ_CP042444,1,40156,41381,+,1225
295,NZ_OX366326,1,471952,473177,-,1225
295,NZ_CP037426,1,477637,478862,+,1225
295,NZ_OX366339,1,1351432,1352657,-,1225
295,NZ_OX366355,1,991384,992609,-,1225
295,NZ_CP046922,1,40004,41229,+,1225
295,NZ_OX366370,1,629704,630927,-,1223
295,NZ_OX366385,1,1091916,1093139,-,1223
295,NZ_OX366399,1,321641,322866,+,1225
295,NZ_OX366395,1,533173,534398,+,1225
295,NZ_OX366396,1,397667,398892,-,1225
295,NZ_OX366351,1,333801,335026,+,1225
295,NZ_OX366381,1,1386767,1387992,+,1225
295,NZ_OX366342,1,776270,777493,+,1223
295,NZ_OX366369,1,317974,319199,+,1225
295,NZ_OX366356,1,349938,351163,+,1225
295,NZ_OX366377,1,261851,263076,-,1225
295,NZ_OX366388,1,1456252,1457477,-,1225
295,NZ_OX366357,1,1238807,1240032,+,1225
295,NZ_CP072012,1,994591,995816,-,1225
295,NZ_OX366398,1,868615,869840,-,1225
295,NC_002978,6,40155,41380,+,1225
295,NZ_OX366389,1,380151,381376,+,1225
295,NZ_OX366397,1,321408,322633,+,1225
295,NZ_OX366378,1,961574,962799,-,1225
295,NZ_CP090903,1,40155,41380,+,1225
295,NZ_OX366374,1,1112200,1113425,-,1225
295,NZ_CP090901,1,40155,41380,+,1225
295,NZ_CP046923,1,40004,41229,+,1225
295,NZ_CP069055,1,39038,40263,+,1225
295,NZ_CP072670,1,40003,41228,+,1225
295,NZ_CP090899,1,40155,41380,+,1225
295,NZ_CP046924,1,40004,41229,+,1225
295,NZ_OX366348,1,928410,929635,-,1225
295,NZ_CP046921,1,40004,41229,+,1225
295,NZ_OX366338,1,1364030,1365255,-,1225
295,NZ_CP054557,1,440313,441538,+,1225
295,NZ_CP072669,1,40003,41228,+,1225
295,NC_021089,1,40150,41375,+,1225
296,NZ_OX366376,1,873192,874905,+,1713
296,NZ_OX366393,1,534018,535731,+,1713
296,NZ_OX366372,1,641541,643254,+,1713
296,NZ_CP072672,1,41262,42975,+,1713
296,NZ_CP069060,1,64723,66436,-,1713
296,NZ_CP072667,1,41262,42975,+,1713
296,NZ_CP072671,1,41262,42975,+,1713
296,NZ_CP072668,1,41262,42975,+,1713
296,NZ_CP072666,1,41262,42975,+,1713
296,NZ_CP090902,1,41414,43127,+,1713
296,NZ_CP090948,1,41414,43127,+,1713
296,NZ_CP069052,1,44221,45934,+,1713
296,NZ_CP076228,1,42205,43918,+,1713
296,NZ_CP042445,1,41414,43127,+,1713
296,NZ_CP042904,1,41914,43627,+,1713
296,NC_012416,1,41915,43628,+,1713
296,NZ_CP069053,1,64723,66436,-,1713
296,NZ_CP042446,1,41414,43127,+,1713
296,NZ_CP041215,1,476104,477817,-,1713
296,NZ_OX366353,1,780752,782465,+,1713
296,NZ_OX366387,1,544367,546080,+,1713
296,NZ_OX366368,1,323398,325111,+,1713
296,NZ_OX366379,1,324416,326129,+,1713
296,NZ_CP091195,1,954206,955919,+,1713
296,NZ_OX366375,1,235802,237515,-,1713
296,NZ_CP046925,1,41262,42975,+,1713
296,NZ_OX366318,1,416711,418424,+,1713
296,NZ_OX366319,1,871437,873150,+,1713
296,NZ_OX366332,1,322379,324092,+,1713
296,NZ_CP110359,1,40963,42676,+,1713
296,NZ_OU953855,1,434586,436299,+,1713
296,NZ_OX366272,1,874738,876451,-,1713
296,NZ_OX366347,1,431991,433704,+,1713
296,NZ_OU909470,1,1231742,1233455,+,1713
296,NZ_OX366363,1,610905,612618,-,1713
296,NZ_OX366364,1,455853,457558,-,1705
296,NZ_OX366359,1,321288,323001,+,1713
296,NZ_OX366349,1,1591123,1592836,-,1713
296,NZ_OX366380,1,686659,688372,+,1713
296,NZ_OX366344,1,520667,522380,-,1713
296,NZ_CP090900,1,41414,43127,+,1713
296,NZ_OX366352,1,1010528,1012241,-,1713
296,NZ_OX366362,1,996892,998597,+,1705
296,NZ_OX366400,1,322161,323874,+,1713
296,NZ_OX366327,1,471304,473017,+,1713
296,NZ_OX366367,1,1283951,1285656,-,1705
296,NZ_CP042444,1,41415,43128,+,1713
296,NZ_OX366326,1,470205,471918,-,1713
296,NZ_CP037426,1,478896,480609,+,1713
296,NZ_OX366339,1,1349685,1351398,-,1713
296,NZ_OX366355,1,989637,991350,-,1713
296,NZ_CP046922,1,41263,42976,+,1713
296,NZ_OX366370,1,627953,629666,-,1713
296,NZ_OX366385,1,1090165,1091878,-,1713
296,NZ_OX366399,1,322900,324613,+,1713
296,NZ_OX366395,1,534432,536145,+,1713
296,NZ_OX366396,1,395920,397633,-,1713
296,NZ_OX366351,1,335060,336773,+,1713
296,NZ_OX366381,1,1388026,1389739,+,1713
296,NZ_OX366342,1,777531,779244,+,1713
296,NZ_OX366369,1,319233,320946,+,1713
296,NZ_OX366356,1,351197,352910,+,1713
296,NZ_OX366377,1,260104,261817,-,1713
296,NZ_OX366388,1,1454505,1456218,-,1713
296,NZ_OX366357,1,1240066,1241779,+,1713
296,NZ_CP072012,1,992844,994557,-,1713
296,NZ_OX366398,1,866868,868581,-,1713
296,NC_002978,6,41414,43127,+,1713
296,NZ_OX366389,1,381410,383123,+,1713
296,NZ_OX366397,1,322667,324380,+,1713
296,NZ_OX366378,1,959827,961540,-,1713
296,NZ_CP090903,1,41414,43127,+,1713
296,NZ_OX366374,1,1110453,1112166,-,1713
296,NZ_CP090901,1,41414,43127,+,1713
296,NZ_CP046923,1,41263,42976,+,1713
296,NZ_CP069055,1,40297,42010,+,1713
296,NZ_CP072670,1,41262,42975,+,1713
296,NZ_CP090899,1,41414,43127,+,1713
296,NZ_CP046924,1,41263,42976,+,1713
296,NZ_OX366348,1,926663,928376,-,1713
296,NZ_CP046921,1,41263,42976,+,1713
296,NZ_OX366338,1,1362283,1363996,-,1713
296,NZ_CP054557,1,441572,443285,+,1713
296,NZ_CP072669,1,41262,42975,+,1713
296,NC_021089,1,41409,43122,+,1713
297,NZ_OX366376,1,875054,876333,+,1279
297,NZ_OX366393,1,535880,537159,+,1279
297,NZ_OX366372,1,643403,644682,+,1279
297,NZ_CP072672,1,43116,44395,+,1279
297,NZ_CP069060,1,63303,64582,-,1279
297,NZ_CP072667,1,43116,44395,+,1279
297,NZ_CP072671,1,43116,44395,+,1279
297,NZ_CP072668,1,43116,44395,+,1279
297,NZ_CP072666,1,43116,44395,+,1279
297,NZ_CP090902,1,43268,44547,+,1279
297,NZ_CP090948,1,43268,44547,+,1279
297,NZ_CP069052,1,46075,47354,+,1279
297,NZ_CP076228,1,44059,45338,+,1279
297,NZ_CP042445,1,43268,44547,+,1279
297,NZ_CP042904,1,43767,45046,+,1279
297,NC_012416,1,43768,45047,+,1279
297,NZ_CP069053,1,63303,64582,-,1279
297,NZ_CP042446,1,43268,44547,+,1279
297,NZ_CP041215,1,474562,475841,-,1279
297,NZ_OX366353,1,782727,784006,+,1279
297,NZ_OX366387,1,546220,547499,+,1279
297,NZ_OX366368,1,325252,326531,+,1279
297,NZ_OX366379,1,326270,327549,+,1279
297,NZ_CP091195,1,956059,957338,+,1279
297,NZ_OX366375,1,234383,235662,-,1279
297,NZ_CP046925,1,43116,44395,+,1279
297,NZ_OX366318,1,418564,419843,+,1279
297,NZ_OX366319,1,873290,874569,+,1279
297,NZ_OX366332,1,324355,325634,+,1279
297,NZ_CP110359,1,42816,44095,+,1279
297,NZ_OU953855,1,418340,419619,-,1279
297,NZ_OX366272,1,873319,874598,-,1279
297,NZ_OX366347,1,433844,435123,+,1279
297,NZ_OU909470,1,1233587,1234866,+,1279
297,NZ_OX366363,1,609486,610765,-,1279
297,NZ_OX366364,1,454434,455713,-,1279
297,NZ_OX366359,1,323264,324543,+,1279
297,NZ_OX366349,1,1588592,1589871,-,1279
297,NZ_OX366380,1,688504,689783,+,1279
297,NZ_OX366344,1,519239,520518,-,1279
297,NZ_CP090900,1,43268,44547,+,1279
297,NZ_OX366352,1,1008986,1010265,-,1279
297,NZ_OX366362,1,998737,1000016,+,1279
297,NZ_OX366400,1,324014,325293,+,1279
297,NZ_OX366327,1,473288,474567,+,1279
297,NZ_OX366367,1,1282536,1283811,-,1275
297,NZ_CP042444,1,43269,44548,+,1279
297,NZ_OX366326,1,468786,470065,-,1279
297,NZ_CP037426,1,480749,482028,+,1279
297,NZ_OX366339,1,1348267,1349546,-,1279
297,NZ_OX366355,1,988218,989497,-,1279
297,NZ_CP046922,1,43117,44396,+,1279
297,NZ_OX366370,1,626525,627804,-,1279
297,NZ_OX366385,1,1088754,1090033,-,1279
297,NZ_OX366399,1,324754,326033,+,1279
297,NZ_OX366395,1,536285,537564,+,1279
297,NZ_OX366396,1,394501,395780,-,1279
297,NZ_OX366351,1,336913,338192,+,1279
297,NZ_OX366381,1,1389879,1391158,+,1279
297,NZ_OX366342,1,779393,780672,+,1279
297,NZ_OX366369,1,321086,322365,+,1279
297,NZ_OX366356,1,353050,354329,+,1279
297,NZ_OX366377,1,258685,259964,-,1279
297,NZ_OX366388,1,1453086,1454365,-,1279
297,NZ_OX366357,1,1241919,1243198,+,1279
297,NZ_CP072012,1,991424,992703,-,1279
297,NZ_OX366398,1,865449,866728,-,1279
297,NC_002978,6,43268,44547,+,1279
297,NZ_OX366389,1,383263,384542,+,1279
297,NZ_OX366397,1,324643,325922,+,1279
297,NZ_OX366378,1,958408,959687,-,1279
297,NZ_CP090903,1,43268,44547,+,1279
297,NZ_OX366374,1,1109035,1110314,-,1279
297,NZ_CP090901,1,43268,44547,+,1279
297,NZ_CP046923,1,43117,44396,+,1279
297,NZ_CP069055,1,42151,43430,+,1279
297,NZ_CP072670,1,43116,44395,+,1279
297,NZ_CP090899,1,43268,44547,+,1279
297,NZ_CP046924,1,43117,44396,+,1279
297,NZ_OX366348,1,925244,926523,-,1279
297,NZ_CP046921,1,43117,44396,+,1279
297,NZ_OX366338,1,1360864,1362143,-,1279
297,NZ_CP054557,1,443425,444704,+,1279
297,NZ_CP072669,1,43116,44395,+,1279
297,NC_021089,1,43385,44664,+,1279
298,NZ_OX366376,1,878044,879187,+,1143
298,NZ_OX366393,1,538883,540026,+,1143
298,NZ_OX366372,1,646405,647548,+,1143
298,NZ_CP072672,1,75456,76608,-,1152
298,NZ_CP069060,1,86143,87295,-,1152
298,NZ_CP072667,1,75456,76608,-,1152
298,NZ_CP072671,1,75456,76608,-,1152
298,NZ_CP072668,1,75456,76608,-,1152
298,NZ_CP072666,1,75456,76608,-,1152
298,NZ_CP090902,1,75608,76760,-,1152
298,NZ_CP090948,1,75608,76760,-,1152
298,NZ_CP069052,1,152836,153988,+,1152
298,NZ_CP076228,1,78020,79172,-,1152
298,NZ_CP042445,1,75608,76760,-,1152
298,NZ_CP042904,1,167040,168192,+,1152
298,NC_012416,1,169622,170774,+,1152
298,NZ_CP069053,1,459982,461134,+,1152
298,NZ_CP042446,1,75608,76760,-,1152
298,NZ_CP041215,1,520201,521349,+,1148
298,NZ_OX366353,1,455059,456207,+,1148
298,NZ_OX366387,1,767481,768633,+,1152
298,NZ_OX366368,1,356707,357859,-,1152
298,NZ_OX366379,1,357725,358877,-,1152
298,NZ_CP091195,1,983122,984274,-,1152
298,NZ_OX366375,1,456868,458018,+,1150
298,NZ_CP046925,1,75456,76608,-,1152
298,NZ_OX366318,1,542719,543867,+,1148
298,NZ_OX366319,1,716847,717995,-,1148
298,NZ_OX366332,1,441298,442446,+,1148
298,NZ_CP110359,1,1076390,1077542,-,1152
298,NZ_OU953855,1,903934,905086,+,1152
298,NZ_OX366272,1,307652,308804,+,1152
298,NZ_OX366347,1,556668,557820,+,1152
298,NZ_OU909470,1,1236059,1237211,+,1152
298,NZ_OX366363,1,475640,476788,-,1148
298,NZ_OX366364,1,390332,391484,+,1152
298,NZ_OX366359,1,338885,340033,-,1148
298,NZ_OX366349,1,1585739,1586882,-,1143
298,NZ_OX366380,1,690976,692128,+,1152
298,NZ_OX366344,1,516375,517518,-,1143
298,NZ_CP090900,1,75608,76760,-,1152
298,NZ_OX366352,1,400796,401944,+,1148
298,NZ_OX366362,1,569172,570324,-,1152
298,NZ_OX366400,1,716679,717827,-,1148
298,NZ_OX366327,1,591167,592319,+,1152
298,NZ_OX366367,1,1079803,1080955,+,1152
298,NZ_CP042444,1,75609,76761,-,1152
298,NZ_OX366326,1,634521,635669,+,1148
298,NZ_CP037426,1,710561,711712,-,1151
298,NZ_OX366339,1,255959,257111,+,1152
298,NZ_OX366355,1,863021,864169,-,1148
298,NZ_CP046922,1,75442,76594,-,1152
298,NZ_OX366370,1,623758,624901,-,1143
298,NZ_OX366385,1,1085562,1086714,-,1152
298,NZ_OX366399,1,356209,357361,-,1152
298,NZ_OX366395,1,1488042,1489194,+,1152
298,NZ_OX366396,1,1282928,1284080,+,1152
298,NZ_OX366351,1,459215,460363,+,1148
298,NZ_OX366381,1,1024490,1025638,-,1148
298,NZ_OX366342,1,782395,783538,+,1143
298,NZ_OX366369,1,442887,444035,+,1148
298,NZ_OX366356,1,463476,464628,+,1152
298,NZ_OX366377,1,545974,547126,+,1152
298,NZ_OX366388,1,1276577,1277729,+,1152
298,NZ_OX366357,1,266371,267523,+,1152
298,NZ_CP072012,1,960093,961245,+,1152
298,NZ_OX366398,1,1013338,1014490,-,1152
298,NC_002978,6,75608,76760,-,1152
298,NZ_OX366389,1,419576,420728,-,1152
298,NZ_OX366397,1,674761,675909,-,1148
298,NZ_OX366378,1,854816,855968,+,1152
298,NZ_CP090903,1,75608,76760,-,1152
298,NZ_CP090901,1,75608,76760,-,1152
298,NZ_CP046923,1,75442,76594,-,1152
298,NZ_CP069055,1,148604,149756,+,1152
298,NZ_CP072670,1,75456,76608,-,1152
298,NZ_CP090899,1,75608,76760,-,1152
298,NZ_CP046924,1,75442,76594,-,1152
298,NZ_OX366348,1,810831,811983,-,1152
298,NZ_CP046921,1,75442,76594,-,1152
298,NZ_OX366338,1,158903,160055,-,1152
298,NZ_CP054557,1,1168382,1169534,+,1152
298,NZ_CP072669,1,75456,76608,-,1152
298,NC_021089,1,160641,161789,+,1148
299,NZ_OX366376,1,879461,882014,+,2553
299,NZ_OX366393,1,466429,468982,+,2553
299,NZ_OX366372,1,647822,650375,+,2553
299,NZ_CP072672,1,171473,174000,+,2527
299,NZ_CP069060,1,181832,184359,+,2527
299,NZ_CP072667,1,171455,173982,+,2527
299,NZ_CP072671,1,171455,173982,+,2527
299,NZ_CP072668,1,171455,173982,+,2527
299,NZ_CP072666,1,171455,173982,+,2527
299,NZ_CP090902,1,171607,174134,+,2527
299,NZ_CP090948,1,171607,174134,+,2527
299,NZ_CP069052,1,176497,179024,+,2527
299,NZ_CP076228,1,174828,177353,+,2525
299,NZ_CP042445,1,171607,174134,+,2527
299,NZ_CP042904,1,174937,177479,+,2542
299,NC_012416,1,177519,180061,+,2542
299,NZ_CP069053,1,362918,365445,-,2527
299,NZ_CP042446,1,171607,174134,+,2527
299,NZ_CP041215,1,528418,530960,+,2542
299,NZ_OX366353,1,521913,524456,-,2543
299,NZ_OX366387,1,1347037,1349579,-,2542
299,NZ_OX366368,1,450505,453032,+,2527
299,NZ_OX366379,1,451523,454050,+,2527
299,NZ_CP091195,1,1444348,1446875,+,2527
299,NZ_OX366375,1,542368,544895,+,2527
299,NZ_CP046925,1,171455,173982,+,2527
299,NZ_OX366318,1,549966,552493,+,2527
299,NZ_OX366319,1,708352,710878,-,2526
299,NZ_OX366332,1,449517,452059,+,2542
299,NZ_CP110359,1,1067441,1069992,-,2551
299,NZ_OU953855,1,1477968,1480510,+,2542
299,NZ_OX366272,1,775135,777686,-,2551
299,NZ_OX366347,1,564981,567508,+,2527
299,NZ_OU909470,1,286201,288721,-,2520
299,NZ_OX366363,1,467033,469575,-,2542
299,NZ_OX366364,1,864860,867410,-,2550
299,NZ_OX366359,1,447792,450334,+,2542
299,NZ_OX366349,1,1582912,1585465,-,2553
299,NZ_OX366380,1,610930,613465,+,2535
299,NZ_OX366344,1,513548,516101,-,2553
299,NZ_CP090900,1,171607,174134,+,2527
299,NZ_OX366352,1,678201,680743,-,2542
299,NZ_OX366362,1,436022,438549,-,2527
299,NZ_OX366400,1,708053,710580,-,2527
299,NZ_OX366327,1,599086,601628,+,2542
299,NZ_OX366367,1,698583,701133,+,2550
299,NZ_CP042444,1,171545,174072,+,2527
299,NZ_OX366326,1,641768,644295,+,2527
299,NZ_CP037426,1,701404,703931,-,2527
299,NZ_OX366339,1,264981,267508,+,2527
299,NZ_OX366355,1,854319,856845,-,2526
299,NZ_CP046922,1,171305,173832,+,2527
299,NZ_OX366370,1,620963,623505,-,2542
299,NZ_OX366385,1,199200,201735,-,2535
299,NZ_OX366399,1,450016,452543,+,2527
299,NZ_OX366395,1,1043247,1045774,-,2527
299,NZ_OX366396,1,831354,833881,+,2527
299,NZ_OX366351,1,466462,468989,+,2527
299,NZ_OX366381,1,1015788,1018314,-,2526
299,NZ_OX366342,1,783812,786365,+,2553
299,NZ_OX366369,1,450004,452530,+,2526
299,NZ_OX366356,1,470158,472684,+,2526
299,NZ_OX366377,1,555964,558515,+,2551
299,NZ_OX366388,1,830447,832989,-,2542
299,NZ_OX366357,1,1284356,1286883,+,2527
299,NZ_CP072012,1,372900,375427,+,2527
299,NZ_OX366398,1,1110210,1112761,+,2551
299,NC_002978,6,171607,174134,+,2527
299,NZ_OX366389,1,621296,623847,+,2551
299,NZ_OX366397,1,396986,399528,+,2542
299,NZ_OX366378,1,257944,260471,+,2527
299,NZ_CP090903,1,171607,174134,+,2527
299,NZ_OX366374,1,972330,974857,-,2527
299,NZ_CP090901,1,171607,174134,+,2527
299,NZ_CP046923,1,171305,173832,+,2527
299,NZ_CP069055,1,168760,171287,+,2527
299,NZ_CP072670,1,171455,173982,+,2527
299,NZ_CP090899,1,171607,174134,+,2527
299,NZ_CP046924,1,171305,173832,+,2527
299,NZ_OX366348,1,802213,804740,-,2527
299,NZ_CP046921,1,171305,173832,+,2527
299,NZ_OX366338,1,1193852,1196379,-,2527
299,NZ_CP054557,1,1175616,1178143,+,2527
299,NZ_CP072669,1,171455,173982,+,2527
299,NC_021089,1,168859,171401,+,2542
300,NZ_OX366376,1,883719,884573,+,854
300,NZ_OX366393,1,470688,471542,+,854
300,NZ_OX366372,1,652081,652935,+,854
300,NZ_OU909470,1,283983,284821,-,838
300,NZ_OX366364,1,862495,863345,-,850
300,NZ_OX366349,1,1579251,1580089,-,838
300,NZ_OX366380,1,616480,617319,+,839
300,NZ_OX366344,1,510981,511834,-,853
300,NZ_OX366362,1,433787,434626,-,839
300,NZ_OX366367,1,703110,703961,+,851
300,NZ_OX366370,1,619814,620667,-,853
300,NZ_OX366385,1,1298366,1299205,+,839
300,NZ_OX366342,1,788071,788925,+,854
301,NZ_OX366376,1,886020,886761,+,741
301,NZ_OX366393,1,472990,473731,+,741
301,NZ_OX366372,1,218571,219321,+,750
301,NZ_OX366372,1,654383,655124,+,741
301,NZ_OX366349,1,1576960,1577702,-,742
301,NZ_OX366344,1,508772,509514,-,742
301,NZ_OX366342,1,790373,791114,+,741
302,NZ_OX366376,1,887909,888635,+,726
302,NZ_OX366393,1,474880,475606,+,726
302,NZ_OX366372,1,656273,656999,+,726
302,NZ_OX366349,1,1575509,1576198,-,689
302,NZ_OX366344,1,507285,508010,-,725
302,NZ_OX366342,1,792263,792989,+,726
303,NZ_OX366376,1,895494,896117,+,623
303,NZ_OX366393,1,482477,483100,+,623
303,NZ_OX366372,1,663846,664469,+,623
303,NZ_OX366342,1,1040550,1041173,+,623
304,NZ_OX366376,1,897575,898178,+,603
304,NZ_OX366393,1,484558,485161,+,603
304,NZ_OX366372,1,665927,666530,+,603
304,NZ_OX366363,1,388490,389093,+,603
304,NZ_OX366364,1,488252,488821,+,569
304,NZ_OX366362,1,1379345,1379948,+,603
304,NZ_OX366342,1,1042631,1043234,+,603
304,NZ_OX366377,1,700780,701383,+,603
304,NZ_OX366398,1,1250890,1251493,-,603
305,NZ_OX366376,1,899866,900427,+,561
305,NZ_OX366393,1,486531,487092,+,561
305,NZ_OX366372,1,668217,668778,+,561
305,NZ_OX366342,1,1044922,1045483,+,561
306,NZ_OX366376,1,900672,901746,+,1074
306,NZ_OX366393,1,487337,488411,+,1074
306,NZ_OX366372,1,669023,670097,+,1074
306,NZ_OX366342,1,1045728,1046802,+,1074
307,NZ_OX366376,1,902360,903024,+,664
307,NZ_OX366393,1,489025,489689,+,664
307,NZ_OX366372,1,670711,671375,+,664
307,NZ_CP072672,1,588406,589071,-,665
307,NZ_CP069060,1,1168018,1168683,+,665
307,NZ_CP072667,1,588388,589053,-,665
307,NZ_CP072671,1,588388,589053,-,665
307,NZ_CP072668,1,588375,589040,-,665
307,NZ_CP072666,1,588388,589053,-,665
307,NZ_CP090902,1,588540,589205,-,665
307,NZ_CP090948,1,588540,589205,-,665
307,NZ_CP069052,1,569101,569766,-,665
307,NZ_CP042445,1,588528,589193,-,665
307,NZ_CP042904,1,1072080,1072745,-,665
307,NC_012416,1,609668,610333,-,665
307,NC_012416,1,1116127,1116792,-,665
307,NZ_CP069053,1,1204993,1205658,-,665
307,NZ_CP042446,1,588540,589205,-,665
307,NZ_OX366387,1,303816,304493,+,677
307,NZ_OX366368,1,964764,965429,-,665
307,NZ_OX366379,1,963298,963963,-,665
307,NZ_CP091195,1,620119,620784,+,665
307,NZ_CP046925,1,588388,589053,-,665
307,NZ_OX366318,1,204262,204927,-,665
307,NZ_OX366318,1,224883,225548,-,665
307,NZ_OX366318,1,925508,926173,+,665
307,NZ_OX366332,1,534859,535524,+,665
307,NZ_CP110359,1,659662,660327,-,665
307,NZ_OU909470,1,1170111,1170776,+,665
307,NZ_OX366363,1,393148,393813,+,665
307,NZ_OX366364,1,493031,493696,+,665
307,NZ_OX366359,1,675546,676211,-,665
307,NZ_OX366349,1,422106,422783,-,677
307,NZ_CP090900,1,588540,589205,-,665
307,NZ_OX366327,1,346875,347540,+,665
307,NZ_OX366327,1,424818,425483,+,665
307,NZ_CP042444,1,589077,589742,-,665
307,NZ_OX366326,1,619688,620353,+,665
307,NZ_CP046922,1,650254,650919,-,665
307,NZ_OX366399,1,956496,957161,-,665
307,NZ_OX366396,1,924222,924887,-,665
307,NZ_OX366396,1,1146017,1146682,+,665
307,NZ_OX366351,1,992459,993124,+,665
307,NZ_OX366342,1,1047416,1048080,+,664
307,NZ_OX366377,1,705404,706069,+,665
307,NZ_OX366388,1,955519,956178,-,659
307,NZ_OX366388,1,1169109,1169768,+,659
307,NZ_CP072012,1,102020,102685,+,665
307,NZ_OX366398,1,1246204,1246869,-,665
307,NC_002978,6,588540,589205,-,665
307,NZ_CP090903,1,588540,589205,-,665
307,NZ_CP090901,1,588540,589205,-,665
307,NZ_CP046923,1,566502,567167,-,665
307,NZ_CP069055,1,642299,642964,-,665
307,NZ_CP072670,1,588380,589045,-,665
307,NZ_CP090899,1,588540,589205,-,665
307,NZ_CP046924,1,587440,588105,-,665
307,NZ_OX366348,1,374783,375448,+,665
307,NZ_CP046921,1,650254,650919,-,665
307,NZ_CP072669,1,588388,589053,-,665
307,NC_021089,1,254108,254773,+,665
308,NZ_OX366376,1,903194,903879,+,685
308,NZ_OX366393,1,489859,490544,+,685
308,NZ_OX366372,1,671545,672230,+,685
308,NZ_OX366342,1,1048250,1048935,+,685
309,NZ_OX366376,1,910664,911584,+,920
309,NZ_OX366393,1,497339,498257,+,918
309,NZ_OX366372,1,679024,679944,+,920
309,NZ_CP072672,1,663124,664055,-,931
309,NZ_CP069060,1,504150,505081,-,931
309,NZ_CP072667,1,663106,664037,-,931
309,NZ_CP072671,1,663106,664037,-,931
309,NZ_CP072668,1,663093,664024,-,931
309,NZ_CP072666,1,663106,664037,-,931
309,NZ_CP090902,1,663258,664189,-,931
309,NZ_CP090948,1,663258,664189,-,931
309,NZ_CP069052,1,710551,711482,-,931
309,NZ_CP076228,1,596220,597149,-,929
309,NZ_CP042445,1,663246,664177,-,931
309,NZ_CP042904,1,554693,555606,-,913
309,NC_012416,1,558013,558926,-,913
309,NZ_CP069053,1,504158,505089,-,931
309,NZ_CP042446,1,663258,664189,-,931
309,NZ_CP041215,1,745222,746153,+,931
309,NZ_OX366353,1,1162906,1163837,+,931
309,NZ_OX366387,1,1383619,1384559,-,940
309,NZ_OX366368,1,1028769,1029700,-,931
309,NZ_OX366379,1,1027303,1028234,-,931
309,NZ_CP091195,1,140172,141112,+,940
309,NZ_OX366375,1,954070,955010,-,940
309,NZ_CP046925,1,663106,664037,-,931
309,NZ_OX366318,1,958637,959577,-,940
309,NZ_OX366319,1,256873,257813,+,940
309,NZ_OX366332,1,1046195,1047126,-,931
309,NZ_CP110359,1,544876,545816,+,940
309,NZ_OU953855,1,1309173,1310113,+,940
309,NZ_OX366272,1,905196,906136,-,940
309,NZ_OX366347,1,850731,851671,+,940
309,NZ_OU909470,1,901610,902542,+,932
309,NZ_OX366363,1,1280173,1281104,+,931
309,NZ_OX366364,1,943152,944055,-,903
309,NZ_OX366359,1,876833,877764,-,931
309,NZ_OX366349,1,850383,851303,-,920
309,NZ_OX366380,1,879266,880198,-,932
309,NZ_OX366344,1,408922,409842,+,920
309,NZ_CP090900,1,663258,664189,-,931
309,NZ_OX366352,1,1147201,1148132,-,931
309,NZ_OX366362,1,592203,593144,+,941
309,NZ_OX366400,1,826237,827177,-,940
309,NZ_OX366327,1,963687,964627,-,940
309,NZ_OX366367,1,612588,613518,+,930
309,NZ_CP042444,1,663795,664726,-,931
309,NZ_OX366326,1,1086969,1087909,-,940
309,NZ_CP037426,1,95794,96734,+,940
309,NZ_OX366339,1,746220,747160,-,940
309,NZ_OX366355,1,281129,282069,+,940
309,NZ_CP046922,1,724972,725903,-,931
309,NZ_OX366370,1,503434,504350,+,916
309,NZ_OX366385,1,459601,460533,+,932
309,NZ_OX366399,1,544974,545905,+,931
309,NZ_OX366395,1,546463,547394,+,931
309,NZ_OX366396,1,620356,621296,+,940
309,NZ_OX366351,1,1035037,1035977,-,940
309,NZ_OX366381,1,366896,367836,+,940
309,NZ_OX366342,1,1055731,1056651,+,920
309,NZ_OX366369,1,1151630,1152570,-,940
309,NZ_OX366356,1,868675,869606,-,931
309,NZ_OX366377,1,658092,659032,+,940
309,NZ_OX366388,1,343892,344832,+,940
309,NZ_OX366357,1,464347,465269,+,922
309,NZ_CP072012,1,896780,897711,-,931
309,NZ_OX366398,1,582967,583907,+,940
309,NC_002978,6,663258,664189,-,931
309,NZ_OX366389,1,428248,429028,+,780
309,NZ_OX366397,1,1197360,1198291,-,931
309,NZ_OX366378,1,725413,726353,+,940
309,NZ_CP090903,1,663258,664189,-,931
309,NZ_OX366374,1,566725,567656,-,931
309,NZ_CP090901,1,663258,664189,-,931
309,NZ_CP046923,1,641220,642151,-,931
309,NZ_CP069055,1,586023,586954,-,931
309,NZ_CP072670,1,663098,664029,-,931
309,NZ_CP090899,1,663258,664189,-,931
309,NZ_CP046924,1,662158,663089,-,931
309,NZ_OX366348,1,316117,317048,+,931
309,NZ_CP046921,1,724972,725903,-,931
309,NZ_OX366338,1,891083,891948,-,865
309,NZ_CP054557,1,363848,364779,-,931
309,NZ_CP072669,1,663106,664037,-,931
309,NC_021089,1,696982,697913,-,931
310,NZ_OX366376,1,912389,913913,+,1524
310,NZ_OX366393,1,499062,500586,+,1524
310,NZ_OX366372,1,680749,682273,+,1524
310,NZ_CP072672,1,658985,660619,-,1634
310,NZ_CP069060,1,500012,501646,-,1634
310,NZ_CP072667,1,658967,660601,-,1634
310,NZ_CP072671,1,658967,660601,-,1634
310,NZ_CP072668,1,658954,660588,-,1634
310,NZ_CP072666,1,658967,660601,-,1634
310,NZ_CP090902,1,659119,660753,-,1634
310,NZ_CP090948,1,659119,660753,-,1634
310,NZ_CP069052,1,706413,708047,-,1634
310,NZ_CP076228,1,591062,592696,-,1634
310,NZ_CP042445,1,659107,660741,-,1634
310,NZ_CP042904,1,550789,552315,-,1526
310,NC_012416,1,554109,555635,-,1526
310,NZ_CP069053,1,500020,501654,-,1634
310,NZ_CP042446,1,659119,660753,-,1634
310,NZ_CP041215,1,748649,750174,+,1525
310,NZ_OX366353,1,1166335,1167860,+,1525
310,NZ_OX366387,1,1379487,1381121,-,1634
310,NZ_OX366368,1,1024631,1026265,-,1634
310,NZ_OX366379,1,1023165,1024799,-,1634
310,NZ_CP091195,1,298048,299574,-,1526
310,NZ_OX366375,1,949938,951572,-,1634
310,NZ_CP046925,1,658967,660601,-,1634
310,NZ_OX366318,1,954505,956139,-,1634
310,NZ_OX366319,1,260861,262494,+,1633
310,NZ_OX366332,1,1042171,1043697,-,1526
310,NZ_CP110359,1,548314,549840,+,1526
310,NZ_OU953855,1,1311391,1312916,+,1525
310,NZ_OX366272,1,900837,902363,-,1526
310,NZ_OX366347,1,854172,855698,+,1526
310,NZ_OU909470,1,439884,441518,-,1634
310,NZ_OX366363,1,1285010,1286529,+,1519
310,NZ_OX366364,1,940822,942347,-,1525
310,NZ_OX366359,1,872809,874335,-,1526
310,NZ_OX366349,1,848052,849578,-,1526
310,NZ_OX366380,1,875612,877246,-,1634
310,NZ_OX366344,1,410647,412171,+,1524
310,NZ_CP090900,1,659119,660753,-,1634
310,NZ_OX366352,1,1143177,1144703,-,1526
310,NZ_OX366362,1,595423,597056,+,1633
310,NZ_OX366400,1,822105,823739,-,1634
310,NZ_OX366327,1,957863,959348,-,1485
310,NZ_OX366367,1,614353,615877,+,1524
310,NZ_CP042444,1,659656,661290,-,1634
310,NZ_OX366326,1,1082837,1084471,-,1634
310,NZ_CP037426,1,99232,100866,+,1634
310,NZ_OX366339,1,741859,743385,-,1526
310,NZ_OX366355,1,285117,286750,+,1633
310,NZ_CP046922,1,720833,722467,-,1634
310,NZ_OX366370,1,505155,506679,+,1524
310,NZ_OX366385,1,462568,464201,+,1633
310,NZ_OX366399,1,548409,550042,+,1633
310,NZ_OX366395,1,549552,551078,+,1526
310,NZ_OX366396,1,624130,625655,+,1525
310,NZ_OX366351,1,1030905,1032539,-,1634
310,NZ_OX366381,1,370884,372517,+,1633
310,NZ_OX366342,1,1057456,1058980,+,1524
310,NZ_OX366369,1,1147927,1149561,-,1634
310,NZ_OX366356,1,864541,866174,-,1633
310,NZ_OX366377,1,661530,663055,+,1525
310,NZ_OX366388,1,347009,348534,+,1525
310,NZ_OX366357,1,467501,469026,+,1525
310,NZ_CP072012,1,892642,894276,-,1634
310,NZ_OX366398,1,586405,587930,+,1525
310,NC_002978,6,659119,660753,-,1634
310,NZ_OX366389,1,1065421,1066947,-,1526
310,NZ_OX366397,1,1193336,1194862,-,1526
310,NZ_OX366378,1,697843,699369,-,1526
310,NZ_CP090903,1,659119,660753,-,1634
310,NZ_OX366374,1,562648,564175,-,1527
310,NZ_CP090901,1,659119,660753,-,1634
310,NZ_CP046923,1,637081,638715,-,1634
310,NZ_CP069055,1,579600,581234,-,1634
310,NZ_CP072670,1,658959,660593,-,1634
310,NZ_CP090899,1,659119,660753,-,1634
310,NZ_CP046924,1,658019,659653,-,1634
310,NZ_OX366348,1,319552,321185,+,1633
310,NZ_CP046921,1,720833,722467,-,1634
310,NZ_OX366338,1,882818,884345,-,1527
310,NZ_CP054557,1,359710,361344,-,1634
310,NZ_CP072669,1,658967,660601,-,1634
310,NC_021089,1,692958,694484,-,1526
311,NZ_OX366376,1,913915,914994,+,1079
311,NZ_OX366376,1,1059051,1060131,-,1080
311,NZ_OX366393,1,500588,501667,+,1079
311,NZ_OX366393,1,1282855,1283935,-,1080
311,NZ_OX366372,1,524192,525272,+,1080
311,NZ_OX366372,1,682275,683354,+,1079
311,NZ_CP072672,1,16159,17239,+,1080
311,NZ_CP072672,1,657905,658984,-,1079
311,NZ_CP069060,1,16273,17353,+,1080
311,NZ_CP069060,1,498932,500011,-,1079
311,NZ_CP072667,1,16159,17239,+,1080
311,NZ_CP072667,1,657887,658966,-,1079
311,NZ_CP072671,1,16159,17239,+,1080
311,NZ_CP072671,1,657887,658966,-,1079
311,NZ_CP072668,1,16159,17239,+,1080
311,NZ_CP072668,1,657874,658953,-,1079
311,NZ_CP072666,1,16159,17239,+,1080
311,NZ_CP072666,1,657887,658966,-,1079
311,NZ_CP090902,1,16311,17391,+,1080
311,NZ_CP090902,1,658039,659118,-,1079
311,NZ_CP090948,1,16311,17391,+,1080
311,NZ_CP090948,1,658039,659118,-,1079
311,NZ_CP069052,1,16273,17353,+,1080
311,NZ_CP069052,1,705333,706412,-,1079
311,NZ_CP076228,1,16216,17297,+,1081
311,NZ_CP076228,1,589983,591061,-,1078
311,NZ_CP042445,1,16311,17391,+,1080
311,NZ_CP042445,1,658027,659106,-,1079
311,NZ_CP042904,1,16436,17516,+,1080
311,NZ_CP042904,1,549709,550788,-,1079
311,NC_012416,1,16437,17517,+,1080
311,NC_012416,1,553029,554108,-,1079
311,NZ_CP069053,1,16273,17353,+,1080
311,NZ_CP069053,1,498940,500019,-,1079
311,NZ_CP042446,1,16311,17391,+,1080
311,NZ_CP042446,1,658039,659118,-,1079
311,NZ_CP041215,1,562786,563866,-,1080
311,NZ_CP041215,1,750176,751255,+,1079
311,NZ_OX366353,1,756141,757221,+,1080
311,NZ_OX366353,1,1167862,1168941,+,1079
311,NZ_OX366387,1,518817,519897,+,1080
311,NZ_OX366387,1,1378407,1379486,-,1079
311,NZ_OX366368,1,298286,299366,+,1080
311,NZ_OX366368,1,1023551,1024630,-,1079
311,NZ_OX366379,1,299304,300384,+,1080
311,NZ_OX366379,1,1022085,1023164,-,1079
311,NZ_CP091195,1,296968,298047,-,1079
311,NZ_CP091195,1,1383090,1384170,-,1080
311,NZ_OX366375,1,316635,317715,+,1080
311,NZ_OX366375,1,948858,949937,-,1079
311,NZ_CP046925,1,16159,17239,+,1080
311,NZ_CP046925,1,657887,658966,-,1079
311,NZ_OX366318,1,389592,390672,+,1080
311,NZ_OX366318,1,953425,954504,-,1079
311,NZ_OX366319,1,262496,263575,+,1079
311,NZ_OX366319,1,903227,904307,-,1080
311,NZ_OX366332,1,296901,297981,+,1080
311,NZ_OX366332,1,1041091,1042170,-,1079
311,NZ_CP110359,1,16200,17280,+,1080
311,NZ_CP110359,1,549842,550921,+,1079
311,NZ_OU953855,1,44578,45658,+,1080
311,NZ_OU953855,1,1312918,1313997,+,1079
311,NZ_OX366272,1,899757,900836,-,1079
311,NZ_OX366272,1,1087032,1088112,-,1080
311,NZ_OX366347,1,406955,408035,+,1080
311,NZ_OX366347,1,855700,856779,+,1079
311,NZ_OU909470,1,181768,182848,-,1080
311,NZ_OU909470,1,438804,439883,-,1079
311,NZ_OX366363,1,637824,638904,-,1080
311,NZ_OX366363,1,1286531,1287610,+,1079
311,NZ_OX366364,1,698290,699370,+,1080
311,NZ_OX366364,1,939742,940821,-,1079
311,NZ_OX366359,1,295360,296440,+,1080
311,NZ_OX366359,1,871729,872808,-,1079
311,NZ_OX366349,1,77316,78396,+,1080
311,NZ_OX366349,1,846972,848051,-,1079
311,NZ_OX366380,1,308836,309916,-,1080
311,NZ_OX366380,1,874532,875611,-,1079
311,NZ_OX366344,1,412173,413252,+,1079
311,NZ_OX366344,1,1065872,1066952,+,1080
311,NZ_CP090900,1,16311,17391,+,1080
311,NZ_CP090900,1,658039,659118,-,1079
311,NZ_OX366352,1,1035631,1036711,-,1080
311,NZ_OX366352,1,1142097,1143176,-,1079
311,NZ_OX366362,1,491263,492343,+,1080
311,NZ_OX366362,1,597058,598130,+,1072
311,NZ_OX366400,1,298818,299898,+,1080
311,NZ_OX366400,1,821025,822104,-,1079
311,NZ_OX366327,1,445415,446495,+,1080
311,NZ_OX366327,1,956783,957862,-,1079
311,NZ_OX366367,1,615879,616958,+,1079
311,NZ_OX366367,1,863128,864208,-,1080
311,NZ_CP042444,1,16311,17391,+,1080
311,NZ_CP042444,1,658576,659655,-,1079
311,NZ_OX366326,1,495784,496864,-,1080
311,NZ_OX366326,1,1081757,1082836,-,1079
311,NZ_CP037426,1,16194,17274,+,1080
311,NZ_CP037426,1,100868,101947,+,1079
311,NZ_OX366339,1,740779,741858,-,1079
311,NZ_OX366339,1,1067252,1068332,+,1080
311,NZ_OX366355,1,286752,287831,+,1079
311,NZ_OX366355,1,1017087,1018167,-,1080
311,NZ_CP046922,1,16159,17239,+,1080
311,NZ_CP046922,1,719753,720832,-,1079
311,NZ_OX366370,1,506681,507760,+,1079
311,NZ_OX366370,1,996893,997973,-,1080
311,NZ_OX366385,1,280355,281435,-,1080
311,NZ_OX366385,1,464203,465282,+,1079
311,NZ_OX366399,1,297788,298868,+,1080
311,NZ_OX366399,1,550044,551123,+,1079
311,NZ_OX366395,1,443597,444677,+,1080
311,NZ_OX366395,1,551080,552159,+,1079
311,NZ_OX366396,1,360629,361709,+,1080
311,NZ_OX366396,1,625657,626736,+,1079
311,NZ_OX366351,1,309118,310198,+,1080
311,NZ_OX366351,1,1029825,1030904,-,1079
311,NZ_OX366381,1,372519,373598,+,1079
311,NZ_OX366381,1,1361209,1362289,+,1080
311,NZ_OX366342,1,75707,76787,-,1080
311,NZ_OX366342,1,1058982,1060061,+,1079
311,NZ_OX366369,1,292872,293952,+,1080
311,NZ_OX366369,1,1146847,1147926,-,1079
311,NZ_OX366356,1,327204,328284,+,1080
311,NZ_OX366356,1,863461,864540,-,1079
311,NZ_OX366377,1,286661,287741,-,1080
311,NZ_OX366377,1,663057,664136,+,1079
311,NZ_OX366388,1,348536,349615,+,1079
311,NZ_OX366388,1,1481018,1482098,-,1080
311,NZ_OX366357,1,469028,470107,+,1079
311,NZ_OX366357,1,724343,725423,-,1080
311,NZ_CP072012,1,891562,892641,-,1079
311,NZ_CP072012,1,1018589,1019669,-,1080
311,NZ_OX366398,1,587932,589011,+,1079
311,NZ_OX366398,1,893452,894532,-,1080
311,NC_002978,6,16311,17391,+,1080
311,NC_002978,6,658039,659118,-,1079
311,NZ_OX366389,1,355059,356139,+,1080
311,NZ_OX366389,1,1064341,1065420,-,1079
311,NZ_OX366397,1,296760,297840,+,1080
311,NZ_OX366397,1,1192256,1193335,-,1079
311,NZ_OX366378,1,696763,697842,-,1079
311,NZ_OX366378,1,900331,901411,-,1080
311,NZ_CP090903,1,16311,17391,+,1080
311,NZ_CP090903,1,658039,659118,-,1079
311,NZ_OX366374,1,561568,562647,-,1079
311,NZ_OX366374,1,1133084,1134164,-,1080
311,NZ_CP090901,1,16311,17391,+,1080
311,NZ_CP090901,1,658039,659118,-,1079
311,NZ_CP046923,1,16159,17239,+,1080
311,NZ_CP046923,1,636001,637080,-,1079
311,NZ_CP069055,1,16368,17448,+,1080
311,NZ_CP069055,1,578520,579599,-,1079
311,NZ_CP072670,1,16159,17239,+,1080
311,NZ_CP072670,1,657879,658958,-,1079
311,NZ_CP090899,1,16311,17391,+,1080
311,NZ_CP090899,1,658039,659118,-,1079
311,NZ_CP046924,1,16159,17239,+,1080
311,NZ_CP046924,1,656939,658018,-,1079
311,NZ_OX366348,1,321187,322266,+,1079
311,NZ_OX366348,1,952264,953344,-,1080
311,NZ_CP046921,1,16159,17239,+,1080
311,NZ_CP046921,1,719753,720832,-,1079
311,NZ_OX366338,1,881738,882817,-,1079
311,NZ_OX366338,1,1474760,1475840,+,1080
311,NZ_CP054557,1,358630,359709,-,1079
311,NZ_CP054557,1,417581,418661,+,1080
311,NZ_CP072669,1,16159,17239,+,1080
311,NZ_CP072669,1,657887,658966,-,1079
311,NC_021089,1,16391,17471,+,1080
311,NC_021089,1,691878,692957,-,1079
312,NZ_OX366376,1,914995,926832,+,11837
312,NZ_OX366393,1,1271017,1282853,-,11836
312,NZ_OX366372,1,525273,537110,+,11837
312,NZ_CP072672,1,17240,29077,+,11837
312,NZ_CP069060,1,17354,29191,+,11837
312,NZ_CP072667,1,17240,29077,+,11837
312,NZ_CP072671,1,17240,29077,+,11837
312,NZ_CP072668,1,17240,29077,+,11837
312,NZ_CP072666,1,17240,29077,+,11837
312,NZ_CP090902,1,17392,29229,+,11837
312,NZ_CP090948,1,17392,29229,+,11837
312,NZ_CP069052,1,17354,29191,+,11837
312,NZ_CP076228,1,17298,29135,+,11837
312,NZ_CP042445,1,17392,29229,+,11837
312,NZ_CP042904,1,17517,29354,+,11837
312,NC_012416,1,17518,29355,+,11837
312,NZ_CP069053,1,17354,29191,+,11837
312,NZ_CP042446,1,17392,29229,+,11837
312,NZ_CP041215,1,550948,562784,-,11836
312,NZ_OX366353,1,757222,769059,+,11837
312,NZ_OX366387,1,519898,531735,+,11837
312,NZ_OX366368,1,299367,311204,+,11837
312,NZ_OX366379,1,300385,312222,+,11837
312,NZ_CP091195,1,1371252,1383088,-,11836
312,NZ_OX366375,1,317716,329553,+,11837
312,NZ_CP046925,1,17240,29077,+,11837
312,NZ_OX366318,1,390673,402510,+,11837
312,NZ_OX366319,1,891389,903225,-,11836
312,NZ_OX366332,1,297982,309819,+,11837
312,NZ_CP110359,1,17281,29118,+,11837
312,NZ_OU953855,1,45659,57496,+,11837
312,NZ_OX366272,1,887919,899755,-,11836
312,NZ_OX366347,1,408036,419873,+,11837
312,NZ_OU909470,1,169933,181766,-,11833
312,NZ_OX366363,1,625986,637822,-,11836
312,NZ_OX366364,1,699371,711200,+,11829
312,NZ_OX366359,1,296441,308278,+,11837
312,NZ_OX366349,1,78397,90234,+,11837
312,NZ_OX366380,1,296998,308834,-,11836
312,NZ_OX366344,1,1066953,1078788,+,11835
312,NZ_CP090900,1,17392,29229,+,11837
312,NZ_OX366352,1,1023793,1035629,-,11836
312,NZ_OX366362,1,492344,504175,+,11831
312,NZ_OX366400,1,299899,311736,+,11837
312,NZ_OX366327,1,446496,458333,+,11837
312,NZ_OX366367,1,851298,863126,-,11828
312,NZ_CP042444,1,17392,29229,+,11837
312,NZ_OX366326,1,483946,495782,-,11836
312,NZ_CP037426,1,17275,29112,+,11837
312,NZ_OX366339,1,1068333,1080170,+,11837
312,NZ_OX366355,1,1005249,1017085,-,11836
312,NZ_CP046922,1,17240,29077,+,11837
312,NZ_OX366370,1,985055,996891,-,11836
312,NZ_OX366385,1,268517,280353,-,11836
312,NZ_OX366399,1,298869,310706,+,11837
312,NZ_OX366395,1,444678,456515,+,11837
312,NZ_OX366396,1,361710,373554,+,11844
312,NZ_OX366351,1,310199,322036,+,11837
312,NZ_OX366381,1,1362290,1374127,+,11837
312,NZ_OX366342,1,63869,75705,-,11836
312,NZ_OX366369,1,293953,305790,+,11837
312,NZ_OX366356,1,328285,340122,+,11837
312,NZ_OX366377,1,274823,286659,-,11836
312,NZ_OX366388,1,1469180,1481016,-,11836
312,NZ_OX366357,1,712505,724341,-,11836
312,NZ_CP072012,1,1006751,1018587,-,11836
312,NZ_OX366398,1,881614,893450,-,11836
312,NC_002978,6,17392,29229,+,11837
312,NZ_OX366389,1,356140,367977,+,11837
312,NZ_OX366397,1,297841,309678,+,11837
312,NZ_OX366378,1,888493,900329,-,11836
312,NZ_CP090903,1,17392,29229,+,11837
312,NZ_OX366374,1,1121246,1133082,-,11836
312,NZ_CP090901,1,17392,29229,+,11837
312,NZ_CP046923,1,17240,29077,+,11837
312,NZ_CP069055,1,17449,29286,+,11837
312,NZ_CP072670,1,17240,29077,+,11837
312,NZ_CP090899,1,17392,29229,+,11837
312,NZ_CP046924,1,17240,29077,+,11837
312,NZ_OX366348,1,940426,952262,-,11836
312,NZ_CP046921,1,17240,29077,+,11837
312,NZ_OX366338,1,1475841,1487676,+,11835
312,NZ_CP054557,1,418662,430499,+,11837
312,NZ_CP072669,1,17240,29077,+,11837
312,NC_021089,1,17472,29309,+,11837
313,NZ_OX366376,1,927924,928715,+,791
313,NZ_OX366393,1,1269134,1269917,-,783
313,NZ_OX366372,1,538209,538993,+,784
313,NZ_OX366364,1,714279,715066,+,787
313,NZ_OX366349,1,91333,92115,+,782
313,NZ_OX366367,1,846983,847770,-,787
313,NZ_OX366370,1,983180,983954,-,774
313,NZ_OX366342,1,61985,62768,-,783
314,NZ_OX366376,1,928927,931836,+,2909
314,NZ_OX366393,1,1266013,1268922,-,2909
314,NZ_OX366372,1,539205,542114,+,2909
314,NZ_CP072672,1,31015,33947,+,2932
314,NZ_CP069060,1,31130,34063,+,2933
314,NZ_CP072667,1,31015,33947,+,2932
314,NZ_CP072671,1,31015,33947,+,2932
314,NZ_CP072668,1,31015,33947,+,2932
314,NZ_CP072666,1,31015,33947,+,2932
314,NZ_CP090902,1,31167,34099,+,2932
314,NZ_CP090948,1,31167,34099,+,2932
314,NZ_CP069052,1,31130,34063,+,2933
314,NZ_CP076228,1,31074,34007,+,2933
314,NZ_CP042445,1,31167,34099,+,2932
314,NZ_CP042904,1,32071,35004,+,2933
314,NC_012416,1,32072,35005,+,2933
314,NZ_CP069053,1,31130,34063,+,2933
314,NZ_CP042446,1,31167,34099,+,2932
314,NZ_CP041215,1,484860,487794,-,2934
314,NZ_OX366353,1,771776,774703,+,2927
314,NZ_OX366387,1,533650,536588,+,2938
314,NZ_OX366368,1,313143,316076,+,2933
314,NZ_OX366379,1,314161,317094,+,2933
314,NZ_CP091195,1,1365592,1368526,-,2934
314,NZ_OX366375,1,332270,335203,+,2933
314,NZ_CP046925,1,31015,33947,+,2932
314,NZ_OX366318,1,404449,407382,+,2933
314,NZ_OX366319,1,885738,888672,-,2934
314,NZ_OX366332,1,312536,315469,+,2933
314,NZ_CP110359,1,31009,33934,+,2925
314,NZ_OU953855,1,60222,63147,+,2925
314,NZ_OX366272,1,883103,886028,-,2925
314,NZ_OX366347,1,421764,424689,+,2925
314,NZ_OU909470,1,164772,167705,-,2933
314,NZ_OX366363,1,621161,624095,-,2934
314,NZ_OX366364,1,715326,718257,+,2931
314,NZ_OX366359,1,310995,313928,+,2933
314,NZ_OX366349,1,92329,95241,+,2912
314,NZ_OX366380,1,291859,294770,-,2911
314,NZ_OX366344,1,1080836,1083746,+,2910
314,NZ_CP090900,1,31167,34099,+,2932
314,NZ_OX366352,1,1018142,1021076,-,2934
314,NZ_OX366362,1,506942,509847,+,2905
314,NZ_OX366400,1,313675,316608,+,2933
314,NZ_OX366327,1,461050,463983,+,2933
314,NZ_OX366367,1,843837,846777,-,2940
314,NZ_CP042444,1,31168,34100,+,2932
314,NZ_OX366326,1,479073,482007,-,2934
314,NZ_CP037426,1,31829,34762,+,2933
314,NZ_OX366339,1,1082896,1085823,+,2927
314,NZ_OX366355,1,999598,1002532,-,2934
314,NZ_CP046922,1,31016,33948,+,2932
314,NZ_OX366370,1,980056,982968,-,2912
314,NZ_OX366385,1,263390,266301,-,2911
314,NZ_OX366399,1,312645,315578,+,2933
314,NZ_OX366395,1,459232,462157,+,2925
314,NZ_OX366396,1,376280,379207,+,2927
314,NZ_OX366351,1,323975,326908,+,2933
314,NZ_OX366381,1,1376844,1379777,+,2933
314,NZ_OX366342,1,58864,61773,-,2909
314,NZ_OX366369,1,308507,311440,+,2933
314,NZ_OX366356,1,342013,344946,+,2933
314,NZ_OX366377,1,269950,272884,-,2934
314,NZ_OX366388,1,1463520,1466454,-,2934
314,NZ_OX366357,1,707684,710614,-,2930
314,NZ_CP072012,1,1001878,1004812,-,2934
314,NZ_OX366398,1,876741,879675,-,2934
314,NC_002978,6,31167,34099,+,2932
314,NZ_OX366389,1,371167,374100,+,2933
314,NZ_OX366397,1,312395,315328,+,2933
314,NZ_OX366378,1,882833,885767,-,2934
314,NZ_CP090903,1,31167,34099,+,2932
314,NZ_OX366374,1,1116428,1119355,-,2927
314,NZ_CP090901,1,31167,34099,+,2932
314,NZ_CP046923,1,31016,33948,+,2932
314,NZ_CP069055,1,31225,34158,+,2933
314,NZ_CP072670,1,31015,33947,+,2932
314,NZ_CP090899,1,31167,34099,+,2932
314,NZ_CP046924,1,31016,33948,+,2932
314,NZ_OX366348,1,935553,938487,-,2934
314,NZ_CP046921,1,31016,33948,+,2932
314,NZ_OX366338,1,1490431,1493335,+,2904
314,NZ_CP054557,1,432438,435380,+,2942
314,NZ_CP072669,1,31015,33947,+,2932
314,NC_021089,1,32026,34959,+,2933
315,NZ_OX366376,1,942236,942857,+,621
315,NZ_OU909470,1,1139516,1140137,+,621
315,NZ_OX366362,1,674828,675449,+,621
315,NZ_OX366388,1,925388,926006,+,618
315,NZ_OX366388,1,1199280,1199899,-,619
315,NZ_CP072012,1,790445,791067,-,622
315,NZ_CP072012,1,855152,855771,-,619
316,NZ_OX366376,1,950839,952893,+,2054
316,NZ_OX366327,1,315748,317794,+,2046
317,NZ_OX366376,1,959323,959888,+,565
317,NZ_OX366376,1,1133519,1134084,-,565
317,NZ_OX366393,1,384249,384814,-,565
317,NZ_OX366393,1,852312,852877,+,565
317,NZ_OX366372,1,253425,253990,+,565
317,NZ_CP072672,1,248959,249527,+,568
317,NZ_CP072667,1,248941,249509,+,568
317,NZ_CP072671,1,248941,249509,+,568
317,NZ_CP072668,1,248941,249509,+,568
317,NZ_CP072666,1,248941,249509,+,568
317,NZ_CP090902,1,249093,249661,+,568
317,NZ_CP090948,1,249093,249661,+,568
317,NZ_CP042445,1,249093,249661,+,568
317,NZ_CP042446,1,249093,249661,+,568
317,NZ_OX366353,1,902553,903121,+,568
317,NZ_OX366368,1,954864,955432,-,568
317,NZ_OX366379,1,953398,953966,-,568
317,NZ_CP091195,1,1334832,1335398,+,566
317,NZ_CP046925,1,248941,249509,+,568
317,NZ_OX366319,1,602391,602956,-,565
317,NZ_OX366332,1,543208,543773,+,565
317,NZ_CP110359,1,939831,940397,+,566
317,NZ_OX366272,1,982264,982832,-,568
317,NZ_OU909470,1,1177478,1178045,+,567
317,NZ_OX366364,1,505107,505675,+,568
317,NZ_OX366359,1,648240,648808,-,568
317,NZ_OX366380,1,1050722,1051288,-,566
317,NZ_CP090900,1,249093,249661,+,568
317,NZ_OX366352,1,942137,942705,+,568
317,NZ_OX366327,1,358935,359502,+,567
317,NZ_OX366327,1,433628,434193,+,565
317,NZ_CP042444,1,249031,249599,+,568
317,NZ_OX366326,1,350987,351552,-,565
317,NZ_OX366339,1,499454,500022,-,568
317,NZ_OX366355,1,614353,614918,-,565
317,NZ_CP046922,1,248790,249358,+,568
317,NZ_OX366399,1,946596,947164,-,568
317,NZ_OX366351,1,1004526,1005091,+,565
317,NZ_OX366381,1,876857,877422,-,565
317,NZ_OX366342,1,862482,863050,+,568
317,NZ_OX366342,1,912802,913370,+,568
317,NZ_OX366369,1,573696,574261,+,565
317,NZ_CP072012,1,112018,112586,+,568
317,NC_002978,6,249093,249661,+,568
317,NZ_OX366397,1,759844,760412,+,568
317,NZ_OX366378,1,1113951,1114517,-,566
317,NZ_CP090903,1,249093,249661,+,568
317,NZ_CP090901,1,249093,249661,+,568
317,NZ_CP046923,1,248790,249358,+,568
317,NZ_CP069055,1,632400,632968,-,568
317,NZ_CP072670,1,248941,249509,+,568
317,NZ_CP090899,1,249093,249661,+,568
317,NZ_CP046924,1,248790,249358,+,568
317,NZ_OX366348,1,384772,385337,+,565
317,NZ_CP046921,1,248790,249358,+,568
317,NZ_CP054557,1,282997,283562,-,565
317,NZ_CP072669,1,248941,249509,+,568
317,NC_021089,1,263768,264336,+,568
317,NC_021089,1,288604,289172,+,568
318,NZ_OX366376,1,974554,975750,+,1196
318,NZ_OX366376,1,1117657,1118852,-,1195
318,NZ_OX366376,1,1210044,1211239,-,1195
318,NZ_OX366393,1,362366,363561,-,1195
318,NZ_OX366393,1,1041273,1042468,-,1195
318,NZ_OX366372,1,268644,269840,+,1196
318,NZ_OX366372,1,562125,563321,+,1196
318,NZ_OX366342,1,928400,929596,+,1196
318,NZ_OX366342,1,1381775,1382971,+,1196
319,NZ_OX366376,1,977447,979014,+,1567
319,NZ_OX366393,1,1037471,1039038,-,1567
319,NZ_OX366372,1,763139,764706,-,1567
319,NZ_CP072672,1,158388,159977,+,1589
319,NZ_CP069060,1,168626,170220,+,1594
319,NZ_CP072667,1,158370,159959,+,1589
319,NZ_CP072671,1,158370,159959,+,1589
319,NZ_CP072668,1,158370,159959,+,1589
319,NZ_CP072666,1,158370,159959,+,1589
319,NZ_CP090902,1,158522,160111,+,1589
319,NZ_CP090948,1,158522,160111,+,1589
319,NZ_CP069052,1,69906,71500,-,1594
319,NZ_CP076228,1,161636,163225,+,1589
319,NZ_CP042445,1,158522,160111,+,1589
319,NZ_CP042904,1,78573,80163,-,1590
319,NC_012416,1,81154,82744,-,1590
319,NZ_CP069053,1,377057,378651,-,1594
319,NZ_CP042446,1,158522,160111,+,1589
319,NZ_CP041215,1,417511,419101,-,1590
319,NZ_OX366353,1,100356,101946,-,1590
319,NZ_OX366387,1,1282817,1284407,-,1590
319,NZ_OX366368,1,437307,438896,+,1589
319,NZ_OX366379,1,438325,439914,+,1589
319,NZ_CP091195,1,743546,745135,+,1589
319,NZ_OX366375,1,402173,403762,+,1589
319,NZ_CP046925,1,158370,159959,+,1589
319,NZ_OX366318,1,461791,463381,-,1590
319,NZ_OX366319,1,799750,801339,+,1589
319,NZ_OX366332,1,380136,381725,+,1589
319,NZ_CP110359,1,1156210,1157799,+,1589
319,NZ_OU953855,1,981873,983463,-,1590
319,NZ_OX366272,1,795158,796748,-,1590
319,NZ_OX366347,1,469935,471525,-,1590
319,NZ_OU909470,1,1305092,1306643,+,1551
319,NZ_OX366363,1,562507,564096,+,1589
319,NZ_OX366364,1,34938,36514,+,1576
319,NZ_OX366359,1,399160,400750,-,1590
319,NZ_OX366349,1,502108,503675,+,1567
319,NZ_OX366380,1,702703,704254,-,1551
319,NZ_OX366344,1,494437,496004,-,1567
319,NZ_CP090900,1,158522,160111,+,1589
319,NZ_OX366352,1,356196,357767,+,1571
319,NZ_OX366362,1,987687,989263,-,1576
319,NZ_OX366400,1,331533,333123,-,1590
319,NZ_OX366327,1,508906,510496,-,1590
319,NZ_OX366367,1,1320284,1321860,+,1576
319,NZ_CP042444,1,158460,160049,+,1589
319,NZ_OX366326,1,431854,433443,+,1589
319,NZ_CP037426,1,517622,519211,+,1589
319,NZ_OX366339,1,221395,222985,-,1590
319,NZ_OX366355,1,946005,947594,+,1589
319,NZ_CP046922,1,158220,159809,+,1589
319,NZ_OX366370,1,430067,431643,+,1576
319,NZ_OX366385,1,1071966,1073517,+,1551
319,NZ_OX366399,1,436809,438398,+,1589
319,NZ_OX366395,1,1072653,1074231,+,1578
319,NZ_OX366396,1,998946,1000535,+,1589
319,NZ_OX366351,1,375647,377237,-,1590
319,NZ_OX366381,1,77558,79147,+,1589
319,NZ_OX366342,1,1141469,1143036,-,1567
319,NZ_OX366369,1,359674,361264,-,1590
319,NZ_OX366356,1,407257,408808,+,1551
319,NZ_OX366377,1,809220,810809,+,1589
319,NZ_OX366388,1,1288902,1290492,-,1590
319,NZ_OX366357,1,54607,56197,-,1590
319,NZ_CP072012,1,359711,361300,+,1589
319,NZ_OX366398,1,1096079,1097668,+,1589
319,NC_002978,6,158522,160111,+,1589
319,NZ_OX366389,1,606237,607826,+,1589
319,NZ_OX366397,1,382770,384359,+,1589
319,NZ_OX366378,1,1069842,1071431,+,1589
319,NZ_CP090903,1,158522,160111,+,1589
319,NZ_OX366374,1,163034,164623,+,1589
319,NZ_CP090901,1,158522,160111,+,1589
319,NZ_CP046923,1,158220,159809,+,1589
319,NZ_CP069055,1,66045,67635,-,1590
319,NZ_CP072670,1,158370,159959,+,1589
319,NZ_CP090899,1,158522,160111,+,1589
319,NZ_CP046924,1,158220,159809,+,1589
319,NZ_OX366348,1,892361,893950,+,1589
319,NZ_CP046921,1,158220,159809,+,1589
319,NZ_OX366338,1,134449,136027,+,1578
319,NZ_CP054557,1,484755,486345,-,1590
319,NZ_CP072669,1,158370,159959,+,1589
319,NC_021089,1,98625,100214,+,1589
320,NZ_OX366376,1,979925,981059,+,1134
320,NZ_OX366393,1,1035426,1036561,-,1135
320,NZ_OX366372,1,761093,762228,-,1135
320,NZ_CP072672,1,72562,73706,-,1144
320,NZ_CP069060,1,81799,82943,-,1144
320,NZ_CP072667,1,72562,73706,-,1144
320,NZ_CP072671,1,72562,73706,-,1144
320,NZ_CP072668,1,72562,73706,-,1144
320,NZ_CP072666,1,72562,73706,-,1144
320,NZ_CP090902,1,72714,73858,-,1144
320,NZ_CP090948,1,72714,73858,-,1144
320,NZ_CP069052,1,157188,158331,+,1143
320,NZ_CP076228,1,75127,76271,-,1144
320,NZ_CP042445,1,72714,73858,-,1144
320,NC_012416,1,71380,72524,-,1144
320,NZ_CP069053,1,464334,465477,+,1143
320,NZ_CP042446,1,72714,73858,-,1144
320,NZ_CP041215,1,406580,407720,-,1140
320,NZ_OX366353,1,577077,578212,-,1135
320,NZ_OX366387,1,1313800,1314934,+,1134
320,NZ_OX366368,1,353813,354957,-,1144
320,NZ_OX366379,1,354831,355975,-,1144
320,NZ_CP091195,1,1433877,1435026,-,1149
320,NZ_OX366375,1,412030,413173,+,1143
320,NZ_CP046925,1,72562,73706,-,1144
320,NZ_OX366318,1,450800,451944,-,1144
320,NZ_OX366319,1,842181,843324,+,1143
320,NZ_OX366332,1,388926,390060,+,1134
320,NZ_CP110359,1,1164410,1165556,+,1146
320,NZ_OU953855,1,1345420,1346538,+,1118
320,NZ_OX366272,1,786453,787603,-,1150
320,NZ_OX366347,1,462176,463320,-,1144
320,NZ_OU909470,1,1294050,1295190,-,1140
320,NZ_OX366363,1,574836,575985,+,1149
320,NZ_OX366364,1,1201347,1202490,+,1143
320,NZ_OX366359,1,390843,391978,-,1135
320,NZ_OX366349,1,504586,505720,+,1134
320,NZ_OX366380,1,902245,903379,+,1134
320,NZ_OX366344,1,488676,489811,-,1135
320,NZ_CP090900,1,72714,73858,-,1144
320,NZ_OX366352,1,311326,312461,-,1135
320,NZ_OX366362,1,960269,961412,+,1143
320,NZ_OX366400,1,658851,660000,-,1149
320,NZ_OX366327,1,501156,502300,-,1144
320,NZ_OX366367,1,102805,103949,-,1144
320,NZ_CP042444,1,72715,73859,-,1144
320,NZ_CP037426,1,527478,528621,+,1143
320,NZ_OX366339,1,156308,157444,-,1136
320,NZ_OX366355,1,971307,972451,-,1144
320,NZ_CP046922,1,72548,73692,-,1144
320,NZ_OX366370,1,432676,433825,+,1149
320,NZ_OX366385,1,122476,123616,-,1140
320,NZ_OX366399,1,353315,354459,-,1144
320,NZ_OX366395,1,1099916,1101050,+,1134
320,NZ_OX366396,1,599631,600766,+,1135
320,NZ_OX366351,1,367049,368193,-,1144
320,NZ_OX366381,1,100929,102073,-,1144
320,NZ_OX366342,1,1139423,1140558,-,1135
320,NZ_OX366369,1,351081,352225,-,1144
320,NZ_OX366356,1,432337,433585,-,1248
320,NZ_OX366388,1,1255503,1256646,+,1143
320,NZ_OX366357,1,1248104,1249247,+,1143
320,NZ_CP072012,1,963003,964146,+,1143
320,NZ_OX366398,1,1009518,1010662,-,1144
320,NC_002978,6,72714,73858,-,1144
320,NZ_OX366389,1,415755,416899,-,1144
320,NZ_OX366397,1,671962,673097,-,1135
320,NZ_CP090903,1,72714,73858,-,1144
320,NZ_CP090901,1,72714,73858,-,1144
320,NZ_CP046923,1,72548,73692,-,1144
320,NZ_CP069055,1,151506,152649,+,1143
320,NZ_CP072670,1,72562,73706,-,1144
320,NZ_CP090899,1,72714,73858,-,1144
320,NZ_CP046924,1,72548,73692,-,1144
320,NZ_OX366348,1,901446,902575,+,1129
320,NZ_CP046921,1,72548,73692,-,1144
320,NZ_CP054557,1,475286,476430,-,1144
320,NZ_CP072669,1,72562,73706,-,1144
320,NC_021089,1,108595,109729,+,1134
321,NZ_OX366376,1,986814,991559,+,4745
321,NZ_OX366393,1,540251,544994,+,4743
321,NZ_OX366372,1,750792,755522,-,4730
321,NZ_CP072672,1,62285,67016,-,4731
321,NZ_CP069060,1,41662,46393,+,4731
321,NZ_CP072667,1,62285,67016,-,4731
321,NZ_CP072671,1,62285,67016,-,4731
321,NZ_CP072668,1,62285,67016,-,4731
321,NZ_CP072666,1,62285,67016,-,4731
321,NZ_CP090902,1,62437,67168,-,4731
321,NZ_CP090948,1,62437,67168,-,4731
321,NZ_CP069052,1,165796,170527,+,4731
321,NZ_CP076228,1,63231,67962,-,4731
321,NZ_CP042445,1,62437,67168,-,4731
321,NZ_CP042904,1,60588,65319,-,4731
321,NC_012416,1,60589,65320,-,4731
321,NZ_CP069053,1,41662,46393,+,4731
321,NZ_CP042446,1,62437,67168,-,4731
321,NZ_CP041215,1,455610,460341,+,4731
321,NZ_OX366353,1,579750,584481,-,4731
321,NZ_OX366387,1,1320252,1324998,+,4746
321,NZ_OX366368,1,343535,348266,-,4731
321,NZ_OX366379,1,344553,349284,-,4731
321,NZ_CP091195,1,972309,977040,-,4731
321,NZ_OX366375,1,420120,424851,+,4731
321,NZ_CP046925,1,62285,67016,-,4731
321,NZ_OX366318,1,440651,445382,-,4731
321,NZ_OX366319,1,850084,854815,+,4731
321,NZ_OX366332,1,339854,344585,-,4731
321,NZ_CP110359,1,62150,66881,-,4731
321,NZ_OU953855,1,953951,958682,-,4731
321,NZ_OX366272,1,313439,318170,+,4731
321,NZ_OX366347,1,452156,456887,-,4731
321,NZ_OU909470,1,1282749,1287483,-,4734
321,NZ_OX366363,1,581726,586457,+,4731
321,NZ_OX366364,1,1169334,1174080,+,4746
321,NZ_OX366359,1,436111,440842,+,4731
321,NZ_OX366349,1,773041,777786,+,4745
321,NZ_OX366344,1,479777,484522,-,4745
321,NZ_CP090900,1,62437,67168,-,4731
321,NZ_OX366352,1,313995,318726,-,4731
321,NZ_OX366362,1,556795,561544,-,4749
321,NZ_OX366400,1,774968,779699,-,4731
321,NZ_OX366327,1,491610,496341,-,4731
321,NZ_OX366367,1,132349,137095,-,4746
321,NZ_CP042444,1,62438,67169,-,4731
321,NZ_OX366326,1,444523,449254,+,4731
321,NZ_CP037426,1,533730,538461,+,4731
321,NZ_OX366339,1,145268,149999,-,4731
321,NZ_OX366355,1,960045,964776,-,4731
321,NZ_CP046922,1,62271,67002,-,4731
321,NZ_OX366370,1,436993,441738,-,4745
321,NZ_OX366385,1,824809,829543,-,4734
321,NZ_OX366399,1,343037,347768,-,4731
321,NZ_OX366395,1,641574,646305,+,4731
321,NZ_OX366396,1,405934,410665,-,4731
321,NZ_OX366351,1,358400,363131,-,4731
321,NZ_OX366381,1,90647,95378,-,4731
321,NZ_OX366342,1,1127065,1131810,-,4745
321,NZ_OX366369,1,340375,345106,-,4731
321,NZ_OX366356,1,369814,374557,-,4743
321,NZ_OX366377,1,390908,395639,-,4731
321,NZ_OX366388,1,1262426,1267157,+,4731
321,NZ_OX366357,1,1134128,1138858,-,4730
321,NZ_CP072012,1,969694,974425,+,4731
321,NZ_OX366398,1,999434,1004165,-,4731
321,NC_002978,6,62437,67168,-,4731
321,NZ_OX366389,1,405951,410682,-,4731
321,NZ_OX366397,1,340133,344864,-,4731
321,NZ_OX366378,1,938707,943438,+,4731
321,NZ_CP090903,1,62437,67168,-,4731
321,NZ_OX366374,1,1076037,1080768,-,4731
321,NZ_CP090901,1,62437,67168,-,4731
321,NZ_CP046923,1,62271,67002,-,4731
321,NZ_CP069055,1,158074,162805,+,4731
321,NZ_CP072670,1,62285,67016,-,4731
321,NZ_CP090899,1,62437,67168,-,4731
321,NZ_CP046924,1,62271,67002,-,4731
321,NZ_OX366348,1,903658,908389,+,4731
321,NZ_CP046921,1,62271,67002,-,4731
321,NZ_OX366338,1,398563,403294,-,4731
321,NZ_CP054557,1,468274,473005,-,4731
321,NZ_CP072669,1,62285,67016,-,4731
321,NC_021089,1,58884,63615,-,4731
322,NZ_OX366376,1,991623,992906,+,1283
322,NZ_OX366393,1,545058,546341,+,1283
322,NZ_OX366372,1,749445,750728,-,1283
322,NZ_CP072672,1,528345,529632,+,1287
322,NZ_CP069060,1,1266698,1267985,+,1287
322,NZ_CP072667,1,528327,529614,+,1287
322,NZ_CP072671,1,528327,529614,+,1287
322,NZ_CP072668,1,528314,529601,+,1287
322,NZ_CP072666,1,528327,529614,+,1287
322,NZ_CP090902,1,528479,529766,+,1287
322,NZ_CP090948,1,528479,529766,+,1287
322,NZ_CP069052,1,509133,510420,+,1287
322,NZ_CP076228,1,338792,340079,+,1287
322,NZ_CP042445,1,528467,529754,+,1287
322,NZ_CP042904,1,380650,381929,+,1279
322,NC_012416,1,381740,383019,+,1279
322,NZ_CP069053,1,1165496,1166783,-,1287
322,NZ_CP042446,1,528479,529766,+,1287
322,NZ_CP041215,1,1127117,1128392,-,1275
322,NZ_OX366353,1,42439,43714,-,1275
322,NZ_OX366387,1,1079464,1080752,+,1288
322,NZ_OX366368,1,533491,534778,-,1287
322,NZ_OX366379,1,534536,535823,-,1287
322,NZ_CP091195,1,645977,647264,+,1287
322,NZ_OX366375,1,685860,687132,-,1272
322,NZ_CP046925,1,528327,529614,+,1287
322,NZ_OX366318,1,637303,638591,-,1288
322,NZ_OX366319,1,653077,654349,+,1272
322,NZ_OX366332,1,757708,758983,-,1275
322,NZ_CP110359,1,984313,985601,+,1288
322,NZ_OU953855,1,263344,264631,+,1287
322,NZ_OX366272,1,556506,557794,+,1288
322,NZ_OX366347,1,648756,650031,-,1275
322,NZ_OU909470,1,1281402,1282680,-,1278
322,NZ_OX366363,1,276694,277981,+,1287
322,NZ_OX366364,1,1174144,1175435,+,1291
322,NZ_OX366359,1,524657,525932,-,1275
322,NZ_OX366349,1,777850,779127,+,1277
322,NZ_OX366344,1,478430,479713,-,1283
322,NZ_CP090900,1,528479,529766,+,1287
322,NZ_OX366352,1,975383,976658,+,1275
322,NZ_OX366362,1,958352,959635,-,1283
322,NZ_OX366400,1,613761,615049,+,1288
322,NZ_OX366327,1,686436,687711,-,1275
322,NZ_OX366367,1,130999,132285,-,1286
322,NZ_CP042444,1,529016,530303,+,1287
322,NZ_OX366326,1,732127,733415,-,1288
322,NZ_CP037426,1,344884,346156,+,1272
322,NZ_OX366339,1,361506,362794,-,1288
322,NZ_OX366355,1,720191,721463,+,1272
322,NZ_CP046922,1,589995,591282,+,1287
322,NZ_OX366370,1,435647,436930,-,1283
322,NZ_OX366385,1,823495,824740,-,1245
322,NZ_OX366399,1,533028,534315,-,1287
322,NZ_OX366395,1,674629,675917,-,1288
322,NZ_OX366396,1,819543,820831,+,1288
322,NZ_OX366351,1,553960,555248,-,1288
322,NZ_OX366381,1,927642,928914,+,1272
322,NZ_OX366342,1,1125718,1127001,-,1283
322,NZ_OX366369,1,831833,833105,+,1272
322,NZ_OX366356,1,743606,744894,+,1288
322,NZ_OX366377,1,642667,643943,-,1276
322,NZ_OX366388,1,727870,729157,+,1287
322,NZ_OX366357,1,1171352,1172639,+,1287
322,NZ_CP072012,1,455800,457087,-,1287
322,NZ_OX366398,1,1194344,1195620,-,1276
322,NC_002978,6,528479,529766,+,1287
322,NZ_OX366389,1,712085,713361,-,1276
322,NZ_OX366397,1,775414,776689,-,1275
322,NZ_OX366378,1,707579,708866,-,1287
322,NZ_CP090903,1,528479,529766,+,1287
322,NZ_OX366374,1,866504,867792,+,1288
322,NZ_CP090901,1,528479,529766,+,1287
322,NZ_CP046923,1,506243,507530,+,1287
322,NZ_CP069055,1,545184,546471,+,1287
322,NZ_CP072670,1,528319,529606,+,1287
322,NZ_CP090899,1,528479,529766,+,1287
322,NZ_CP046924,1,527181,528468,+,1287
322,NZ_OX366348,1,716942,718229,+,1287
322,NZ_CP046921,1,589995,591282,+,1287
322,NZ_OX366338,1,816040,817326,+,1286
322,NZ_CP054557,1,1261765,1263052,-,1287
322,NZ_CP072669,1,528327,529614,+,1287
322,NC_021089,1,519578,520853,+,1275
323,NZ_OX366376,1,992907,994101,+,1194
323,NZ_OX366393,1,546342,547536,+,1194
323,NZ_OX366372,1,748249,749443,-,1194
323,NZ_OX366342,1,1124522,1125716,-,1194
323,NZ_OX366357,1,1172640,1173834,+,1194
324,NZ_OX366376,1,994103,996808,+,2705
324,NZ_OX366393,1,547538,550243,+,2705
324,NZ_OX366372,1,745543,748248,-,2705
324,NZ_CP072672,1,534159,536865,+,2706
324,NZ_CP069060,1,1270585,1273291,+,2706
324,NZ_CP072667,1,534141,536847,+,2706
324,NZ_CP072671,1,534141,536847,+,2706
324,NZ_CP072668,1,534128,536834,+,2706
324,NZ_CP072666,1,534141,536847,+,2706
324,NZ_CP090902,1,534293,536999,+,2706
324,NZ_CP090948,1,534293,536999,+,2706
324,NZ_CP069052,1,513939,516645,+,2706
324,NZ_CP076228,1,344731,347437,+,2706
324,NZ_CP042445,1,534281,536987,+,2706
324,NZ_CP042904,1,387817,390523,+,2706
324,NC_012416,1,388907,391613,+,2706
324,NZ_CP069053,1,1160190,1162896,-,2706
324,NZ_CP042446,1,534293,536999,+,2706
324,NZ_CP041215,1,1120933,1123639,-,2706
324,NZ_OX366353,1,36759,39465,-,2706
324,NZ_OX366387,1,1028773,1031479,-,2706
324,NZ_OX366368,1,527050,529756,-,2706
324,NZ_OX366379,1,528095,530801,-,2706
324,NZ_CP091195,1,650614,653320,+,2706
324,NZ_OX366375,1,677977,680683,-,2706
324,NZ_CP046925,1,534141,536847,+,2706
324,NZ_OX366318,1,630482,633188,-,2706
324,NZ_OX366319,1,658833,661539,+,2706
324,NZ_OX366332,1,751524,754230,-,2706
324,NZ_CP110359,1,990206,992912,+,2706
324,NZ_OU953855,1,498922,501628,+,2706
324,NZ_OX366272,1,1065196,1067902,+,2706
324,NZ_OX366347,1,642887,645529,-,2642
324,NZ_OU909470,1,1277543,1280249,-,2706
324,NZ_OX366363,1,281681,284387,+,2706
324,NZ_OX366364,1,1179110,1181815,+,2705
324,NZ_OX366359,1,518473,521179,-,2706
324,NZ_OX366349,1,782370,785063,+,2693
324,NZ_OX366380,1,985640,988346,-,2706
324,NZ_OX366344,1,473014,475707,-,2693
324,NZ_CP090900,1,534293,536999,+,2706
324,NZ_OX366352,1,980514,983220,+,2706
324,NZ_OX366362,1,952364,955070,+,2706
324,NZ_OX366400,1,617389,620095,+,2706
324,NZ_OX366327,1,679993,682699,-,2706
324,NZ_OX366367,1,125050,127756,-,2706
324,NZ_CP042444,1,534830,537536,+,2706
324,NZ_OX366326,1,724455,727161,-,2706
324,NZ_CP037426,1,241036,243742,+,2706
324,NZ_OX366339,1,355314,358020,-,2706
324,NZ_OX366355,1,770811,773517,+,2706
324,NZ_CP046922,1,595809,598515,+,2706
324,NZ_OX366370,1,409320,412026,+,2706
324,NZ_OX366385,1,819602,822308,-,2706
324,NZ_OX366399,1,526587,529293,-,2706
324,NZ_OX366395,1,671722,674428,-,2706
324,NZ_OX366396,1,1009153,1011859,-,2706
324,NZ_OX366351,1,546288,548994,-,2706
324,NZ_OX366381,1,933398,936104,+,2706
324,NZ_OX366342,1,1121816,1124521,-,2705
324,NZ_OX366369,1,1106103,1108809,+,2706
324,NZ_OX366356,1,747620,750326,+,2706
324,NZ_OX366377,1,635854,638560,-,2706
324,NZ_OX366388,1,734747,737453,+,2706
324,NZ_OX366357,1,1173836,1176542,+,2706
324,NZ_CP072012,1,449359,452065,-,2706
324,NZ_OX366398,1,1187531,1190237,-,2706
324,NC_002978,6,534293,536999,+,2706
324,NZ_OX366389,1,705272,707978,-,2706
324,NZ_OX366397,1,768222,770928,-,2706
324,NZ_OX366378,1,701523,704229,-,2706
324,NZ_CP090903,1,534293,536999,+,2706
324,NZ_OX366374,1,871003,873709,+,2706
324,NZ_CP090901,1,534293,536999,+,2706
324,NZ_CP046923,1,512057,514763,+,2706
324,NZ_CP069055,1,551125,553831,+,2706
324,NZ_CP072670,1,534133,536839,+,2706
324,NZ_CP090899,1,534293,536999,+,2706
324,NZ_CP046924,1,532995,535701,+,2706
324,NZ_OX366348,1,722713,725419,+,2706
324,NZ_CP046921,1,595809,598515,+,2706
324,NZ_OX366338,1,781210,783910,+,2700
324,NZ_CP054557,1,1254575,1257281,-,2706
324,NZ_CP072669,1,534141,536847,+,2706
324,NC_021089,1,523448,526154,+,2706
325,NZ_OX366376,1,998118,999709,+,1591
325,NZ_OX366393,1,551553,553144,+,1591
325,NZ_OX366372,1,742645,744233,-,1588
325,NZ_CP072672,1,176450,178080,+,1630
325,NZ_CP069060,1,186809,188439,+,1630
325,NZ_CP072667,1,176432,178062,+,1630
325,NZ_CP072671,1,176432,178062,+,1630
325,NZ_CP072668,1,176432,178062,+,1630
325,NZ_CP072666,1,176432,178062,+,1630
325,NZ_CP090902,1,176584,178214,+,1630
325,NZ_CP090948,1,176584,178214,+,1630
325,NZ_CP069052,1,181474,183104,+,1630
325,NZ_CP076228,1,179802,181432,+,1630
325,NZ_CP042445,1,176584,178214,+,1630
325,NZ_CP042904,1,180095,181725,+,1630
325,NC_012416,1,182677,184307,+,1630
325,NZ_CP069053,1,358838,360468,-,1630
325,NZ_CP042446,1,176584,178214,+,1630
325,NZ_CP041215,1,533626,535256,+,1630
325,NZ_OX366353,1,517617,519247,-,1630
325,NZ_OX366387,1,1412290,1413900,+,1610
325,NZ_OX366368,1,455482,457112,+,1630
325,NZ_OX366379,1,456500,458130,+,1630
325,NZ_CP091195,1,1449335,1450965,+,1630
325,NZ_OX366375,1,549397,550921,+,1524
325,NZ_CP046925,1,176432,178062,+,1630
325,NZ_OX366318,1,556570,558200,+,1630
325,NZ_OX366319,1,703335,704965,-,1630
325,NZ_OX366332,1,454725,456355,+,1630
325,NZ_CP110359,1,1063360,1064990,-,1630
325,NZ_OU953855,1,148212,149842,-,1630
325,NZ_OX366272,1,771045,772675,-,1630
325,NZ_OX366347,1,569968,571598,+,1630
325,NZ_OU909470,1,56404,57995,+,1591
325,NZ_OX366363,1,462937,464567,-,1630
325,NZ_OX366364,1,858234,859816,-,1582
325,NZ_OX366359,1,453000,454630,+,1630
325,NZ_OX366349,1,786808,788399,+,1591
325,NZ_OX366380,1,983050,984641,-,1591
325,NZ_OX366344,1,470253,471844,-,1591
325,NZ_CP090900,1,176584,178214,+,1630
325,NZ_OX366352,1,673905,675535,-,1630
325,NZ_OX366362,1,1327343,1328925,+,1582
325,NZ_OX366400,1,702690,704320,-,1630
325,NZ_OX366327,1,605392,607022,+,1630
325,NZ_OX366367,1,705264,706869,+,1605
325,NZ_CP042444,1,176522,178152,+,1630
325,NZ_OX366326,1,648372,650002,+,1630
325,NZ_CP037426,1,695652,697176,-,1524
325,NZ_OX366339,1,271604,273234,+,1630
325,NZ_OX366355,1,849302,850932,-,1630
325,NZ_CP046922,1,176282,177912,+,1630
325,NZ_OX366370,1,413253,414844,+,1591
325,NZ_OX366385,1,815312,816903,-,1591
325,NZ_OX366399,1,454993,456623,+,1630
325,NZ_OX366395,1,1038795,1040379,-,1584
325,NZ_OX366396,1,836341,837971,+,1630
325,NZ_OX366351,1,473066,474696,+,1630
325,NZ_OX366381,1,1010771,1012401,-,1630
325,NZ_OX366342,1,1118915,1120506,-,1591
325,NZ_OX366369,1,455942,457572,+,1630
325,NZ_OX366356,1,475134,476764,+,1630
325,NZ_OX366377,1,560965,562595,+,1630
325,NZ_OX366388,1,826366,827996,-,1630
325,NZ_OX366357,1,20573,22203,+,1630
325,NZ_CP072012,1,377877,379507,+,1630
325,NZ_OX366398,1,1115211,1116841,+,1630
325,NC_002978,6,176584,178214,+,1630
325,NZ_OX366389,1,626297,627927,+,1630
325,NZ_OX366397,1,402193,403823,+,1630
325,NZ_OX366378,1,262931,264561,+,1630
325,NZ_CP090903,1,176584,178214,+,1630
325,NZ_OX366374,1,968228,969812,-,1584
325,NZ_CP090901,1,176584,178214,+,1630
325,NZ_CP046923,1,176282,177912,+,1630
325,NZ_CP069055,1,173737,175367,+,1630
325,NZ_CP072670,1,176432,178062,+,1630
325,NZ_CP090899,1,176584,178214,+,1630
325,NZ_CP046924,1,176282,177912,+,1630
325,NZ_OX366348,1,796506,798136,-,1630
325,NZ_CP046921,1,176282,177912,+,1630
325,NZ_OX366338,1,1173011,1174634,-,1623
325,NZ_CP054557,1,1180593,1182223,+,1630
325,NZ_CP072669,1,176432,178062,+,1630
325,NC_021089,1,174067,175697,+,1630
326,NZ_OX366376,1,1000711,1002031,+,1320
326,NZ_OX366393,1,554146,555466,+,1320
326,NZ_OX366372,1,740320,741640,-,1320
326,NZ_CP072672,1,38630,39950,-,1320
326,NZ_CP069060,1,67748,69068,+,1320
326,NZ_CP072667,1,38630,39950,-,1320
326,NZ_CP072671,1,38630,39950,-,1320
326,NZ_CP072668,1,38630,39950,-,1320
326,NZ_CP072666,1,38630,39950,-,1320
326,NZ_CP090902,1,38782,40102,-,1320
326,NZ_CP090948,1,38782,40102,-,1320
326,NZ_CP069052,1,41589,42909,-,1320
326,NZ_CP076228,1,39573,40893,-,1320
326,NZ_CP042445,1,38782,40102,-,1320
326,NZ_CP042904,1,39282,40602,-,1320
326,NC_012416,1,39283,40603,-,1320
326,NZ_CP069053,1,67748,69068,+,1320
326,NZ_CP042446,1,38782,40102,-,1320
326,NZ_CP041215,1,479129,480449,+,1320
326,NZ_OX366353,1,778120,779440,-,1320
326,NZ_OX366387,1,541736,543056,-,1320
326,NZ_OX366368,1,320766,322086,-,1320
326,NZ_OX366379,1,321784,323104,-,1320
326,NZ_CP091195,1,951574,952894,-,1320
326,NZ_OX366375,1,238827,240147,+,1320
326,NZ_CP046925,1,38630,39950,-,1320
326,NZ_OX366318,1,414079,415399,-,1320
326,NZ_OX366319,1,868805,870125,-,1320
326,NZ_OX366332,1,319747,321067,-,1320
326,NZ_CP110359,1,38331,39651,-,1320
326,NZ_OU953855,1,431954,433274,-,1320
326,NZ_OX366272,1,877763,879083,+,1320
326,NZ_OX366347,1,429359,430679,-,1320
326,NZ_OU909470,1,58962,60280,+,1318
326,NZ_OX366363,1,613930,615250,+,1320
326,NZ_OX366364,1,855658,856978,-,1320
326,NZ_OX366359,1,318656,319976,-,1320
326,NZ_OX366349,1,789413,790733,+,1320
326,NZ_OX366380,1,979932,981250,-,1318
326,NZ_OX366344,1,467934,469254,-,1320
326,NZ_CP090900,1,38782,40102,-,1320
326,NZ_OX366352,1,1013553,1014873,+,1320
326,NZ_OX366362,1,993509,994829,-,1320
326,NZ_OX366400,1,319529,320849,-,1320
326,NZ_OX366327,1,468672,469992,-,1320
326,NZ_OX366367,1,707113,708433,+,1320
326,NZ_CP042444,1,38783,40103,-,1320
326,NZ_OX366326,1,473230,474550,+,1320
326,NZ_CP037426,1,476264,477584,-,1320
326,NZ_OX366339,1,1352710,1354030,+,1320
326,NZ_OX366355,1,992662,993982,+,1320
326,NZ_CP046922,1,38631,39951,-,1320
326,NZ_OX366370,1,416837,418157,+,1320
326,NZ_OX366385,1,812213,813531,-,1318
326,NZ_OX366399,1,320268,321588,-,1320
326,NZ_OX366395,1,465690,467010,-,1320
326,NZ_OX366396,1,398945,400265,+,1320
326,NZ_OX366351,1,332428,333748,-,1320
326,NZ_OX366381,1,1385394,1386714,-,1320
326,NZ_OX366342,1,1116593,1117913,-,1320
326,NZ_OX366369,1,316601,317921,-,1320
326,NZ_OX366356,1,348565,349885,-,1320
326,NZ_OX366377,1,263129,264449,+,1320
326,NZ_OX366388,1,1457530,1458850,+,1320
326,NZ_OX366357,1,1237171,1238491,-,1320
326,NZ_CP072012,1,995869,997189,+,1320
326,NZ_OX366398,1,869893,871213,+,1320
326,NC_002978,6,38782,40102,-,1320
326,NZ_OX366389,1,378778,380098,-,1320
326,NZ_OX366397,1,320035,321355,-,1320
326,NZ_OX366378,1,962852,964172,+,1320
326,NZ_CP090903,1,38782,40102,-,1320
326,NZ_OX366374,1,1113749,1115069,+,1320
326,NZ_CP090901,1,38782,40102,-,1320
326,NZ_CP046923,1,38631,39951,-,1320
326,NZ_CP069055,1,37665,38985,-,1320
326,NZ_CP072670,1,38630,39950,-,1320
326,NZ_CP090899,1,38782,40102,-,1320
326,NZ_CP046924,1,38631,39951,-,1320
326,NZ_OX366348,1,929688,931008,+,1320
326,NZ_CP046921,1,38631,39951,-,1320
326,NZ_OX366338,1,1365579,1366899,+,1320
326,NZ_CP054557,1,438940,440260,-,1320
326,NZ_CP072669,1,38630,39950,-,1320
326,NC_021089,1,38777,40097,-,1320
327,NZ_OX366376,1,1002627,1004466,+,1839
327,NZ_OX366393,1,556062,557901,+,1839
327,NZ_OX366372,1,737885,739724,-,1839
327,NZ_CP072672,1,418127,419977,+,1850
327,NZ_CP069060,1,406797,408647,+,1850
327,NZ_CP072667,1,418109,419959,+,1850
327,NZ_CP072671,1,418109,419959,+,1850
327,NZ_CP072668,1,418096,419946,+,1850
327,NZ_CP072666,1,418109,419959,+,1850
327,NZ_CP090902,1,418261,420111,+,1850
327,NZ_CP090948,1,418261,420111,+,1850
327,NZ_CP069052,1,462772,464622,-,1850
327,NZ_CP076228,1,292848,294698,-,1850
327,NZ_CP042445,1,418261,420111,+,1850
327,NZ_CP042904,1,328366,330215,-,1849
327,NC_012416,1,329457,331306,-,1849
327,NZ_CP069053,1,138630,140480,-,1850
327,NZ_CP042446,1,418261,420111,+,1850
327,NZ_CP041215,1,1176082,1177914,+,1832
327,NZ_OX366353,1,393081,394913,+,1832
327,NZ_OX366387,1,1132865,1134721,-,1856
327,NZ_OX366368,1,813751,815601,-,1850
327,NZ_OX366379,1,771242,773092,-,1850
327,NZ_CP091195,1,196433,198264,+,1831
327,NZ_OX366375,1,524361,526210,+,1849
327,NZ_CP046925,1,418109,419959,+,1850
327,NZ_OX366318,1,722393,724248,-,1855
327,NZ_OX366319,1,511420,513269,-,1849
327,NZ_OX366332,1,806902,808734,+,1832
327,NZ_CP110359,1,760349,762205,-,1856
327,NZ_OU953855,1,1116026,1117876,+,1850
327,NZ_OX366272,1,461177,463033,+,1856
327,NZ_OX366347,1,931026,932882,+,1856
327,NZ_OU909470,1,60443,62276,+,1833
327,NZ_OX366363,1,187477,189332,+,1855
327,NZ_OX366364,1,673964,675811,+,1847
327,NZ_OX366359,1,610540,612372,-,1832
327,NZ_OX366349,1,791329,793168,+,1839
327,NZ_OX366380,1,977922,979761,-,1839
327,NZ_OX366344,1,465499,467338,-,1839
327,NZ_CP090900,1,418261,420111,+,1850
327,NZ_OX366352,1,535945,537777,+,1832
327,NZ_OX366362,1,904760,906607,+,1847
327,NZ_OX366400,1,522262,524117,+,1855
327,NZ_OX366327,1,776526,778375,-,1849
327,NZ_OX366367,1,884978,886810,-,1832
327,NZ_CP042444,1,418762,420612,+,1850
327,NZ_OX366326,1,817217,819072,-,1855
327,NZ_CP037426,1,194272,196121,+,1849
327,NZ_OX366339,1,595446,597284,-,1838
327,NZ_OX366355,1,455131,456980,+,1849
327,NZ_CP046922,1,543422,545272,-,1850
327,NZ_OX366370,1,418753,420592,+,1839
327,NZ_OX366385,1,810203,812042,-,1839
327,NZ_OX366399,1,740826,742676,-,1850
327,NZ_OX366395,1,817572,819410,+,1838
327,NZ_OX366396,1,884148,885986,-,1838
327,NZ_OX366351,1,641703,643558,-,1855
327,NZ_OX366381,1,669022,670871,-,1849
327,NZ_OX366342,1,1114158,1115997,-,1839
327,NZ_OX366369,1,747047,748896,+,1849
327,NZ_OX366356,1,656537,658387,+,1850
327,NZ_OX366377,1,934997,936852,-,1855
327,NZ_OX366388,1,617089,618945,+,1856
327,NZ_OX366357,1,519587,521425,+,1838
327,NZ_CP072012,1,517236,519086,+,1850
327,NZ_OX366398,1,180070,181925,+,1855
327,NC_002978,6,418261,420111,+,1850
327,NZ_OX366389,1,840339,842194,-,1855
327,NZ_OX366397,1,824608,826440,+,1832
327,NZ_OX366378,1,332144,333975,+,1831
327,NZ_CP090903,1,418261,420111,+,1850
327,NZ_OX366374,1,147170,149001,+,1831
327,NZ_CP090901,1,418261,420111,+,1850
327,NZ_CP046923,1,459670,461520,-,1850
327,NZ_CP069055,1,456032,457882,+,1850
327,NZ_CP072670,1,418101,419951,+,1850
327,NZ_CP090899,1,418261,420111,+,1850
327,NZ_CP046924,1,480608,482458,-,1850
327,NZ_OX366348,1,510042,511891,-,1849
327,NZ_CP046921,1,543422,545272,-,1850
327,NZ_OX366338,1,1084476,1086314,-,1838
327,NZ_CP054557,1,166029,167878,+,1849
327,NZ_CP072669,1,418109,419959,+,1850
327,NC_021089,1,403218,405050,-,1832
328,NZ_OX366376,1,1004896,1005713,+,817
328,NZ_OX366393,1,558331,559148,+,817
328,NZ_OX366372,1,736706,737455,-,749
328,NZ_OX366349,1,793598,794415,+,817
328,NZ_OX366380,1,976710,977530,-,820
328,NZ_OX366344,1,464239,465056,-,817
328,NZ_OX366385,1,808991,809811,-,820
328,NZ_OX366342,1,1112911,1113728,-,817
329,NZ_OX366376,1,1007216,1007862,+,646
329,NZ_OX366393,1,560651,561297,+,646
329,NZ_OX366372,1,734569,735215,-,646
329,NZ_CP042904,1,327571,328217,-,646
329,NC_012416,1,328662,329308,-,646
329,NZ_CP041215,1,1178059,1178705,+,646
329,NZ_OX366353,1,395058,395704,+,646
329,NZ_OX366387,1,1132073,1132719,-,646
329,NZ_OX366375,1,526356,527002,+,646
329,NZ_OX366318,1,721602,722248,-,646
329,NZ_OX366319,1,510628,511274,-,646
329,NZ_OX366332,1,808879,809525,+,646
329,NZ_OU953855,1,1118024,1118670,+,646
329,NZ_OX366364,1,675954,676600,+,646
329,NZ_OX366359,1,609749,610395,-,646
329,NZ_OX366349,1,795882,796528,+,646
329,NZ_OX366344,1,462120,462766,-,646
329,NZ_OX366352,1,537922,538568,+,646
329,NZ_OX366400,1,524262,524908,+,646
329,NZ_OX366327,1,775735,776381,-,646
329,NZ_OX366367,1,884206,884835,-,629
329,NZ_OX366326,1,816426,817072,-,646
329,NZ_CP037426,1,196267,196913,+,646
329,NZ_OX366355,1,457126,457772,+,646
329,NZ_OX366351,1,640912,641558,-,646
329,NZ_OX366381,1,668230,668876,-,646
329,NZ_OX366342,1,1110771,1111417,-,646
329,NZ_OX366369,1,749042,749688,+,646
329,NZ_OX366377,1,934206,934852,-,646
329,NZ_OX366398,1,182070,182716,+,646
329,NZ_OX366389,1,839548,840194,-,646
329,NZ_OX366397,1,826585,827231,+,646
329,NC_021089,1,402427,403073,-,646
330,NZ_OX366376,1,1009704,1013393,+,3689
330,NZ_OX366393,1,563139,566828,+,3689
330,NZ_OX366372,1,728987,732675,-,3688
330,NZ_CP072672,1,422137,425837,+,3700
330,NZ_CP069060,1,410805,414505,+,3700
330,NZ_CP072667,1,422119,425819,+,3700
330,NZ_CP072671,1,422119,425819,+,3700
330,NZ_CP072668,1,422106,425806,+,3700
330,NZ_CP072666,1,422119,425819,+,3700
330,NZ_CP090902,1,422271,425971,+,3700
330,NZ_CP090948,1,422271,425971,+,3700
330,NZ_CP069052,1,456914,460614,-,3700
330,NZ_CP076228,1,286988,290688,-,3700
330,NZ_CP042445,1,422271,425971,+,3700
330,NZ_CP042904,1,321614,325323,-,3709
330,NC_012416,1,322705,326414,-,3709
330,NZ_CP069053,1,132772,136472,-,3700
330,NZ_CP042446,1,422271,425971,+,3700
330,NZ_CP041215,1,1180773,1184482,+,3709
330,NZ_OX366353,1,397508,401217,+,3709
330,NZ_OX366387,1,1126375,1130075,-,3700
330,NZ_OX366368,1,807891,811591,-,3700
330,NZ_OX366379,1,765382,769082,-,3700
330,NZ_CP091195,1,200359,204058,+,3699
330,NZ_OX366375,1,528763,532463,+,3700
330,NZ_CP046925,1,422119,425819,+,3700
330,NZ_OX366318,1,715871,719571,-,3700
330,NZ_OX366319,1,504873,508582,-,3709
330,NZ_OX366332,1,811593,815302,+,3709
330,NZ_CP110359,1,752564,756264,-,3700
330,NZ_OU953855,1,1120917,1124617,+,3700
330,NZ_OX366272,1,466267,469967,+,3700
330,NZ_OX366347,1,935800,939503,+,3703
330,NZ_OX366363,1,192202,195902,+,3700
330,NZ_OX366364,1,678668,682377,+,3709
330,NZ_OX366359,1,604236,607945,-,3709
330,NZ_OX366349,1,798657,802346,+,3689
330,NZ_OX366380,1,967796,971497,-,3701
330,NZ_OX366344,1,456260,459948,-,3688
330,NZ_CP090900,1,422271,425971,+,3700
330,NZ_OX366352,1,540648,544357,+,3709
330,NZ_OX366362,1,816311,820017,-,3706
330,NZ_OX366400,1,526939,530639,+,3700
330,NZ_OX366327,1,769739,773439,-,3700
330,NZ_OX366367,1,877502,881211,-,3709
330,NZ_CP042444,1,422772,426472,+,3700
330,NZ_OX366326,1,810695,814395,-,3700
330,NZ_CP037426,1,198674,202374,+,3700
330,NZ_OX366339,1,589350,593049,-,3699
330,NZ_OX366355,1,459818,463527,+,3709
330,NZ_CP046922,1,537562,541262,-,3700
330,NZ_OX366370,1,609406,612986,+,3580
330,NZ_OX366385,1,799351,803052,-,3701
330,NZ_OX366399,1,734966,738666,-,3700
330,NZ_OX366395,1,823212,826915,+,3703
330,NZ_OX366396,1,878052,881751,-,3699
330,NZ_OX366351,1,635181,638881,-,3700
330,NZ_OX366381,1,662475,666184,-,3709
330,NZ_OX366342,1,1105189,1108877,-,3688
330,NZ_OX366369,1,751734,755443,+,3709
330,NZ_OX366356,1,661021,664720,+,3699
330,NZ_OX366377,1,928493,932192,-,3699
330,NZ_OX366388,1,621342,625041,+,3699
330,NZ_OX366357,1,524284,527947,+,3663
330,NZ_CP072012,1,521246,524946,+,3700
330,NZ_OX366398,1,184730,188429,+,3699
330,NC_002978,6,422271,425971,+,3700
330,NZ_OX366389,1,833835,837534,-,3699
330,NZ_OX366397,1,829329,833038,+,3709
330,NZ_OX366378,1,336331,340030,+,3699
330,NZ_CP090903,1,422271,425971,+,3700
330,NZ_OX366374,1,152449,156103,+,3654
330,NZ_CP090901,1,422271,425971,+,3700
330,NZ_CP046923,1,453810,457510,-,3700
330,NZ_CP069055,1,460042,463742,+,3700
330,NZ_CP072670,1,422111,425811,+,3700
330,NZ_CP090899,1,422271,425971,+,3700
330,NZ_CP046924,1,474748,478448,-,3700
330,NZ_OX366348,1,503418,507117,-,3699
330,NZ_CP046921,1,537562,541262,-,3700
330,NZ_OX366338,1,1078227,1081919,-,3692
330,NZ_CP054557,1,170803,174502,+,3699
330,NZ_CP072669,1,422119,425819,+,3700
330,NC_021089,1,396620,400329,-,3709
331,NZ_OX366376,1,1013952,1015180,+,1228
331,NZ_OX366393,1,567387,568615,+,1228
331,NZ_OX366372,1,727200,728428,-,1228
331,NZ_CP072672,1,426005,427216,+,1211
331,NZ_CP069060,1,414673,415884,+,1211
331,NZ_CP072667,1,425987,427198,+,1211
331,NZ_CP072671,1,425987,427198,+,1211
331,NZ_CP072668,1,425974,427185,+,1211
331,NZ_CP072666,1,425987,427198,+,1211
331,NZ_CP090902,1,426139,427350,+,1211
331,NZ_CP090948,1,426139,427350,+,1211
331,NZ_CP069052,1,455535,456745,-,1210
331,NZ_CP076228,1,285609,286819,-,1210
331,NZ_CP042445,1,426139,427350,+,1211
331,NZ_CP042904,1,320400,321586,-,1186
331,NC_012416,1,321491,322677,-,1186
331,NZ_CP069053,1,131393,132603,-,1210
331,NZ_CP042446,1,426139,427350,+,1211
331,NZ_CP041215,1,1185111,1186339,+,1228
331,NZ_OX366353,1,401778,403006,+,1228
331,NZ_OX366387,1,1124996,1126206,-,1210
331,NZ_OX366368,1,806512,807722,-,1210
331,NZ_OX366379,1,764003,765213,-,1210
331,NZ_CP091195,1,204618,205846,+,1228
331,NZ_OX366375,1,532855,534040,+,1185
331,NZ_CP046925,1,425987,427198,+,1211
331,NZ_OX366318,1,714492,715702,-,1210
331,NZ_OX366319,1,503494,504704,-,1210
331,NZ_OX366332,1,815931,817159,+,1228
331,NZ_CP110359,1,750776,752004,-,1228
331,NZ_OU953855,1,1534750,1535979,+,1229
331,NZ_OX366272,1,470596,471824,+,1228
331,NZ_OX366347,1,940467,941695,+,1228
331,NZ_OX366363,1,196092,197303,+,1211
331,NZ_OX366364,1,730355,731532,-,1177
331,NZ_OX366359,1,602448,603676,-,1228
331,NZ_OX366349,1,803593,804821,+,1228
331,NZ_OX366380,1,966596,967781,-,1185
331,NZ_OX366344,1,454473,455701,-,1228
331,NZ_CP090900,1,426139,427350,+,1211
331,NZ_OX366352,1,544986,546214,+,1228
331,NZ_OX366362,1,813193,814394,-,1201
331,NZ_OX366400,1,530807,532018,+,1211
331,NZ_OX366327,1,768147,769332,-,1185
331,NZ_OX366367,1,830569,831746,+,1177
331,NZ_CP042444,1,426640,427851,+,1211
331,NZ_OX366326,1,809316,810526,-,1210
331,NZ_CP037426,1,202766,203951,+,1185
331,NZ_OX366339,1,587585,588813,-,1228
331,NZ_OX366355,1,463695,464906,+,1211
331,NZ_CP046922,1,536183,537393,-,1210
331,NZ_OX366370,1,613111,614296,+,1185
331,NZ_OX366385,1,798151,799336,-,1185
331,NZ_OX366399,1,733587,734797,-,1210
331,NZ_OX366395,1,837464,838684,-,1220
331,NZ_OX366396,1,876432,877660,-,1228
331,NZ_OX366351,1,633802,635012,-,1210
331,NZ_OX366381,1,661096,662306,-,1210
331,NZ_OX366342,1,1103402,1104630,-,1228
331,NZ_OX366369,1,755611,756822,+,1211
331,NZ_OX366356,1,664748,665934,+,1186
331,NZ_OX366377,1,927114,928324,-,1210
331,NZ_OX366388,1,625670,626898,+,1228
331,NZ_OX366357,1,527962,529147,+,1185
331,NZ_CP072012,1,525114,526325,+,1211
331,NZ_OX366398,1,188597,189808,+,1211
331,NC_002978,6,426139,427350,+,1211
331,NZ_OX366389,1,832456,833666,-,1210
331,NZ_OX366397,1,833667,834895,+,1228
331,NZ_OX366378,1,340659,341887,+,1228
331,NZ_CP090903,1,426139,427350,+,1211
331,NZ_OX366374,1,158439,159678,+,1239
331,NZ_CP090901,1,426139,427350,+,1211
331,NZ_CP046923,1,452431,453641,-,1210
331,NZ_CP069055,1,463910,465120,+,1210
331,NZ_CP072670,1,425979,427190,+,1211
331,NZ_CP090899,1,426139,427350,+,1211
331,NZ_CP046924,1,473369,474579,-,1210
331,NZ_OX366348,1,502039,503249,-,1210
331,NZ_CP046921,1,536183,537393,-,1210
331,NZ_OX366338,1,923098,924300,-,1202
331,NZ_CP054557,1,175688,176899,+,1211
331,NZ_CP072669,1,425987,427198,+,1211
331,NC_021089,1,394763,395991,-,1228
332,NZ_OX366376,1,1016039,1017355,+,1316
332,NZ_OX366393,1,569474,570790,+,1316
332,NZ_OX366372,1,725024,726341,-,1317
332,NZ_CP072672,1,427876,429185,+,1309
332,NZ_CP069060,1,416571,417880,+,1309
332,NZ_CP072667,1,427858,429167,+,1309
332,NZ_CP072671,1,427858,429167,+,1309
332,NZ_CP072668,1,427845,429154,+,1309
332,NZ_CP072666,1,427858,429167,+,1309
332,NZ_CP090902,1,428010,429319,+,1309
332,NZ_CP090948,1,428010,429319,+,1309
332,NZ_CP069052,1,453538,454848,-,1310
332,NZ_CP076228,1,283612,284922,-,1310
332,NZ_CP042445,1,428010,429319,+,1309
332,NZ_CP042904,1,318385,319710,-,1325
332,NC_012416,1,319476,320801,-,1325
332,NZ_CP069053,1,129396,130706,-,1310
332,NZ_CP042446,1,428010,429319,+,1309
332,NZ_CP041215,1,1187075,1188409,+,1334
332,NZ_OX366353,1,403742,405076,+,1334
332,NZ_OX366387,1,1122999,1124309,-,1310
332,NZ_OX366368,1,804515,805825,-,1310
332,NZ_OX366379,1,762006,763316,-,1310
332,NZ_CP091195,1,206533,207863,+,1330
332,NZ_OX366375,1,534698,536004,+,1306
332,NZ_CP046925,1,427858,429167,+,1309
332,NZ_OX366318,1,712480,713805,-,1325
332,NZ_OX366319,1,501473,502807,-,1334
332,NZ_OX366332,1,817895,819229,+,1334
332,NZ_CP110359,1,748782,750095,-,1313
332,NZ_OU953855,1,1536678,1537987,+,1309
332,NZ_OX366272,1,472511,473820,+,1309
332,NZ_OX366347,1,942464,943797,+,1333
332,NZ_OX366363,1,198002,199332,+,1330
332,NZ_OX366364,1,728369,729688,-,1319
332,NZ_OX366359,1,600377,601712,-,1335
332,NZ_OX366349,1,805830,807150,+,1320
332,NZ_OX366380,1,964489,965794,-,1305
332,NZ_OX366344,1,452450,453776,-,1326
332,NZ_CP090900,1,428010,429319,+,1309
332,NZ_OX366352,1,546949,548283,+,1334
332,NZ_OX366362,1,810999,812322,-,1323
332,NZ_OX366400,1,532705,534029,+,1324
332,NZ_OX366327,1,766138,767460,-,1322
332,NZ_OX366367,1,832413,833728,+,1315
332,NZ_CP042444,1,428511,429820,+,1309
332,NZ_OX366326,1,807304,808629,-,1325
332,NZ_CP037426,1,204609,205915,+,1306
332,NZ_OX366339,1,585483,586816,-,1333
332,NZ_OX366355,1,465593,466926,+,1333
332,NZ_CP046922,1,534213,535523,-,1310
332,NZ_OX366370,1,615155,616477,+,1322
332,NZ_OX366385,1,796043,797348,-,1305
332,NZ_OX366399,1,731590,732900,-,1310
332,NZ_OX366395,1,835292,836602,-,1310
332,NZ_OX366396,1,874414,875747,-,1333
332,NZ_OX366351,1,631790,633115,-,1325
332,NZ_OX366381,1,659075,660409,-,1334
332,NZ_OX366342,1,1101225,1102543,-,1318
332,NZ_OX366369,1,757509,758842,+,1333
332,NZ_OX366356,1,666621,667927,+,1306
332,NZ_OX366377,1,925102,926427,-,1325
332,NZ_OX366388,1,627667,628976,+,1309
332,NZ_OX366357,1,529846,531152,+,1306
332,NZ_CP072012,1,527012,528321,+,1309
332,NZ_OX366398,1,190495,191819,+,1324
332,NC_002978,6,428010,429319,+,1309
332,NZ_OX366389,1,830444,831769,-,1325
332,NZ_OX366397,1,835631,836965,+,1334
332,NZ_OX366378,1,342574,343904,+,1330
332,NZ_CP090903,1,428010,429319,+,1309
332,NZ_OX366374,1,160345,161678,+,1333
332,NZ_CP090901,1,428010,429319,+,1309
332,NZ_CP046923,1,450461,451771,-,1310
332,NZ_CP069055,1,465807,467116,+,1309
332,NZ_CP072670,1,427850,429159,+,1309
332,NZ_CP090899,1,428010,429319,+,1309
332,NZ_CP046924,1,471399,472709,-,1310
332,NZ_OX366348,1,500018,501352,-,1334
332,NZ_CP046921,1,534213,535523,-,1310
332,NZ_OX366338,1,921133,922443,-,1310
332,NZ_CP054557,1,177586,178919,+,1333
332,NZ_CP072669,1,427858,429167,+,1309
332,NC_021089,1,392692,394027,-,1335
333,NZ_OX366376,1,1022952,1024820,+,1868
333,NZ_OX366393,1,577142,579010,+,1868
333,NZ_OX366372,1,717497,719365,-,1868
333,NZ_CP072672,1,433045,434983,+,1938
333,NZ_CP069060,1,421690,423628,+,1938
333,NZ_CP072667,1,433027,434965,+,1938
333,NZ_CP072671,1,433027,434965,+,1938
333,NZ_CP072668,1,433014,434952,+,1938
333,NZ_CP072666,1,433027,434965,+,1938
333,NZ_CP090902,1,433179,435117,+,1938
333,NZ_CP090948,1,433179,435117,+,1938
333,NZ_CP069052,1,447791,449729,-,1938
333,NZ_CP076228,1,277816,279754,-,1938
333,NZ_CP042445,1,433179,435117,+,1938
333,NZ_CP042904,1,277945,279772,+,1827
333,NC_012416,1,280529,282356,+,1827
333,NZ_CP069053,1,123649,125587,-,1938
333,NZ_CP042446,1,433179,435117,+,1938
333,NZ_CP041215,1,1193115,1195053,+,1938
333,NZ_OX366353,1,408928,410866,+,1938
333,NZ_OX366387,1,1040818,1042756,-,1938
333,NZ_OX366368,1,798717,800655,-,1938
333,NZ_OX366379,1,756208,758146,-,1938
333,NZ_CP091195,1,211921,213859,+,1938
333,NZ_OX366375,1,842134,844063,-,1929
333,NZ_CP046925,1,433027,434965,+,1938
333,NZ_OX366318,1,706780,708718,-,1938
333,NZ_OX366319,1,496718,498656,-,1938
333,NZ_OX366332,1,823081,825019,+,1938
333,NZ_CP110359,1,743181,745110,-,1929
333,NZ_OU953855,1,1541695,1543624,+,1929
333,NZ_OX366272,1,477664,479593,+,1929
333,NZ_OX366347,1,946830,948753,+,1923
333,NZ_OU909470,1,1431891,1433820,-,1929
333,NZ_OX366363,1,203175,205104,+,1929
333,NZ_OX366364,1,721028,722785,-,1757
333,NZ_OX366359,1,594588,596526,-,1938
333,NZ_OX366349,1,812482,814344,+,1862
333,NZ_OX366380,1,814840,816708,-,1868
333,NZ_OX366344,1,445443,447311,-,1868
333,NZ_CP090900,1,433179,435117,+,1938
333,NZ_OX366352,1,552135,554073,+,1938
333,NZ_OX366362,1,805834,807702,-,1868
333,NZ_OX366400,1,537792,539730,+,1938
333,NZ_OX366327,1,760380,762339,-,1959
333,NZ_OX366367,1,838244,840001,+,1757
333,NZ_CP042444,1,433680,435618,+,1938
333,NZ_OX366326,1,801604,803542,-,1938
333,NZ_CP037426,1,208068,209997,+,1929
333,NZ_OX366339,1,387842,389801,+,1959
333,NZ_OX366355,1,469744,471682,+,1938
333,NZ_CP046922,1,528415,530353,-,1938
333,NZ_OX366370,1,494186,495943,+,1757
333,NZ_OX366385,1,541439,543307,+,1868
333,NZ_OX366399,1,725792,727730,-,1938
333,NZ_OX366395,1,854433,856371,+,1938
333,NZ_OX366396,1,865885,867907,-,2022
333,NZ_OX366351,1,626090,628028,-,1938
333,NZ_OX366381,1,654320,656258,-,1938
333,NZ_OX366342,1,1093717,1095585,-,1868
333,NZ_OX366369,1,762443,764381,+,1938
333,NZ_OX366356,1,671885,673823,+,1938
333,NZ_OX366377,1,919407,921345,-,1938
333,NZ_OX366388,1,633095,635033,+,1938
333,NZ_OX366357,1,644624,646562,-,1938
333,NZ_CP072012,1,532182,534120,+,1938
333,NZ_OX366398,1,195577,197515,+,1938
333,NC_002978,6,433179,435117,+,1938
333,NZ_OX366389,1,824750,826688,-,1938
333,NZ_OX366397,1,840776,842714,+,1938
333,NZ_OX366378,1,347526,349464,+,1938
333,NZ_CP090903,1,433179,435117,+,1938
333,NZ_OX366374,1,166576,168508,+,1932
333,NZ_CP090901,1,433179,435117,+,1938
333,NZ_CP046923,1,444663,446601,-,1938
333,NZ_CP069055,1,470976,472914,+,1938
333,NZ_CP072670,1,433019,434957,+,1938
333,NZ_CP090899,1,433179,435117,+,1938
333,NZ_CP046924,1,465601,467539,-,1938
333,NZ_OX366348,1,494216,496145,-,1929
333,NZ_CP046921,1,528415,530353,-,1938
333,NZ_OX366338,1,913655,915636,-,1981
333,NZ_CP054557,1,186281,188210,+,1929
333,NZ_CP072669,1,433027,434965,+,1938
333,NC_021089,1,388280,390218,-,1938
334,NZ_OX366376,1,1030344,1037535,+,7191
334,NZ_OX366393,1,523183,530373,-,7190
334,NZ_OX366372,1,704870,712061,-,7191
334,NZ_CP072672,1,279277,286461,-,7184
334,NZ_CP069060,1,262762,269946,-,7184
334,NZ_CP072667,1,279259,286443,-,7184
334,NZ_CP072671,1,279259,286443,-,7184
334,NZ_CP072668,1,279259,286443,-,7184
334,NZ_CP072666,1,279259,286443,-,7184
334,NZ_CP090902,1,279411,286595,-,7184
334,NZ_CP090948,1,279411,286595,-,7184
334,NZ_CP069052,1,257427,264611,-,7184
334,NZ_CP076228,1,454074,461258,+,7184
334,NZ_CP042445,1,279411,286595,-,7184
334,NZ_CP042904,1,519183,526171,+,6988
334,NC_012416,1,522503,529491,+,6988
334,NZ_CP069053,1,277331,284515,+,7184
334,NZ_CP042446,1,279411,286595,-,7184
334,NZ_CP041215,1,787184,794372,-,7188
334,NZ_OX366353,1,297543,304731,-,7188
334,NZ_OX366387,1,890713,897897,-,7184
334,NZ_OX366368,1,628886,636065,-,7179
334,NZ_OX366379,1,908966,916150,+,7184
334,NZ_CP091195,1,264618,271830,+,7212
334,NZ_OX366375,1,731331,738498,+,7167
334,NZ_CP046925,1,279259,286443,-,7184
334,NZ_OX366318,1,864201,871385,+,7184
334,NZ_OX366319,1,559406,566581,+,7175
334,NZ_OX366332,1,996134,1003322,+,7188
334,NZ_CP110359,1,897319,904497,+,7178
334,NZ_OU953855,1,1265125,1272309,+,7184
334,NZ_OX366272,1,360248,367426,+,7178
334,NZ_OX366347,1,659011,666186,-,7175
334,NZ_OU909470,1,1418454,1425451,-,6997
334,NZ_OX366363,1,42810,49805,-,6995
334,NZ_OX366364,1,908693,915850,+,7157
334,NZ_OX366359,1,826807,833971,+,7164
334,NZ_OX366349,1,818265,825456,+,7191
334,NZ_OX366380,1,805831,812828,-,6997
334,NZ_OX366344,1,434768,441937,-,7169
334,NZ_CP090900,1,279411,286595,-,7184
334,NZ_OX366352,1,757158,764346,+,7188
334,NZ_OX366362,1,622277,629504,-,7227
334,NZ_OX366400,1,368841,375994,-,7153
334,NZ_OX366327,1,904977,911973,+,6996
334,NZ_OX366367,1,639435,646615,-,7180
334,NZ_CP042444,1,278993,286177,-,7184
334,NZ_OX366326,1,960151,967335,+,7184
334,NZ_CP037426,1,578275,585442,+,7167
334,NZ_OX366339,1,656392,663585,-,7193
334,NZ_OX366355,1,573932,581107,+,7175
334,NZ_CP046922,1,279109,286293,-,7184
334,NZ_OX366370,1,529301,536447,-,7146
334,NZ_OX366385,1,550200,557197,+,6997
334,NZ_OX366399,1,902030,909214,+,7184
334,NZ_OX366395,1,574367,581555,-,7188
334,NZ_OX366396,1,1179630,1186823,+,7193
334,NZ_OX366351,1,774891,782075,-,7184
334,NZ_OX366381,1,538198,545373,-,7175
334,NZ_OX366342,1,1081576,1088747,-,7171
334,NZ_OX366369,1,606228,613403,-,7175
334,NZ_OX366356,1,518150,525434,-,7284
334,NZ_OX366377,1,473699,480892,+,7193
334,NZ_OX366388,1,467133,474345,-,7212
334,NZ_OX366357,1,85790,92787,-,6997
334,NZ_CP072012,1,214649,221833,-,7184
334,NZ_OX366398,1,29898,37091,-,7193
334,NC_002978,6,279411,286595,-,7184
334,NZ_OX366389,1,971394,978587,+,7193
334,NZ_OX366397,1,1077743,1084931,+,7188
334,NZ_OX366378,1,664413,671625,+,7212
334,NZ_CP090903,1,279411,286595,-,7184
334,NZ_OX366374,1,528944,536130,+,7186
334,NZ_CP090901,1,279411,286595,-,7184
334,NZ_CP046923,1,279109,286293,-,7184
334,NZ_CP069055,1,311075,318259,-,7184
334,NZ_CP072670,1,279251,286435,-,7184
334,NZ_CP090899,1,279411,286595,-,7184
334,NZ_CP046924,1,279109,286293,-,7184
334,NZ_OX366348,1,578569,585573,+,7004
334,NZ_CP046921,1,279109,286293,-,7184
334,NZ_OX366338,1,852038,859233,+,7195
334,NZ_CP054557,1,244269,251273,+,7004
334,NZ_CP072669,1,279259,286443,-,7184
334,NC_021089,1,645281,652469,+,7188
335,NZ_OX366376,1,1037790,1039446,+,1656
335,NZ_OX366393,1,521272,522928,-,1656
335,NZ_OX366372,1,702959,704615,-,1656
335,NZ_CP072672,1,636637,638280,+,1643
335,NZ_CP069060,1,477670,479313,+,1643
335,NZ_CP072667,1,636619,638262,+,1643
335,NZ_CP072671,1,636619,638262,+,1643
335,NZ_CP072668,1,636606,638249,+,1643
335,NZ_CP072666,1,636619,638262,+,1643
335,NZ_CP090902,1,636771,638414,+,1643
335,NZ_CP090948,1,636771,638414,+,1643
335,NZ_CP069052,1,684071,685714,+,1643
335,NZ_CP076228,1,567807,569450,+,1643
335,NZ_CP042445,1,636759,638402,+,1643
335,NZ_CP042904,1,528449,530095,+,1646
335,NC_012416,1,531769,533415,+,1646
335,NZ_CP069053,1,477678,479321,+,1643
335,NZ_CP042446,1,636771,638414,+,1643
335,NZ_CP041215,1,770859,772515,-,1656
335,NZ_OX366353,1,1188545,1190201,-,1656
335,NZ_OX366387,1,1357160,1358816,+,1656
335,NZ_OX366368,1,1002289,1003932,+,1643
335,NZ_OX366379,1,1000823,1002466,+,1643
335,NZ_CP091195,1,274226,275882,+,1656
335,NZ_OX366375,1,927605,929261,+,1656
335,NZ_CP046925,1,636619,638262,+,1643
335,NZ_OX366318,1,932172,933828,+,1656
335,NZ_OX366319,1,283172,284828,-,1656
335,NZ_OX366332,1,1019831,1021487,+,1656
335,NZ_CP110359,1,570521,572177,-,1656
335,NZ_OU953855,1,628622,630278,-,1656
335,NZ_OX366272,1,692229,693885,+,1656
335,NZ_OX366347,1,876330,877986,-,1656
335,NZ_OU909470,1,417320,418976,+,1656
335,NZ_OX366363,1,1307214,1308870,-,1656
335,NZ_OX366364,1,918472,920114,+,1642
335,NZ_OX366359,1,850469,852125,+,1656
335,NZ_OX366349,1,825711,827367,+,1656
335,NZ_OX366380,1,852357,854013,+,1656
335,NZ_OX366344,1,432857,434513,-,1656
335,NZ_CP090900,1,636771,638414,+,1643
335,NZ_OX366352,1,1120837,1122493,+,1656
335,NZ_OX366362,1,617732,619388,-,1656
335,NZ_OX366400,1,798924,800577,+,1653
335,NZ_OX366327,1,935523,937169,+,1646
335,NZ_OX366367,1,636579,638221,-,1642
335,NZ_CP042444,1,637308,638951,+,1643
335,NZ_OX366326,1,1060510,1062166,+,1656
335,NZ_CP037426,1,121544,123200,-,1656
335,NZ_OX366339,1,718574,720230,+,1656
335,NZ_OX366355,1,307428,309084,-,1656
335,NZ_CP046922,1,698485,700128,+,1643
335,NZ_OX366370,1,527364,529020,-,1656
335,NZ_OX366385,1,160379,162035,-,1656
335,NZ_OX366399,1,570742,572385,-,1643
335,NZ_OX366395,1,571757,573414,-,1657
335,NZ_OX366396,1,646333,647989,-,1656
335,NZ_OX366351,1,1008572,1010228,+,1656
335,NZ_OX366381,1,393195,394851,-,1656
335,NZ_OX366342,1,1079665,1081321,-,1656
335,NZ_OX366369,1,1125594,1127250,+,1656
335,NZ_OX366356,1,842101,843757,+,1656
335,NZ_OX366377,1,683727,685383,-,1656
335,NZ_OX366388,1,369219,370875,-,1656
335,NZ_OX366357,1,489696,491349,-,1653
335,NZ_CP072012,1,870300,871943,+,1643
335,NZ_OX366398,1,609459,611115,-,1656
335,NC_002978,6,636771,638414,+,1643
335,NZ_OX366389,1,1043088,1044744,+,1656
335,NZ_OX366397,1,1170996,1172652,+,1656
335,NZ_OX366378,1,674021,675677,+,1656
335,NZ_CP090903,1,636771,638414,+,1643
335,NZ_OX366374,1,537631,539281,+,1650
335,NZ_CP090901,1,636771,638414,+,1643
335,NZ_CP046923,1,614733,616376,+,1643
335,NZ_CP069055,1,557258,558901,+,1643
335,NZ_CP072670,1,636611,638254,+,1643
335,NZ_CP090899,1,636771,638414,+,1643
335,NZ_CP046924,1,635671,637314,+,1643
335,NZ_OX366348,1,341857,343513,-,1656
335,NZ_CP046921,1,698485,700128,+,1643
335,NZ_OX366338,1,860487,862129,+,1642
335,NZ_CP054557,1,337077,338733,+,1656
335,NZ_CP072669,1,636619,638262,+,1643
335,NC_021089,1,670618,672274,+,1656
336,NZ_OX366376,1,1039499,1040805,+,1306
336,NZ_OX366393,1,519913,521219,-,1306
336,NZ_OX366372,1,701600,702906,-,1306
336,NZ_CP072672,1,638345,639644,+,1299
336,NZ_CP069060,1,479378,480677,+,1299
336,NZ_CP072667,1,638327,639626,+,1299
336,NZ_CP072671,1,638327,639626,+,1299
336,NZ_CP072668,1,638314,639613,+,1299
336,NZ_CP072666,1,638327,639626,+,1299
336,NZ_CP090902,1,638479,639778,+,1299
336,NZ_CP090948,1,638479,639778,+,1299
336,NZ_CP069052,1,685779,687078,+,1299
336,NZ_CP076228,1,569515,570814,+,1299
336,NZ_CP042445,1,638467,639766,+,1299
336,NZ_CP042904,1,530158,531463,+,1305
336,NC_012416,1,533478,534783,+,1305
336,NZ_CP069053,1,479386,480685,+,1299
336,NZ_CP042446,1,638479,639778,+,1299
336,NZ_CP041215,1,769501,770806,-,1305
336,NZ_OX366353,1,1187187,1188492,-,1305
336,NZ_OX366387,1,1358869,1360161,+,1292
336,NZ_OX366368,1,1003997,1005296,+,1299
336,NZ_OX366379,1,1002531,1003830,+,1299
336,NZ_CP091195,1,275935,277207,+,1272
336,NZ_OX366375,1,929314,930612,+,1298
336,NZ_CP046925,1,638327,639626,+,1299
336,NZ_OX366318,1,933881,935179,+,1298
336,NZ_OX366319,1,281821,283119,-,1298
336,NZ_OX366332,1,1021540,1022845,+,1305
336,NZ_CP110359,1,569179,570468,-,1289
336,NZ_OU953855,1,627270,628569,-,1299
336,NZ_OX366272,1,693938,695233,+,1295
336,NZ_OX366347,1,874976,876277,-,1301
336,NZ_OU909470,1,419029,420328,+,1299
336,NZ_OX366363,1,1305856,1307161,-,1305
336,NZ_OX366364,1,920178,921484,+,1306
336,NZ_OX366359,1,852178,853483,+,1305
336,NZ_OX366349,1,827420,828726,+,1306
336,NZ_OX366380,1,854066,855365,+,1299
336,NZ_OX366344,1,431498,432804,-,1306
336,NZ_CP090900,1,638479,639778,+,1299
336,NZ_OX366352,1,1122546,1123851,+,1305
336,NZ_OX366362,1,616386,617685,-,1299
336,NZ_OX366400,1,801484,802779,+,1295
336,NZ_OX366327,1,937232,938534,+,1302
336,NZ_OX366367,1,635216,636515,-,1299
336,NZ_CP042444,1,639016,640315,+,1299
336,NZ_OX366326,1,1062219,1063511,+,1292
336,NZ_CP037426,1,120193,121491,-,1298
336,NZ_OX366339,1,720283,721578,+,1295
336,NZ_OX366355,1,306077,307375,-,1298
336,NZ_CP046922,1,700193,701492,+,1299
336,NZ_OX366370,1,526005,527311,-,1306
336,NZ_OX366385,1,159027,160326,-,1299
336,NZ_OX366399,1,569378,570677,-,1299
336,NZ_OX366395,1,570405,571704,-,1299
336,NZ_OX366396,1,644985,646280,-,1295
336,NZ_OX366351,1,1010281,1011579,+,1298
336,NZ_OX366381,1,391844,393142,-,1298
336,NZ_OX366342,1,1078306,1079612,-,1306
336,NZ_OX366369,1,1127303,1128601,+,1298
336,NZ_OX366356,1,843810,845099,+,1289
336,NZ_OX366377,1,682382,683674,-,1292
336,NZ_OX366388,1,367861,369166,-,1305
336,NZ_OX366357,1,488350,489643,-,1293
336,NZ_CP072012,1,872008,873307,+,1299
336,NZ_OX366398,1,608108,609406,-,1298
336,NC_002978,6,638479,639778,+,1299
336,NZ_OX366389,1,1044797,1046095,+,1298
336,NZ_OX366397,1,1172705,1174010,+,1305
336,NZ_OX366378,1,675730,677002,+,1272
336,NZ_CP090903,1,638479,639778,+,1299
336,NZ_OX366374,1,540317,541616,+,1299
336,NZ_CP090901,1,638479,639778,+,1299
336,NZ_CP046923,1,616441,617740,+,1299
336,NZ_CP069055,1,558966,560265,+,1299
336,NZ_CP072670,1,638319,639618,+,1299
336,NZ_CP090899,1,638479,639778,+,1299
336,NZ_CP046924,1,637379,638678,+,1299
336,NZ_OX366348,1,340512,341804,-,1292
336,NZ_CP046921,1,700193,701492,+,1299
336,NZ_OX366338,1,862193,863492,+,1299
336,NZ_CP054557,1,338786,340078,+,1292
336,NZ_CP072669,1,638327,639626,+,1299
336,NC_021089,1,672327,673632,+,1305
337,NZ_OX366376,1,1041792,1059049,+,17257
337,NZ_OX366393,1,501668,518926,-,17258
337,NZ_OX366372,1,683355,700613,-,17258
337,NZ_CP072672,1,640631,657903,+,17272
337,NZ_CP069060,1,481664,498930,+,17266
337,NZ_CP072667,1,640613,657885,+,17272
337,NZ_CP072671,1,640613,657885,+,17272
337,NZ_CP072668,1,640600,657872,+,17272
337,NZ_CP072666,1,640613,657885,+,17272
337,NZ_CP090902,1,640765,658037,+,17272
337,NZ_CP090948,1,640765,658037,+,17272
337,NZ_CP069052,1,688065,705331,+,17266
337,NZ_CP076228,1,572715,589981,+,17266
337,NZ_CP042445,1,640753,658025,+,17272
337,NZ_CP042904,1,532450,549707,+,17257
337,NC_012416,1,535770,553027,+,17257
337,NZ_CP069053,1,481672,498938,+,17266
337,NZ_CP042446,1,640765,658037,+,17272
337,NZ_CP041215,1,751256,768514,-,17258
337,NZ_OX366353,1,1168942,1186200,-,17258
337,NZ_OX366387,1,1361148,1378405,+,17257
337,NZ_OX366368,1,1006283,1023549,+,17266
337,NZ_OX366379,1,1004817,1022083,+,17266
337,NZ_CP091195,1,279709,296966,+,17257
337,NZ_OX366375,1,931599,948856,+,17257
337,NZ_CP046925,1,640613,657885,+,17272
337,NZ_OX366318,1,936166,953423,+,17257
337,NZ_OX366319,1,263576,280834,-,17258
337,NZ_OX366332,1,1023832,1041089,+,17257
337,NZ_CP110359,1,550922,568189,-,17267
337,NZ_OU953855,1,1313998,1331256,-,17258
337,NZ_OX366272,1,1069764,1087030,+,17266
337,NZ_OX366347,1,856780,873986,-,17206
337,NZ_OU909470,1,421317,438802,+,17485
337,NZ_OX366363,1,1287611,1304869,-,17258
337,NZ_OX366364,1,922471,939740,+,17269
337,NZ_OX366359,1,854470,871727,+,17257
337,NZ_OX366349,1,829713,846970,+,17257
337,NZ_OX366380,1,857333,874530,+,17197
337,NZ_OX366344,1,413253,430511,-,17258
337,NZ_CP090900,1,640765,658037,+,17272
337,NZ_OX366352,1,1124838,1142095,+,17257
337,NZ_OX366362,1,598132,615399,-,17267
337,NZ_OX366400,1,803766,821023,+,17257
337,NZ_OX366327,1,939524,956781,+,17257
337,NZ_OX366367,1,616959,634229,-,17270
337,NZ_CP042444,1,641302,658574,+,17272
337,NZ_OX366326,1,1064498,1081755,+,17257
337,NZ_CP037426,1,101948,119206,-,17258
337,NZ_OX366339,1,723520,740777,+,17257
337,NZ_OX366355,1,287832,305090,-,17258
337,NZ_CP046922,1,702479,719751,+,17272
337,NZ_OX366370,1,507761,525018,-,17257
337,NZ_OX366385,1,465283,482541,-,17258
337,NZ_OX366399,1,551124,568391,-,17267
337,NZ_OX366395,1,552160,569418,-,17258
337,NZ_OX366396,1,626737,643995,-,17258
337,NZ_OX366351,1,1012566,1029823,+,17257
337,NZ_OX366381,1,373599,390857,-,17258
337,NZ_OX366342,1,1060062,1077319,-,17257
337,NZ_OX366369,1,1129588,1146845,+,17257
337,NZ_OX366356,1,846193,863459,+,17266
337,NZ_OX366377,1,664137,681395,-,17258
337,NZ_OX366388,1,349616,366874,-,17258
337,NZ_OX366357,1,470108,487363,-,17255
337,NZ_CP072012,1,874294,891560,+,17266
337,NZ_OX366398,1,589012,606270,-,17258
337,NC_002978,6,640765,658037,+,17272
337,NZ_OX366389,1,1047082,1064339,+,17257
337,NZ_OX366397,1,1174997,1192254,+,17257
337,NZ_OX366378,1,679504,696761,+,17257
337,NZ_CP090903,1,640765,658037,+,17272
337,NZ_OX366374,1,544354,561566,+,17212
337,NZ_CP090901,1,640765,658037,+,17272
337,NZ_CP046923,1,618727,635999,+,17272
337,NZ_CP069055,1,561252,578518,+,17266
337,NZ_CP072670,1,640605,657877,+,17272
337,NZ_CP090899,1,640765,658037,+,17272
337,NZ_CP046924,1,639665,656937,+,17272
337,NZ_OX366348,1,322267,339525,-,17258
337,NZ_CP046921,1,702479,719751,+,17272
337,NZ_OX366338,1,864479,881736,+,17257
337,NZ_CP054557,1,341371,358628,+,17257
337,NZ_CP072669,1,640613,657885,+,17272
337,NC_021089,1,674619,691876,+,17257
338,NZ_OX366376,1,1060148,1063313,+,3165
338,NZ_OX366393,1,1283952,1287117,+,3165
338,NZ_OX366372,1,521010,524175,-,3165
338,NZ_CP072672,1,12965,16142,-,3177
338,NZ_CP069060,1,13095,16256,-,3161
338,NZ_CP072667,1,12965,16142,-,3177
338,NZ_CP072671,1,12965,16142,-,3177
338,NZ_CP072668,1,12965,16142,-,3177
338,NZ_CP072666,1,12965,16142,-,3177
338,NZ_CP090902,1,13117,16294,-,3177
338,NZ_CP090948,1,13117,16294,-,3177
338,NZ_CP069052,1,13095,16256,-,3161
338,NZ_CP076228,1,13038,16199,-,3161
338,NZ_CP042445,1,13117,16294,-,3177
338,NZ_CP042904,1,13258,16419,-,3161
338,NC_012416,1,13259,16420,-,3161
338,NZ_CP069053,1,13095,16256,-,3161
338,NZ_CP042446,1,13117,16294,-,3177
338,NZ_CP041215,1,563883,567043,+,3160
338,NZ_OX366353,1,752963,756124,-,3161
338,NZ_OX366387,1,515639,518800,-,3161
338,NZ_OX366368,1,295108,298269,-,3161
338,NZ_OX366379,1,296126,299287,-,3161
338,NZ_CP091195,1,1384187,1387362,+,3175
338,NZ_OX366375,1,313457,316618,-,3161
338,NZ_CP046925,1,12965,16142,-,3177
338,NZ_OX366318,1,386414,389575,-,3161
338,NZ_OX366319,1,904324,907484,+,3160
338,NZ_OX366332,1,293723,296884,-,3161
338,NZ_CP110359,1,13022,16183,-,3161
338,NZ_OU953855,1,41400,44561,-,3161
338,NZ_OX366272,1,1088129,1091289,+,3160
338,NZ_OX366347,1,403777,406938,-,3161
338,NZ_OU909470,1,182865,186052,+,3187
338,NZ_OX366363,1,638921,642095,+,3174
338,NZ_OX366364,1,695107,698273,-,3166
338,NZ_OX366359,1,292182,295343,-,3161
338,NZ_OX366349,1,74134,77299,-,3165
338,NZ_OX366380,1,309933,313102,+,3169
338,NZ_OX366344,1,1062684,1065855,-,3171
338,NZ_CP090900,1,13117,16294,-,3177
338,NZ_OX366352,1,1036728,1039888,+,3160
338,NZ_OX366362,1,488127,491246,-,3119
338,NZ_OX366400,1,295640,298801,-,3161
338,NZ_OX366327,1,442237,445398,-,3161
338,NZ_OX366367,1,864225,867396,+,3171
338,NZ_CP042444,1,13117,16294,-,3177
338,NZ_OX366326,1,496881,500041,+,3160
338,NZ_CP037426,1,13016,16177,-,3161
338,NZ_OX366339,1,1064060,1067235,-,3175
338,NZ_OX366355,1,1018184,1021344,+,3160
338,NZ_CP046922,1,12965,16142,-,3177
338,NZ_OX366370,1,997990,1001136,+,3146
338,NZ_OX366385,1,281452,284627,+,3175
338,NZ_OX366399,1,294610,297771,-,3161
338,NZ_OX366395,1,440419,443580,-,3161
338,NZ_OX366396,1,357437,360612,-,3175
338,NZ_OX366351,1,305940,309101,-,3161
338,NZ_OX366381,1,1358031,1361192,-,3161
338,NZ_OX366342,1,76804,79969,+,3165
338,NZ_OX366369,1,289694,292855,-,3161
338,NZ_OX366356,1,324026,327187,-,3161
338,NZ_OX366377,1,287758,290918,+,3160
338,NZ_OX366388,1,1482115,1485275,+,3160
338,NZ_OX366357,1,725440,728601,+,3161
338,NZ_CP072012,1,1019686,1022846,+,3160
338,NZ_OX366398,1,894549,897709,+,3160
338,NC_002978,6,13117,16294,-,3177
338,NZ_OX366389,1,351881,355042,-,3161
338,NZ_OX366397,1,293582,296743,-,3161
338,NZ_OX366378,1,901428,904603,+,3175
338,NZ_CP090903,1,13117,16294,-,3177
338,NZ_OX366374,1,1134181,1137341,+,3160
338,NZ_CP090901,1,13117,16294,-,3177
338,NZ_CP046923,1,12965,16142,-,3177
338,NZ_CP069055,1,13190,16351,-,3161
338,NZ_CP072670,1,12965,16142,-,3177
338,NZ_CP090899,1,13117,16294,-,3177
338,NZ_CP046924,1,12965,16142,-,3177
338,NZ_OX366348,1,953367,956521,+,3154
338,NZ_CP046921,1,12965,16142,-,3177
338,NZ_OX366338,1,1471582,1474743,-,3161
338,NZ_CP054557,1,414403,417564,-,3161
338,NZ_CP072669,1,12965,16142,-,3177
338,NC_021089,1,13213,16374,-,3161
339,NZ_OX366376,1,1063983,1064887,+,904
339,NZ_OX366393,1,1288012,1288916,+,904
339,NZ_OX366372,1,519436,520340,-,904
339,NZ_CP072672,1,139686,140589,-,903
339,NZ_CP069060,1,149924,150827,-,903
339,NZ_CP072667,1,139668,140571,-,903
339,NZ_CP072671,1,139668,140571,-,903
339,NZ_CP072668,1,139668,140571,-,903
339,NZ_CP072666,1,139668,140571,-,903
339,NZ_CP090902,1,139820,140723,-,903
339,NZ_CP090948,1,139820,140723,-,903
339,NZ_CP069052,1,89304,90207,+,903
339,NZ_CP076228,1,142927,143830,-,903
339,NZ_CP042445,1,139820,140723,-,903
339,NZ_CP042904,1,97871,98774,+,903
339,NC_012416,1,100452,101355,+,903
339,NZ_CP069053,1,396450,397353,+,903
339,NZ_CP042446,1,139820,140723,-,903
339,NZ_CP041215,1,437641,438544,+,903
339,NZ_OX366353,1,145080,145983,-,903
339,NZ_OX366387,1,1302188,1303091,+,903
339,NZ_OX366368,1,418599,419502,-,903
339,NZ_OX366379,1,419617,420520,-,903
339,NZ_CP091195,1,725083,725986,-,903
339,NZ_OX366375,1,382606,383509,-,903
339,NZ_CP046925,1,139668,140571,-,903
339,NZ_OX366318,1,481799,482702,+,903
339,NZ_OX366319,1,781095,781998,-,903
339,NZ_OX366332,1,360694,361597,-,903
339,NZ_CP110359,1,1137516,1138420,-,904
339,NZ_OU953855,1,322251,323154,-,903
339,NZ_OX366272,1,814543,815447,+,904
339,NZ_OX366347,1,489346,490250,+,904
339,NZ_OU909470,1,186878,187782,+,904
339,NZ_OX366363,1,543103,544006,-,903
339,NZ_OX366364,1,692324,693227,-,903
339,NZ_OX366359,1,419289,420192,+,903
339,NZ_OX366349,1,72569,73473,-,904
339,NZ_OX366380,1,1195157,1196061,+,904
339,NZ_OX366344,1,1061098,1062002,-,904
339,NZ_CP090900,1,139820,140723,-,903
339,NZ_OX366352,1,334436,335339,-,903
339,NZ_OX366362,1,446362,447266,-,904
339,NZ_OX366400,1,351541,352444,+,903
339,NZ_OX366327,1,528295,529198,+,903
339,NZ_OX366367,1,869205,870108,+,903
339,NZ_CP042444,1,139758,140661,-,903
339,NZ_OX366326,1,412547,413450,-,903
339,NZ_CP037426,1,498973,499877,-,904
339,NZ_OX366339,1,169465,170368,-,903
339,NZ_OX366355,1,927350,928253,-,903
339,NZ_CP046922,1,139513,140416,-,903
339,NZ_OX366370,1,251030,251935,-,905
339,NZ_OX366385,1,617181,618085,+,904
339,NZ_OX366399,1,418101,419004,-,903
339,NZ_OX366395,1,1053561,1054465,-,904
339,NZ_OX366396,1,932473,933376,-,903
339,NZ_OX366351,1,395655,396558,+,903
339,NZ_OX366381,1,58904,59807,-,903
339,NZ_OX366342,1,80621,81525,+,904
339,NZ_OX366369,1,379015,379918,+,903
339,NZ_OX366356,1,388725,389619,-,894
339,NZ_OX366377,1,790155,791058,-,903
339,NZ_OX366388,1,1308051,1308954,+,903
339,NZ_OX366357,1,1348704,1349608,-,904
339,NZ_CP072012,1,341003,341906,-,903
339,NZ_OX366398,1,1077014,1077917,-,903
339,NC_002978,6,139820,140723,-,903
339,NZ_OX366389,1,250574,251429,-,855
339,NZ_OX366389,1,587172,588075,-,903
339,NZ_OX366397,1,363328,364231,-,903
339,NZ_OX366378,1,1051380,1052283,-,903
339,NZ_CP090903,1,139820,140723,-,903
339,NZ_OX366374,1,1045405,1046240,-,835
339,NZ_CP090901,1,139820,140723,-,903
339,NZ_CP046923,1,139513,140416,-,903
339,NZ_CP069055,1,85441,86344,+,903
339,NZ_CP072670,1,139668,140571,-,903
339,NZ_CP090899,1,139820,140723,-,903
339,NZ_CP046924,1,139513,140416,-,903
339,NZ_OX366348,1,873049,873952,-,903
339,NZ_CP046921,1,139513,140416,-,903
339,NZ_OX366338,1,1114335,1115239,+,904
339,NZ_CP054557,1,504734,505637,+,903
339,NZ_CP072669,1,139668,140571,-,903
339,NC_021089,1,79521,80424,-,903
340,NZ_OX366376,1,1065113,1066763,+,1650
340,NZ_OX366393,1,1289142,1290792,+,1650
340,NZ_OX366372,1,517559,519209,-,1650
340,NZ_OX366349,1,70692,72342,-,1650
340,NZ_OX366344,1,1059221,1060871,-,1650
340,NZ_OX366370,1,249215,250803,-,1588
340,NZ_OX366342,1,81751,83400,+,1649
341,NZ_OX366376,1,1068093,1069584,+,1491
341,NZ_OX366393,1,1292122,1293616,+,1494
341,NZ_OX366372,1,515482,516976,-,1494
341,NZ_CP072672,1,136429,137923,-,1494
341,NZ_CP069060,1,146667,148161,-,1494
341,NZ_CP072667,1,136411,137905,-,1494
341,NZ_CP072671,1,136411,137905,-,1494
341,NZ_CP072668,1,136411,137905,-,1494
341,NZ_CP072666,1,136411,137905,-,1494
341,NZ_CP090902,1,136563,138057,-,1494
341,NZ_CP090948,1,136563,138057,-,1494
341,NZ_CP069052,1,91970,93464,+,1494
341,NZ_CP076228,1,139670,141164,-,1494
341,NZ_CP042445,1,136563,138057,-,1494
341,NZ_CP042904,1,100537,102031,+,1494
341,NC_012416,1,103118,104612,+,1494
341,NZ_CP069053,1,399116,400610,+,1494
341,NZ_CP042446,1,136563,138057,-,1494
341,NZ_CP041215,1,439567,441054,+,1487
341,NZ_OX366353,1,142570,144064,-,1494
341,NZ_OX366387,1,1304854,1306348,+,1494
341,NZ_OX366368,1,415342,416836,-,1494
341,NZ_OX366379,1,416360,417854,-,1494
341,NZ_CP091195,1,722573,724060,-,1487
341,NZ_OX366375,1,380096,381590,-,1494
341,NZ_CP046925,1,136411,137905,-,1494
341,NZ_OX366318,1,484465,485959,+,1494
341,NZ_OX366319,1,777838,779332,-,1494
341,NZ_OX366332,1,357437,358924,-,1487
341,NZ_CP110359,1,1134259,1135753,-,1494
341,NZ_OU953855,1,318994,320488,-,1494
341,NZ_OX366272,1,817210,818704,+,1494
341,NZ_OX366347,1,492013,493507,+,1494
341,NZ_OU909470,1,189546,191040,+,1494
341,NZ_OX366363,1,539846,541340,-,1494
341,NZ_OX366364,1,688562,690056,-,1494
341,NZ_OX366359,1,421955,423449,+,1494
341,NZ_OX366349,1,67868,69362,-,1494
341,NZ_OX366380,1,1197838,1199318,+,1480
341,NZ_OX366344,1,1056397,1057891,-,1494
341,NZ_CP090900,1,136563,138057,-,1494
341,NZ_OX366352,1,331179,332673,-,1494
341,NZ_OX366362,1,443099,444593,-,1494
341,NZ_OX366400,1,354207,355701,+,1494
341,NZ_OX366327,1,530961,532449,+,1488
341,NZ_OX366367,1,872031,873525,+,1494
341,NZ_CP042444,1,136501,137995,-,1494
341,NZ_OX366326,1,408543,410037,-,1494
341,NZ_CP037426,1,496463,497957,-,1494
341,NZ_OX366339,1,166208,167702,-,1494
341,NZ_OX366355,1,924093,925587,-,1494
341,NZ_CP046922,1,136256,137750,-,1494
341,NZ_OX366370,1,246404,247898,-,1494
341,NZ_OX366385,1,619862,621342,+,1480
341,NZ_OX366399,1,414844,416338,-,1494
341,NZ_OX366395,1,1105152,1106646,-,1494
341,NZ_OX366396,1,929216,930710,-,1494
341,NZ_OX366351,1,399068,400562,+,1494
341,NZ_OX366381,1,55647,57141,-,1494
341,NZ_OX366342,1,84730,86224,+,1494
341,NZ_OX366369,1,381681,383175,+,1494
341,NZ_OX366356,1,386206,387700,-,1494
341,NZ_OX366377,1,786898,788392,-,1494
341,NZ_OX366388,1,1311814,1313308,+,1494
341,NZ_OX366357,1,1343932,1345426,-,1494
341,NZ_CP072012,1,337746,339240,-,1494
341,NZ_OX366398,1,1073757,1075251,-,1494
341,NC_002978,6,136563,138057,-,1494
341,NZ_OX366389,1,583915,585409,-,1494
341,NZ_OX366397,1,359324,360818,-,1494
341,NZ_OX366378,1,1048870,1050357,-,1487
341,NZ_CP090903,1,136563,138057,-,1494
341,NZ_OX366374,1,1042148,1043642,-,1494
341,NZ_CP090901,1,136563,138057,-,1494
341,NZ_CP046923,1,136256,137750,-,1494
341,NZ_CP069055,1,88107,89601,+,1494
341,NZ_CP072670,1,136411,137905,-,1494
341,NZ_CP090899,1,136563,138057,-,1494
341,NZ_CP046924,1,136256,137750,-,1494
341,NZ_OX366348,1,869792,871286,-,1494
341,NZ_CP046921,1,136256,137750,-,1494
341,NZ_OX366338,1,1117870,1119364,+,1494
341,NZ_CP054557,1,507400,508894,+,1494
341,NZ_CP072669,1,136411,137905,-,1494
341,NC_021089,1,76264,77758,-,1494
342,NZ_OX366376,1,1070241,1071235,+,994
342,NZ_OX366393,1,1294273,1295267,+,994
342,NZ_OX366372,1,513829,514825,-,996
342,NZ_OX366342,1,86881,87875,+,994
343,NZ_OX366376,1,1075229,1076218,+,989
343,NZ_OX366393,1,1232175,1233179,+,1004
343,NZ_OX366372,1,873131,874119,-,988
343,NZ_CP072672,1,388480,389480,+,1000
343,NZ_CP069060,1,377101,378101,+,1000
343,NZ_CP072667,1,388462,389462,+,1000
343,NZ_CP072671,1,388462,389462,+,1000
343,NZ_CP072668,1,388449,389449,+,1000
343,NZ_CP072666,1,388462,389462,+,1000
343,NZ_CP090902,1,388614,389614,+,1000
343,NZ_CP090948,1,388614,389614,+,1000
343,NZ_CP069052,1,493318,494318,-,1000
343,NZ_CP076228,1,322741,323741,-,1000
343,NZ_CP042445,1,388614,389614,+,1000
343,NZ_CP042904,1,358545,359544,-,999
343,NC_012416,1,359636,360634,-,998
343,NZ_CP069053,1,169176,170176,-,1000
343,NZ_CP042446,1,388614,389614,+,1000
343,NZ_CP041215,1,1146550,1147519,+,969
343,NZ_OX366353,1,363564,364533,+,969
343,NZ_OX366387,1,1165199,1166199,-,1000
343,NZ_OX366368,1,844374,845374,-,1000
343,NZ_OX366379,1,801813,802813,-,1000
343,NZ_CP091195,1,165370,166369,+,999
343,NZ_OX366375,1,494172,495171,+,999
343,NZ_CP046925,1,388462,389462,+,1000
343,NZ_OX366318,1,753491,754491,-,1000
343,NZ_OX366319,1,542292,543291,-,999
343,NZ_OX366332,1,777232,778201,+,969
343,NZ_CP110359,1,790660,791648,-,988
343,NZ_OU953855,1,1504383,1505382,+,999
343,NZ_OX366272,1,832260,833248,-,988
343,NZ_OX366347,1,901661,902651,+,990
343,NZ_OU909470,1,591106,592110,+,1004
343,NZ_OX366363,1,156153,157152,+,999
343,NZ_OX366364,1,743992,744961,+,969
343,NZ_OX366359,1,641050,642019,-,969
343,NZ_OX366349,1,544876,545864,-,988
343,NZ_OX366380,1,1162388,1163377,+,989
343,NZ_OX366344,1,982884,983873,+,989
343,NZ_CP090900,1,388614,389614,+,1000
343,NZ_OX366352,1,446864,447833,+,969
343,NZ_OX366362,1,648412,649381,+,969
343,NZ_OX366400,1,492019,493019,+,1000
343,NZ_OX366327,1,806538,807537,-,999
343,NZ_OX366367,1,815645,816614,-,969
343,NZ_CP042444,1,389115,390115,+,1000
343,NZ_OX366326,1,848310,849310,-,1000
343,NZ_CP037426,1,164104,165103,+,999
343,NZ_OX366339,1,415610,416609,-,999
343,NZ_OX366355,1,425108,426107,+,999
343,NZ_CP046922,1,573919,574919,-,1000
343,NZ_OX366370,1,290437,291425,-,988
343,NZ_OX366385,1,586193,587197,+,1004
343,NZ_OX366399,1,771397,772397,-,1000
343,NZ_OX366395,1,787277,788282,+,1005
343,NZ_OX366396,1,1135121,1136120,-,999
343,NZ_OX366351,1,672801,673801,-,1000
343,NZ_OX366381,1,699908,700907,-,999
343,NZ_OX366342,1,1408758,1409746,-,988
343,NZ_OX366369,1,717024,718023,+,999
343,NZ_OX366356,1,624979,625979,+,1000
343,NZ_OX366377,1,965834,966833,-,999
343,NZ_OX366388,1,586704,587703,+,999
343,NZ_OX366357,1,785257,786261,-,1004
343,NZ_CP072012,1,487411,488411,+,1000
343,NZ_OX366398,1,150089,151088,+,999
343,NC_002978,6,388614,389614,+,1000
343,NZ_OX366389,1,871133,872132,-,999
343,NZ_OX366397,1,794930,795899,+,969
343,NZ_OX366378,1,396787,397786,-,999
343,NZ_CP090903,1,388614,389614,+,1000
343,NZ_OX366374,1,315922,316891,-,969
343,NZ_CP090901,1,388614,389614,+,1000
343,NZ_CP046923,1,490167,491167,-,1000
343,NZ_CP069055,1,426311,427311,+,1000
343,NZ_CP072670,1,388454,389454,+,1000
343,NZ_CP090899,1,388614,389614,+,1000
343,NZ_CP046924,1,511105,512105,-,1000
343,NZ_OX366348,1,541000,541999,-,999
343,NZ_CP046921,1,573919,574919,-,1000
343,NZ_OX366338,1,848655,849959,-,1304
343,NZ_CP054557,1,135760,136759,+,999
343,NZ_CP072669,1,388462,389462,+,1000
343,NC_021089,1,500368,501337,-,969
344,NZ_OX366376,1,1076622,1078209,+,1587
344,NZ_OX366393,1,1233583,1235170,+,1587
344,NZ_OX366372,1,871140,872727,-,1587
344,NZ_CP072672,1,389888,391465,+,1577
344,NZ_CP069060,1,378509,380086,+,1577
344,NZ_CP072667,1,389870,391447,+,1577
344,NZ_CP072671,1,389870,391447,+,1577
344,NZ_CP072668,1,389857,391434,+,1577
344,NZ_CP072666,1,389870,391447,+,1577
344,NZ_CP090902,1,390022,391599,+,1577
344,NZ_CP090948,1,390022,391599,+,1577
344,NZ_CP069052,1,491333,492910,-,1577
344,NZ_CP076228,1,320756,322333,-,1577
344,NZ_CP042445,1,390022,391599,+,1577
344,NZ_CP042904,1,356553,358130,-,1577
344,NC_012416,1,357644,359221,-,1577
344,NZ_CP069053,1,167191,168768,-,1577
344,NZ_CP042446,1,390022,391599,+,1577
344,NZ_CP041215,1,1147934,1149511,+,1577
344,NZ_OX366353,1,364948,366525,+,1577
344,NZ_OX366387,1,1163207,1164784,-,1577
344,NZ_OX366368,1,842389,843966,-,1577
344,NZ_OX366379,1,799828,801405,-,1577
344,NZ_CP091195,1,166784,168361,+,1577
344,NZ_OX366375,1,495586,497163,+,1577
344,NZ_CP046925,1,389870,391447,+,1577
344,NZ_OX366318,1,751499,753076,-,1577
344,NZ_OX366319,1,540300,541877,-,1577
344,NZ_OX366332,1,778616,780193,+,1577
344,NZ_CP110359,1,788669,790246,-,1577
344,NZ_OU953855,1,1505797,1507374,+,1577
344,NZ_OX366272,1,830269,831846,-,1577
344,NZ_OX366347,1,903066,904643,+,1577
344,NZ_OU909470,1,592525,594102,+,1577
344,NZ_OX366363,1,157567,159144,+,1577
344,NZ_OX366364,1,745488,747064,+,1576
344,NZ_OX366359,1,639058,640635,-,1577
344,NZ_OX366349,1,542885,544472,-,1587
344,NZ_OX366380,1,1163792,1165368,+,1576
344,NZ_OX366344,1,984287,985864,+,1577
344,NZ_CP090900,1,390022,391599,+,1577
344,NZ_OX366352,1,448248,449825,+,1577
344,NZ_OX366362,1,649786,651373,+,1587
344,NZ_OX366400,1,493434,495011,+,1577
344,NZ_OX366327,1,804546,806123,-,1577
344,NZ_OX366367,1,813654,815240,-,1586
344,NZ_CP042444,1,390523,392100,+,1577
344,NZ_OX366326,1,846318,847895,-,1577
344,NZ_CP037426,1,165518,167095,+,1577
344,NZ_OX366339,1,413618,415195,-,1577
344,NZ_OX366355,1,426522,428099,+,1577
344,NZ_CP046922,1,571934,573511,-,1577
344,NZ_OX366370,1,288326,289902,-,1576
344,NZ_OX366385,1,587612,589188,+,1576
344,NZ_OX366399,1,769412,770989,-,1577
344,NZ_OX366395,1,788696,790273,+,1577
344,NZ_OX366396,1,1133129,1134706,-,1577
344,NZ_OX366351,1,670809,672386,-,1577
344,NZ_OX366381,1,697916,699493,-,1577
344,NZ_OX366342,1,1406767,1408354,-,1587
344,NZ_OX366369,1,718438,720015,+,1577
344,NZ_OX366356,1,626395,627972,+,1577
344,NZ_OX366377,1,963842,965419,-,1577
344,NZ_OX366388,1,588118,589695,+,1577
344,NZ_OX366357,1,783265,784842,-,1577
344,NZ_CP072012,1,488819,490396,+,1577
344,NZ_OX366398,1,151503,153080,+,1577
344,NC_002978,6,390022,391599,+,1577
344,NZ_OX366389,1,869141,870718,-,1577
344,NZ_OX366397,1,796314,797891,+,1577
344,NZ_OX366378,1,394795,396372,-,1577
344,NZ_CP090903,1,390022,391599,+,1577
344,NZ_OX366374,1,313930,315507,-,1577
344,NZ_CP090901,1,390022,391599,+,1577
344,NZ_CP046923,1,488182,489759,-,1577
344,NZ_CP069055,1,427719,429296,+,1577
344,NZ_CP072670,1,389862,391439,+,1577
344,NZ_CP090899,1,390022,391599,+,1577
344,NZ_CP046924,1,509120,510697,-,1577
344,NZ_OX366348,1,539009,540586,-,1577
344,NZ_CP046921,1,571934,573511,-,1577
344,NZ_OX366338,1,846663,848250,-,1587
344,NZ_CP054557,1,137173,138750,+,1577
344,NZ_CP072669,1,389870,391447,+,1577
344,NC_021089,1,498376,499953,-,1577
345,NZ_OX366376,1,1078605,1079123,+,518
345,NZ_OX366393,1,1235566,1236084,+,518
345,NZ_OX366372,1,870226,870744,-,518
345,NZ_OU909470,1,594508,595026,+,518
345,NZ_OX366364,1,747478,747996,+,518
345,NZ_OX366349,1,541971,542489,-,518
345,NZ_OX366344,1,986260,986778,+,518
345,NZ_OX366362,1,651778,652287,+,509
345,NZ_OX366367,1,812722,813240,-,518
345,NZ_OX366395,1,790669,791187,+,518
345,NZ_OX366342,1,1405853,1406371,-,518
345,NZ_OX366356,1,628394,628912,+,518
345,NZ_OX366357,1,782326,782843,-,517
345,NZ_OX366374,1,312991,313508,-,517
345,NZ_OX366338,1,845752,846269,-,517
346,NZ_OX366376,1,1079175,1080467,+,1292
346,NZ_OX366393,1,1236136,1237428,+,1292
346,NZ_OX366372,1,868887,870174,-,1287
346,NZ_CP072672,1,392455,393752,+,1297
346,NZ_CP069060,1,381076,382373,+,1297
346,NZ_CP072667,1,392437,393734,+,1297
346,NZ_CP072671,1,392437,393734,+,1297
346,NZ_CP072668,1,392424,393721,+,1297
346,NZ_CP072666,1,392437,393734,+,1297
346,NZ_CP090902,1,392589,393886,+,1297
346,NZ_CP090948,1,392589,393886,+,1297
346,NZ_CP069052,1,489046,490343,-,1297
346,NZ_CP076228,1,318469,319766,-,1297
346,NZ_CP042445,1,392589,393886,+,1297
346,NZ_CP042904,1,354266,355563,-,1297
346,NC_012416,1,355357,356654,-,1297
346,NZ_CP069053,1,164904,166201,-,1297
346,NZ_CP042446,1,392589,393886,+,1297
346,NZ_CP041215,1,1150501,1151798,+,1297
346,NZ_OX366353,1,367515,368812,+,1297
346,NZ_OX366387,1,1160920,1162217,-,1297
346,NZ_OX366368,1,840048,841399,-,1351
346,NZ_OX366379,1,797541,798838,-,1297
346,NZ_CP091195,1,169351,170648,+,1297
346,NZ_OX366375,1,498153,499450,+,1297
346,NZ_CP046925,1,392437,393734,+,1297
346,NZ_OX366318,1,749212,750509,-,1297
346,NZ_OX366319,1,538013,539310,-,1297
346,NZ_OX366332,1,781183,782480,+,1297
346,NZ_CP110359,1,786382,787679,-,1297
346,NZ_OU953855,1,1508364,1509661,+,1297
346,NZ_OX366272,1,827982,829279,-,1297
346,NZ_OX366347,1,905633,906930,+,1297
346,NZ_OU909470,1,595080,596375,+,1295
346,NZ_OX366363,1,160134,161431,+,1297
346,NZ_OX366364,1,748048,749343,+,1295
346,NZ_OX366359,1,636771,638068,-,1297
346,NZ_OX366349,1,540627,541919,-,1292
346,NZ_OX366380,1,1166359,1167656,+,1297
346,NZ_OX366344,1,986830,988122,+,1292
346,NZ_CP090900,1,392589,393886,+,1297
346,NZ_OX366352,1,450815,452112,+,1297
346,NZ_OX366362,1,652339,653634,+,1295
346,NZ_OX366400,1,496001,497298,+,1297
346,NZ_OX366327,1,802259,803556,-,1297
346,NZ_OX366367,1,811375,812670,-,1295
346,NZ_CP042444,1,393090,394387,+,1297
346,NZ_OX366326,1,844031,845328,-,1297
346,NZ_CP037426,1,168085,169382,+,1297
346,NZ_OX366339,1,411331,412628,-,1297
346,NZ_OX366355,1,429089,430386,+,1297
346,NZ_CP046922,1,569647,570944,-,1297
346,NZ_OX366370,1,286041,287335,-,1294
346,NZ_OX366385,1,590179,591476,+,1297
346,NZ_OX366399,1,767125,768422,-,1297
346,NZ_OX366395,1,791239,792534,+,1295
346,NZ_OX366396,1,1130842,1132139,-,1297
346,NZ_OX366351,1,668522,669819,-,1297
346,NZ_OX366381,1,695629,696926,-,1297
346,NZ_OX366342,1,1404509,1405801,-,1292
346,NZ_OX366369,1,721005,722302,+,1297
346,NZ_OX366356,1,628964,630259,+,1295
346,NZ_OX366377,1,961555,962852,-,1297
346,NZ_OX366388,1,590685,591982,+,1297
346,NZ_OX366357,1,780978,782275,-,1297
346,NZ_CP072012,1,491386,492683,+,1297
346,NZ_OX366398,1,154070,155367,+,1297
346,NC_002978,6,392589,393886,+,1297
346,NZ_OX366389,1,866854,868151,-,1297
346,NZ_OX366397,1,798881,800178,+,1297
346,NZ_OX366378,1,392508,393805,-,1297
346,NZ_CP090903,1,392589,393886,+,1297
346,NZ_OX366374,1,311643,312940,-,1297
346,NZ_CP090901,1,392589,393886,+,1297
346,NZ_CP046923,1,485895,487192,-,1297
346,NZ_CP069055,1,430286,431583,+,1297
346,NZ_CP072670,1,392429,393726,+,1297
346,NZ_CP090899,1,392589,393886,+,1297
346,NZ_CP046924,1,506833,508130,-,1297
346,NZ_OX366348,1,536722,538019,-,1297
346,NZ_CP046921,1,569647,570944,-,1297
346,NZ_OX366338,1,844414,845700,-,1286
346,NZ_CP054557,1,139740,141037,+,1297
346,NZ_CP072669,1,392437,393734,+,1297
346,NC_021089,1,496089,497386,-,1297
347,NZ_OX366376,1,1080602,1081857,+,1255
347,NZ_OX366393,1,1237563,1238818,+,1255
347,NZ_OX366372,1,867492,868747,-,1255
347,NZ_CP072672,1,386298,387552,-,1254
347,NZ_CP069060,1,374834,376088,-,1254
347,NZ_CP072667,1,386280,387534,-,1254
347,NZ_CP072671,1,386280,387534,-,1254
347,NZ_CP072668,1,386267,387521,-,1254
347,NZ_CP072666,1,386280,387534,-,1254
347,NZ_CP090902,1,386432,387686,-,1254
347,NZ_CP090948,1,386432,387686,-,1254
347,NZ_CP069052,1,495331,496585,+,1254
347,NZ_CP076228,1,324767,326027,+,1260
347,NZ_CP042445,1,386432,387686,-,1254
347,NZ_CP042904,1,360470,361724,+,1254
347,NC_012416,1,361560,362814,+,1254
347,NZ_CP069053,1,171189,172443,+,1254
347,NZ_CP042446,1,386432,387686,-,1254
347,NZ_CP041215,1,1144322,1145576,-,1254
347,NZ_OX366353,1,361369,362622,-,1253
347,NZ_OX366387,1,1169084,1170338,+,1254
347,NZ_OX366368,1,846387,847641,+,1254
347,NZ_OX366379,1,803826,805080,+,1254
347,NZ_CP091195,1,163013,164267,-,1254
347,NZ_CP046925,1,386280,387534,-,1254
347,NZ_OX366318,1,755512,756766,+,1254
347,NZ_OX366332,1,775004,776258,-,1254
347,NZ_CP110359,1,792417,793671,+,1254
347,NZ_OU953855,1,1502022,1503276,-,1254
347,NZ_OX366272,1,834029,835283,+,1254
347,NZ_OX366347,1,899627,900881,-,1254
347,NZ_OU909470,1,596507,597762,+,1255
347,NZ_OX366363,1,153886,155140,-,1254
347,NZ_OX366364,1,749475,750730,+,1255
347,NZ_OX366359,1,642993,644247,+,1254
347,NZ_OX366349,1,539237,540492,-,1255
347,NZ_OX366380,1,1167788,1169043,+,1255
347,NZ_OX366344,1,988257,989512,+,1255
347,NZ_CP090900,1,386432,387686,-,1254
347,NZ_OX366352,1,444636,445890,-,1254
347,NZ_OX366362,1,653779,655033,+,1254
347,NZ_OX366400,1,489744,490998,-,1254
347,NZ_OX366327,1,808557,809811,+,1254
347,NZ_OX366367,1,809988,811243,-,1255
347,NZ_CP042444,1,386933,388187,-,1254
347,NZ_OX366326,1,850331,851585,+,1254
347,NZ_OX366339,1,417803,419057,+,1254
347,NZ_OX366355,1,422399,423653,-,1254
347,NZ_CP046922,1,575847,577101,+,1254
347,NZ_OX366370,1,284651,285906,-,1255
347,NZ_OX366385,1,591608,592863,+,1255
347,NZ_OX366399,1,773410,774664,+,1254
347,NZ_OX366395,1,785285,786539,-,1254
347,NZ_OX366396,1,1137305,1138559,+,1254
347,NZ_OX366351,1,674822,676076,+,1254
347,NZ_OX366381,1,702362,703616,+,1254
347,NZ_OX366342,1,1403119,1404374,-,1255
347,NZ_OX366369,1,714328,715582,-,1254
347,NZ_OX366356,1,622719,623973,-,1254
347,NZ_OX366377,1,967846,969100,+,1254
347,NZ_OX366388,1,584256,585510,-,1254
347,NZ_OX366357,1,786973,788226,+,1253
347,NZ_CP072012,1,485144,486398,-,1254
347,NZ_OX366398,1,147822,149076,-,1254
347,NC_002978,6,386432,387686,-,1254
347,NZ_OX366389,1,873145,874399,+,1254
347,NZ_OX366397,1,792702,793956,-,1254
347,NZ_OX366378,1,398872,400126,+,1254
347,NZ_CP090903,1,386432,387686,-,1254
347,NZ_OX366374,1,292429,293683,-,1254
347,NZ_CP090901,1,386432,387686,-,1254
347,NZ_CP046923,1,492095,493349,+,1254
347,NZ_CP069055,1,424044,425298,-,1254
347,NZ_CP072670,1,386272,387526,-,1254
347,NZ_CP090899,1,386432,387686,-,1254
347,NZ_CP046924,1,513033,514287,+,1254
347,NZ_OX366348,1,543012,544266,+,1254
347,NZ_CP046921,1,575847,577101,+,1254
347,NZ_OX366338,1,829407,830661,-,1254
347,NZ_CP054557,1,133648,134902,-,1254
347,NZ_CP072669,1,386280,387534,-,1254
347,NC_021089,1,502311,503565,+,1254
348,NZ_OX366376,1,1083072,1085981,+,2909
348,NZ_OX366393,1,1240032,1242941,+,2909
348,NZ_OX366372,1,863507,866417,-,2910
348,NZ_CP072672,1,665593,668502,+,2909
348,NZ_CP069060,1,506619,509528,+,2909
348,NZ_CP072667,1,665575,668484,+,2909
348,NZ_CP072671,1,665575,668484,+,2909
348,NZ_CP072668,1,665562,668471,+,2909
348,NZ_CP072666,1,665575,668484,+,2909
348,NZ_CP090902,1,665727,668636,+,2909
348,NZ_CP090948,1,665727,668636,+,2909
348,NZ_CP069052,1,713020,715929,+,2909
348,NZ_CP076228,1,598689,601598,+,2909
348,NZ_CP042445,1,665715,668624,+,2909
348,NZ_CP042904,1,558379,561279,+,2900
348,NC_012416,1,561699,564599,+,2900
348,NZ_CP069053,1,506627,509536,+,2909
348,NZ_CP042446,1,665727,668636,+,2909
348,NZ_CP041215,1,740754,743664,-,2910
348,NZ_OX366353,1,1158438,1161348,-,2910
348,NZ_OX366387,1,1385843,1388752,+,2909
348,NZ_OX366368,1,1031239,1034148,+,2909
348,NZ_OX366379,1,1029773,1032682,+,2909
348,NZ_CP091195,1,135730,138640,-,2910
348,NZ_OX366375,1,956293,959193,+,2900
348,NZ_CP046925,1,665575,668484,+,2909
348,NZ_OX366318,1,961192,964101,+,2909
348,NZ_OX366319,1,252688,255589,-,2901
348,NZ_OX366332,1,1048684,1051593,+,2909
348,NZ_CP110359,1,540442,543344,-,2902
348,NZ_OU953855,1,1304730,1307640,-,2910
348,NZ_OX366272,1,907668,910570,+,2902
348,NZ_OX366347,1,846335,849245,-,2910
348,NZ_OU909470,1,598873,601773,+,2900
348,NZ_OX366363,1,1274831,1277741,-,2910
348,NZ_OX366364,1,945673,948527,+,2854
348,NZ_OX366359,1,879322,882231,+,2909
348,NZ_OX366349,1,535151,538010,-,2859
348,NZ_OX366380,1,1170479,1173367,+,2888
348,NZ_OX366344,1,990619,993475,+,2856
348,NZ_CP090900,1,665727,668636,+,2909
348,NZ_OX366352,1,1149690,1152599,+,2909
348,NZ_OX366362,1,695834,698743,+,2909
348,NZ_OX366400,1,828792,831701,+,2909
348,NZ_OX366327,1,965855,968755,+,2900
348,NZ_OX366367,1,607784,610629,-,2845
348,NZ_CP042444,1,666264,669173,+,2909
348,NZ_OX366326,1,1089524,1092433,+,2909
348,NZ_CP037426,1,91610,94511,-,2901
348,NZ_OX366339,1,748700,751612,+,2912
348,NZ_OX366355,1,276944,279845,-,2901
348,NZ_CP046922,1,727441,730350,+,2909
348,NZ_OX366370,1,279762,282621,-,2859
348,NZ_OX366385,1,594299,597187,+,2888
348,NZ_OX366399,1,540525,543435,-,2910
348,NZ_OX366395,1,541955,544865,-,2910
348,NZ_OX366396,1,613982,616894,-,2912
348,NZ_OX366351,1,1037592,1040501,+,2909
348,NZ_OX366381,1,362711,365612,-,2901
348,NZ_OX366342,1,1399134,1402044,-,2910
348,NZ_OX366369,1,1153854,1156754,+,2900
348,NZ_OX366356,1,870992,873901,+,2909
348,NZ_OX366377,1,653650,656560,-,2910
348,NZ_OX366388,1,337904,340814,-,2910
348,NZ_OX366357,1,459974,462884,-,2910
348,NZ_CP072012,1,899250,902159,+,2909
348,NZ_OX366398,1,577674,580584,-,2910
348,NC_002978,6,665727,668636,+,2909
348,NZ_OX366389,1,1067927,1070836,+,2909
348,NZ_OX366397,1,1199849,1202758,+,2909
348,NZ_OX366378,1,721076,723986,-,2910
348,NZ_CP090903,1,665727,668636,+,2909
348,NZ_OX366374,1,569446,572367,+,2921
348,NZ_CP090901,1,665727,668636,+,2909
348,NZ_CP046923,1,643689,646598,+,2909
348,NZ_CP069055,1,588493,591402,+,2909
348,NZ_CP072670,1,665567,668476,+,2909
348,NZ_CP090899,1,665727,668636,+,2909
348,NZ_CP046924,1,664627,667536,+,2909
348,NZ_OX366348,1,311592,314502,-,2910
348,NZ_CP046921,1,727441,730350,+,2909
348,NZ_OX366338,1,893486,896341,+,2855
348,NZ_CP054557,1,366394,369303,+,2909
348,NZ_CP072669,1,665575,668484,+,2909
348,NC_021089,1,699471,702380,+,2909
349,NZ_OX366376,1,1086939,1088469,+,1530
349,NZ_OX366393,1,1243899,1245430,+,1531
349,NZ_OX366372,1,861019,862550,-,1531
349,NZ_CP072672,1,671754,673282,+,1528
349,NZ_CP069060,1,513690,515218,+,1528
349,NZ_CP072667,1,671736,673264,+,1528
349,NZ_CP072671,1,671736,673264,+,1528
349,NZ_CP072668,1,671723,673251,+,1528
349,NZ_CP072666,1,671736,673264,+,1528
349,NZ_CP090902,1,671888,673416,+,1528
349,NZ_CP090948,1,671888,673416,+,1528
349,NZ_CP069052,1,1062841,1064369,+,1528
349,NZ_CP076228,1,665392,666920,+,1528
349,NZ_CP042445,1,671876,673404,+,1528
349,NZ_CP042904,1,604118,605642,+,1524
349,NC_012416,1,639774,641297,+,1523
349,NZ_CP069053,1,513698,515226,+,1528
349,NZ_CP042446,1,671888,673416,+,1528
349,NZ_CP041215,1,738269,739797,-,1528
349,NZ_OX366353,1,1155953,1157481,-,1528
349,NZ_OX366387,1,1389710,1391238,+,1528
349,NZ_OX366368,1,1037408,1038936,+,1528
349,NZ_OX366379,1,1035942,1037470,+,1528
349,NZ_CP091195,1,133245,134773,-,1528
349,NZ_OX366375,1,960151,961691,+,1540
349,NZ_CP046925,1,671736,673264,+,1528
349,NZ_OX366318,1,965059,966587,+,1528
349,NZ_OX366319,1,250203,251731,-,1528
349,NZ_OX366332,1,1052551,1054079,+,1528
349,NZ_CP110359,1,533388,534916,-,1528
349,NZ_OU953855,1,914054,915593,+,1539
349,NZ_OX366272,1,1045635,1047163,-,1528
349,NZ_OX366347,1,843859,845378,-,1519
349,NZ_OU909470,1,602731,604262,+,1531
349,NZ_OX366363,1,1272335,1273874,-,1539
349,NZ_OX366364,1,948563,950082,+,1519
349,NZ_OX366359,1,883189,884717,+,1528
349,NZ_OX366349,1,533474,534985,-,1511
349,NZ_OX366380,1,1174325,1175856,+,1531
349,NZ_OX366344,1,993643,995155,+,1512
349,NZ_CP090900,1,671888,673416,+,1528
349,NZ_OX366352,1,1153557,1155085,+,1528
349,NZ_OX366362,1,700255,701767,+,1512
349,NZ_OX366400,1,832659,834187,+,1528
349,NZ_OX366327,1,969713,971241,+,1528
349,NZ_OX366367,1,606229,607748,-,1519
349,NZ_CP042444,1,672425,673953,+,1528
349,NZ_OX366326,1,1093391,1094919,+,1528
349,NZ_CP037426,1,89114,90653,-,1539
349,NZ_OX366339,1,754834,756362,+,1528
349,NZ_OX366355,1,274459,275987,-,1528
349,NZ_CP046922,1,733602,735130,+,1528
349,NZ_OX366370,1,278083,279596,-,1513
349,NZ_OX366385,1,598145,599676,+,1531
349,NZ_OX366399,1,1070675,1072203,+,1528
349,NZ_OX366395,1,636265,637793,+,1528
349,NZ_OX366396,1,609235,610763,-,1528
349,NZ_OX366351,1,1041459,1042987,+,1528
349,NZ_OX366381,1,360226,361754,-,1528
349,NZ_OX366342,1,1396646,1398177,-,1531
349,NZ_OX366369,1,1157712,1159240,+,1528
349,NZ_OX366356,1,874859,876387,+,1528
349,NZ_OX366377,1,1261481,1263019,-,1538
349,NZ_OX366388,1,335419,336947,-,1528
349,NZ_OX366357,1,884018,885546,-,1528
349,NZ_CP072012,1,50071,51599,-,1528
349,NZ_OX366398,1,745448,746986,-,1538
349,NC_002978,6,671888,673416,+,1528
349,NZ_OX366389,1,1074096,1075634,+,1538
349,NZ_OX366397,1,1203716,1205244,+,1528
349,NZ_OX366378,1,718591,720119,-,1528
349,NZ_CP090903,1,671888,673416,+,1528
349,NZ_OX366374,1,576885,578423,+,1538
349,NZ_CP090901,1,671888,673416,+,1528
349,NZ_CP046923,1,649850,651378,+,1528
349,NZ_CP069055,1,671374,672902,+,1528
349,NZ_CP072670,1,671728,673256,+,1528
349,NZ_CP090899,1,671888,673416,+,1528
349,NZ_CP046924,1,670788,672316,+,1528
349,NZ_OX366348,1,309107,310635,-,1528
349,NZ_CP046921,1,733602,735130,+,1528
349,NZ_OX366338,1,897299,898827,+,1528
349,NZ_CP054557,1,371165,372693,+,1528
349,NZ_CP072669,1,671736,673264,+,1528
349,NC_021089,1,703338,704866,+,1528
350,NZ_OX366376,1,1092756,1099669,+,6913
350,NZ_OX366393,1,1249718,1256631,+,6913
350,NZ_OX366372,1,849818,856731,-,6913
350,NZ_CP072672,1,296548,303463,+,6915
350,NZ_CP069060,1,280217,287132,+,6915
350,NZ_CP072667,1,296530,303445,+,6915
350,NZ_CP072671,1,296530,303445,+,6915
350,NZ_CP072668,1,296530,303445,+,6915
350,NZ_CP072666,1,296530,303445,+,6915
350,NZ_CP090902,1,296682,303597,+,6915
350,NZ_CP090948,1,296682,303597,+,6915
350,NZ_CP069052,1,274882,281797,+,6915
350,NZ_CP076228,1,437326,444241,-,6915
350,NZ_CP042445,1,296682,303597,+,6915
350,NZ_CP042904,1,503756,510666,+,6910
350,NC_012416,1,507075,513985,+,6910
350,NZ_CP069053,1,260145,267060,-,6915
350,NZ_CP042446,1,296682,303597,+,6915
350,NZ_CP041215,1,804015,810931,-,6916
350,NZ_OX366353,1,333059,339974,+,6915
350,NZ_OX366387,1,1603521,1610431,-,6910
350,NZ_OX366368,1,646321,653236,+,6915
350,NZ_OX366379,1,891801,898716,-,6915
350,NZ_CP091195,1,246678,253587,-,6909
350,NZ_OX366375,1,714177,721092,-,6915
350,NZ_CP046925,1,296530,303445,+,6915
350,NZ_OX366318,1,845270,852185,-,6915
350,NZ_OX366319,1,396727,403642,+,6915
350,NZ_OX366332,1,980430,987345,+,6915
350,NZ_CP110359,1,877869,884790,-,6921
350,NZ_OU953855,1,1392345,1399260,+,6915
350,NZ_OX366272,1,342447,349323,-,6876
350,NZ_OX366347,1,675688,682603,+,6915
350,NZ_OU909470,1,654602,661503,-,6901
350,NZ_OX366363,1,62098,69008,+,6910
350,NZ_OX366364,1,983833,990749,-,6916
350,NZ_OX366359,1,810974,817889,+,6915
350,NZ_OX366349,1,521858,528755,-,6897
350,NZ_OX366380,1,1182613,1189525,+,6912
350,NZ_OX366344,1,999445,1006355,+,6910
350,NZ_CP090900,1,296682,303597,+,6915
350,NZ_OX366352,1,741454,748369,+,6915
350,NZ_OX366362,1,1179292,1186202,-,6910
350,NZ_OX366400,1,400306,407221,-,6915
350,NZ_OX366327,1,886191,893101,-,6910
350,NZ_OX366367,1,563844,570760,+,6916
350,NZ_CP042444,1,296264,303179,+,6915
350,NZ_OX366326,1,941222,948137,-,6915
350,NZ_CP037426,1,560062,566977,-,6915
350,NZ_OX366339,1,678042,684957,+,6915
350,NZ_OX366355,1,555341,562256,-,6915
350,NZ_CP046922,1,296380,303295,+,6915
350,NZ_OX366370,1,901197,908113,+,6916
350,NZ_OX366385,1,605580,612492,+,6912
350,NZ_OX366399,1,884968,891883,-,6915
350,NZ_OX366395,1,1117925,1124840,+,6915
350,NZ_OX366396,1,146804,153713,-,6909
350,NZ_OX366351,1,948929,955844,-,6915
350,NZ_OX366381,1,555428,562298,+,6870
350,NZ_OX366342,1,1385445,1392358,-,6913
350,NZ_OX366369,1,623565,630480,+,6915
350,NZ_OX366356,1,535633,542548,+,6915
350,NZ_OX366377,1,456573,463488,-,6915
350,NZ_OX366388,1,519573,526488,-,6915
350,NZ_OX366357,1,991339,998260,+,6921
350,NZ_CP072012,1,232000,238915,+,6915
350,NZ_OX366398,1,48553,55468,+,6915
350,NC_002978,6,296682,303597,+,6915
350,NZ_OX366389,1,952027,958942,-,6915
350,NZ_OX366397,1,1061910,1068825,+,6915
350,NZ_OX366378,1,646473,653382,-,6909
350,NZ_CP090903,1,296682,303597,+,6915
350,NZ_OX366374,1,941421,948336,-,6915
350,NZ_CP090901,1,296682,303597,+,6915
350,NZ_CP046923,1,296380,303295,+,6915
350,NZ_CP069055,1,328426,335341,+,6915
350,NZ_CP072670,1,296522,303437,+,6915
350,NZ_CP090899,1,296682,303597,+,6915
350,NZ_CP046924,1,296380,303295,+,6915
350,NZ_OX366348,1,411283,418186,+,6903
350,NZ_CP046921,1,296380,303295,+,6915
350,NZ_OX366338,1,799108,806018,+,6910
350,NZ_CP054557,1,225137,232040,-,6903
350,NZ_CP072669,1,296530,303445,+,6915
350,NC_021089,1,629448,636363,+,6915
351,NZ_OX366376,1,1101840,1102807,+,967
351,NZ_OX366393,1,1078074,1079037,-,963
351,NZ_OX366372,1,271419,272386,+,967
351,NZ_CP072672,1,304287,305256,+,969
351,NZ_CP069060,1,287956,288925,+,969
351,NZ_CP072667,1,304269,305238,+,969
351,NZ_CP072671,1,304269,305238,+,969
351,NZ_CP072668,1,304269,305238,+,969
351,NZ_CP072666,1,304269,305238,+,969
351,NZ_CP090902,1,304421,305390,+,969
351,NZ_CP090948,1,304421,305390,+,969
351,NZ_CP069052,1,282621,283590,+,969
351,NZ_CP076228,1,435532,436502,-,970
351,NZ_CP042445,1,304421,305390,+,969
351,NZ_CP042904,1,511490,512459,+,969
351,NC_012416,1,514809,515778,+,969
351,NZ_CP069053,1,258351,259321,-,970
351,NZ_CP042446,1,304421,305390,+,969
351,NZ_CP041215,1,802221,803191,-,970
351,NZ_OX366353,1,340798,341767,+,969
351,NZ_OX366387,1,1601727,1602697,-,970
351,NZ_OX366368,1,654060,655029,+,969
351,NZ_OX366379,1,890007,890977,-,970
351,NZ_CP091195,1,244884,245854,-,970
351,NZ_OX366375,1,712383,713353,-,970
351,NZ_CP046925,1,304269,305238,+,969
351,NZ_OX366318,1,843476,844446,-,970
351,NZ_OX366319,1,404466,405435,+,969
351,NZ_OX366332,1,988169,989138,+,969
351,NZ_CP110359,1,876075,877045,-,970
351,NZ_OU953855,1,1523865,1524834,+,969
351,NZ_OX366272,1,340653,341623,-,970
351,NZ_OX366347,1,683427,684396,+,969
351,NZ_OU909470,1,652808,653778,-,970
351,NZ_OX366363,1,69832,70801,+,969
351,NZ_OX366364,1,982039,983009,-,970
351,NZ_OX366359,1,818713,819682,+,969
351,NZ_OX366349,1,520064,521034,-,970
351,NZ_OX366380,1,1190349,1191318,+,969
351,NZ_OX366344,1,1007179,1008148,+,969
351,NZ_CP090900,1,304421,305390,+,969
351,NZ_OX366352,1,749193,750162,+,969
351,NZ_OX366362,1,1177498,1178468,-,970
351,NZ_OX366400,1,398512,399482,-,970
351,NZ_OX366327,1,884397,885367,-,970
351,NZ_OX366367,1,571584,572553,+,969
351,NZ_CP042444,1,304003,304972,+,969
351,NZ_OX366326,1,939428,940398,-,970
351,NZ_CP037426,1,558268,559238,-,970
351,NZ_OX366339,1,685781,686750,+,969
351,NZ_OX366355,1,553547,554517,-,970
351,NZ_CP046922,1,304119,305088,+,969
351,NZ_OX366370,1,908937,909906,+,969
351,NZ_OX366385,1,613316,614285,+,969
351,NZ_OX366399,1,883174,884141,-,967
351,NZ_OX366395,1,1125664,1126633,+,969
351,NZ_OX366396,1,145010,145980,-,970
351,NZ_OX366351,1,947135,948105,-,970
351,NZ_OX366381,1,564786,565755,+,969
351,NZ_OX366342,1,1144429,1145396,+,967
351,NZ_OX366369,1,631304,632273,+,969
351,NZ_OX366356,1,543372,544341,+,969
351,NZ_OX366377,1,454779,455749,-,970
351,NZ_OX366388,1,517779,518749,-,970
351,NZ_OX366357,1,999084,1000053,+,969
351,NZ_CP072012,1,239739,240708,+,969
351,NZ_OX366398,1,56292,57261,+,969
351,NC_002978,6,304421,305390,+,969
351,NZ_OX366389,1,950233,951203,-,970
351,NZ_OX366397,1,1069649,1070618,+,969
351,NZ_OX366378,1,644679,645649,-,970
351,NZ_CP090903,1,304421,305390,+,969
351,NZ_OX366374,1,937778,938767,-,989
351,NZ_CP090901,1,304421,305390,+,969
351,NZ_CP046923,1,304119,305088,+,969
351,NZ_CP069055,1,336165,337134,+,969
351,NZ_CP072670,1,304261,305230,+,969
351,NZ_CP090899,1,304421,305390,+,969
351,NZ_CP046924,1,304119,305088,+,969
351,NZ_OX366348,1,419010,419979,+,969
351,NZ_CP046921,1,304119,305088,+,969
351,NZ_OX366338,1,806842,807811,+,969
351,NZ_CP054557,1,223343,224313,-,970
351,NZ_CP072669,1,304269,305238,+,969
351,NC_021089,1,637187,638156,+,969
352,NZ_OX366376,1,1102937,1103847,+,910
352,NZ_OX366393,1,1077035,1077944,-,909
352,NZ_OX366372,1,272516,273426,+,910
352,NZ_CP072672,1,305382,306284,+,902
352,NZ_CP069060,1,289051,289953,+,902
352,NZ_CP072667,1,305364,306266,+,902
352,NZ_CP072671,1,305364,306266,+,902
352,NZ_CP072668,1,305364,306266,+,902
352,NZ_CP072666,1,305364,306266,+,902
352,NZ_CP090902,1,305516,306418,+,902
352,NZ_CP090948,1,305516,306418,+,902
352,NZ_CP069052,1,283716,284618,+,902
352,NZ_CP076228,1,434505,435406,-,901
352,NZ_CP042445,1,305516,306418,+,902
352,NZ_CP042904,1,512585,513487,+,902
352,NC_012416,1,515904,516806,+,902
352,NZ_CP069053,1,257324,258225,-,901
352,NZ_CP042446,1,305516,306418,+,902
352,NZ_CP041215,1,801194,802095,-,901
352,NZ_OX366353,1,341893,342795,+,902
352,NZ_OX366387,1,1600700,1601601,-,901
352,NZ_OX366368,1,655155,656057,+,902
352,NZ_OX366379,1,888980,889881,-,901
352,NZ_CP091195,1,243857,244758,-,901
352,NZ_OX366375,1,711356,712257,-,901
352,NZ_CP046925,1,305364,306266,+,902
352,NZ_OX366318,1,842449,843350,-,901
352,NZ_OX366319,1,405561,406463,+,902
352,NZ_OX366332,1,989264,990166,+,902
352,NZ_CP110359,1,875048,875949,-,901
352,NZ_OU953855,1,1524960,1525862,+,902
352,NZ_OX366272,1,339626,340527,-,901
352,NZ_OX366347,1,684522,685424,+,902
352,NZ_OU909470,1,651781,652682,-,901
352,NZ_OX366363,1,70927,71829,+,902
352,NZ_OX366364,1,981001,981914,-,913
352,NZ_OX366359,1,819808,820710,+,902
352,NZ_OX366349,1,519029,519938,-,909
352,NZ_OX366380,1,1192349,1193267,+,918
352,NZ_OX366344,1,1008274,1009184,+,910
352,NZ_CP090900,1,305516,306418,+,902
352,NZ_OX366352,1,750288,751190,+,902
352,NZ_OX366362,1,1176471,1177372,-,901
352,NZ_OX366400,1,397485,398386,-,901
352,NZ_OX366327,1,883370,884271,-,901
352,NZ_OX366367,1,572678,573592,+,914
352,NZ_CP042444,1,305098,306000,+,902
352,NZ_OX366326,1,938401,939302,-,901
352,NZ_CP037426,1,557241,558142,-,901
352,NZ_OX366339,1,686876,687778,+,902
352,NZ_OX366355,1,552520,553421,-,901
352,NZ_CP046922,1,305214,306116,+,902
352,NZ_OX366370,1,910036,910942,+,906
352,NZ_OX366385,1,614411,615313,+,902
352,NZ_OX366399,1,882147,883048,-,901
352,NZ_OX366395,1,1126759,1127658,+,899
352,NZ_OX366396,1,143983,144884,-,901
352,NZ_OX366351,1,946108,947009,-,901
352,NZ_OX366381,1,565881,566783,+,902
352,NZ_OX366342,1,1145526,1146436,+,910
352,NZ_OX366369,1,632399,633301,+,902
352,NZ_OX366356,1,544467,545369,+,902
352,NZ_OX366377,1,453752,454653,-,901
352,NZ_OX366388,1,516752,517653,-,901
352,NZ_OX366357,1,1000179,1001078,+,899
352,NZ_CP072012,1,240834,241736,+,902
352,NZ_OX366398,1,57387,58289,+,902
352,NC_002978,6,305516,306418,+,902
352,NZ_OX366389,1,949206,950107,-,901
352,NZ_OX366397,1,1070744,1071646,+,902
352,NZ_OX366378,1,643652,644553,-,901
352,NZ_CP090903,1,305516,306418,+,902
352,NZ_OX366374,1,935917,936818,-,901
352,NZ_CP090901,1,305516,306418,+,902
352,NZ_CP046923,1,305214,306116,+,902
352,NZ_CP069055,1,337260,338162,+,902
352,NZ_CP072670,1,305356,306258,+,902
352,NZ_CP090899,1,305516,306418,+,902
352,NZ_CP046924,1,305214,306116,+,902
352,NZ_OX366348,1,420105,421007,+,902
352,NZ_CP046921,1,305214,306116,+,902
352,NZ_OX366338,1,807937,808782,+,845
352,NZ_CP054557,1,222316,223217,-,901
352,NZ_CP072669,1,305364,306266,+,902
352,NC_021089,1,638282,639184,+,902
353,NZ_OX366376,1,1103848,1104730,+,882
353,NZ_OX366393,1,1076152,1077033,-,881
353,NZ_OX366372,1,273427,274309,+,882
353,NZ_CP072672,1,306285,307167,+,882
353,NZ_CP069060,1,289954,290830,+,876
353,NZ_CP072667,1,306267,307149,+,882
353,NZ_CP072671,1,306267,307149,+,882
353,NZ_CP072668,1,306267,307149,+,882
353,NZ_CP072666,1,306267,307149,+,882
353,NZ_CP090902,1,306419,307301,+,882
353,NZ_CP090948,1,306419,307301,+,882
353,NZ_CP069052,1,284619,285495,+,876
353,NZ_CP076228,1,433622,434503,-,881
353,NZ_CP042445,1,306419,307301,+,882
353,NZ_CP042904,1,513488,514370,+,882
353,NC_012416,1,516807,517689,+,882
353,NZ_CP069053,1,256447,257322,-,875
353,NZ_CP042446,1,306419,307301,+,882
353,NZ_CP041215,1,800311,801192,-,881
353,NZ_OX366353,1,342796,343678,+,882
353,NZ_OX366387,1,1599817,1600698,-,881
353,NZ_OX366368,1,656058,656940,+,882
353,NZ_OX366379,1,888097,888978,-,881
353,NZ_CP091195,1,242974,243855,-,881
353,NZ_OX366375,1,710473,711354,-,881
353,NZ_CP046925,1,306267,307149,+,882
353,NZ_OX366318,1,841566,842447,-,881
353,NZ_OX366319,1,406464,407346,+,882
353,NZ_OX366332,1,990167,991049,+,882
353,NZ_CP110359,1,874165,875046,-,881
353,NZ_OU953855,1,1525863,1526745,+,882
353,NZ_OX366272,1,338743,339624,-,881
353,NZ_OX366347,1,685425,686307,+,882
353,NZ_OU909470,1,650898,651779,-,881
353,NZ_OX366363,1,71830,72712,+,882
353,NZ_OX366364,1,980124,980999,-,875
353,NZ_OX366359,1,820711,821593,+,882
353,NZ_OX366349,1,518149,519027,-,878
353,NZ_OX366380,1,1193268,1194150,+,882
353,NZ_OX366344,1,1009185,1010064,+,879
353,NZ_CP090900,1,306419,307301,+,882
353,NZ_OX366352,1,751191,752073,+,882
353,NZ_OX366362,1,1175588,1176469,-,881
353,NZ_OX366400,1,396602,397483,-,881
353,NZ_OX366327,1,882487,883368,-,881
353,NZ_OX366367,1,573593,574475,+,882
353,NZ_CP042444,1,306001,306883,+,882
353,NZ_OX366326,1,937518,938399,-,881
353,NZ_CP037426,1,556358,557239,-,881
353,NZ_OX366339,1,687779,688661,+,882
353,NZ_OX366355,1,551637,552518,-,881
353,NZ_CP046922,1,306117,306999,+,882
353,NZ_OX366370,1,910943,911825,+,882
353,NZ_OX366385,1,615314,616196,+,882
353,NZ_OX366399,1,881264,882145,-,881
353,NZ_OX366395,1,1127659,1128541,+,882
353,NZ_OX366396,1,143100,143981,-,881
353,NZ_OX366351,1,945225,946106,-,881
353,NZ_OX366381,1,566784,567666,+,882
353,NZ_OX366342,1,1146437,1147319,+,882
353,NZ_OX366369,1,633302,634184,+,882
353,NZ_OX366356,1,545370,546252,+,882
353,NZ_OX366377,1,451662,452537,-,875
353,NZ_OX366388,1,515869,516750,-,881
353,NZ_OX366357,1,1001079,1001961,+,882
353,NZ_CP072012,1,241737,242619,+,882
353,NZ_OX366398,1,58290,59172,+,882
353,NC_002978,6,306419,307301,+,882
353,NZ_OX366389,1,948323,949204,-,881
353,NZ_OX366397,1,1071647,1072529,+,882
353,NZ_OX366378,1,642769,643650,-,881
353,NZ_CP090903,1,306419,307301,+,882
353,NZ_OX366374,1,935034,935915,-,881
353,NZ_CP090901,1,306419,307301,+,882
353,NZ_CP046923,1,306117,306999,+,882
353,NZ_CP069055,1,338163,339045,+,882
353,NZ_CP072670,1,306259,307141,+,882
353,NZ_CP090899,1,306419,307301,+,882
353,NZ_CP046924,1,306117,306999,+,882
353,NZ_OX366348,1,421008,421890,+,882
353,NZ_CP046921,1,306117,306999,+,882
353,NZ_CP054557,1,221433,222314,-,881
353,NZ_CP072669,1,306267,307149,+,882
353,NC_021089,1,639185,640067,+,882
354,NZ_OX366376,1,1105621,1108143,+,2522
354,NZ_OX366393,1,1123153,1125675,+,2522
354,NZ_OX366372,1,275200,277722,+,2522
354,NZ_CP072672,1,103306,105822,-,2516
354,NZ_CP069060,1,113536,116052,-,2516
354,NZ_CP072667,1,103288,105804,-,2516
354,NZ_CP072671,1,103288,105804,-,2516
354,NZ_CP072668,1,103288,105804,-,2516
354,NZ_CP072666,1,103288,105804,-,2516
354,NZ_CP090902,1,103440,105956,-,2516
354,NZ_CP090948,1,103440,105956,-,2516
354,NZ_CP069052,1,124078,126595,+,2517
354,NZ_CP076228,1,107076,109592,-,2516
354,NZ_CP042445,1,103440,105956,-,2516
354,NZ_CP042904,1,137760,140277,+,2517
354,NC_012416,1,140342,142859,+,2517
354,NZ_CP069053,1,431224,433741,+,2517
354,NZ_CP042446,1,103440,105956,-,2516
354,NZ_CP041215,1,491480,493997,+,2517
354,NZ_OX366353,1,1052989,1055506,+,2517
354,NZ_OX366387,1,655158,657686,+,2528
354,NZ_OX366368,1,384559,387075,-,2516
354,NZ_OX366379,1,385577,388093,-,2516
354,NZ_CP091195,1,1217821,1220349,+,2528
354,NZ_OX366375,1,339258,341775,+,2517
354,NZ_CP046925,1,103288,105804,-,2516
354,NZ_OX366318,1,513877,516394,+,2517
354,NZ_OX366319,1,745626,748142,-,2516
354,NZ_OX366332,1,413235,415752,+,2517
354,NZ_CP110359,1,1104042,1106570,-,2528
354,NZ_OU953855,1,1013808,1016333,-,2525
354,NZ_OX366272,1,577663,580191,+,2528
354,NZ_OX366347,1,526949,529477,+,2528
354,NZ_OU909470,1,647462,649990,-,2528
354,NZ_OX366363,1,502753,505281,-,2528
354,NZ_OX366364,1,975702,978230,-,2528
354,NZ_OX366359,1,365422,367938,-,2516
354,NZ_OX366349,1,513301,515823,-,2522
354,NZ_OX366380,1,1234708,1237236,-,2528
354,NZ_OX366344,1,1010844,1013366,+,2522
354,NZ_CP090900,1,103440,105956,-,2516
354,NZ_OX366352,1,372733,375250,+,2517
354,NZ_OX366362,1,1301644,1304172,+,2528
354,NZ_OX366400,1,744134,746650,-,2516
354,NZ_OX366327,1,563334,565851,+,2517
354,NZ_OX366367,1,575375,577903,+,2528
354,NZ_CP042444,1,103441,105957,-,2516
354,NZ_OX366326,1,376914,379430,-,2516
354,NZ_CP037426,1,66737,69253,-,2516
354,NZ_OX366339,1,227023,229540,+,2517
354,NZ_OX366355,1,890901,893417,-,2516
354,NZ_CP046922,1,103133,105649,-,2516
354,NZ_OX366370,1,912355,914883,+,2528
354,NZ_OX366385,1,1326862,1329390,-,2528
354,NZ_OX366399,1,384061,386577,-,2516
354,NZ_OX366395,1,1142186,1144714,-,2528
354,NZ_OX366396,1,1238400,1240917,+,2517
354,NZ_OX366351,1,428429,430946,+,2517
354,NZ_OX366381,1,1051390,1053906,-,2516
354,NZ_OX366342,1,1171268,1173790,+,2522
354,NZ_OX366369,1,412870,415387,+,2517
354,NZ_OX366356,1,436098,438615,+,2517
354,NZ_OX366377,1,517157,519674,+,2517
354,NZ_OX366388,1,1342617,1345145,+,2528
354,NZ_OX366357,1,451662,454190,+,2528
354,NZ_CP072012,1,1328312,1330828,-,2516
354,NZ_OX366398,1,1040790,1043306,-,2516
354,NC_002978,6,103440,105956,-,2516
354,NZ_OX366389,1,548824,551340,-,2516
354,NZ_OX366397,1,437613,440129,-,2516
354,NZ_OX366378,1,875203,877731,-,2528
354,NZ_CP090903,1,103440,105956,-,2516
354,NZ_OX366374,1,1027452,1029969,+,2517
354,NZ_CP090901,1,103440,105956,-,2516
354,NZ_CP046923,1,103133,105649,-,2516
354,NZ_CP069055,1,120208,122725,+,2517
354,NZ_CP072670,1,103288,105804,-,2516
354,NZ_CP090899,1,103440,105956,-,2516
354,NZ_CP046924,1,103133,105649,-,2516
354,NZ_OX366348,1,838011,840527,-,2516
354,NZ_CP046921,1,103133,105649,-,2516
354,NZ_OX366338,1,476460,478988,-,2528
354,NZ_CP054557,1,1137103,1139620,+,2517
354,NZ_CP072669,1,103288,105804,-,2516
354,NC_021089,1,132719,135236,+,2517
355,NZ_OX366376,1,1108527,1111227,+,2700
355,NZ_OX366393,1,1126059,1128759,+,2700
355,NZ_OX366372,1,278106,280799,+,2693
355,NZ_CP072672,1,99886,102579,-,2693
355,NZ_CP069060,1,110116,112809,-,2693
355,NZ_CP072667,1,99868,102561,-,2693
355,NZ_CP072671,1,99868,102561,-,2693
355,NZ_CP072668,1,99868,102561,-,2693
355,NZ_CP072666,1,99868,102561,-,2693
355,NZ_CP090902,1,100020,102713,-,2693
355,NZ_CP090948,1,100020,102713,-,2693
355,NZ_CP069052,1,127322,130015,+,2693
355,NZ_CP076228,1,103656,106349,-,2693
355,NZ_CP042445,1,100020,102713,-,2693
355,NZ_CP042904,1,140412,143112,+,2700
355,NC_012416,1,142994,145694,+,2700
355,NZ_CP069053,1,434468,437161,+,2693
355,NZ_CP042446,1,100020,102713,-,2693
355,NZ_CP041215,1,494132,496825,+,2693
355,NZ_OX366353,1,1055641,1058335,+,2694
355,NZ_OX366387,1,658413,661113,+,2700
355,NZ_OX366368,1,381139,383832,-,2693
355,NZ_OX366379,1,382157,384850,-,2693
355,NZ_CP091195,1,1220476,1223169,+,2693
355,NZ_OX366375,1,342502,345195,+,2693
355,NZ_CP046925,1,99868,102561,-,2693
355,NZ_OX366318,1,517121,519809,+,2688
355,NZ_OX366319,1,742206,744899,-,2693
355,NZ_OX366332,1,415887,418580,+,2693
355,NZ_CP110359,1,1099779,1102465,-,2686
355,NZ_OU953855,1,1010723,1013416,-,2693
355,NZ_OX366272,1,581774,584467,+,2693
355,NZ_OX366347,1,529612,532305,+,2693
355,NZ_OU909470,1,644627,647327,-,2700
355,NZ_OX366363,1,499668,502361,-,2693
355,NZ_OX366364,1,972404,975105,-,2701
355,NZ_OX366359,1,362594,365287,-,2693
355,NZ_OX366349,1,510466,513166,-,2700
355,NZ_OX366380,1,1231883,1234582,-,2699
355,NZ_OX366344,1,1013751,1016451,+,2700
355,NZ_CP090900,1,100020,102713,-,2693
355,NZ_OX366352,1,375385,378078,+,2693
355,NZ_OX366362,1,1304571,1307258,+,2687
355,NZ_OX366400,1,740719,743407,-,2688
355,NZ_OX366327,1,565986,568679,+,2693
355,NZ_OX366367,1,578604,581305,+,2701
355,NZ_CP042444,1,100021,102714,-,2693
355,NZ_OX366326,1,373499,376187,-,2688
355,NZ_CP037426,1,63317,66010,-,2693
355,NZ_OX366339,1,230267,232967,+,2700
355,NZ_OX366355,1,886501,889194,-,2693
355,NZ_CP046922,1,99713,102406,-,2693
355,NZ_OX366370,1,915018,917718,+,2700
355,NZ_OX366385,1,1324036,1326735,-,2699
355,NZ_OX366399,1,380641,383334,-,2693
355,NZ_OX366395,1,1139358,1142042,-,2684
355,NZ_OX366396,1,1100569,1103269,+,2700
355,NZ_OX366351,1,431673,434361,+,2688
355,NZ_OX366381,1,1047970,1050663,-,2693
355,NZ_OX366342,1,1174174,1176859,+,2685
355,NZ_OX366369,1,416114,418807,+,2693
355,NZ_OX366356,1,439004,441704,+,2700
355,NZ_OX366377,1,520401,523094,+,2693
355,NZ_OX366388,1,1345272,1347965,+,2693
355,NZ_OX366357,1,1104495,1107188,-,2693
355,NZ_CP072012,1,1324892,1327585,-,2693
355,NZ_OX366398,1,1037370,1040063,-,2693
355,NC_002978,6,100020,102713,-,2693
355,NZ_OX366389,1,545404,548097,-,2693
355,NZ_OX366397,1,434785,437478,-,2693
355,NZ_OX366378,1,872383,875076,-,2693
355,NZ_CP090903,1,100020,102713,-,2693
355,NZ_OX366374,1,1030360,1033053,+,2693
355,NZ_CP090901,1,100020,102713,-,2693
355,NZ_CP046923,1,99713,102406,-,2693
355,NZ_CP069055,1,123453,126146,+,2693
355,NZ_CP072670,1,99868,102561,-,2693
355,NZ_CP090899,1,100020,102713,-,2693
355,NZ_CP046924,1,99713,102406,-,2693
355,NZ_OX366348,1,834591,837284,-,2693
355,NZ_CP046921,1,99713,102406,-,2693
355,NZ_OX366338,1,473368,476061,-,2693
355,NZ_CP054557,1,1140347,1143040,+,2693
355,NZ_CP072669,1,99868,102561,-,2693
355,NC_021089,1,135371,138064,+,2693
356,NZ_OX366376,1,1111239,1113852,+,2613
356,NZ_OX366393,1,1128771,1131384,+,2613
356,NZ_OX366372,1,280811,283424,+,2613
356,NZ_CP072672,1,97253,99883,-,2630
356,NZ_CP069060,1,107483,110113,-,2630
356,NZ_CP072667,1,97235,99865,-,2630
356,NZ_CP072671,1,97235,99865,-,2630
356,NZ_CP072668,1,97235,99865,-,2630
356,NZ_CP072666,1,97235,99865,-,2630
356,NZ_CP090902,1,97387,100017,-,2630
356,NZ_CP090948,1,97387,100017,-,2630
356,NZ_CP069052,1,130018,132648,+,2630
356,NZ_CP076228,1,101023,103653,-,2630
356,NZ_CP042445,1,97387,100017,-,2630
356,NZ_CP042904,1,143115,145754,+,2639
356,NC_012416,1,145697,148336,+,2639
356,NZ_CP069053,1,437164,439794,+,2630
356,NZ_CP042446,1,97387,100017,-,2630
356,NZ_CP041215,1,496828,499458,+,2630
356,NZ_OX366353,1,1058338,1060968,+,2630
356,NZ_OX366387,1,661116,663755,+,2639
356,NZ_OX366368,1,378506,381136,-,2630
356,NZ_OX366379,1,379524,382154,-,2630
356,NZ_CP091195,1,1223181,1225802,+,2621
356,NZ_OX366375,1,345198,347837,+,2639
356,NZ_CP046925,1,97235,99865,-,2630
356,NZ_OX366318,1,519812,522442,+,2630
356,NZ_OX366319,1,739564,742203,-,2639
356,NZ_OX366332,1,418583,421213,+,2630
356,NZ_CP110359,1,1097146,1099776,-,2630
356,NZ_OU953855,1,1008090,1010720,-,2630
356,NZ_OX366272,1,584470,587100,+,2630
356,NZ_OX366347,1,532308,534938,+,2630
356,NZ_OU909470,1,641708,644322,-,2614
356,NZ_OX366363,1,497026,499665,-,2639
356,NZ_OX366364,1,969779,972401,-,2622
356,NZ_OX366359,1,359961,362591,-,2630
356,NZ_OX366349,1,25550,28183,+,2633
356,NZ_OX366380,1,1228964,1231578,-,2614
356,NZ_OX366344,1,1016463,1019085,+,2622
356,NZ_CP090900,1,97387,100017,-,2630
356,NZ_OX366352,1,378081,380711,+,2630
356,NZ_OX366362,1,1307861,1310468,+,2607
356,NZ_OX366400,1,738086,740716,-,2630
356,NZ_OX366327,1,568682,571321,+,2639
356,NZ_OX366367,1,581911,584516,+,2605
356,NZ_CP042444,1,97388,100018,-,2630
356,NZ_OX366326,1,370866,373496,-,2630
356,NZ_CP037426,1,60675,63314,-,2639
356,NZ_OX366339,1,232979,235600,+,2621
356,NZ_OX366355,1,883859,886498,-,2639
356,NZ_CP046922,1,97080,99710,-,2630
356,NZ_OX366370,1,917730,920356,+,2626
356,NZ_OX366385,1,1321117,1323731,-,2614
356,NZ_OX366399,1,378008,380638,-,2630
356,NZ_OX366395,1,1136157,1138755,-,2598
356,NZ_OX366396,1,1103281,1105902,+,2621
356,NZ_OX366351,1,434364,436994,+,2630
356,NZ_OX366381,1,1045328,1047967,-,2639
356,NZ_OX366342,1,1176871,1179484,+,2613
356,NZ_OX366369,1,418810,421449,+,2639
356,NZ_OX366356,1,441707,444346,+,2639
356,NZ_OX366377,1,523097,525727,+,2630
356,NZ_OX366388,1,1347977,1350598,+,2621
356,NZ_OX366357,1,1101560,1104158,-,2598
356,NZ_CP072012,1,1322259,1324889,-,2630
356,NZ_OX366398,1,1034737,1037367,-,2630
356,NC_002978,6,97387,100017,-,2630
356,NZ_OX366389,1,542771,545401,-,2630
356,NZ_OX366397,1,432152,434782,-,2630
356,NZ_OX366378,1,869750,872371,-,2621
356,NZ_CP090903,1,97387,100017,-,2630
356,NZ_OX366374,1,1033656,1036279,+,2623
356,NZ_CP090901,1,97387,100017,-,2630
356,NZ_CP046923,1,97080,99710,-,2630
356,NZ_CP069055,1,126149,128779,+,2630
356,NZ_CP072670,1,97235,99865,-,2630
356,NZ_CP090899,1,97387,100017,-,2630
356,NZ_CP046924,1,97080,99710,-,2630
356,NZ_OX366348,1,831958,834588,-,2630
356,NZ_CP046921,1,97080,99710,-,2630
356,NZ_OX366338,1,469398,472021,-,2623
356,NZ_CP054557,1,1143043,1145673,+,2630
356,NZ_CP072669,1,97235,99865,-,2630
356,NC_021089,1,138067,140697,+,2630
357,NZ_OX366376,1,1113888,1117138,+,3250
357,NZ_OX366393,1,1131420,1134670,+,3250
357,NZ_OX366372,1,283460,286710,+,3250
357,NZ_CP072672,1,93966,97217,-,3251
357,NZ_CP069060,1,104196,107447,-,3251
357,NZ_CP072667,1,93948,97199,-,3251
357,NZ_CP072671,1,93948,97199,-,3251
357,NZ_CP072668,1,93948,97199,-,3251
357,NZ_CP072666,1,93948,97199,-,3251
357,NZ_CP090902,1,94100,97351,-,3251
357,NZ_CP090948,1,94100,97351,-,3251
357,NZ_CP069052,1,132684,135935,+,3251
357,NZ_CP076228,1,97736,100987,-,3251
357,NZ_CP042445,1,94100,97351,-,3251
357,NZ_CP042904,1,145790,149041,+,3251
357,NC_012416,1,148372,151623,+,3251
357,NZ_CP069053,1,439830,443081,+,3251
357,NZ_CP042446,1,94100,97351,-,3251
357,NZ_CP041215,1,499494,502745,+,3251
357,NZ_OX366353,1,1061004,1064255,+,3251
357,NZ_OX366387,1,663791,667042,+,3251
357,NZ_OX366368,1,375219,378469,-,3250
357,NZ_OX366379,1,376237,379487,-,3250
357,NZ_CP091195,1,1225838,1229089,+,3251
357,NZ_OX366375,1,347873,351124,+,3251
357,NZ_CP046925,1,93948,97199,-,3251
357,NZ_OX366318,1,522478,525729,+,3251
357,NZ_OX366319,1,736277,739528,-,3251
357,NZ_OX366332,1,421249,424500,+,3251
357,NZ_CP110359,1,1093859,1097110,-,3251
357,NZ_OU953855,1,1004803,1008054,-,3251
357,NZ_OX366272,1,587136,590387,+,3251
357,NZ_OX366347,1,534974,538329,+,3355
357,NZ_OU909470,1,638421,641672,-,3251
357,NZ_OX366363,1,493739,496990,-,3251
357,NZ_OX366364,1,966493,969743,-,3250
357,NZ_OX366359,1,356674,359925,-,3251
357,NZ_OX366349,1,28219,31469,+,3250
357,NZ_OX366380,1,1225677,1228928,-,3251
357,NZ_OX366344,1,1019124,1022371,+,3247
357,NZ_CP090900,1,94100,97351,-,3251
357,NZ_OX366352,1,380747,383998,+,3251
357,NZ_OX366362,1,1312433,1315658,+,3225
357,NZ_OX366400,1,734799,738050,-,3251
357,NZ_OX366327,1,571357,574608,+,3251
357,NZ_OX366367,1,584559,587815,+,3256
357,NZ_CP042444,1,94101,97352,-,3251
357,NZ_OX366326,1,367579,370830,-,3251
357,NZ_CP037426,1,57388,60639,-,3251
357,NZ_OX366339,1,235636,238887,+,3251
357,NZ_OX366355,1,880572,883823,-,3251
357,NZ_CP046922,1,93793,97044,-,3251
357,NZ_OX366370,1,920395,923647,+,3252
357,NZ_OX366385,1,1317830,1321081,-,3251
357,NZ_OX366399,1,374721,377972,-,3251
357,NZ_OX366395,1,1131140,1134391,-,3251
357,NZ_OX366396,1,1105938,1109189,+,3251
357,NZ_OX366351,1,437030,440281,+,3251
357,NZ_OX366381,1,1042041,1045292,-,3251
357,NZ_OX366342,1,1179520,1182770,+,3250
357,NZ_OX366369,1,421485,424736,+,3251
357,NZ_OX366356,1,444382,447633,+,3251
357,NZ_OX366377,1,525763,529014,+,3251
357,NZ_OX366388,1,1350634,1353885,+,3251
357,NZ_OX366357,1,1096552,1099792,-,3240
357,NZ_CP072012,1,1318972,1322223,-,3251
357,NZ_OX366398,1,1031450,1034701,-,3251
357,NC_002978,6,94100,97351,-,3251
357,NZ_OX366389,1,539481,542735,-,3254
357,NZ_OX366397,1,428865,432116,-,3251
357,NZ_OX366378,1,866463,869714,-,3251
357,NZ_CP090903,1,94100,97351,-,3251
357,NZ_OX366374,1,1036315,1039549,+,3234
357,NZ_CP090901,1,94100,97351,-,3251
357,NZ_CP046923,1,93793,97044,-,3251
357,NZ_CP069055,1,128815,132066,+,3251
357,NZ_CP072670,1,93948,97199,-,3251
357,NZ_CP090899,1,94100,97351,-,3251
357,NZ_CP046924,1,93793,97044,-,3251
357,NZ_OX366348,1,828671,831922,-,3251
357,NZ_CP046921,1,93793,97044,-,3251
357,NZ_OX366338,1,466111,469356,-,3245
357,NZ_CP054557,1,1145709,1148960,+,3251
357,NZ_CP072669,1,93948,97199,-,3251
357,NC_021089,1,140733,143984,+,3251
358,NZ_OX366376,1,1136335,1137027,+,692
358,NZ_OX366393,1,387038,387740,+,702
358,NZ_OX366342,1,909928,910632,-,704
359,NZ_OX366376,1,1137796,1138338,+,542
359,NZ_OX366393,1,388509,389051,+,542
359,NZ_OX366342,1,908618,909159,-,541
360,NZ_OX366376,1,1152298,1152850,+,552
360,NZ_OX366372,1,242715,243267,-,552
360,NZ_OX366349,1,1532758,1533310,+,552
360,NZ_OX366380,1,1077321,1077880,+,559
360,NZ_OX366342,1,894119,894671,-,552
360,NZ_OX366357,1,829924,830483,+,559
361,NZ_OX366376,1,1152851,1153558,+,707
361,NZ_OX366372,1,242006,242713,-,707
361,NZ_OX366349,1,1533311,1534018,+,707
361,NZ_OX366342,1,893410,894117,-,707
362,NZ_OX366376,1,1154104,1155010,+,906
362,NZ_OX366372,1,240555,241461,-,906
362,NZ_OX366349,1,1534564,1535470,+,906
362,NZ_OX366380,1,1079142,1080048,+,906
362,NZ_OX366342,1,891959,892865,-,906
362,NZ_OX366357,1,831712,832615,+,903
363,NZ_OX366376,1,1155011,1155709,+,698
363,NZ_OX366372,1,239856,240553,-,697
363,NZ_OX366349,1,1535471,1536174,+,703
363,NZ_OX366342,1,891255,891957,-,702
364,NZ_OX366376,1,1176055,1178213,+,2158
364,NZ_OX366393,1,806475,808632,-,2157
364,NZ_OU909470,1,1349350,1351508,-,2158
365,NZ_OX366376,1,1179262,1181076,+,1814
365,NZ_OX366393,1,803611,805425,-,1814
366,NZ_OX366376,1,1187611,1188992,+,1381
366,NZ_OX366393,1,1082752,1084133,+,1381
366,NZ_OX366372,1,8784,10165,+,1381
366,NZ_CP072672,1,995755,997150,+,1395
366,NZ_CP069060,1,840563,841958,+,1395
366,NZ_CP072667,1,995729,997124,+,1395
366,NZ_CP072671,1,995737,997132,+,1395
366,NZ_CP072668,1,995724,997119,+,1395
366,NZ_CP072666,1,995737,997132,+,1395
366,NZ_CP090902,1,995889,997284,+,1395
366,NZ_CP090948,1,995889,997284,+,1395
366,NZ_CP069052,1,814112,815507,-,1395
366,NZ_CP076228,1,986733,988128,-,1395
366,NZ_CP042445,1,995877,997272,+,1395
366,NZ_CP042904,1,1108811,1110220,+,1409
366,NC_012416,1,1152858,1154267,+,1409
366,NZ_CP069053,1,840571,841966,+,1395
366,NZ_CP042446,1,995887,997282,+,1395
366,NZ_CP041215,1,1440815,1442210,-,1395
366,NZ_OX366353,1,1121001,1122396,-,1395
366,NZ_OX366387,1,7125,8503,+,1378
366,NZ_OX366368,1,7124,8519,+,1395
366,NZ_OX366379,1,7124,8519,+,1395
366,NZ_CP091195,1,1080458,1081835,-,1377
366,NZ_OX366375,1,6605,8010,+,1405
366,NZ_CP046925,1,995737,997132,+,1395
366,NZ_OX366318,1,8044,9439,+,1395
366,NZ_OX366319,1,5832,7227,+,1395
366,NZ_OX366332,1,7191,8586,+,1395
366,NZ_CP110359,1,228421,229816,+,1395
366,NZ_OU953855,1,566270,567665,+,1395
366,NZ_OX366272,1,7126,8521,+,1395
366,NZ_OX366347,1,725691,727086,+,1395
366,NZ_OU909470,1,926690,928119,-,1429
366,NZ_OX366363,1,1013344,1014722,+,1378
366,NZ_OX366364,1,4490,5913,+,1423
366,NZ_OX366359,1,7191,8586,+,1395
366,NZ_OX366349,1,4470,5883,+,1413
366,NZ_OX366380,1,5762,7192,+,1430
366,NZ_OX366344,1,4470,5874,+,1404
366,NZ_CP090900,1,995889,997284,+,1395
366,NZ_OX366352,1,7191,8586,+,1395
366,NZ_OX366362,1,86920,88351,+,1431
366,NZ_OX366400,1,8044,9439,+,1395
366,NZ_OX366327,1,7125,8503,+,1378
366,NZ_OX366367,1,4502,5913,+,1411
366,NZ_CP042444,1,997243,998638,+,1395
366,NZ_OX366326,1,8044,9439,+,1395
366,NZ_CP037426,1,1185462,1186867,+,1405
366,NZ_OX366339,1,7125,8520,+,1395
366,NZ_OX366355,1,8103,9498,+,1395
366,NZ_CP046922,1,1057785,1059180,+,1395
366,NZ_OX366370,1,4493,5874,+,1381
366,NZ_OX366385,1,5762,7192,+,1430
366,NZ_OX366399,1,7124,8519,+,1395
366,NZ_OX366395,1,4490,5885,+,1395
366,NZ_OX366396,1,5831,7226,+,1395
366,NZ_OX366351,1,8895,10290,+,1395
366,NZ_OX366381,1,7090,8485,+,1395
366,NZ_OX366342,1,950566,951946,-,1380
366,NZ_OX366369,1,7124,8519,+,1395
366,NZ_OX366356,1,5778,7170,+,1392
366,NZ_OX366377,1,7125,8520,+,1395
366,NZ_OX366388,1,7051,8429,+,1378
366,NZ_OX366357,1,5688,7083,+,1395
366,NZ_CP072012,1,1257814,1259209,+,1395
366,NZ_OX366398,1,477606,479001,+,1395
366,NC_002978,6,995889,997284,+,1395
366,NZ_OX366389,1,7125,8520,+,1395
366,NZ_OX366397,1,7191,8586,+,1395
366,NZ_OX366378,1,5755,7133,+,1378
366,NZ_CP090903,1,995889,997284,+,1395
366,NZ_OX366374,1,438079,439491,+,1412
366,NZ_CP090901,1,995889,997284,+,1395
366,NZ_CP046923,1,974033,975428,+,1395
366,NZ_CP069055,1,1045109,1046504,-,1395
366,NZ_CP072670,1,995729,997124,+,1395
366,NZ_CP090899,1,995889,997284,+,1395
366,NZ_CP046924,1,994971,996366,+,1395
366,NZ_OX366348,1,7202,8597,+,1395
366,NZ_CP046921,1,1057785,1059180,+,1395
366,NZ_OX366338,1,4403,5797,+,1394
366,NZ_CP054557,1,791945,793358,+,1413
366,NZ_CP072669,1,995737,997132,+,1395
366,NC_021089,1,1023532,1024927,+,1395
367,NZ_OX366376,1,1190602,1191309,+,707
367,NZ_OX366376,1,1483108,1483819,-,711
367,NZ_OX366393,1,1085744,1086455,+,711
367,NZ_OX366372,1,11776,12487,+,711
367,NZ_OX366368,1,592632,593343,-,711
367,NZ_OX366379,1,653763,654474,-,711
367,NZ_CP091195,1,567263,567974,-,711
367,NZ_OU909470,1,920036,920667,+,631
367,NZ_OX366364,1,1232962,1233602,-,640
367,NZ_OX366349,1,1082414,1083125,+,711
367,NZ_OX366380,1,346704,347335,-,631
367,NZ_OX366344,1,7171,7882,+,711
367,NZ_OX366352,1,85510,86221,-,711
367,NZ_OX366352,1,501625,502336,+,711
367,NZ_OX366352,1,896239,896950,-,711
367,NZ_OX366367,1,408282,408993,-,711
367,NZ_OX366367,1,1491495,1492142,+,647
367,NZ_OX366370,1,1201084,1201779,-,695
367,NZ_OX366385,1,931495,932126,-,631
367,NZ_OX366342,1,948244,948955,-,711
367,NZ_OX366357,1,222466,223177,-,711
367,NZ_CP072012,1,756423,757134,+,711
367,NZ_OX366397,1,565728,566439,-,711
367,NZ_OX366374,1,836859,837563,-,704
367,NZ_OX366338,1,1395055,1395766,+,711
368,NZ_OX366376,1,1191559,1192807,+,1248
368,NZ_OX366393,1,1086701,1087949,+,1248
368,NZ_OX366372,1,12733,13981,+,1248
368,NZ_CP072672,1,477086,478346,-,1260
368,NZ_CP069060,1,464714,465974,-,1260
368,NZ_CP072667,1,477068,478328,-,1260
368,NZ_CP072671,1,477068,478328,-,1260
368,NZ_CP072668,1,477055,478315,-,1260
368,NZ_CP072666,1,477068,478328,-,1260
368,NZ_CP090902,1,477220,478480,-,1260
368,NZ_CP090948,1,477220,478480,-,1260
368,NZ_CP069052,1,405445,406705,+,1260
368,NZ_CP076228,1,234280,235540,+,1260
368,NZ_CP042445,1,477220,478480,-,1260
368,NZ_CP042904,1,258156,259416,+,1260
368,NC_012416,1,260739,261999,+,1260
368,NZ_CP069053,1,81295,82555,+,1260
368,NZ_CP042446,1,477220,478480,-,1260
368,NZ_CP041215,1,1240817,1242077,-,1260
368,NZ_OX366353,1,1283204,1284464,-,1260
368,NZ_OX366387,1,1104788,1106048,+,1260
368,NZ_OX366368,1,755444,756704,+,1260
368,NZ_OX366379,1,711649,712909,+,1260
368,NZ_CP091195,1,457210,458470,-,1260
368,NZ_OX366375,1,793438,794698,+,1260
368,NZ_CP046925,1,477068,478328,-,1260
368,NZ_OX366318,1,662593,663853,+,1260
368,NZ_OX366319,1,627973,629233,-,1260
368,NZ_OX366332,1,869256,870516,-,1260
368,NZ_CP110359,1,959017,960277,-,1260
368,NZ_OU953855,1,601609,602869,-,1260
368,NZ_OX366272,1,529802,531062,-,1260
368,NZ_OX366347,1,994667,995927,-,1260
368,NZ_OU909470,1,921087,922347,+,1260
368,NZ_OX366363,1,251472,252732,-,1260
368,NZ_OX366364,1,1229752,1231017,-,1265
368,NZ_OX366359,1,549472,550732,+,1260
368,NZ_OX366349,1,1083379,1084627,+,1248
368,NZ_OX366380,1,344145,345405,-,1260
368,NZ_OX366344,1,8119,9384,+,1265
368,NZ_CP090900,1,477220,478480,-,1260
368,NZ_OX366352,1,598369,599629,-,1260
368,NZ_OX366362,1,1407617,1408882,-,1265
368,NZ_OX366400,1,588499,589759,-,1260
368,NZ_OX366327,1,712696,713956,+,1260
368,NZ_OX366367,1,1492654,1493919,+,1265
368,NZ_CP042444,1,477721,478981,-,1260
368,NZ_OX366326,1,757417,758677,+,1260
368,NZ_CP037426,1,261601,262861,-,1260
368,NZ_OX366339,1,576244,577504,-,1260
368,NZ_OX366355,1,694121,695381,-,1260
368,NZ_CP046922,1,485052,486312,+,1260
368,NZ_OX366370,1,1199572,1200819,-,1247
368,NZ_OX366385,1,319028,320288,-,1260
368,NZ_OX366399,1,681232,682492,+,1260
368,NZ_OX366395,1,654472,655732,+,1260
368,NZ_OX366396,1,789098,790358,+,1260
368,NZ_OX366351,1,579249,580509,+,1260
368,NZ_OX366381,1,902538,903798,-,1260
368,NZ_OX366342,1,946750,947997,-,1247
368,NZ_OX366369,1,806733,807993,-,1260
368,NZ_OX366356,1,719246,720506,-,1260
368,NZ_OX366377,1,869353,870613,+,1260
368,NZ_OX366388,1,701259,702519,-,1260
368,NZ_OX366357,1,304678,305938,+,1260
368,NZ_CP072012,1,575835,577095,-,1260
368,NZ_OX366398,1,645876,647136,+,1260
368,NC_002978,6,477220,478480,-,1260
368,NZ_OX366389,1,741487,742747,+,1260
368,NZ_OX366397,1,965196,966456,-,1260
368,NZ_OX366378,1,1196061,1197321,-,1260
368,NZ_CP090903,1,477220,478480,-,1260
368,NZ_OX366374,1,835460,836707,-,1247
368,NZ_CP090901,1,477220,478480,-,1260
368,NZ_CP046923,1,401300,402560,+,1260
368,NZ_CP069055,1,515821,517081,-,1260
368,NZ_CP072670,1,477060,478320,-,1260
368,NZ_CP090899,1,477220,478480,-,1260
368,NZ_CP046924,1,422238,423498,+,1260
368,NZ_OX366348,1,447300,448560,+,1260
368,NZ_CP046921,1,485052,486312,+,1260
368,NZ_OX366338,1,634133,635393,+,1260
368,NZ_CP054557,1,29819,31079,+,1260
368,NZ_CP072669,1,477068,478328,-,1260
368,NC_021089,1,342826,344086,+,1260
369,NZ_OX366376,1,1193927,1196114,+,2187
369,NZ_OX366393,1,1089069,1091256,+,2187
369,NZ_OX366372,1,15101,17288,+,2187
369,NZ_CP072672,1,473801,475993,-,2192
369,NZ_CP069060,1,461429,463621,-,2192
369,NZ_CP072667,1,473783,475975,-,2192
369,NZ_CP072671,1,473783,475975,-,2192
369,NZ_CP072668,1,473770,475962,-,2192
369,NZ_CP072666,1,473783,475975,-,2192
369,NZ_CP090902,1,473935,476127,-,2192
369,NZ_CP090948,1,473935,476127,-,2192
369,NZ_CP069052,1,407798,409990,+,2192
369,NZ_CP076228,1,236633,238825,+,2192
369,NZ_CP042445,1,473935,476127,-,2192
369,NZ_CP042904,1,260437,262629,+,2192
369,NC_012416,1,263020,265212,+,2192
369,NZ_CP069053,1,83648,85840,+,2192
369,NZ_CP042446,1,473935,476127,-,2192
369,NZ_CP041215,1,1237528,1239724,-,2196
369,NZ_OX366353,1,1279915,1282111,-,2196
369,NZ_OX366387,1,1107141,1109337,+,2196
369,NZ_OX366368,1,757797,759989,+,2192
369,NZ_OX366379,1,714002,716194,+,2192
369,NZ_CP091195,1,453473,455665,-,2192
369,NZ_OX366375,1,795732,797915,+,2183
369,NZ_CP046925,1,473783,475975,-,2192
369,NZ_OX366318,1,664946,667138,+,2192
369,NZ_OX366319,1,624688,626880,-,2192
369,NZ_OX366332,1,865967,868163,-,2196
369,NZ_CP110359,1,955728,957924,-,2196
369,NZ_OU953855,1,598293,600489,-,2196
369,NZ_OX366272,1,526513,528709,-,2196
369,NZ_OX366347,1,991450,993646,-,2196
369,NZ_OU909470,1,923464,925660,+,2196
369,NZ_OX366363,1,248183,250379,-,2196
369,NZ_OX366364,1,1224900,1227096,-,2196
369,NZ_OX366359,1,551825,554021,+,2196
369,NZ_OX366349,1,1085765,1087952,+,2187
369,NZ_OX366380,1,340928,343124,-,2196
369,NZ_OX366344,1,10486,12673,+,2187
369,NZ_CP090900,1,473935,476127,-,2192
369,NZ_OX366352,1,595080,597276,-,2196
369,NZ_OX366362,1,1403609,1405805,-,2196
369,NZ_OX366400,1,585214,587406,-,2192
369,NZ_OX366327,1,714977,717169,+,2192
369,NZ_OX366367,1,1495473,1497669,+,2196
369,NZ_CP042444,1,474436,476628,-,2192
369,NZ_OX366326,1,759770,761962,+,2192
369,NZ_CP037426,1,258384,260567,-,2183
369,NZ_OX366339,1,572955,575151,-,2196
369,NZ_OX366355,1,690836,693028,-,2192
369,NZ_CP046922,1,487405,489597,+,2192
369,NZ_OX366370,1,1196274,1198470,-,2196
369,NZ_OX366385,1,315811,318007,-,2196
369,NZ_OX366399,1,683585,685777,+,2192
369,NZ_OX366395,1,657196,659388,+,2192
369,NZ_OX366396,1,791451,793647,+,2196
369,NZ_OX366351,1,581602,583794,+,2192
369,NZ_OX366381,1,899253,901445,-,2192
369,NZ_OX366342,1,943443,945630,-,2187
369,NZ_OX366369,1,803448,805640,-,2192
369,NZ_OX366356,1,716042,718197,-,2155
369,NZ_OX366377,1,871706,873902,+,2196
369,NZ_OX366388,1,696423,698615,-,2192
369,NZ_OX366357,1,307463,309659,+,2196
369,NZ_CP072012,1,572550,574742,-,2192
369,NZ_OX366398,1,648229,650421,+,2192
369,NC_002978,6,473935,476127,-,2192
369,NZ_OX366389,1,743840,746032,+,2192
369,NZ_OX366397,1,961907,964103,-,2196
369,NZ_OX366378,1,1192324,1194516,-,2192
369,NZ_CP090903,1,473935,476127,-,2192
369,NZ_OX366374,1,831707,833899,-,2192
369,NZ_CP090901,1,473935,476127,-,2192
369,NZ_CP046923,1,403653,405845,+,2192
369,NZ_CP069055,1,512536,514728,-,2192
369,NZ_CP072670,1,473775,475967,-,2192
369,NZ_CP090899,1,473935,476127,-,2192
369,NZ_CP046924,1,424591,426783,+,2192
369,NZ_OX366348,1,449653,451845,+,2192
369,NZ_CP046921,1,487405,489597,+,2192
369,NZ_OX366338,1,636986,639178,+,2192
369,NZ_CP054557,1,32172,34368,+,2196
369,NZ_CP072669,1,473783,475975,-,2192
369,NC_021089,1,345179,347375,+,2196
370,NZ_OX366376,1,1196775,1198826,+,2051
370,NZ_OX366393,1,1091918,1093969,+,2051
370,NZ_OX366372,1,17950,20001,+,2051
370,NZ_CP072672,1,789413,791482,-,2069
370,NZ_CP069060,1,633300,635369,-,2069
370,NZ_CP072667,1,789395,791464,-,2069
370,NZ_CP072671,1,789395,791464,-,2069
370,NZ_CP072668,1,789382,791451,-,2069
370,NZ_CP072666,1,789395,791464,-,2069
370,NZ_CP090902,1,789547,791616,-,2069
370,NZ_CP090948,1,789547,791616,-,2069
370,NZ_CP069052,1,1184290,1186359,-,2069
370,NZ_CP076228,1,748434,750504,+,2070
370,NZ_CP042445,1,789535,791604,-,2069
370,NZ_CP042904,1,813362,815422,-,2060
370,NC_012416,1,849861,851921,-,2060
370,NZ_CP069053,1,633308,635377,-,2069
370,NZ_CP042446,1,789547,791616,-,2069
370,NZ_CP041215,1,1262688,1264747,-,2059
370,NZ_OX366353,1,214671,216730,-,2059
370,NZ_OX366387,1,1447381,1449442,-,2061
370,NZ_OX366368,1,1235452,1237521,-,2069
370,NZ_OX366379,1,1154967,1157036,-,2069
370,NZ_CP091195,1,842949,845019,+,2070
370,NZ_OX366375,1,1083580,1085641,-,2061
370,NZ_CP046925,1,789395,791464,-,2069
370,NZ_OX366318,1,1089411,1091480,-,2069
370,NZ_OX366319,1,53727,55788,-,2061
370,NZ_OX366332,1,1172876,1174935,-,2059
370,NZ_CP110359,1,273727,275786,-,2059
370,NZ_OU953855,1,868960,871019,+,2059
370,NZ_OX366272,1,1249549,1251608,+,2059
370,NZ_OX366347,1,149148,151207,+,2059
370,NZ_OU909470,1,1079018,1081078,-,2060
370,NZ_OX366363,1,1153141,1155203,+,2062
370,NZ_OX366364,1,112685,114771,+,2086
370,NZ_OX366359,1,1003383,1005442,-,2059
370,NZ_OX366349,1,1375001,1377052,+,2051
370,NZ_OX366380,1,287478,289516,-,2038
370,NZ_OX366344,1,13345,15396,+,2051
370,NZ_CP090900,1,789547,791616,-,2069
370,NZ_OX366352,1,1210898,1212957,+,2059
370,NZ_OX366362,1,378910,380971,+,2061
370,NZ_OX366400,1,952581,954650,-,2069
370,NZ_OX366327,1,1086659,1088720,-,2061
370,NZ_OX366367,1,18321,20407,-,2086
370,NZ_CP042444,1,789982,792051,-,2069
370,NZ_OX366326,1,1297056,1299125,-,2069
370,NZ_CP037426,1,1164983,1167045,+,2062
370,NZ_OX366339,1,904217,906279,+,2062
370,NZ_OX366355,1,57602,59663,-,2061
370,NZ_CP046922,1,851360,853429,-,2069
370,NZ_OX366370,1,10862,12895,+,2033
370,NZ_OX366385,1,259136,261174,-,2038
370,NZ_OX366399,1,1189595,1191664,-,2069
370,NZ_OX366395,1,107148,109186,+,2038
370,NZ_OX366396,1,534215,536276,-,2061
370,NZ_OX366351,1,1243481,1245550,-,2069
370,NZ_OX366381,1,165207,167268,-,2061
370,NZ_OX366342,1,940730,942781,-,2051
370,NZ_OX366369,1,1276383,1278444,-,2061
370,NZ_OX366356,1,993206,995283,-,2077
370,NZ_OX366377,1,1138128,1140205,+,2077
370,NZ_OX366388,1,270868,272929,-,2061
370,NZ_OX366357,1,417390,419428,+,2038
370,NZ_CP072012,1,1387877,1389947,+,2070
370,NZ_OX366398,1,269202,271279,-,2077
370,NC_002978,6,789547,791616,-,2069
370,NZ_OX366389,1,1084989,1087066,+,2077
370,NZ_OX366397,1,1397180,1399239,-,2059
370,NZ_OX366378,1,124159,126229,+,2070
370,NZ_CP090903,1,789547,791616,-,2069
370,NZ_OX366374,1,642401,644439,-,2038
370,NZ_CP090901,1,789547,791616,-,2069
370,NZ_CP046923,1,767608,769677,-,2069
370,NZ_CP069055,1,788658,790727,-,2069
370,NZ_CP072670,1,789387,791456,-,2069
370,NZ_CP090899,1,789547,791616,-,2069
370,NZ_CP046924,1,788546,790615,-,2069
370,NZ_OX366348,1,190482,192552,+,2070
370,NZ_CP046921,1,851360,853429,-,2069
370,NZ_OX366338,1,1260392,1262430,-,2038
370,NZ_CP054557,1,1014847,1016917,+,2070
370,NZ_CP072669,1,789395,791464,-,2069
370,NC_021089,1,822935,824994,-,2059
371,NZ_OX366376,1,1200041,1201466,+,1425
371,NZ_OX366393,1,1095184,1096609,+,1425
371,NZ_OX366372,1,21216,22641,+,1425
371,NZ_CP072672,1,786865,788280,-,1415
371,NZ_CP069060,1,630752,632167,-,1415
371,NZ_CP072667,1,786847,788262,-,1415
371,NZ_CP072671,1,786847,788262,-,1415
371,NZ_CP072668,1,786834,788249,-,1415
371,NZ_CP072666,1,786847,788262,-,1415
371,NZ_CP090902,1,786999,788414,-,1415
371,NZ_CP090948,1,786999,788414,-,1415
371,NZ_CP069052,1,1181742,1183157,-,1415
371,NZ_CP076228,1,751637,753052,+,1415
371,NZ_CP042445,1,786987,788402,-,1415
371,NZ_CP042904,1,810701,812115,-,1414
371,NC_012416,1,847200,848614,-,1414
371,NZ_CP069053,1,630760,632175,-,1415
371,NZ_CP042446,1,786999,788414,-,1415
371,NZ_CP041215,1,1260153,1261567,-,1414
371,NZ_OX366353,1,212136,213550,-,1414
371,NZ_OX366387,1,1444836,1446260,-,1424
371,NZ_OX366368,1,1232904,1234319,-,1415
371,NZ_OX366379,1,1152419,1153834,-,1415
371,NZ_CP091195,1,846140,847554,+,1414
371,NZ_OX366375,1,1081057,1082471,-,1414
371,NZ_CP046925,1,786847,788262,-,1415
371,NZ_OX366318,1,1086863,1088278,-,1415
371,NZ_OX366319,1,134463,135877,+,1414
371,NZ_OX366332,1,1170341,1171755,-,1414
371,NZ_CP110359,1,271177,272592,-,1415
371,NZ_OU953855,1,872152,873577,+,1425
371,NZ_OX366272,1,1252741,1254156,+,1415
371,NZ_OX366347,1,152565,153990,+,1425
371,NZ_OU909470,1,1076622,1078041,-,1419
371,NZ_OX366363,1,1156315,1157730,+,1415
371,NZ_OX366364,1,115895,117301,+,1406
371,NZ_OX366359,1,1000848,1002262,-,1414
371,NZ_OX366349,1,1378087,1379512,+,1425
371,NZ_OX366380,1,285058,286483,-,1425
371,NZ_OX366344,1,16499,17924,+,1425
371,NZ_CP090900,1,786999,788414,-,1415
371,NZ_OX366352,1,1214078,1215492,+,1414
371,NZ_OX366362,1,382005,383409,+,1404
371,NZ_OX366400,1,949759,951174,-,1415
371,NZ_OX366327,1,1084005,1085419,-,1414
371,NZ_OX366367,1,15791,17197,-,1406
371,NZ_CP042444,1,787434,788849,-,1415
371,NZ_OX366326,1,1294508,1295923,-,1415
371,NZ_CP037426,1,1234968,1236382,-,1414
371,NZ_OX366339,1,907519,908933,+,1414
371,NZ_OX366355,1,1334403,1335817,+,1414
371,NZ_CP046922,1,848812,850227,-,1415
371,NZ_OX366370,1,13966,15383,+,1417
371,NZ_OX366385,1,256716,258141,-,1425
371,NZ_OX366399,1,1187047,1188462,-,1415
371,NZ_OX366395,1,110306,111729,+,1423
371,NZ_OX366396,1,531561,532975,-,1414
371,NZ_OX366351,1,1240933,1242348,-,1415
371,NZ_OX366381,1,245969,247383,+,1414
371,NZ_OX366342,1,938084,939509,-,1425
371,NZ_OX366369,1,1273015,1274429,-,1414
371,NZ_OX366356,1,990579,991993,-,1414
371,NZ_OX366377,1,1141317,1142732,+,1415
371,NZ_OX366388,1,268333,269747,-,1414
371,NZ_OX366357,1,516342,517767,-,1425
371,NZ_CP072012,1,1391080,1392495,+,1415
371,NZ_OX366398,1,266675,268090,-,1415
371,NC_002978,6,786999,788414,-,1415
371,NZ_OX366389,1,1088178,1089593,+,1415
371,NZ_OX366397,1,1394645,1396059,-,1414
371,NZ_OX366378,1,127350,128764,+,1414
371,NZ_CP090903,1,786999,788414,-,1415
371,NZ_OX366374,1,175204,176628,+,1424
371,NZ_CP090901,1,786999,788414,-,1415
371,NZ_CP046923,1,765060,766475,-,1415
371,NZ_CP069055,1,786110,787525,-,1415
371,NZ_CP072670,1,786839,788254,-,1415
371,NZ_CP090899,1,786999,788414,-,1415
371,NZ_CP046924,1,785998,787413,-,1415
371,NZ_OX366348,1,193664,195079,+,1415
371,NZ_CP046921,1,848812,850227,-,1415
371,NZ_OX366338,1,1257048,1258465,-,1417
371,NZ_CP054557,1,1018029,1019444,+,1415
371,NZ_CP072669,1,786847,788262,-,1415
371,NC_021089,1,820400,821814,-,1414
372,NZ_OX366376,1,1201492,1203118,+,1626
372,NZ_OX366393,1,1096635,1098261,+,1626
372,NZ_OX366372,1,22667,24293,+,1626
372,NZ_CP072672,1,785203,786825,-,1622
372,NZ_CP069060,1,629090,630712,-,1622
372,NZ_CP072667,1,785185,786807,-,1622
372,NZ_CP072671,1,785185,786807,-,1622
372,NZ_CP072668,1,785172,786794,-,1622
372,NZ_CP072666,1,785185,786807,-,1622
372,NZ_CP090902,1,785337,786959,-,1622
372,NZ_CP090948,1,785337,786959,-,1622
372,NZ_CP069052,1,1180080,1181702,-,1622
372,NZ_CP076228,1,753092,754714,+,1622
372,NZ_CP042445,1,785325,786947,-,1622
372,NZ_CP042904,1,809039,810661,-,1622
372,NC_012416,1,845538,847160,-,1622
372,NZ_CP069053,1,629098,630720,-,1622
372,NZ_CP042446,1,785337,786959,-,1622
372,NZ_CP041215,1,1258491,1260113,-,1622
372,NZ_OX366353,1,210474,212096,-,1622
372,NZ_OX366387,1,1441846,1443423,-,1577
372,NZ_OX366368,1,1231242,1232864,-,1622
372,NZ_OX366379,1,1150757,1152379,-,1622
372,NZ_CP091195,1,847594,849216,+,1622
372,NZ_OX366375,1,1079395,1081017,-,1622
372,NZ_CP046925,1,785185,786807,-,1622
372,NZ_OX366318,1,1085201,1086823,-,1622
372,NZ_OX366319,1,135917,137539,+,1622
372,NZ_OX366332,1,1168679,1170301,-,1622
372,NZ_CP110359,1,269515,271140,-,1625
372,NZ_OU953855,1,1630306,1631924,+,1618
372,NZ_OX366272,1,1254193,1255818,+,1625
372,NZ_OX366347,1,215529,217147,-,1618
372,NZ_OU909470,1,1074968,1076590,-,1622
372,NZ_OX366363,1,1157770,1159392,+,1622
372,NZ_OX366364,1,16736,18354,-,1618
372,NZ_OX366359,1,999186,1000808,-,1622
372,NZ_OX366349,1,1379538,1381164,+,1626
372,NZ_OX366380,1,283412,285032,-,1620
372,NZ_OX366344,1,17950,19576,+,1626
372,NZ_CP090900,1,785337,786959,-,1622
372,NZ_OX366352,1,1215532,1217154,+,1622
372,NZ_OX366362,1,383773,385383,+,1610
372,NZ_OX366400,1,948097,949719,-,1622
372,NZ_OX366327,1,1082343,1083965,-,1622
372,NZ_OX366367,1,14120,15745,-,1625
372,NZ_CP042444,1,785772,787394,-,1622
372,NZ_OX366326,1,1292846,1294468,-,1622
372,NZ_CP037426,1,1233306,1234928,-,1622
372,NZ_OX366339,1,908973,910595,+,1622
372,NZ_OX366355,1,1335857,1337479,+,1622
372,NZ_CP046922,1,847150,848772,-,1622
372,NZ_OX366370,1,15409,17035,+,1626
372,NZ_OX366385,1,255070,256690,-,1620
372,NZ_OX366399,1,1185385,1187007,-,1622
372,NZ_OX366395,1,111755,113381,+,1626
372,NZ_OX366396,1,529899,531521,-,1622
372,NZ_OX366351,1,1239271,1240893,-,1622
372,NZ_OX366381,1,247423,249045,+,1622
372,NZ_OX366342,1,936432,938058,-,1626
372,NZ_OX366369,1,1271353,1272975,-,1622
372,NZ_OX366356,1,988917,990539,-,1622
372,NZ_OX366377,1,1142772,1144394,+,1622
372,NZ_OX366388,1,266671,268293,-,1622
372,NZ_OX366357,1,514690,516316,-,1626
372,NZ_CP072012,1,1392535,1394157,+,1622
372,NZ_OX366398,1,265013,266635,-,1622
372,NC_002978,6,785337,786959,-,1622
372,NZ_OX366389,1,1089633,1091255,+,1622
372,NZ_OX366397,1,1392983,1394605,-,1622
372,NZ_OX366378,1,128804,130426,+,1622
372,NZ_CP090903,1,785337,786959,-,1622
372,NZ_OX366374,1,176959,178577,+,1618
372,NZ_CP090901,1,785337,786959,-,1622
372,NZ_CP046923,1,763398,765020,-,1622
372,NZ_CP069055,1,784448,786070,-,1622
372,NZ_CP072670,1,785177,786799,-,1622
372,NZ_CP090899,1,785337,786959,-,1622
372,NZ_CP046924,1,784336,785958,-,1622
372,NZ_OX366348,1,195119,196741,+,1622
372,NZ_CP046921,1,847150,848772,-,1622
372,NZ_OX366338,1,1255099,1256717,-,1618
372,NZ_CP054557,1,1019484,1021106,+,1622
372,NZ_CP072669,1,785185,786807,-,1622
372,NC_021089,1,818738,820360,-,1622
373,NZ_OX366376,1,1203779,1206189,+,2410
373,NZ_OX366393,1,1098922,1101332,+,2410
373,NZ_OX366372,1,24954,27364,+,2410
373,NZ_CP072672,1,782111,784542,-,2431
373,NZ_CP069060,1,625079,627510,-,2431
373,NZ_CP072667,1,782093,784524,-,2431
373,NZ_CP072671,1,782093,784524,-,2431
373,NZ_CP072668,1,782080,784511,-,2431
373,NZ_CP072666,1,782093,784524,-,2431
373,NZ_CP090902,1,782245,784676,-,2431
373,NZ_CP090948,1,782245,784676,-,2431
373,NZ_CP069052,1,1176069,1178500,-,2431
373,NZ_CP076228,1,755375,757805,+,2430
373,NZ_CP042445,1,782233,784664,-,2431
373,NZ_CP042904,1,805975,808378,-,2403
373,NC_012416,1,842474,844877,-,2403
373,NZ_CP069053,1,625087,627518,-,2431
373,NZ_CP042446,1,782245,784676,-,2431
373,NZ_CP041215,1,1255434,1257830,-,2396
373,NZ_OX366353,1,207418,209813,-,2395
373,NZ_OX366387,1,1436680,1439078,-,2398
373,NZ_OX366368,1,1228150,1230581,-,2431
373,NZ_OX366379,1,1147665,1150096,-,2431
373,NZ_CP091195,1,849877,852289,+,2412
373,NZ_OX366375,1,1075381,1077813,-,2432
373,NZ_CP046925,1,782093,784524,-,2431
373,NZ_OX366318,1,1082109,1084540,-,2431
373,NZ_OX366319,1,138200,140631,+,2431
373,NZ_OX366332,1,1165622,1168018,-,2396
373,NZ_CP110359,1,266428,268854,-,2426
373,NZ_OU953855,1,1632585,1635015,+,2430
373,NZ_OX366272,1,1256479,1258905,+,2426
373,NZ_OX366347,1,212442,214868,-,2426
373,NZ_OU909470,1,1071941,1074303,-,2362
373,NZ_OX366363,1,1160053,1162483,+,2430
373,NZ_OX366364,1,13634,16075,-,2441
373,NZ_OX366359,1,996129,998525,-,2396
373,NZ_OX366349,1,1381825,1384235,+,2410
373,NZ_OX366380,1,280402,282751,-,2349
373,NZ_OX366344,1,20237,22647,+,2410
373,NZ_CP090900,1,782245,784676,-,2431
373,NZ_OX366352,1,1217815,1220211,+,2396
373,NZ_OX366362,1,386044,388452,+,2408
373,NZ_OX366400,1,945005,947436,-,2431
373,NZ_OX366327,1,1079284,1081682,-,2398
373,NZ_OX366367,1,11051,13459,-,2408
373,NZ_CP042444,1,782680,785111,-,2431
373,NZ_OX366326,1,1289754,1292185,-,2431
373,NZ_CP037426,1,1230213,1232645,-,2432
373,NZ_OX366339,1,911256,913686,+,2430
373,NZ_OX366355,1,1338140,1340571,+,2431
373,NZ_CP046922,1,844058,846489,-,2431
373,NZ_OX366370,1,31118,33507,-,2389
373,NZ_OX366385,1,251086,253434,-,2348
373,NZ_OX366399,1,1182293,1184724,-,2431
373,NZ_OX366395,1,114042,116459,+,2417
373,NZ_OX366396,1,526807,529238,-,2431
373,NZ_OX366351,1,1236179,1238610,-,2431
373,NZ_OX366381,1,249706,252137,+,2431
373,NZ_OX366342,1,933361,935771,-,2410
373,NZ_OX366369,1,1268260,1270692,-,2432
373,NZ_OX366356,1,985744,988152,-,2408
373,NZ_OX366377,1,1145055,1147485,+,2430
373,NZ_OX366388,1,263597,266010,-,2413
373,NZ_OX366357,1,238554,240972,+,2418
373,NZ_CP072012,1,1394818,1397248,+,2430
373,NZ_OX366398,1,261921,264352,-,2431
373,NC_002978,6,782245,784676,-,2431
373,NZ_OX366389,1,1092835,1095265,+,2430
373,NZ_OX366397,1,1389926,1392322,-,2396
373,NZ_OX366378,1,131087,133499,+,2412
373,NZ_CP090903,1,782245,784676,-,2431
373,NZ_OX366374,1,180090,182440,+,2350
373,NZ_CP090901,1,782245,784676,-,2431
373,NZ_CP046923,1,760306,762737,-,2431
373,NZ_CP069055,1,781356,783787,-,2431
373,NZ_CP072670,1,782085,784516,-,2431
373,NZ_CP090899,1,782245,784676,-,2431
373,NZ_CP046924,1,781244,783675,-,2431
373,NZ_OX366348,1,197402,199832,+,2430
373,NZ_CP046921,1,844058,846489,-,2431
373,NZ_OX366338,1,1251170,1253585,-,2415
373,NZ_CP054557,1,1021767,1024197,+,2430
373,NZ_CP072669,1,782093,784524,-,2431
373,NC_021089,1,815681,818077,-,2396
374,NZ_OX366376,1,1206738,1207994,+,1256
374,NZ_OX366393,1,1101881,1103137,+,1256
374,NZ_OX366372,1,27913,29169,+,1256
374,NZ_CP072672,1,780462,781713,-,1251
374,NZ_CP069060,1,623430,624681,-,1251
374,NZ_CP072667,1,780444,781695,-,1251
374,NZ_CP072671,1,780444,781695,-,1251
374,NZ_CP072668,1,780431,781682,-,1251
374,NZ_CP072666,1,780444,781695,-,1251
374,NZ_CP090902,1,780596,781847,-,1251
374,NZ_CP090948,1,780596,781847,-,1251
374,NZ_CP069052,1,1174420,1175671,-,1251
374,NZ_CP076228,1,758204,759454,+,1250
374,NZ_CP042445,1,780584,781835,-,1251
374,NZ_CP042904,1,804193,805444,-,1251
374,NC_012416,1,840692,841943,-,1251
374,NZ_CP069053,1,623438,624689,-,1251
374,NZ_CP042446,1,780596,781847,-,1251
374,NZ_CP041215,1,1253794,1255045,-,1251
374,NZ_OX366353,1,205778,207029,-,1251
374,NZ_OX366387,1,1434927,1436178,-,1251
374,NZ_OX366368,1,1226501,1227752,-,1251
374,NZ_OX366379,1,1146016,1147267,-,1251
374,NZ_CP091195,1,852688,853938,+,1250
374,NZ_OX366375,1,1073628,1074879,-,1251
374,NZ_CP046925,1,780444,781695,-,1251
374,NZ_OX366318,1,1079286,1080537,-,1251
374,NZ_OX366319,1,141134,142384,+,1250
374,NZ_OX366332,1,1163982,1165233,-,1251
374,NZ_CP110359,1,264827,266078,-,1251
374,NZ_OU953855,1,1635414,1636664,+,1250
374,NZ_OX366272,1,1259255,1260505,+,1250
374,NZ_OX366347,1,210840,212091,-,1251
374,NZ_OU909470,1,1070389,1071646,-,1257
374,NZ_OX366363,1,1162882,1164132,+,1250
374,NZ_OX366364,1,10553,11810,-,1257
374,NZ_OX366359,1,994557,995808,-,1251
374,NZ_OX366349,1,1384945,1386201,+,1256
374,NZ_OX366380,1,278955,280206,-,1251
374,NZ_OX366344,1,23196,24452,+,1256
374,NZ_CP090900,1,780596,781847,-,1251
374,NZ_OX366352,1,1220600,1221850,+,1250
374,NZ_OX366362,1,1266641,1267891,+,1250
374,NZ_OX366400,1,941147,942398,-,1251
374,NZ_OX366327,1,1077626,1078877,-,1251
374,NZ_OX366367,1,9269,10520,-,1251
374,NZ_CP042444,1,781031,782282,-,1251
374,NZ_OX366326,1,1286931,1288182,-,1251
374,NZ_CP037426,1,1228460,1229711,-,1251
374,NZ_OX366339,1,914085,915335,+,1250
374,NZ_OX366355,1,1342052,1343302,+,1250
374,NZ_CP046922,1,842409,843660,-,1251
374,NZ_OX366370,1,29579,30836,-,1257
374,NZ_OX366385,1,249639,250890,-,1251
374,NZ_OX366399,1,1180644,1181895,-,1251
374,NZ_OX366395,1,116859,118091,+,1232
374,NZ_OX366396,1,525158,526409,-,1251
374,NZ_OX366351,1,1233356,1234607,-,1251
374,NZ_OX366381,1,252640,253890,+,1250
374,NZ_OX366342,1,931623,932880,-,1257
374,NZ_OX366369,1,1266507,1267758,-,1251
374,NZ_OX366356,1,984237,985488,-,1251
374,NZ_OX366377,1,1147884,1149134,+,1250
374,NZ_OX366388,1,261948,263199,-,1251
374,NZ_OX366357,1,241322,242572,+,1250
374,NZ_CP072012,1,1397647,1398897,+,1250
374,NZ_OX366398,1,260272,261523,-,1251
374,NC_002978,6,780596,781847,-,1251
374,NZ_OX366389,1,1095664,1096914,+,1250
374,NZ_OX366397,1,1388286,1389537,-,1251
374,NZ_OX366378,1,133898,135148,+,1250
374,NZ_CP090903,1,780596,781847,-,1251
374,NZ_OX366374,1,184015,185256,+,1241
374,NZ_CP090901,1,780596,781847,-,1251
374,NZ_CP046923,1,758657,759908,-,1251
374,NZ_CP069055,1,779707,780958,-,1251
374,NZ_CP072670,1,780436,781687,-,1251
374,NZ_CP090899,1,780596,781847,-,1251
374,NZ_CP046924,1,779595,780846,-,1251
374,NZ_OX366348,1,200231,201481,+,1250
374,NZ_CP046921,1,842409,843660,-,1251
374,NZ_OX366338,1,1249707,1250964,-,1257
374,NZ_CP054557,1,1024596,1025846,+,1250
374,NZ_CP072669,1,780444,781695,-,1251
374,NC_021089,1,814041,815292,-,1251
375,NZ_OX366376,1,1223822,1224330,+,508
375,NZ_OX366393,1,376169,376677,+,508
375,NZ_CP042904,1,1307583,1308091,+,508
375,NC_012416,1,1352281,1352789,+,508
375,NZ_OU909470,1,399243,399745,+,502
375,NZ_OX366349,1,263231,263739,+,508
375,NZ_OX366380,1,842556,843064,-,508
375,NZ_OX366342,1,1368662,1369170,-,508
375,NZ_OX366388,1,859856,860364,+,508
375,NZ_OX366388,1,1109079,1109585,-,506
376,NZ_OX366376,1,1228348,1230036,+,1688
376,NZ_OX366393,1,434593,436281,+,1688
376,NZ_OX366342,1,1330732,1332420,+,1688
377,NZ_OX366376,1,1232064,1234106,+,2042
377,NZ_OX366393,1,438309,440351,+,2042
377,NZ_OX366372,1,287752,289833,+,2081
377,NZ_CP072672,1,449831,451842,-,2011
377,NZ_CP069060,1,437313,439324,-,2011
377,NZ_CP072667,1,449813,451824,-,2011
377,NZ_CP072671,1,449813,451824,-,2011
377,NZ_CP072668,1,449800,451811,-,2011
377,NZ_CP072666,1,449813,451824,-,2011
377,NZ_CP090902,1,449965,451976,-,2011
377,NZ_CP090948,1,449965,451976,-,2011
377,NZ_CP069052,1,432095,434106,+,2011
377,NZ_CP076228,1,260788,262814,+,2026
377,NZ_CP042445,1,449965,451976,-,2011
377,NZ_CP042904,1,295083,297109,-,2026
377,NC_012416,1,297666,299692,-,2026
377,NZ_CP069053,1,107945,109956,+,2011
377,NZ_CP042446,1,449965,451976,-,2011
377,NZ_CP041215,1,1208603,1210629,-,2026
377,NZ_OX366353,1,424340,426366,-,2026
377,NZ_OX366387,1,1092639,1094665,-,2026
377,NZ_OX366368,1,782572,784598,+,2026
377,NZ_OX366379,1,738777,740803,+,2026
377,NZ_CP091195,1,340311,342337,+,2026
377,NZ_OX366375,1,823408,825434,+,2026
377,NZ_CP046925,1,449813,451824,-,2011
377,NZ_OX366318,1,691089,693115,+,2026
377,NZ_OX366319,1,476589,478631,+,2042
377,NZ_OX366332,1,838719,840745,-,2026
377,NZ_CP110359,1,726529,728555,+,2026
377,NZ_OU953855,1,659625,661651,-,2026
377,NZ_OX366272,1,494253,496279,-,2026
377,NZ_OX366347,1,962412,964438,-,2026
377,NZ_OU909470,1,126420,128445,-,2025
377,NZ_OX366363,1,220319,222345,-,2026
377,NZ_OX366364,1,820331,822373,-,2042
377,NZ_OX366359,1,579073,581099,+,2026
377,NZ_OX366349,1,1267890,1269932,+,2042
377,NZ_OX366380,1,500796,502822,-,2026
377,NZ_OX366344,1,607082,609124,+,2042
377,NZ_CP090900,1,449965,451976,-,2011
377,NZ_OX366352,1,567826,569852,-,2026
377,NZ_OX366362,1,1025401,1027427,+,2026
377,NZ_OX366400,1,556092,558118,-,2026
377,NZ_OX366327,1,743116,745142,+,2026
377,NZ_OX366367,1,740526,742561,+,2035
377,NZ_CP042444,1,450466,452477,-,2011
377,NZ_OX366326,1,785062,787088,+,2026
377,NZ_CP037426,1,285991,288017,-,2026
377,NZ_OX366339,1,403073,405099,-,2026
377,NZ_OX366355,1,487472,489514,-,2042
377,NZ_CP046922,1,511556,513567,+,2011
377,NZ_OX366370,1,478544,480586,-,2042
377,NZ_OX366385,1,731182,733208,+,2026
377,NZ_OX366399,1,708360,710386,+,2026
377,NZ_OX366395,1,697501,699543,+,2042
377,NZ_OX366396,1,655376,657402,+,2026
377,NZ_OX366351,1,608596,610622,+,2026
377,NZ_OX366381,1,716242,718284,-,2042
377,NZ_OX366342,1,1334448,1336490,+,2042
377,NZ_OX366369,1,779110,781152,-,2042
377,NZ_OX366356,1,687834,689860,-,2026
377,NZ_OX366377,1,902236,904262,+,2026
377,NZ_OX366388,1,668033,670059,-,2026
377,NZ_OX366357,1,173651,175677,-,2026
377,NZ_CP072012,1,547858,549884,-,2026
377,NZ_OX366398,1,213915,215941,-,2026
377,NC_002978,6,449965,451976,-,2011
377,NZ_OX366389,1,808781,810807,+,2026
377,NZ_OX366397,1,856467,858493,-,2026
377,NZ_OX366378,1,454537,456563,-,2026
377,NZ_CP090903,1,449965,451976,-,2011
377,NZ_OX366374,1,802462,804418,-,1956
377,NZ_CP090901,1,449965,451976,-,2011
377,NZ_CP046923,1,427804,429815,+,2011
377,NZ_CP069055,1,488397,490423,-,2026
377,NZ_CP072670,1,449805,451816,-,2011
377,NZ_CP090899,1,449965,451976,-,2011
377,NZ_CP046924,1,448742,450753,+,2011
377,NZ_OX366348,1,477198,479224,+,2026
377,NZ_CP046921,1,511556,513567,+,2011
377,NZ_OX366338,1,770939,772965,+,2026
377,NZ_CP054557,1,204293,206319,-,2026
377,NZ_CP072669,1,449813,451824,-,2011
377,NC_021089,1,372556,374582,+,2026
378,NZ_OX366376,1,1234116,1234679,+,563
378,NZ_OX366393,1,440361,440924,+,563
378,NZ_OX366372,1,289843,290406,+,563
378,NZ_CP072672,1,449258,449821,-,563
378,NZ_CP069060,1,436740,437303,-,563
378,NZ_CP072667,1,449240,449803,-,563
378,NZ_CP072671,1,449240,449803,-,563
378,NZ_CP072668,1,449227,449790,-,563
378,NZ_CP072666,1,449240,449803,-,563
378,NZ_CP090902,1,449392,449955,-,563
378,NZ_CP090948,1,449392,449955,-,563
378,NZ_CP069052,1,434116,434679,+,563
378,NZ_CP076228,1,262824,263387,+,563
378,NZ_CP042445,1,449392,449955,-,563
378,NZ_CP042904,1,294516,295073,-,557
378,NC_012416,1,297099,297656,-,557
378,NZ_CP069053,1,109966,110529,+,563
378,NZ_CP042446,1,449392,449955,-,563
378,NZ_CP041215,1,1208030,1208593,-,563
378,NZ_OX366353,1,423767,424330,-,563
378,NZ_OX366387,1,1092066,1092629,-,563
378,NZ_OX366368,1,784608,785171,+,563
378,NZ_OX366379,1,740813,741376,+,563
378,NZ_CP091195,1,227106,227663,-,557
378,NZ_OX366375,1,825444,826007,+,563
378,NZ_CP046925,1,449240,449803,-,563
378,NZ_OX366318,1,693125,693688,+,563
378,NZ_OX366319,1,478641,479204,+,563
378,NZ_OX366332,1,838146,838709,-,563
378,NZ_CP110359,1,728568,729128,+,560
378,NZ_OU953855,1,659052,659615,-,563
378,NZ_OX366272,1,493680,494240,-,560
378,NZ_OX366347,1,961839,962402,-,563
378,NZ_OU909470,1,125847,126410,-,563
378,NZ_OX366363,1,219746,220309,-,563
378,NZ_OX366364,1,819758,820321,-,563
378,NZ_OX366359,1,581109,581672,+,563
378,NZ_OX366349,1,1269942,1270505,+,563
378,NZ_OX366380,1,500223,500786,-,563
378,NZ_OX366344,1,609134,609697,+,563
378,NZ_CP090900,1,449392,449955,-,563
378,NZ_OX366352,1,567253,567816,-,563
378,NZ_OX366362,1,1027437,1028000,+,563
378,NZ_OX366400,1,555519,556082,-,563
378,NZ_OX366327,1,745152,745715,+,563
378,NZ_OX366367,1,742578,743141,+,563
378,NZ_CP042444,1,449893,450456,-,563
378,NZ_OX366326,1,787098,787661,+,563
378,NZ_CP037426,1,285418,285981,-,563
378,NZ_OX366339,1,402501,403063,-,562
378,NZ_OX366355,1,486899,487462,-,563
378,NZ_CP046922,1,513577,514140,+,563
378,NZ_OX366370,1,477971,478534,-,563
378,NZ_OX366385,1,733218,733781,+,563
378,NZ_OX366399,1,710396,710959,+,563
378,NZ_OX366395,1,699553,700110,+,557
378,NZ_OX366396,1,711048,711604,-,556
378,NZ_OX366351,1,610632,611195,+,563
378,NZ_OX366381,1,715669,716232,-,563
378,NZ_OX366342,1,1336500,1337063,+,563
378,NZ_OX366369,1,778537,779100,-,563
378,NZ_OX366356,1,687261,687824,-,563
378,NZ_OX366377,1,904272,904835,+,563
378,NZ_OX366388,1,667460,668023,-,563
378,NZ_OX366357,1,173084,173641,-,557
378,NZ_CP072012,1,547285,547848,-,563
378,NZ_OX366398,1,213342,213905,-,563
378,NC_002978,6,449392,449955,-,563
378,NZ_OX366389,1,810817,811380,+,563
378,NZ_OX366397,1,855894,856457,-,563
378,NZ_OX366378,1,362705,363262,-,557
378,NZ_CP090903,1,449392,449955,-,563
378,NZ_OX366374,1,801895,802440,-,545
378,NZ_CP090901,1,449392,449955,-,563
378,NZ_CP046923,1,429825,430388,+,563
378,NZ_CP069055,1,487824,488387,-,563
378,NZ_CP072670,1,449232,449795,-,563
378,NZ_CP090899,1,449392,449955,-,563
378,NZ_CP046924,1,450763,451326,+,563
378,NZ_OX366348,1,479234,479797,+,563
378,NZ_CP046921,1,513577,514140,+,563
378,NZ_OX366338,1,772975,773532,+,557
378,NZ_CP054557,1,203720,204283,-,563
378,NZ_CP072669,1,449240,449803,-,563
378,NC_021089,1,374592,375143,+,551
379,NZ_OX366376,1,1235004,1238075,+,3071
379,NZ_OX366393,1,441249,444320,+,3071
379,NZ_OX366372,1,290731,293802,+,3071
379,NZ_CP072672,1,772135,775254,-,3119
379,NZ_CP069060,1,615099,618218,-,3119
379,NZ_CP072667,1,772117,775236,-,3119
379,NZ_CP072671,1,772117,775236,-,3119
379,NZ_CP072668,1,772104,775223,-,3119
379,NZ_CP072666,1,772117,775236,-,3119
379,NZ_CP090902,1,772269,775388,-,3119
379,NZ_CP090948,1,772269,775388,-,3119
379,NZ_CP069052,1,1166089,1169208,-,3119
379,NZ_CP076228,1,764667,767786,+,3119
379,NZ_CP042445,1,772257,775376,-,3119
379,NZ_CP042904,1,795674,798784,-,3110
379,NC_012416,1,830547,833657,-,3110
379,NZ_CP069053,1,615107,618226,-,3119
379,NZ_CP042446,1,772269,775388,-,3119
379,NZ_CP041215,1,905842,908961,+,3119
379,NZ_OX366353,1,193135,196254,-,3119
379,NZ_OX366387,1,677482,680592,+,3110
379,NZ_OX366368,1,1218170,1221289,-,3119
379,NZ_OX366379,1,1137685,1140804,-,3119
379,NZ_CP091195,1,1481385,1484504,+,3119
379,NZ_OX366375,1,1065068,1068187,-,3119
379,NZ_CP046925,1,772117,775236,-,3119
379,NZ_OX366318,1,1069954,1073073,-,3119
379,NZ_OX366319,1,148719,151838,+,3119
379,NZ_OX366332,1,1154109,1157228,-,3119
379,NZ_CP110359,1,256320,259439,-,3119
379,NZ_OU953855,1,1367739,1370849,+,3110
379,NZ_OX366272,1,1221545,1224664,-,3119
379,NZ_OX366347,1,202286,205405,-,3119
379,NZ_OU909470,1,122340,125530,-,3190
379,NZ_OX366363,1,1169537,1172647,+,3110
379,NZ_OX366364,1,463487,466562,+,3075
379,NZ_OX366359,1,981918,985037,-,3119
379,NZ_OX366349,1,1270830,1273901,+,3071
379,NZ_OX366380,1,496717,499907,-,3190
379,NZ_OX366344,1,610022,613093,+,3071
379,NZ_CP090900,1,772269,775388,-,3119
379,NZ_OX366352,1,1230905,1234024,+,3119
379,NZ_OX366362,1,227657,230854,+,3197
379,NZ_OX366400,1,933366,936485,-,3119
379,NZ_OX366327,1,1069092,1072211,-,3119
379,NZ_OX366367,1,1289074,1292158,+,3084
379,NZ_CP042444,1,772704,775823,-,3119
379,NZ_OX366326,1,1277599,1280718,-,3119
379,NZ_CP037426,1,1219924,1223043,-,3119
379,NZ_OX366339,1,921762,924880,+,3118
379,NZ_OX366355,1,172936,176055,+,3119
379,NZ_CP046922,1,834082,837201,-,3119
379,NZ_OX366370,1,474595,477646,-,3051
379,NZ_OX366385,1,734097,737287,+,3190
379,NZ_OX366399,1,1172313,1175432,-,3119
379,NZ_OX366395,1,123356,126466,+,3110
379,NZ_OX366396,1,1209613,1212732,+,3119
379,NZ_OX366351,1,1224024,1227143,-,3119
379,NZ_OX366381,1,259427,262546,+,3119
379,NZ_OX366342,1,1337388,1340459,+,3071
379,NZ_OX366369,1,1257852,1260971,-,3119
379,NZ_OX366356,1,975414,978516,-,3102
379,NZ_OX366377,1,1154356,1157475,+,3119
379,NZ_OX366388,1,253370,256489,-,3119
379,NZ_OX366357,1,1147613,1150707,+,3094
379,NZ_CP072012,1,1405526,1408645,+,3119
379,NZ_OX366398,1,251932,255051,-,3119
379,NC_002978,6,772269,775388,-,3119
379,NZ_OX366389,1,1102136,1105255,+,3119
379,NZ_OX366397,1,1375643,1378762,-,3119
379,NZ_OX366378,1,535804,538923,+,3119
379,NZ_CP090903,1,772269,775388,-,3119
379,NZ_OX366374,1,786263,789358,+,3095
379,NZ_CP090901,1,772269,775388,-,3119
379,NZ_CP046923,1,750330,753449,-,3119
379,NZ_CP069055,1,771375,774494,-,3119
379,NZ_CP072670,1,772109,775228,-,3119
379,NZ_CP090899,1,772269,775388,-,3119
379,NZ_CP046924,1,771268,774387,-,3119
379,NZ_OX366348,1,206687,209806,+,3119
379,NZ_CP046921,1,834082,837201,-,3119
379,NZ_OX366338,1,1216240,1219359,+,3119
379,NZ_CP054557,1,1031068,1034187,+,3119
379,NZ_CP072669,1,772117,775236,-,3119
379,NC_021089,1,804371,807489,-,3118
380,NZ_OX366376,1,1238300,1240016,+,1716
380,NZ_OX366393,1,444545,446261,+,1716
380,NZ_OX366372,1,294027,295743,+,1716
380,NZ_CP072672,1,770169,771883,-,1714
380,NZ_CP069060,1,613133,614847,-,1714
380,NZ_CP072667,1,770151,771865,-,1714
380,NZ_CP072671,1,770151,771865,-,1714
380,NZ_CP072668,1,770138,771852,-,1714
380,NZ_CP072666,1,770151,771865,-,1714
380,NZ_CP090902,1,770303,772017,-,1714
380,NZ_CP090948,1,770303,772017,-,1714
380,NZ_CP069052,1,1164123,1165837,-,1714
380,NZ_CP076228,1,768037,769752,+,1715
380,NZ_CP042445,1,770291,772005,-,1714
380,NZ_CP042904,1,652890,654612,-,1722
380,NC_012416,1,688543,690265,-,1722
380,NZ_CP069053,1,613141,614855,-,1714
380,NZ_CP042446,1,770303,772017,-,1714
380,NZ_CP041215,1,909212,910927,+,1715
380,NZ_OX366353,1,191168,192882,-,1714
380,NZ_OX366387,1,681925,683640,+,1715
380,NZ_OX366368,1,1216204,1217918,-,1714
380,NZ_OX366379,1,1135719,1137433,-,1714
380,NZ_CP091195,1,1484755,1486470,+,1715
380,NZ_OX366375,1,1063102,1064816,-,1714
380,NZ_CP046925,1,770151,771865,-,1714
380,NZ_OX366318,1,1067988,1069702,-,1714
380,NZ_OX366319,1,152089,153804,+,1715
380,NZ_OX366332,1,1152144,1153857,-,1713
380,NZ_CP110359,1,436228,437948,+,1720
380,NZ_OU953855,1,1651651,1653371,+,1720
380,NZ_OX366272,1,1219579,1221293,-,1714
380,NZ_OX366347,1,200320,202034,-,1714
380,NZ_OX366363,1,1172898,1174613,+,1715
380,NZ_OX366364,1,466641,468368,+,1727
380,NZ_OX366359,1,979952,981666,-,1714
380,NZ_OX366349,1,1274135,1275851,+,1716
380,NZ_OX366380,1,494778,496476,-,1698
380,NZ_OX366344,1,613327,615043,+,1716
380,NZ_CP090900,1,770303,772017,-,1714
380,NZ_OX366352,1,1234275,1235990,+,1715
380,NZ_OX366362,1,231096,232803,+,1707
380,NZ_OX366400,1,931400,933114,-,1714
380,NZ_OX366327,1,1067135,1068840,-,1705
380,NZ_OX366367,1,1292237,1293964,+,1727
380,NZ_CP042444,1,770738,772452,-,1714
380,NZ_OX366326,1,1275633,1277347,-,1714
380,NZ_CP037426,1,1217958,1219672,-,1714
380,NZ_OX366339,1,925132,926847,+,1715
380,NZ_OX366355,1,176306,178021,+,1715
380,NZ_CP046922,1,832116,833830,-,1714
380,NZ_OX366370,1,472787,474514,-,1727
380,NZ_OX366385,1,737527,739226,+,1699
380,NZ_OX366399,1,1170347,1172061,-,1714
380,NZ_OX366395,1,126717,128432,+,1715
380,NZ_OX366396,1,1212982,1214697,+,1715
380,NZ_OX366351,1,1222058,1223772,-,1714
380,NZ_OX366381,1,262796,264512,+,1716
380,NZ_OX366342,1,1340684,1342400,+,1716
380,NZ_OX366369,1,1255886,1257600,-,1714
380,NZ_OX366356,1,973458,975173,-,1715
380,NZ_OX366377,1,1157726,1159441,+,1715
380,NZ_OX366388,1,251404,253118,-,1714
380,NZ_OX366357,1,94074,95789,-,1715
380,NZ_CP072012,1,1408896,1410571,+,1675
380,NZ_OX366398,1,249966,251680,-,1714
380,NC_002978,6,770303,772017,-,1714
380,NZ_OX366389,1,1105506,1107221,+,1715
380,NZ_OX366397,1,1373677,1375391,-,1714
380,NZ_OX366378,1,539174,540889,+,1715
380,NZ_CP090903,1,770303,772017,-,1714
380,NZ_OX366374,1,789618,791333,+,1715
380,NZ_CP090901,1,770303,772017,-,1714
380,NZ_CP046923,1,748364,750078,-,1714
380,NZ_CP069055,1,769409,771130,-,1721
380,NZ_CP072670,1,770143,771857,-,1714
380,NZ_CP090899,1,770303,772017,-,1714
380,NZ_CP046924,1,769302,771016,-,1714
380,NZ_OX366348,1,210057,211772,+,1715
380,NZ_CP046921,1,832116,833830,-,1714
380,NZ_OX366338,1,1221204,1222922,+,1718
380,NZ_CP054557,1,1034438,1036153,+,1715
380,NZ_CP072669,1,770151,771865,-,1714
380,NC_021089,1,802405,804119,-,1714
381,NZ_OX366376,1,1240302,1242741,+,2439
381,NZ_OX366393,1,446547,448991,+,2444
381,NZ_OX366372,1,296029,298467,+,2438
381,NZ_CP072672,1,767446,769881,-,2435
381,NZ_CP069060,1,610417,612845,-,2428
381,NZ_CP072667,1,767428,769863,-,2435
381,NZ_CP072671,1,767428,769863,-,2435
381,NZ_CP072668,1,767415,769850,-,2435
381,NZ_CP072666,1,767428,769863,-,2435
381,NZ_CP090902,1,767580,770015,-,2435
381,NZ_CP090948,1,767580,770015,-,2435
381,NZ_CP069052,1,1161407,1163835,-,2428
381,NZ_CP076228,1,770040,772475,+,2435
381,NZ_CP042445,1,767568,770003,-,2435
381,NZ_CP042904,1,650191,652612,-,2421
381,NC_012416,1,685844,688265,-,2421
381,NZ_CP069053,1,610425,612853,-,2428
381,NZ_CP042446,1,767580,770015,-,2435
381,NZ_CP041215,1,911215,913650,+,2435
381,NZ_OX366353,1,188445,190880,-,2435
381,NZ_OX366387,1,683920,686355,+,2435
381,NZ_OX366368,1,1213481,1215916,-,2435
381,NZ_OX366379,1,1132996,1135431,-,2435
381,NZ_CP091195,1,1486758,1489193,+,2435
381,NZ_OX366375,1,1060382,1062822,-,2440
381,NZ_CP046925,1,767428,769863,-,2435
381,NZ_OX366318,1,1065265,1067700,-,2435
381,NZ_OX366319,1,154084,156519,+,2435
381,NZ_OX366332,1,1149421,1151856,-,2435
381,NZ_CP110359,1,438236,440671,+,2435
381,NZ_OU953855,1,1653659,1656094,+,2435
381,NZ_OX366272,1,1216856,1219291,-,2435
381,NZ_OX366347,1,197597,200032,-,2435
381,NZ_OX366363,1,1174901,1177336,+,2435
381,NZ_OX366364,1,468656,471090,+,2434
381,NZ_OX366359,1,977229,979664,-,2435
381,NZ_OX366349,1,1276137,1278576,+,2439
381,NZ_OX366380,1,492060,494492,-,2432
381,NZ_OX366344,1,615329,617768,+,2439
381,NZ_CP090900,1,767580,770015,-,2435
381,NZ_OX366352,1,1236278,1238713,+,2435
381,NZ_OX366362,1,233091,235526,+,2435
381,NZ_OX366400,1,928677,931112,-,2435
381,NZ_OX366327,1,1064431,1066857,-,2426
381,NZ_OX366367,1,1294252,1296672,+,2420
381,NZ_CP042444,1,768015,770450,-,2435
381,NZ_OX366326,1,1272910,1275345,-,2435
381,NZ_CP037426,1,1215238,1217678,-,2440
381,NZ_OX366339,1,927135,929570,+,2435
381,NZ_OX366355,1,178301,180736,+,2435
381,NZ_CP046922,1,829393,831828,-,2435
381,NZ_OX366370,1,470066,472501,-,2435
381,NZ_OX366385,1,739512,741944,+,2432
381,NZ_OX366399,1,1167624,1170059,-,2435
381,NZ_OX366395,1,128720,131155,+,2435
381,NZ_OX366396,1,1214985,1217420,+,2435
381,NZ_OX366351,1,1219335,1221770,-,2435
381,NZ_OX366381,1,264792,267227,+,2435
381,NZ_OX366342,1,1342686,1345125,+,2439
381,NZ_OX366369,1,1253171,1255606,-,2435
381,NZ_OX366356,1,970725,973170,-,2445
381,NZ_OX366377,1,1159729,1162164,+,2435
381,NZ_OX366388,1,248681,251116,-,2435
381,NZ_OX366357,1,1164597,1167019,+,2422
381,NZ_CP072012,1,1411818,1414258,+,2440
381,NZ_OX366398,1,247243,249678,-,2435
381,NC_002978,6,767580,770015,-,2435
381,NZ_OX366389,1,1107509,1109944,+,2435
381,NZ_OX366397,1,1370954,1373389,-,2435
381,NZ_OX366378,1,541177,543612,+,2435
381,NZ_CP090903,1,767580,770015,-,2435
381,NZ_OX366374,1,791621,794056,+,2435
381,NZ_CP090901,1,767580,770015,-,2435
381,NZ_CP046923,1,745641,748076,-,2435
381,NZ_CP069055,1,766688,769121,-,2433
381,NZ_CP072670,1,767420,769855,-,2435
381,NZ_CP090899,1,767580,770015,-,2435
381,NZ_CP046924,1,766579,769014,-,2435
381,NZ_OX366348,1,212060,214495,+,2435
381,NZ_CP046921,1,829393,831828,-,2435
381,NZ_OX366338,1,1223210,1225645,+,2435
381,NZ_CP054557,1,1037472,1039899,+,2427
381,NZ_CP072669,1,767428,769863,-,2435
381,NC_021089,1,799682,802117,-,2435
382,NZ_OX366376,1,1243223,1245448,+,2225
382,NZ_OX366393,1,449473,451698,+,2225
382,NZ_OX366372,1,298949,301174,+,2225
382,NZ_CP072672,1,861971,864190,+,2219
382,NZ_CP069060,1,705893,708112,+,2219
382,NZ_CP072667,1,861945,864164,+,2219
382,NZ_CP072671,1,861953,864172,+,2219
382,NZ_CP072668,1,861940,864159,+,2219
382,NZ_CP072666,1,861953,864172,+,2219
382,NZ_CP090902,1,862105,864324,+,2219
382,NZ_CP090948,1,862105,864324,+,2219
382,NZ_CP069052,1,947959,950178,-,2219
382,NZ_CP076228,1,859851,862070,+,2219
382,NZ_CP042445,1,862093,864312,+,2219
382,NZ_CP042904,1,883721,885940,-,2219
382,NC_012416,1,919303,921522,-,2219
382,NZ_CP069053,1,705901,708120,+,2219
382,NZ_CP042446,1,862105,864324,+,2219
382,NZ_CP041215,1,1298418,1300654,+,2236
382,NZ_OX366353,1,788260,790495,-,2235
382,NZ_OX366387,1,1764794,1767013,+,2219
382,NZ_OX366368,1,1308266,1310485,+,2219
382,NZ_OX366379,1,1245727,1247946,-,2219
382,NZ_CP091195,1,1040921,1043140,-,2219
382,NZ_OX366375,1,1228637,1230856,+,2219
382,NZ_CP046925,1,861953,864172,+,2219
382,NZ_OX366318,1,1161279,1163498,+,2219
382,NZ_OX366319,1,1208398,1210617,-,2219
382,NZ_OX366332,1,1207802,1210038,+,2236
382,NZ_CP110359,1,354067,356285,+,2218
382,NZ_OU953855,1,1464833,1467052,-,2219
382,NZ_OX366272,1,219790,222009,+,2219
382,NZ_OX366347,1,1221604,1223823,+,2219
382,NZ_OX366363,1,932453,934672,+,2219
382,NZ_OX366364,1,20121,22341,-,2220
382,NZ_OX366359,1,1074939,1077175,-,2236
382,NZ_OX366349,1,1280161,1282386,+,2225
382,NZ_OX366380,1,489368,491579,-,2211
382,NZ_OX366344,1,618250,620473,+,2223
382,NZ_CP090900,1,862105,864324,+,2219
382,NZ_OX366352,1,247482,249718,-,2236
382,NZ_OX366362,1,366517,368688,-,2171
382,NZ_OX366400,1,1025519,1027738,+,2219
382,NZ_OX366327,1,1161000,1163219,+,2219
382,NZ_OX366367,1,1305545,1307772,-,2227
382,NZ_CP042444,1,862540,864759,+,2219
382,NZ_OX366326,1,1368989,1371208,+,2219
382,NZ_CP037426,1,654465,656684,+,2219
382,NZ_OX366339,1,812979,815199,-,2220
382,NZ_OX366355,1,1265582,1267801,+,2219
382,NZ_CP046922,1,924009,926228,+,2219
382,NZ_OX366370,1,339248,341480,-,2232
382,NZ_OX366385,1,742425,744636,+,2211
382,NZ_OX366399,1,1262326,1264545,+,2219
382,NZ_OX366395,1,1258693,1260890,-,2197
382,NZ_OX366396,1,188612,190831,-,2219
382,NZ_OX366351,1,1315415,1317634,+,2219
382,NZ_OX366381,1,1117345,1119564,-,2219
382,NZ_OX366342,1,1345607,1347832,+,2225
382,NZ_OX366369,1,1356440,1358659,+,2219
382,NZ_OX366356,1,1072389,1074608,-,2219
382,NZ_OX366377,1,1063751,1065972,-,2221
382,NZ_OX366388,1,47579,49798,-,2219
382,NZ_OX366357,1,404821,407030,+,2209
382,NZ_CP072012,1,701808,704027,-,2219
382,NZ_OX366398,1,342946,345166,+,2220
382,NC_002978,6,862105,864324,+,2219
382,NZ_OX366389,1,1235768,1237988,+,2220
382,NZ_OX366397,1,1469350,1471585,-,2235
382,NZ_OX366378,1,186373,188592,+,2219
382,NZ_CP090903,1,862105,864324,+,2219
382,NZ_OX366374,1,124849,127046,+,2197
382,NZ_CP090901,1,862105,864324,+,2219
382,NZ_CP046923,1,840257,842476,+,2219
382,NZ_CP069055,1,941533,943752,-,2219
382,NZ_CP072670,1,861945,864164,+,2219
382,NZ_CP090899,1,862105,864324,+,2219
382,NZ_CP046924,1,861195,863414,+,2219
382,NZ_OX366348,1,116971,119190,-,2219
382,NZ_CP046921,1,924009,926228,+,2219
382,NZ_OX366338,1,1337663,1339860,-,2197
382,NZ_CP054557,1,940172,942391,-,2219
382,NZ_CP072669,1,861953,864172,+,2219
382,NC_021089,1,858139,860375,+,2236
383,NZ_OX366376,1,1248503,1249077,+,574
383,NZ_OX366393,1,1118286,1118860,-,574
383,NZ_OX366372,1,304050,304624,+,574
383,NZ_CP072672,1,1238894,1239460,+,566
383,NZ_CP069060,1,1379793,1380359,+,566
383,NZ_CP072667,1,1238868,1239434,+,566
383,NZ_CP072671,1,1238876,1239442,+,566
383,NZ_CP072668,1,1238863,1239429,+,566
383,NZ_CP072666,1,1238876,1239442,+,566
383,NZ_CP090902,1,1239029,1239595,+,566
383,NZ_CP090948,1,1239027,1239593,+,566
383,NZ_CP069052,1,1324093,1324659,+,566
383,NZ_CP076228,1,1259765,1260331,+,566
383,NZ_CP042445,1,1238681,1239247,+,566
383,NZ_CP042904,1,1369870,1370436,+,566
383,NC_012416,1,1413079,1413645,+,566
383,NZ_CP069053,1,1365091,1365657,+,566
383,NZ_CP042446,1,1239026,1239592,+,566
383,NZ_CP041215,1,610605,611172,-,567
383,NZ_OX366353,1,600054,600621,-,567
383,NZ_OX366387,1,603419,603986,-,567
383,NZ_OX366368,1,252450,253016,+,566
383,NZ_OX366379,1,253468,254034,+,566
383,NZ_CP091195,1,883057,883624,-,567
383,NZ_OX366375,1,271178,271744,+,566
383,NZ_CP046925,1,1238876,1239442,+,566
383,NZ_OX366318,1,343172,343738,+,566
383,NZ_OX366319,1,949806,950373,-,567
383,NZ_OX366332,1,250432,250998,+,566
383,NZ_CP110359,1,1279521,1280087,+,566
383,NZ_OU953855,1,768929,769477,+,548
383,NZ_OX366272,1,233454,234020,+,566
383,NZ_OX366347,1,361700,362266,+,566
383,NZ_OU909470,1,139024,139598,+,574
383,NZ_OX366363,1,685576,686143,-,567
383,NZ_OX366364,1,61052,61626,+,574
383,NZ_OX366359,1,249249,249815,+,566
383,NZ_OX366349,1,1285820,1286394,+,574
383,NZ_OX366380,1,485788,486362,-,574
383,NZ_OX366344,1,623593,624167,+,574
383,NZ_CP090900,1,1239031,1239597,+,566
383,NZ_OX366352,1,1440399,1440966,-,567
383,NZ_OX366362,1,1004289,1004863,+,574
383,NZ_OX366400,1,252153,252727,+,574
383,NZ_OX366327,1,253764,254330,+,566
383,NZ_OX366367,1,1344801,1345375,+,574
383,NZ_CP042444,1,1240382,1240948,+,566
383,NZ_OX366326,1,541774,542341,-,567
383,NZ_CP037426,1,1322957,1323523,+,566
383,NZ_OX366339,1,1282214,1282781,-,567
383,NZ_OX366355,1,1065561,1066128,-,567
383,NZ_CP046922,1,1300831,1301397,+,566
383,NZ_OX366370,1,337472,338046,-,574
383,NZ_OX366385,1,534919,535493,-,574
383,NZ_OX366399,1,251952,252518,+,566
383,NZ_OX366395,1,396306,396872,+,566
383,NZ_OX366396,1,471373,471939,+,566
383,NZ_OX366351,1,262790,263356,+,566
383,NZ_OX366381,1,1133462,1134029,-,567
383,NZ_OX366342,1,1350763,1351337,+,574
383,NZ_OX366369,1,247394,247960,+,566
383,NZ_OX366356,1,283236,283810,+,574
383,NZ_OX366377,1,333144,333711,-,567
383,NZ_OX366388,1,1527368,1527935,-,567
383,NZ_OX366357,1,16367,16941,-,574
383,NZ_CP072012,1,1064928,1065495,-,567
383,NZ_OX366398,1,941667,942234,-,567
383,NC_002978,6,1239027,1239593,+,566
383,NZ_OX366389,1,308466,309032,+,566
383,NZ_OX366397,1,250137,250703,+,566
383,NZ_OX366378,1,1032205,1032771,+,566
383,NZ_CP090903,1,1239031,1239597,+,566
383,NZ_OX366374,1,252461,253028,-,567
383,NZ_CP090901,1,1239031,1239597,+,566
383,NZ_CP046923,1,1217079,1217645,+,566
383,NZ_CP069055,1,1239166,1239732,+,566
383,NZ_CP072670,1,1238856,1239422,+,566
383,NZ_CP090899,1,1239031,1239597,+,566
383,NZ_CP046924,1,1238017,1238583,+,566
383,NZ_OX366348,1,999982,1000549,-,567
383,NZ_CP046921,1,1300831,1301397,+,566
383,NZ_OX366338,1,1452809,1453375,+,566
383,NZ_CP054557,1,563258,563780,-,522
383,NZ_CP072669,1,1238879,1239445,+,566
383,NC_021089,1,1265589,1266155,+,566
384,NZ_OX366376,1,1249471,1254177,+,4706
384,NZ_OX366393,1,1113183,1117892,-,4709
384,NZ_OX366372,1,305017,309726,+,4709
384,NZ_CP072672,1,1239795,1244477,+,4682
384,NZ_CP069060,1,1380694,1385376,+,4682
384,NZ_CP072667,1,1239769,1244451,+,4682
384,NZ_CP072671,1,1239777,1244459,+,4682
384,NZ_CP072668,1,1239764,1244446,+,4682
384,NZ_CP072666,1,1239777,1244459,+,4682
384,NZ_CP090902,1,1239930,1244612,+,4682
384,NZ_CP090948,1,1239928,1244610,+,4682
384,NZ_CP069052,1,1324994,1329676,+,4682
384,NZ_CP076228,1,1260666,1265375,+,4709
384,NZ_CP042445,1,1239582,1244264,+,4682
384,NZ_CP042904,1,1370771,1375480,+,4709
384,NC_012416,1,1413980,1418689,+,4709
384,NZ_CP069053,1,1365992,1370674,+,4682
384,NZ_CP042446,1,1239927,1244609,+,4682
384,NZ_CP041215,1,605562,610271,-,4709
384,NZ_OX366353,1,595011,599720,-,4709
384,NZ_OX366387,1,598376,603085,-,4709
384,NZ_OX366368,1,253351,258060,+,4709
384,NZ_OX366379,1,254369,259078,+,4709
384,NZ_CP091195,1,878014,882723,-,4709
384,NZ_OX366375,1,272079,276800,+,4721
384,NZ_CP046925,1,1239777,1244459,+,4682
384,NZ_OX366318,1,344073,348782,+,4709
384,NZ_OX366319,1,944763,949472,-,4709
384,NZ_OX366332,1,251348,256015,+,4667
384,NZ_CP110359,1,1280422,1285131,+,4709
384,NZ_OU953855,1,770055,774755,+,4700
384,NZ_OX366272,1,234355,239064,+,4709
384,NZ_OX366347,1,362601,367283,+,4682
384,NZ_OU909470,1,139918,144625,+,4707
384,NZ_OX366363,1,680560,685242,-,4682
384,NZ_OX366364,1,62008,66696,+,4688
384,NZ_OX366359,1,250150,254850,+,4700
384,NZ_OX366349,1,1286788,1291497,+,4709
384,NZ_OX366380,1,480761,485467,-,4706
384,NZ_OX366344,1,624561,629270,+,4709
384,NZ_CP090900,1,1239932,1244614,+,4682
384,NZ_OX366352,1,1435356,1440065,-,4709
384,NZ_OX366362,1,1005184,1009884,+,4700
384,NZ_OX366400,1,253905,258614,+,4709
384,NZ_OX366327,1,254665,259374,+,4709
384,NZ_OX366367,1,1345781,1350469,+,4688
384,NZ_CP042444,1,1241283,1245965,+,4682
384,NZ_OX366326,1,536731,541440,-,4709
384,NZ_CP037426,1,1323858,1328567,+,4709
384,NZ_OX366339,1,1277171,1281880,-,4709
384,NZ_OX366355,1,1060518,1065227,-,4709
384,NZ_CP046922,1,1301732,1306414,+,4682
384,NZ_OX366370,1,332381,337078,-,4697
384,NZ_OX366385,1,529904,534598,-,4694
384,NZ_OX366399,1,252853,257562,+,4709
384,NZ_OX366395,1,397207,401914,+,4707
384,NZ_OX366396,1,472274,476983,+,4709
384,NZ_OX366351,1,263691,268400,+,4709
384,NZ_OX366381,1,1128419,1133128,-,4709
384,NZ_OX366342,1,1351731,1356440,+,4709
384,NZ_OX366369,1,248295,253004,+,4709
384,NZ_OX366356,1,284137,288831,+,4694
384,NZ_OX366377,1,327280,331959,-,4679
384,NZ_OX366388,1,1522334,1527034,-,4700
384,NZ_OX366357,1,11276,15974,-,4698
384,NZ_CP072012,1,1059885,1064594,-,4709
384,NZ_OX366398,1,935773,940482,-,4709
384,NC_002978,6,1239928,1244610,+,4682
384,NZ_OX366389,1,310218,314900,+,4682
384,NZ_OX366397,1,251038,255747,+,4709
384,NZ_OX366378,1,1033106,1037815,+,4709
384,NZ_CP090903,1,1239932,1244614,+,4682
384,NZ_OX366374,1,247418,252127,-,4709
384,NZ_CP090901,1,1239932,1244614,+,4682
384,NZ_CP046923,1,1217980,1222662,+,4682
384,NZ_CP069055,1,1240067,1244776,+,4709
384,NZ_CP072670,1,1239757,1244439,+,4682
384,NZ_CP090899,1,1239932,1244614,+,4682
384,NZ_CP046924,1,1238918,1243600,+,4682
384,NZ_OX366348,1,994939,999648,-,4709
384,NZ_CP046921,1,1301732,1306414,+,4682
384,NZ_OX366338,1,1453710,1458419,+,4709
384,NZ_CP054557,1,558227,562924,-,4697
384,NZ_CP072669,1,1239780,1244462,+,4682
384,NC_021089,1,1266490,1271199,+,4709
385,NZ_OX366376,1,1254286,1255152,+,866
385,NZ_OX366393,1,1112208,1113074,-,866
385,NZ_OX366372,1,309835,310701,+,866
385,NZ_CP072672,1,1244585,1245446,+,861
385,NZ_CP069060,1,1385484,1386352,+,868
385,NZ_CP072667,1,1244559,1245420,+,861
385,NZ_CP072671,1,1244567,1245428,+,861
385,NZ_CP072668,1,1244554,1245415,+,861
385,NZ_CP072666,1,1244567,1245428,+,861
385,NZ_CP090902,1,1244720,1245581,+,861
385,NZ_CP090948,1,1244718,1245579,+,861
385,NZ_CP069052,1,1329784,1330652,+,868
385,NZ_CP076228,1,1265483,1266351,+,868
385,NZ_CP042445,1,1244372,1245233,+,861
385,NZ_CP042904,1,1375588,1376456,+,868
385,NC_012416,1,1418797,1419665,+,868
385,NZ_CP069053,1,1370782,1371650,+,868
385,NZ_CP042446,1,1244717,1245578,+,861
385,NZ_CP041215,1,604586,605454,-,868
385,NZ_OX366353,1,594035,594903,-,868
385,NZ_OX366387,1,597400,598268,-,868
385,NZ_OX366368,1,258168,259036,+,868
385,NZ_OX366379,1,259186,260054,+,868
385,NZ_CP091195,1,876153,877021,-,868
385,NZ_OX366375,1,276908,277768,+,860
385,NZ_CP046925,1,1244567,1245428,+,861
385,NZ_OX366318,1,348890,349758,+,868
385,NZ_OX366319,1,943823,944691,-,868
385,NZ_OX366332,1,256123,256991,+,868
385,NZ_CP110359,1,1285239,1286107,+,868
385,NZ_OU953855,1,774863,775731,+,868
385,NZ_OX366272,1,239172,240040,+,868
385,NZ_OX366347,1,367391,368259,+,868
385,NZ_OU909470,1,144734,145600,+,866
385,NZ_OX366363,1,679584,680452,-,868
385,NZ_OX366364,1,66806,67671,+,865
385,NZ_OX366359,1,254958,255826,+,868
385,NZ_OX366349,1,1291606,1292448,+,842
385,NZ_OX366380,1,479786,480652,-,866
385,NZ_OX366344,1,629379,630245,+,866
385,NZ_CP090900,1,1244722,1245583,+,861
385,NZ_OX366352,1,1434380,1435248,-,868
385,NZ_OX366362,1,1009994,1010860,+,866
385,NZ_OX366400,1,258722,259590,+,868
385,NZ_OX366327,1,259482,260350,+,868
385,NZ_OX366367,1,1350579,1351444,+,865
385,NZ_CP042444,1,1246073,1246934,+,861
385,NZ_OX366326,1,535755,536623,-,868
385,NZ_CP037426,1,1328675,1329543,+,868
385,NZ_OX366339,1,1276195,1277063,-,868
385,NZ_OX366355,1,1059578,1060446,-,868
385,NZ_CP046922,1,1306522,1307383,+,861
385,NZ_OX366370,1,331406,332272,-,866
385,NZ_OX366385,1,528929,529795,-,866
385,NZ_OX366399,1,257670,258538,+,868
385,NZ_OX366395,1,402022,402890,+,868
385,NZ_OX366396,1,477091,477959,+,868
385,NZ_OX366351,1,268508,269376,+,868
385,NZ_OX366381,1,1127479,1128347,-,868
385,NZ_OX366342,1,1356549,1357415,+,866
385,NZ_OX366369,1,253112,253980,+,868
385,NZ_OX366356,1,288939,289803,+,864
385,NZ_OX366377,1,326304,327172,-,868
385,NZ_OX366388,1,1521358,1522226,-,868
385,NZ_OX366357,1,10300,11168,-,868
385,NZ_CP072012,1,1058909,1059777,-,868
385,NZ_OX366398,1,934797,935665,-,868
385,NC_002978,6,1244718,1245579,+,861
385,NZ_OX366389,1,315008,315876,+,868
385,NZ_OX366397,1,255855,256723,+,868
385,NZ_OX366378,1,857440,858308,+,868
385,NZ_CP090903,1,1244722,1245583,+,861
385,NZ_OX366374,1,245465,246333,-,868
385,NZ_CP090901,1,1244722,1245583,+,861
385,NZ_CP046923,1,1222770,1223631,+,861
385,NZ_CP069055,1,1244884,1245752,+,868
385,NZ_CP072670,1,1244547,1245408,+,861
385,NZ_CP090899,1,1244722,1245583,+,861
385,NZ_CP046924,1,1243708,1244569,+,861
385,NZ_OX366348,1,993963,994831,-,868
385,NZ_CP046921,1,1306522,1307383,+,861
385,NZ_OX366338,1,1458527,1459395,+,868
385,NZ_CP054557,1,557251,558119,-,868
385,NZ_CP072669,1,1244570,1245431,+,861
385,NC_021089,1,1271307,1272175,+,868
386,NZ_OX366376,1,1257548,1258363,+,815
386,NZ_OX366393,1,1108975,1109790,-,815
386,NZ_OX366372,1,313118,313932,+,814
386,NZ_OX366349,1,1294934,1295764,+,830
386,NZ_OX366370,1,328234,329048,-,814
386,NZ_OX366342,1,1359811,1360626,+,815
387,NZ_OX366376,1,1258995,1261670,+,2675
387,NZ_OX366393,1,1105898,1108573,-,2675
387,NZ_OX366372,1,314406,317081,+,2675
387,NZ_CP072672,1,1248191,1250891,+,2700
387,NZ_CP069060,1,1389541,1392241,+,2700
387,NZ_CP072667,1,1248165,1250865,+,2700
387,NZ_CP072671,1,1248173,1250873,+,2700
387,NZ_CP072668,1,1248160,1250860,+,2700
387,NZ_CP072666,1,1248173,1250873,+,2700
387,NZ_CP090902,1,1248326,1251026,+,2700
387,NZ_CP090948,1,1248324,1251024,+,2700
387,NZ_CP069052,1,1333841,1336541,+,2700
387,NZ_CP076228,1,1269226,1271926,+,2700
387,NZ_CP042445,1,1247978,1250678,+,2700
387,NZ_CP042904,1,1378960,1381660,+,2700
387,NC_012416,1,1422169,1424869,+,2700
387,NZ_CP069053,1,1374839,1377539,+,2700
387,NZ_CP042446,1,1248323,1251023,+,2700
387,NZ_CP041215,1,599252,601937,-,2685
387,NZ_OX366353,1,718753,721425,+,2672
387,NZ_OX366387,1,592389,595097,-,2708
387,NZ_OX366368,1,262460,265160,+,2700
387,NZ_OX366379,1,263478,266178,+,2700
387,NZ_CP091195,1,870939,873647,-,2708
387,NZ_OX366375,1,280514,283214,+,2700
387,NZ_CP046925,1,1248173,1250873,+,2700
387,NZ_OX366318,1,352401,355101,+,2700
387,NZ_OX366319,1,938601,941310,-,2709
387,NZ_OX366332,1,259517,262202,+,2685
387,NZ_CP110359,1,1288640,1291349,+,2709
387,NZ_OU953855,1,778365,781020,+,2655
387,NZ_OX366272,1,242573,245303,+,2730
387,NZ_OX366347,1,371050,373722,+,2672
387,NZ_OU909470,1,148069,150768,+,2699
387,NZ_OX366363,1,674385,677026,-,2641
387,NZ_OX366364,1,23168,25823,-,2655
387,NZ_OX366359,1,258109,260794,+,2685
387,NZ_OX366349,1,1296562,1299236,+,2674
387,NZ_OX366380,1,474596,477296,-,2700
387,NZ_OX366344,1,635248,637912,+,2664
387,NZ_CP090900,1,1248328,1251028,+,2700
387,NZ_OX366352,1,1429169,1431854,-,2685
387,NZ_OX366362,1,513164,515823,-,2659
387,NZ_OX366400,1,262233,264933,+,2700
387,NZ_OX366327,1,262864,265564,+,2700
387,NZ_OX366367,1,1308599,1311254,-,2655
387,NZ_CP042444,1,1249679,1252379,+,2700
387,NZ_OX366326,1,530711,533384,-,2673
387,NZ_CP037426,1,1332378,1335078,+,2700
387,NZ_OX366339,1,1270956,1273627,-,2671
387,NZ_OX366355,1,1054356,1057065,-,2709
387,NZ_CP046922,1,1310128,1312828,+,2700
387,NZ_OX366370,1,325307,327971,-,2664
387,NZ_OX366385,1,523739,526439,-,2700
387,NZ_OX366399,1,261962,264662,+,2700
387,NZ_OX366395,1,405282,407941,+,2659
387,NZ_OX366396,1,482401,485073,+,2672
387,NZ_OX366351,1,271746,274420,+,2674
387,NZ_OX366381,1,1122257,1124966,-,2709
387,NZ_OX366342,1,1360939,1363614,+,2675
387,NZ_OX366369,1,256652,259361,+,2709
387,NZ_OX366356,1,292412,295121,+,2709
387,NZ_OX366377,1,320950,323650,-,2700
387,NZ_OX366388,1,1516137,1518845,-,2708
387,NZ_OX366357,1,1160395,1163066,-,2671
387,NZ_CP072012,1,1052785,1055485,-,2700
387,NZ_OX366398,1,929443,932143,-,2700
387,NC_002978,6,1248324,1251024,+,2700
387,NZ_OX366389,1,318231,320931,+,2700
387,NZ_OX366397,1,259372,262057,+,2685
387,NZ_OX366378,1,860821,863529,+,2708
387,NZ_CP090903,1,1248328,1251028,+,2700
387,NZ_OX366374,1,240237,242908,-,2671
387,NZ_CP090901,1,1248328,1251028,+,2700
387,NZ_CP046923,1,1226376,1229076,+,2700
387,NZ_CP069055,1,1248999,1251699,+,2700
387,NZ_CP072670,1,1248153,1250853,+,2700
387,NZ_CP090899,1,1248328,1251028,+,2700
387,NZ_CP046924,1,1247314,1250014,+,2700
387,NZ_OX366348,1,987449,990158,-,2709
387,NZ_CP046921,1,1310128,1312828,+,2700
387,NZ_OX366338,1,1461793,1464452,+,2659
387,NZ_CP054557,1,551835,554544,-,2709
387,NZ_CP072669,1,1248176,1250876,+,2700
387,NC_021089,1,1274823,1277508,+,2685
388,NZ_OX366376,1,1266482,1267043,+,561
388,NZ_OX366393,1,658692,659253,+,561
388,NZ_OX366372,1,321892,322453,+,561
388,NZ_OX366344,1,641378,641938,+,560
388,NZ_OX366362,1,1144548,1145105,-,557
388,NZ_OX366342,1,1326388,1326949,-,561
389,NZ_OX366376,1,1267896,1269324,+,1428
389,NZ_OX366393,1,660106,661534,+,1428
389,NZ_OX366372,1,323306,324734,+,1428
389,NZ_CP072672,1,1255252,1256686,+,1434
389,NZ_CP069060,1,1396602,1398036,+,1434
389,NZ_CP072667,1,1255226,1256660,+,1434
389,NZ_CP072671,1,1255234,1256668,+,1434
389,NZ_CP072668,1,1255221,1256655,+,1434
389,NZ_CP072666,1,1255234,1256668,+,1434
389,NZ_CP090902,1,1255387,1256821,+,1434
389,NZ_CP090948,1,1255385,1256819,+,1434
389,NZ_CP069052,1,1340902,1342336,+,1434
389,NZ_CP076228,1,1277203,1278637,+,1434
389,NZ_CP042445,1,1255039,1256473,+,1434
389,NZ_CP042904,1,1386090,1387525,+,1435
389,NC_012416,1,1429299,1430734,+,1435
389,NZ_CP069053,1,1381900,1383334,+,1434
389,NZ_CP042446,1,1255384,1256818,+,1434
389,NZ_CP041215,1,591260,592694,-,1434
389,NZ_OX366353,1,727302,728736,+,1434
389,NZ_OX366387,1,584486,585920,-,1434
389,NZ_OX366368,1,269521,270955,+,1434
389,NZ_OX366379,1,270539,271973,+,1434
389,NZ_CP091195,1,1412206,1413641,-,1435
389,NZ_OX366375,1,287570,289005,+,1435
389,NZ_CP046925,1,1255234,1256668,+,1434
389,NZ_OX366318,1,360381,361815,+,1434
389,NZ_OX366319,1,931907,933341,-,1434
389,NZ_OX366332,1,268082,269516,+,1434
389,NZ_CP110359,1,1295778,1297212,+,1434
389,NZ_OU953855,1,1754544,1755978,-,1434
389,NZ_OX366272,1,226503,227937,-,1434
389,NZ_OX366347,1,378142,379576,+,1434
389,NZ_OU909470,1,156446,157881,+,1435
389,NZ_OX366363,1,667062,668496,-,1434
389,NZ_OX366364,1,472905,474323,-,1418
389,NZ_OX366359,1,266672,268106,+,1434
389,NZ_OX366349,1,1303246,1304674,+,1428
389,NZ_OX366380,1,469839,471273,-,1434
389,NZ_OX366344,1,642791,644219,+,1428
389,NZ_CP090900,1,1255389,1256823,+,1434
389,NZ_OX366352,1,1421857,1423291,-,1434
389,NZ_OX366362,1,1142265,1143700,-,1435
389,NZ_OX366400,1,270251,271685,+,1434
389,NZ_OX366327,1,272124,273558,+,1434
389,NZ_OX366367,1,1298274,1299708,-,1434
389,NZ_CP042444,1,1256740,1258174,+,1434
389,NZ_OX366326,1,523997,525431,-,1434
389,NZ_CP037426,1,1339432,1340867,+,1435
389,NZ_OX366339,1,1305898,1307333,+,1435
389,NZ_OX366355,1,1045846,1047280,-,1434
389,NZ_CP046922,1,1318108,1319542,+,1434
389,NZ_OX366370,1,320666,322067,-,1401
389,NZ_OX366385,1,518982,520416,-,1434
389,NZ_OX366399,1,269023,270457,+,1434
389,NZ_OX366395,1,413444,414879,+,1435
389,NZ_OX366396,1,328284,329719,+,1435
389,NZ_OX366351,1,279700,281134,+,1434
389,NZ_OX366381,1,1332096,1333530,+,1434
389,NZ_OX366342,1,1324108,1325536,-,1428
389,NZ_OX366369,1,263783,265218,+,1435
389,NZ_OX366356,1,298226,299661,+,1435
389,NZ_OX366377,1,315079,316513,-,1434
389,NZ_OX366388,1,1509249,1510684,-,1435
389,NZ_OX366357,1,1275905,1277339,-,1434
389,NZ_CP072012,1,1046990,1048424,-,1434
389,NZ_OX366398,1,922721,924155,-,1434
389,NC_002978,6,1255385,1256819,+,1434
389,NZ_OX366389,1,325368,326802,+,1434
389,NZ_OX366397,1,267936,269370,+,1434
389,NZ_OX366378,1,929447,930882,-,1435
389,NZ_CP090903,1,1255389,1256823,+,1434
389,NZ_OX366374,1,234014,235449,-,1435
389,NZ_CP090901,1,1255389,1256823,+,1434
389,NZ_CP046923,1,1234356,1235790,+,1434
389,NZ_CP069055,1,1256060,1257494,+,1434
389,NZ_CP072670,1,1255214,1256648,+,1434
389,NZ_CP090899,1,1255389,1256823,+,1434
389,NZ_CP046924,1,1255294,1256728,+,1434
389,NZ_OX366348,1,981577,983011,-,1434
389,NZ_CP046921,1,1318108,1319542,+,1434
389,NZ_OX366338,1,382124,383559,+,1435
389,NZ_CP054557,1,701457,702891,+,1434
389,NZ_CP072669,1,1255237,1256671,+,1434
389,NC_021089,1,1283386,1284820,+,1434
390,NZ_OX366376,1,1271362,1271957,+,595
390,NZ_OX366393,1,663572,664167,+,595
390,NZ_OX366372,1,326772,327367,+,595
390,NZ_CP072672,1,1187491,1188085,-,594
390,NZ_CP069060,1,1328324,1328918,-,594
390,NZ_CP072667,1,1187465,1188059,-,594
390,NZ_CP072671,1,1187473,1188067,-,594
390,NZ_CP072668,1,1187460,1188054,-,594
390,NZ_CP072666,1,1187473,1188067,-,594
390,NZ_CP090902,1,1187626,1188220,-,594
390,NZ_CP090948,1,1187624,1188218,-,594
390,NZ_CP069052,1,1272624,1273218,-,594
390,NZ_CP076228,1,1208031,1208625,-,594
390,NZ_CP042445,1,1187613,1188207,-,594
390,NZ_CP042904,1,1263088,1263682,-,594
390,NC_012416,1,1308304,1308898,-,594
390,NZ_CP069053,1,1313622,1314216,-,594
390,NZ_CP042446,1,1187623,1188217,-,594
390,NZ_CP041215,1,211072,211661,-,589
390,NZ_OX366353,1,626186,626776,+,590
390,NZ_OX366387,1,389933,390523,+,590
390,NZ_OX366368,1,200668,201262,-,594
390,NZ_OX366379,1,201686,202280,-,594
390,NZ_CP091195,1,936048,936643,+,595
390,NZ_OX366375,1,201285,201874,-,589
390,NZ_CP046925,1,1187473,1188067,-,594
390,NZ_OX366318,1,195785,196379,-,594
390,NZ_OX366319,1,1003041,1003631,+,590
390,NZ_OX366332,1,197799,198388,-,589
390,NZ_CP110359,1,1225448,1226037,-,589
390,NZ_OU953855,1,479767,480361,-,594
390,NZ_OX366272,1,433766,434356,+,590
390,NZ_OX366347,1,310128,310717,-,589
390,NZ_OX366363,1,739165,739760,+,595
390,NZ_OX366364,1,1146227,1146822,+,595
390,NZ_OX366359,1,196932,197521,-,589
390,NZ_OX366349,1,1309021,1309616,+,595
390,NZ_OX366380,1,463581,464159,-,578
390,NZ_OX366344,1,646126,646721,+,595
390,NZ_CP090900,1,1187628,1188222,-,594
390,NZ_OX366352,1,1493009,1493599,+,590
390,NZ_OX366362,1,1279782,1280374,+,592
390,NZ_OX366400,1,199755,200349,-,594
390,NZ_OX366327,1,200122,200720,-,598
390,NZ_OX366367,1,159586,160180,-,594
390,NZ_CP042444,1,1188979,1189573,-,594
390,NZ_OX366326,1,199506,200100,-,594
390,NZ_CP037426,1,899909,900498,-,589
390,NZ_OX366339,1,1225630,1226224,-,594
390,NZ_OX366355,1,1119816,1120406,+,590
390,NZ_CP046922,1,1249428,1250022,-,594
390,NZ_OX366370,1,222898,223492,-,594
390,NZ_OX366385,1,511952,512530,-,578
390,NZ_OX366399,1,200170,200764,-,594
390,NZ_OX366395,1,340317,340908,-,591
390,NZ_OX366396,1,1510040,1510635,+,595
390,NZ_OX366351,1,209362,209957,+,595
390,NZ_OX366381,1,1186697,1187287,+,590
390,NZ_OX366342,1,1321475,1322069,-,594
390,NZ_OX366369,1,194137,194726,-,589
390,NZ_OX366356,1,229546,230140,-,594
390,NZ_OX366377,1,384646,385241,+,595
390,NZ_OX366388,1,1643078,1643672,-,594
390,NZ_OX366357,1,871690,872282,+,592
390,NZ_CP072012,1,1116786,1117381,+,595
390,NZ_OX366398,1,993181,993776,+,595
390,NC_002978,6,1187624,1188218,-,594
390,NZ_OX366389,1,257137,257731,-,594
390,NZ_OX366397,1,197505,198094,-,589
390,NZ_OX366378,1,979103,979697,-,594
390,NZ_CP090903,1,1187628,1188222,-,594
390,NZ_OX366374,1,1249689,1250278,-,589
390,NZ_CP090901,1,1187628,1188222,-,594
390,NZ_CP046923,1,1165676,1166270,-,594
390,NZ_CP069055,1,1187581,1188175,-,594
390,NZ_CP072670,1,1187453,1188047,-,594
390,NZ_CP090899,1,1187628,1188222,-,594
390,NZ_CP046924,1,1186614,1187208,-,594
390,NZ_OX366348,1,1051831,1052426,+,595
390,NZ_CP046921,1,1249428,1250022,-,594
390,NZ_OX366338,1,274799,275390,-,591
390,NZ_CP054557,1,617500,618095,+,595
390,NZ_CP072669,1,1187473,1188067,-,594
390,NC_021089,1,1214040,1214629,-,589
391,NZ_OX366376,1,1272025,1273011,+,986
391,NZ_OX366393,1,664235,665221,+,986
391,NZ_OX366372,1,327435,328421,+,986
391,NZ_CP072672,1,1186428,1187423,-,995
391,NZ_CP069060,1,1327261,1328256,-,995
391,NZ_CP072667,1,1186402,1187397,-,995
391,NZ_CP072671,1,1186410,1187405,-,995
391,NZ_CP072668,1,1186397,1187392,-,995
391,NZ_CP072666,1,1186410,1187405,-,995
391,NZ_CP090902,1,1186563,1187558,-,995
391,NZ_CP090948,1,1186561,1187556,-,995
391,NZ_CP069052,1,1271561,1272556,-,995
391,NZ_CP076228,1,1206968,1207963,-,995
391,NZ_CP042445,1,1186550,1187545,-,995
391,NZ_CP042904,1,1262025,1263020,-,995
391,NC_012416,1,1307241,1308236,-,995
391,NZ_CP069053,1,1312559,1313554,-,995
391,NZ_CP042446,1,1186560,1187555,-,995
391,NZ_CP041215,1,209907,210902,-,995
391,NZ_OX366353,1,626946,627941,+,995
391,NZ_OX366387,1,390693,391688,+,995
391,NZ_OX366368,1,199605,200600,-,995
391,NZ_OX366379,1,200623,201618,-,995
391,NZ_CP091195,1,936711,937706,+,995
391,NZ_OX366375,1,200120,201115,-,995
391,NZ_CP046925,1,1186410,1187405,-,995
391,NZ_OX366318,1,194722,195717,-,995
391,NZ_OX366319,1,1003801,1004796,+,995
391,NZ_OX366332,1,196642,197629,-,987
391,NZ_CP110359,1,1224283,1225278,-,995
391,NZ_OU953855,1,478704,479699,-,995
391,NZ_OX366272,1,295507,296490,-,983
391,NZ_OX366347,1,308963,309958,-,995
391,NZ_OX366363,1,739828,740823,+,995
391,NZ_OX366364,1,1146892,1147878,+,986
391,NZ_OX366359,1,195767,196762,-,995
391,NZ_OX366349,1,1309684,1310670,+,986
391,NZ_OX366380,1,462501,463487,-,986
391,NZ_OX366344,1,646789,647775,+,986
391,NZ_CP090900,1,1186565,1187560,-,995
391,NZ_OX366352,1,1493769,1494764,+,995
391,NZ_OX366362,1,1280561,1281554,+,993
391,NZ_OX366400,1,198692,199687,-,995
391,NZ_OX366327,1,198957,199952,-,995
391,NZ_OX366367,1,158530,159516,-,986
391,NZ_CP042444,1,1187916,1188911,-,995
391,NZ_OX366326,1,198443,199438,-,995
391,NZ_CP037426,1,898744,899739,-,995
391,NZ_OX366339,1,1224567,1225562,-,995
391,NZ_OX366355,1,1120576,1121571,+,995
391,NZ_CP046922,1,1248365,1249360,-,995
391,NZ_OX366370,1,221844,222830,-,986
391,NZ_OX366385,1,510872,511858,-,986
391,NZ_OX366399,1,199107,200102,-,995
391,NZ_OX366395,1,339154,340149,-,995
391,NZ_OX366396,1,1510703,1511698,+,995
391,NZ_OX366351,1,210025,211020,+,995
391,NZ_OX366381,1,1187457,1188452,+,995
391,NZ_OX366342,1,1320421,1321407,-,986
391,NZ_OX366369,1,192972,193967,-,995
391,NZ_OX366356,1,228483,229478,-,995
391,NZ_OX366377,1,385309,386304,+,995
391,NZ_OX366388,1,1642015,1643010,-,995
391,NZ_OX366357,1,872450,873436,+,986
391,NZ_CP072012,1,1117449,1118444,+,995
391,NZ_OX366398,1,993844,994839,+,995
391,NC_002978,6,1186561,1187556,-,995
391,NZ_OX366389,1,256074,257069,-,995
391,NZ_OX366397,1,196340,197335,-,995
391,NZ_OX366378,1,978040,979035,-,995
391,NZ_CP090903,1,1186565,1187560,-,995
391,NZ_OX366374,1,1248506,1249500,-,994
391,NZ_CP090901,1,1186565,1187560,-,995
391,NZ_CP046923,1,1164613,1165608,-,995
391,NZ_CP069055,1,1186518,1187513,-,995
391,NZ_CP072670,1,1186390,1187385,-,995
391,NZ_CP090899,1,1186565,1187560,-,995
391,NZ_CP046924,1,1185551,1186546,-,995
391,NZ_OX366348,1,1052494,1053488,+,994
391,NZ_CP046921,1,1248365,1249360,-,995
391,NZ_OX366338,1,273742,274728,-,986
391,NZ_CP054557,1,618163,619158,+,995
391,NZ_CP072669,1,1186410,1187405,-,995
391,NC_021089,1,1212875,1213870,-,995
392,NZ_OX366376,1,1273107,1274173,+,1066
392,NZ_OX366393,1,665317,666383,+,1066
392,NZ_OX366372,1,328517,329583,+,1066
392,NZ_CP072672,1,1185292,1186341,-,1049
392,NZ_CP069060,1,1326125,1327174,-,1049
392,NZ_CP072667,1,1185266,1186315,-,1049
392,NZ_CP072671,1,1185274,1186323,-,1049
392,NZ_CP072668,1,1185261,1186310,-,1049
392,NZ_CP072666,1,1185274,1186323,-,1049
392,NZ_CP090902,1,1185427,1186476,-,1049
392,NZ_CP090948,1,1185425,1186474,-,1049
392,NZ_CP069052,1,1270425,1271474,-,1049
392,NZ_CP076228,1,1205832,1206881,-,1049
392,NZ_CP042445,1,1185414,1186463,-,1049
392,NZ_CP042904,1,1260889,1261938,-,1049
392,NC_012416,1,1306105,1307154,-,1049
392,NZ_CP069053,1,1311423,1312472,-,1049
392,NZ_CP042446,1,1185424,1186473,-,1049
392,NZ_CP041215,1,208753,209811,-,1058
392,NZ_OX366353,1,628037,629095,+,1058
392,NZ_OX366387,1,391775,392833,+,1058
392,NZ_OX366368,1,198469,199518,-,1049
392,NZ_OX366379,1,199487,200536,-,1049
392,NZ_CP091195,1,937793,938851,+,1058
392,NZ_OX366375,1,198966,200024,-,1058
392,NZ_CP046925,1,1185274,1186323,-,1049
392,NZ_OX366318,1,193586,194635,-,1049
392,NZ_OX366319,1,1004892,1005950,+,1058
392,NZ_OX366332,1,195480,196538,-,1058
392,NZ_CP110359,1,1223129,1224187,-,1058
392,NZ_OU953855,1,477559,478617,-,1058
392,NZ_OX366272,1,294353,295411,-,1058
392,NZ_OX366347,1,307809,308867,-,1058
392,NZ_OX366363,1,740910,741968,+,1058
392,NZ_OX366364,1,1147974,1149031,+,1057
392,NZ_OX366359,1,194613,195671,-,1058
392,NZ_OX366349,1,1310766,1311824,+,1058
392,NZ_OX366380,1,461356,462405,-,1049
392,NZ_OX366344,1,648451,649468,+,1017
392,NZ_CP090900,1,1185429,1186478,-,1049
392,NZ_OX366352,1,1494860,1495918,+,1058
392,NZ_OX366362,1,1281651,1282709,+,1058
392,NZ_OX366400,1,197556,198605,-,1049
392,NZ_OX366327,1,197803,198861,-,1058
392,NZ_OX366367,1,157376,158434,-,1058
392,NZ_CP042444,1,1186780,1187829,-,1049
392,NZ_OX366326,1,197307,198356,-,1049
392,NZ_CP037426,1,897590,898648,-,1058
392,NZ_OX366339,1,1223431,1224480,-,1049
392,NZ_OX366355,1,1121667,1122725,+,1058
392,NZ_CP046922,1,1247229,1248278,-,1049
392,NZ_OX366370,1,220682,221748,-,1066
392,NZ_OX366385,1,509727,510776,-,1049
392,NZ_OX366399,1,197971,199020,-,1049
392,NZ_OX366395,1,338000,339058,-,1058
392,NZ_OX366396,1,1511785,1512834,+,1049
392,NZ_OX366351,1,211107,212156,+,1049
392,NZ_OX366381,1,1188548,1189606,+,1058
392,NZ_OX366342,1,1319259,1320325,-,1066
392,NZ_OX366369,1,191818,192876,-,1058
392,NZ_OX366356,1,227347,228396,-,1049
392,NZ_OX366377,1,386391,387440,+,1049
392,NZ_OX366388,1,1640879,1641928,-,1049
392,NZ_OX366357,1,873532,874590,+,1058
392,NZ_CP072012,1,1118531,1119580,+,1049
392,NZ_OX366398,1,994926,995975,+,1049
392,NC_002978,6,1185425,1186474,-,1049
392,NZ_OX366389,1,254938,255987,-,1049
392,NZ_OX366397,1,195186,196244,-,1058
392,NZ_OX366378,1,976895,977953,-,1058
392,NZ_CP090903,1,1185429,1186478,-,1049
392,NZ_OX366374,1,1247352,1248410,-,1058
392,NZ_CP090901,1,1185429,1186478,-,1049
392,NZ_CP046923,1,1163477,1164526,-,1049
392,NZ_CP069055,1,1185382,1186431,-,1049
392,NZ_CP072670,1,1185254,1186303,-,1049
392,NZ_CP090899,1,1185429,1186478,-,1049
392,NZ_CP046924,1,1184415,1185464,-,1049
392,NZ_OX366348,1,1053576,1054625,+,1049
392,NZ_CP046921,1,1247229,1248278,-,1049
392,NZ_OX366338,1,272589,273646,-,1057
392,NZ_CP054557,1,619245,620294,+,1049
392,NZ_CP072669,1,1185274,1186323,-,1049
392,NC_021089,1,1211721,1212779,-,1058
393,NZ_OX366376,1,1274265,1274866,+,601
393,NZ_OX366393,1,666475,667076,+,601
393,NZ_OX366372,1,329675,330276,+,601
393,NZ_CP072672,1,1184599,1185200,-,601
393,NZ_CP069060,1,1325432,1326033,-,601
393,NZ_CP072667,1,1184573,1185174,-,601
393,NZ_CP072671,1,1184581,1185182,-,601
393,NZ_CP072668,1,1184568,1185169,-,601
393,NZ_CP072666,1,1184581,1185182,-,601
393,NZ_CP090902,1,1184734,1185335,-,601
393,NZ_CP090948,1,1184732,1185333,-,601
393,NZ_CP069052,1,1269732,1270333,-,601
393,NZ_CP076228,1,1205139,1205740,-,601
393,NZ_CP042445,1,1184721,1185322,-,601
393,NZ_CP042904,1,1259133,1259728,-,595
393,NC_012416,1,1304349,1304944,-,595
393,NZ_CP069053,1,1310730,1311331,-,601
393,NZ_CP042446,1,1184731,1185332,-,601
393,NZ_CP041215,1,208060,208661,-,601
393,NZ_OX366353,1,629187,629788,+,601
393,NZ_OX366387,1,392925,393526,+,601
393,NZ_OX366368,1,197776,198377,-,601
393,NZ_OX366379,1,198794,199395,-,601
393,NZ_CP091195,1,938943,939544,+,601
393,NZ_OX366375,1,198273,198874,-,601
393,NZ_CP046925,1,1184581,1185182,-,601
393,NZ_OX366318,1,192893,193494,-,601
393,NZ_OX366319,1,1006042,1006643,+,601
393,NZ_OX366332,1,194787,195388,-,601
393,NZ_CP110359,1,1221373,1221968,-,595
393,NZ_OU953855,1,476866,477467,-,601
393,NZ_OX366272,1,292597,293192,-,595
393,NZ_OX366347,1,306053,306648,-,595
393,NZ_OX366363,1,742060,742661,+,601
393,NZ_OX366364,1,1149123,1149724,+,601
393,NZ_OX366359,1,193920,194521,-,601
393,NZ_OX366349,1,1311916,1312517,+,601
393,NZ_OX366380,1,460667,461264,-,597
393,NZ_OX366344,1,649560,650161,+,601
393,NZ_CP090900,1,1184736,1185337,-,601
393,NZ_OX366352,1,1496010,1496611,+,601
393,NZ_OX366362,1,1283866,1284461,+,595
393,NZ_OX366400,1,196863,197464,-,601
393,NZ_OX366327,1,196051,196646,-,595
393,NZ_OX366367,1,156683,157284,-,601
393,NZ_CP042444,1,1186087,1186688,-,601
393,NZ_OX366326,1,196614,197215,-,601
393,NZ_CP037426,1,896897,897498,-,601
393,NZ_OX366339,1,1222738,1223339,-,601
393,NZ_OX366355,1,1122817,1123418,+,601
393,NZ_CP046922,1,1246536,1247137,-,601
393,NZ_OX366370,1,219989,220590,-,601
393,NZ_OX366385,1,509038,509635,-,597
393,NZ_OX366399,1,197278,197879,-,601
393,NZ_OX366395,1,336233,336828,-,595
393,NZ_OX366396,1,1512926,1513527,+,601
393,NZ_OX366351,1,212248,212849,+,601
393,NZ_OX366381,1,1189698,1190299,+,601
393,NZ_OX366342,1,1318566,1319167,-,601
393,NZ_OX366369,1,191125,191726,-,601
393,NZ_OX366356,1,226654,227255,-,601
393,NZ_OX366377,1,387532,388117,+,585
393,NZ_OX366388,1,1640186,1640787,-,601
393,NZ_OX366357,1,262546,263141,-,595
393,NZ_CP072012,1,1119672,1120273,+,601
393,NZ_OX366398,1,996067,996652,+,585
393,NC_002978,6,1184732,1185333,-,601
393,NZ_OX366389,1,254261,254846,-,585
393,NZ_OX366397,1,194493,195094,-,601
393,NZ_OX366378,1,976202,976803,-,601
393,NZ_CP090903,1,1184736,1185337,-,601
393,NZ_OX366374,1,1245612,1246210,-,598
393,NZ_CP090901,1,1184736,1185337,-,601
393,NZ_CP046923,1,1162784,1163385,-,601
393,NZ_CP069055,1,1184689,1185290,-,601
393,NZ_CP072670,1,1184561,1185162,-,601
393,NZ_CP090899,1,1184736,1185337,-,601
393,NZ_CP046924,1,1183722,1184323,-,601
393,NZ_OX366348,1,1054717,1055318,+,601
393,NZ_CP046921,1,1246536,1247137,-,601
393,NZ_OX366338,1,268958,269553,-,595
393,NZ_CP054557,1,620386,620987,+,601
393,NZ_CP072669,1,1184581,1185182,-,601
393,NC_021089,1,1211028,1211629,-,601
394,NZ_OX366376,1,1275428,1276743,+,1315
394,NZ_OX366393,1,667638,668953,+,1315
394,NZ_OX366372,1,330838,332153,+,1315
394,NZ_CP072672,1,1182723,1184037,-,1314
394,NZ_CP069060,1,1323556,1324870,-,1314
394,NZ_CP072667,1,1182697,1184011,-,1314
394,NZ_CP072671,1,1182705,1184019,-,1314
394,NZ_CP072668,1,1182692,1184006,-,1314
394,NZ_CP072666,1,1182705,1184019,-,1314
394,NZ_CP090902,1,1182858,1184172,-,1314
394,NZ_CP090948,1,1182856,1184170,-,1314
394,NZ_CP069052,1,1267856,1269170,-,1314
394,NZ_CP076228,1,1203263,1204577,-,1314
394,NZ_CP042445,1,1182845,1184159,-,1314
394,NZ_CP042904,1,1257257,1258571,-,1314
394,NC_012416,1,1302473,1303787,-,1314
394,NZ_CP069053,1,1308854,1310168,-,1314
394,NZ_CP042446,1,1182855,1184169,-,1314
394,NZ_CP041215,1,206184,207498,-,1314
394,NZ_OX366353,1,630350,631664,+,1314
394,NZ_OX366387,1,394088,395402,+,1314
394,NZ_OX366368,1,195900,197214,-,1314
394,NZ_OX366379,1,196918,198232,-,1314
394,NZ_CP091195,1,940106,941420,+,1314
394,NZ_OX366375,1,196397,197711,-,1314
394,NZ_CP046925,1,1182705,1184019,-,1314
394,NZ_OX366318,1,191017,192331,-,1314
394,NZ_OX366319,1,1007205,1008519,+,1314
394,NZ_OX366332,1,192911,194225,-,1314
394,NZ_CP110359,1,1219497,1220811,-,1314
394,NZ_OU953855,1,474989,476304,-,1315
394,NZ_OX366272,1,290721,292029,-,1308
394,NZ_OX366347,1,304177,305491,-,1314
394,NZ_OX366363,1,743223,744537,+,1314
394,NZ_OX366364,1,1150286,1151601,+,1315
394,NZ_OX366359,1,192044,193358,-,1314
394,NZ_OX366349,1,1313414,1314729,+,1315
394,NZ_OX366380,1,458786,460101,-,1315
394,NZ_OX366344,1,650723,652038,+,1315
394,NZ_CP090900,1,1182860,1184174,-,1314
394,NZ_OX366352,1,1497173,1498487,+,1314
394,NZ_OX366362,1,1285023,1286270,+,1247
394,NZ_OX366400,1,194987,196301,-,1314
394,NZ_OX366327,1,194175,195489,-,1314
394,NZ_OX366367,1,154806,156121,-,1315
394,NZ_CP042444,1,1184211,1185525,-,1314
394,NZ_OX366326,1,194738,196052,-,1314
394,NZ_CP037426,1,895021,896335,-,1314
394,NZ_OX366339,1,1220862,1222176,-,1314
394,NZ_OX366355,1,1123980,1125294,+,1314
394,NZ_CP046922,1,1244660,1245974,-,1314
394,NZ_OX366370,1,218112,219427,-,1315
394,NZ_OX366385,1,507157,508472,-,1315
394,NZ_OX366399,1,195402,196716,-,1314
394,NZ_OX366395,1,334356,335671,-,1315
394,NZ_OX366396,1,1514089,1515403,+,1314
394,NZ_OX366351,1,213411,214725,+,1314
394,NZ_OX366381,1,1190861,1192175,+,1314
394,NZ_OX366342,1,1316689,1318004,-,1315
394,NZ_OX366369,1,189249,190563,-,1314
394,NZ_OX366356,1,224778,226092,-,1314
394,NZ_OX366377,1,197567,198881,-,1314
394,NZ_OX366388,1,1638327,1639624,-,1297
394,NZ_OX366357,1,260670,261984,-,1314
394,NZ_CP072012,1,1120835,1122149,+,1314
394,NZ_OX366398,1,843506,844820,-,1314
394,NC_002978,6,1182856,1184170,-,1314
394,NZ_OX366389,1,51555,52869,+,1314
394,NZ_OX366397,1,192617,193931,-,1314
394,NZ_OX366378,1,974326,975640,-,1314
394,NZ_CP090903,1,1182860,1184174,-,1314
394,NZ_OX366374,1,1243751,1245050,-,1299
394,NZ_CP090901,1,1182860,1184174,-,1314
394,NZ_CP046923,1,1160908,1162222,-,1314
394,NZ_CP069055,1,1182813,1184127,-,1314
394,NZ_CP072670,1,1182685,1183999,-,1314
394,NZ_CP090899,1,1182860,1184174,-,1314
394,NZ_CP046924,1,1181846,1183160,-,1314
394,NZ_OX366348,1,1055880,1057194,+,1314
394,NZ_CP046921,1,1244660,1245974,-,1314
394,NZ_OX366338,1,267082,268396,-,1314
394,NZ_CP054557,1,621549,622863,+,1314
394,NZ_CP072669,1,1182705,1184019,-,1314
394,NC_021089,1,1209152,1210466,-,1314
395,NZ_OX366376,1,1276763,1280917,+,4154
395,NZ_OX366393,1,668973,673127,+,4154
395,NZ_OX366372,1,332173,336327,+,4154
395,NZ_CP072672,1,1178560,1182707,-,4147
395,NZ_CP069060,1,1319393,1323540,-,4147
395,NZ_CP072667,1,1178534,1182681,-,4147
395,NZ_CP072671,1,1178542,1182689,-,4147
395,NZ_CP072668,1,1178529,1182676,-,4147
395,NZ_CP072666,1,1178542,1182689,-,4147
395,NZ_CP090902,1,1178695,1182842,-,4147
395,NZ_CP090948,1,1178693,1182840,-,4147
395,NZ_CP069052,1,1263693,1267840,-,4147
395,NZ_CP076228,1,1199141,1203247,-,4106
395,NZ_CP042445,1,1178682,1182829,-,4147
395,NZ_CP042904,1,1253103,1257241,-,4138
395,NC_012416,1,1298319,1302457,-,4138
395,NZ_CP069053,1,1304691,1308838,-,4147
395,NZ_CP042446,1,1178692,1182839,-,4147
395,NZ_CP041215,1,202021,206168,-,4147
395,NZ_OX366353,1,631680,635827,+,4147
395,NZ_OX366387,1,395418,399565,+,4147
395,NZ_OX366368,1,191737,195884,-,4147
395,NZ_OX366379,1,192755,196902,-,4147
395,NZ_CP091195,1,941436,945583,+,4147
395,NZ_OX366375,1,192234,196381,-,4147
395,NZ_CP046925,1,1178542,1182689,-,4147
395,NZ_OX366318,1,186854,191001,-,4147
395,NZ_OX366319,1,1008535,1012682,+,4147
395,NZ_OX366332,1,188748,192895,-,4147
395,NZ_CP110359,1,1215334,1219481,-,4147
395,NZ_OU953855,1,470651,474973,-,4322
395,NZ_OX366272,1,286558,290705,-,4147
395,NZ_OX366347,1,300035,304161,-,4126
395,NZ_OX366363,1,744553,748659,+,4106
395,NZ_OX366364,1,1151621,1155726,+,4105
395,NZ_OX366359,1,187881,192028,-,4147
395,NZ_OX366349,1,1314749,1318894,+,4145
395,NZ_OX366380,1,454612,458770,-,4158
395,NZ_OX366344,1,652058,656212,+,4154
395,NZ_CP090900,1,1178697,1182844,-,4147
395,NZ_OX366352,1,1498503,1502650,+,4147
395,NZ_OX366362,1,874465,878595,-,4130
395,NZ_OX366400,1,190824,194971,-,4147
395,NZ_OX366327,1,190021,194159,-,4138
395,NZ_OX366367,1,150681,154786,-,4105
395,NZ_CP042444,1,1180048,1184195,-,4147
395,NZ_OX366326,1,190575,194722,-,4147
395,NZ_CP037426,1,890858,895005,-,4147
395,NZ_OX366339,1,1216699,1220846,-,4147
395,NZ_OX366355,1,1125310,1129457,+,4147
395,NZ_CP046922,1,1240497,1244644,-,4147
395,NZ_OX366370,1,213939,218092,-,4153
395,NZ_OX366385,1,502983,507141,-,4158
395,NZ_OX366399,1,191239,195386,-,4147
395,NZ_OX366395,1,330202,334336,-,4134
395,NZ_OX366396,1,1515419,1519566,+,4147
395,NZ_OX366351,1,214741,218888,+,4147
395,NZ_OX366381,1,1192191,1196338,+,4147
395,NZ_OX366342,1,1312515,1316669,-,4154
395,NZ_OX366369,1,185086,189233,-,4147
395,NZ_OX366356,1,220615,224762,-,4147
395,NZ_OX366377,1,193404,197551,-,4147
395,NZ_OX366388,1,1634162,1638294,-,4132
395,NZ_OX366357,1,256507,260654,-,4147
395,NZ_CP072012,1,1122165,1126312,+,4147
395,NZ_OX366398,1,839343,843490,-,4147
395,NC_002978,6,1178693,1182840,-,4147
395,NZ_OX366389,1,52885,56989,+,4104
395,NZ_OX366397,1,188454,192601,-,4147
395,NZ_OX366378,1,970163,974310,-,4147
395,NZ_CP090903,1,1178697,1182844,-,4147
395,NZ_OX366374,1,1239572,1243715,-,4143
395,NZ_CP090901,1,1178697,1182844,-,4147
395,NZ_CP046923,1,1156745,1160892,-,4147
395,NZ_CP069055,1,1178650,1182797,-,4147
395,NZ_CP072670,1,1178522,1182669,-,4147
395,NZ_CP090899,1,1178697,1182844,-,4147
395,NZ_CP046924,1,1177683,1181830,-,4147
395,NZ_OX366348,1,1057210,1061357,+,4147
395,NZ_CP046921,1,1240497,1244644,-,4147
395,NZ_OX366338,1,262908,267066,-,4158
395,NZ_CP054557,1,622879,627026,+,4147
395,NZ_CP072669,1,1178542,1182689,-,4147
395,NC_021089,1,1204989,1209136,-,4147
396,NZ_OX366376,1,1281797,1282331,+,534
396,NZ_OX366393,1,674007,674541,+,534
396,NZ_OX366372,1,337207,337741,+,534
396,NZ_CP072672,1,1177145,1177679,-,534
396,NZ_CP069060,1,1317978,1318512,-,534
396,NZ_CP072667,1,1177119,1177653,-,534
396,NZ_CP072671,1,1177127,1177661,-,534
396,NZ_CP072668,1,1177114,1177648,-,534
396,NZ_CP072666,1,1177127,1177661,-,534
396,NZ_CP090902,1,1177279,1177813,-,534
396,NZ_CP090948,1,1177277,1177811,-,534
396,NZ_CP069052,1,1262278,1262812,-,534
396,NZ_CP076228,1,1196767,1197301,-,534
396,NZ_CP042445,1,1177267,1177801,-,534
396,NZ_CP042904,1,1251688,1252222,-,534
396,NC_012416,1,1296904,1297438,-,534
396,NZ_CP069053,1,1303276,1303810,-,534
396,NZ_CP042446,1,1177277,1177811,-,534
396,NZ_CP041215,1,199753,200287,-,534
396,NZ_OX366353,1,636707,637240,+,533
396,NZ_OX366387,1,400445,400979,+,534
396,NZ_OX366368,1,190322,190856,-,534
396,NZ_OX366379,1,191340,191874,-,534
396,NZ_CP091195,1,946463,946996,+,533
396,NZ_OX366375,1,190819,191353,-,534
396,NZ_CP046925,1,1177127,1177661,-,534
396,NZ_OX366318,1,185439,185973,-,534
396,NZ_OX366319,1,1013562,1014096,+,534
396,NZ_OX366332,1,187333,187867,-,534
396,NZ_CP110359,1,1213919,1214453,-,534
396,NZ_OU953855,1,467000,467534,-,534
396,NZ_OX366272,1,285143,285677,-,534
396,NZ_OX366347,1,298620,299154,-,534
396,NZ_OX366363,1,750823,751357,+,534
396,NZ_OX366364,1,1156643,1157177,+,534
396,NZ_OX366359,1,186466,187000,-,534
396,NZ_OX366349,1,1319774,1320308,+,534
396,NZ_OX366380,1,453197,453731,-,534
396,NZ_OX366344,1,657092,657626,+,534
396,NZ_CP090900,1,1177281,1177815,-,534
396,NZ_OX366352,1,1503530,1504064,+,534
396,NZ_OX366362,1,873050,873584,-,534
396,NZ_OX366400,1,189409,189943,-,534
396,NZ_OX366327,1,185663,186213,-,550
396,NZ_OX366367,1,149229,149763,-,534
396,NZ_CP042444,1,1178633,1179167,-,534
396,NZ_OX366326,1,189160,189694,-,534
396,NZ_CP037426,1,889443,889977,-,534
396,NZ_OX366339,1,1215284,1215818,-,534
396,NZ_OX366355,1,1130337,1130871,+,534
396,NZ_CP046922,1,1239082,1239616,-,534
396,NZ_OX366370,1,212491,213025,-,534
396,NZ_OX366385,1,501568,502102,-,534
396,NZ_OX366399,1,189824,190358,-,534
396,NZ_OX366395,1,328787,329321,-,534
396,NZ_OX366396,1,1520446,1520980,+,534
396,NZ_OX366351,1,219768,220302,+,534
396,NZ_OX366381,1,1197218,1197752,+,534
396,NZ_OX366342,1,1311100,1311634,-,534
396,NZ_OX366369,1,183671,184205,-,534
396,NZ_OX366356,1,219200,219734,-,534
396,NZ_OX366377,1,191989,192523,-,534
396,NZ_OX366388,1,1632747,1633281,-,534
396,NZ_OX366357,1,255092,255626,-,534
396,NZ_CP072012,1,1127192,1127726,+,534
396,NZ_OX366398,1,837928,838462,-,534
396,NC_002978,6,1177277,1177811,-,534
396,NZ_OX366389,1,59749,60283,+,534
396,NZ_OX366397,1,187039,187573,-,534
396,NZ_OX366378,1,968748,969282,-,534
396,NZ_CP090903,1,1177281,1177815,-,534
396,NZ_CP090901,1,1177281,1177815,-,534
396,NZ_CP046923,1,1155330,1155864,-,534
396,NZ_CP069055,1,1177235,1177769,-,534
396,NZ_CP072670,1,1177107,1177641,-,534
396,NZ_CP090899,1,1177281,1177815,-,534
396,NZ_CP046924,1,1176268,1176802,-,534
396,NZ_OX366348,1,1062237,1062771,+,534
396,NZ_CP046921,1,1239082,1239616,-,534
396,NZ_OX366338,1,261493,262027,-,534
396,NZ_CP054557,1,627906,628440,+,534
396,NZ_CP072669,1,1177127,1177661,-,534
396,NC_021089,1,1203574,1204108,-,534
397,NZ_OX366376,1,1282763,1283752,+,989
397,NZ_OX366393,1,674973,675962,+,989
397,NZ_OX366372,1,338173,339162,+,989
397,NZ_CP072672,1,1175725,1176714,-,989
397,NZ_CP069060,1,1316558,1317547,-,989
397,NZ_CP072667,1,1175699,1176688,-,989
397,NZ_CP072671,1,1175707,1176696,-,989
397,NZ_CP072668,1,1175694,1176683,-,989
397,NZ_CP072666,1,1175707,1176696,-,989
397,NZ_CP090902,1,1175859,1176848,-,989
397,NZ_CP090948,1,1175857,1176846,-,989
397,NZ_CP069052,1,1260858,1261847,-,989
397,NZ_CP076228,1,1195347,1196336,-,989
397,NZ_CP042445,1,1175847,1176836,-,989
397,NZ_CP042904,1,1250268,1251257,-,989
397,NC_012416,1,1295484,1296473,-,989
397,NZ_CP069053,1,1301856,1302845,-,989
397,NZ_CP042446,1,1175857,1176846,-,989
397,NZ_CP041215,1,198333,199322,-,989
397,NZ_OX366353,1,637672,638661,+,989
397,NZ_OX366387,1,401411,402400,+,989
397,NZ_OX366368,1,188902,189891,-,989
397,NZ_OX366379,1,189920,190909,-,989
397,NZ_CP091195,1,947429,948418,+,989
397,NZ_OX366375,1,189399,190388,-,989
397,NZ_CP046925,1,1175707,1176696,-,989
397,NZ_OX366318,1,184019,185008,-,989
397,NZ_OX366319,1,1014528,1015517,+,989
397,NZ_OX366332,1,185913,186902,-,989
397,NZ_CP110359,1,1212499,1213488,-,989
397,NZ_OU953855,1,465580,466569,-,989
397,NZ_OX366272,1,283723,284712,-,989
397,NZ_OX366347,1,297200,298189,-,989
397,NZ_OU909470,1,63079,64026,+,947
397,NZ_OX366363,1,751789,752778,+,989
397,NZ_OX366364,1,1157609,1158598,+,989
397,NZ_OX366359,1,185046,186035,-,989
397,NZ_OX366349,1,1320740,1321729,+,989
397,NZ_OX366380,1,451777,452766,-,989
397,NZ_OX366344,1,658058,659047,+,989
397,NZ_CP090900,1,1175861,1176850,-,989
397,NZ_OX366352,1,1504496,1505485,+,989
397,NZ_OX366362,1,871630,872611,-,981
397,NZ_OX366400,1,187989,188978,-,989
397,NZ_OX366327,1,184243,185232,-,989
397,NZ_OX366367,1,147809,148798,-,989
397,NZ_CP042444,1,1177213,1178202,-,989
397,NZ_OX366326,1,187740,188729,-,989
397,NZ_CP037426,1,888023,889012,-,989
397,NZ_OX366339,1,1213864,1214853,-,989
397,NZ_OX366355,1,1131303,1132292,+,989
397,NZ_CP046922,1,1237662,1238651,-,989
397,NZ_OX366370,1,211071,212060,-,989
397,NZ_OX366385,1,500148,501137,-,989
397,NZ_OX366399,1,188404,189393,-,989
397,NZ_OX366395,1,327367,328356,-,989
397,NZ_OX366396,1,1521412,1522401,+,989
397,NZ_OX366351,1,220734,221723,+,989
397,NZ_OX366381,1,1198184,1199173,+,989
397,NZ_OX366342,1,1309680,1310669,-,989
397,NZ_OX366369,1,182251,183240,-,989
397,NZ_OX366356,1,217780,218769,-,989
397,NZ_OX366377,1,190569,191558,-,989
397,NZ_OX366388,1,1631327,1632316,-,989
397,NZ_OX366357,1,253672,254654,-,982
397,NZ_CP072012,1,1128158,1129147,+,989
397,NZ_OX366398,1,836508,837497,-,989
397,NC_002978,6,1175857,1176846,-,989
397,NZ_OX366389,1,60715,61704,+,989
397,NZ_OX366397,1,185619,186608,-,989
397,NZ_OX366378,1,967328,968317,-,989
397,NZ_CP090903,1,1175861,1176850,-,989
397,NZ_OX366374,1,343719,344701,-,982
397,NZ_CP090901,1,1175861,1176850,-,989
397,NZ_CP046923,1,1153910,1154899,-,989
397,NZ_CP069055,1,1175815,1176804,-,989
397,NZ_CP072670,1,1175687,1176676,-,989
397,NZ_CP090899,1,1175861,1176850,-,989
397,NZ_CP046924,1,1174848,1175837,-,989
397,NZ_OX366348,1,1063203,1064192,+,989
397,NZ_CP046921,1,1237662,1238651,-,989
397,NZ_OX366338,1,260073,261062,-,989
397,NZ_CP054557,1,628872,629861,+,989
397,NZ_CP072669,1,1175707,1176696,-,989
397,NC_021089,1,1202154,1203143,-,989
398,NZ_OX366376,1,1286722,1289756,+,3034
398,NZ_OX366393,1,678932,681966,+,3034
398,NZ_OX366372,1,342132,345166,+,3034
398,NZ_CP072672,1,1167335,1170405,-,3070
398,NZ_CP069060,1,1308168,1311238,-,3070
398,NZ_CP072667,1,1167309,1170379,-,3070
398,NZ_CP072671,1,1167317,1170387,-,3070
398,NZ_CP072668,1,1167304,1170374,-,3070
398,NZ_CP072666,1,1167317,1170387,-,3070
398,NZ_CP090902,1,1167469,1170539,-,3070
398,NZ_CP090948,1,1167467,1170537,-,3070
398,NZ_CP069052,1,1252468,1255538,-,3070
398,NZ_CP076228,1,1186043,1189113,-,3070
398,NZ_CP042445,1,1167457,1170527,-,3070
398,NZ_CP042904,1,1244284,1247354,-,3070
398,NC_012416,1,1289500,1292570,-,3070
398,NZ_CP069053,1,1293466,1296536,-,3070
398,NZ_CP042446,1,1167467,1170537,-,3070
398,NZ_CP041215,1,192349,195419,-,3070
398,NZ_OX366353,1,641576,644645,+,3069
398,NZ_OX366387,1,405314,408383,+,3069
398,NZ_OX366368,1,180512,183582,-,3070
398,NZ_OX366379,1,180611,183681,-,3070
398,NZ_CP091195,1,1425801,1428871,-,3070
398,NZ_OX366375,1,183409,186479,-,3070
398,NZ_CP046925,1,1167317,1170387,-,3070
398,NZ_OX366318,1,176641,179711,-,3070
398,NZ_OX366319,1,1018437,1021507,+,3070
398,NZ_OX366332,1,179929,182999,-,3070
398,NZ_CP110359,1,1205010,1208077,-,3067
398,NZ_OU953855,1,456633,459703,-,3070
398,NZ_OX366272,1,277716,280786,-,3070
398,NZ_OX366347,1,291166,294211,-,3045
398,NZ_OU909470,1,224778,227818,+,3040
398,NZ_OX366363,1,757179,760249,+,3070
398,NZ_OX366364,1,1163107,1166114,+,3007
398,NZ_OX366359,1,179062,182132,-,3070
398,NZ_OX366349,1,1324690,1327724,+,3034
398,NZ_OX366380,1,445800,448841,-,3041
398,NZ_OX366344,1,662019,665080,+,3061
398,NZ_CP090900,1,1167471,1170541,-,3070
398,NZ_OX366352,1,1508399,1511469,+,3070
398,NZ_OX366362,1,293047,296084,+,3037
398,NZ_OX366400,1,180643,183681,-,3038
398,NZ_OX366327,1,178259,181329,-,3070
398,NZ_OX366367,1,140197,143204,-,3007
398,NZ_CP042444,1,1168823,1171893,-,3070
398,NZ_OX366326,1,180362,183432,-,3070
398,NZ_CP037426,1,882033,885103,-,3070
398,NZ_OX366339,1,1206386,1209456,-,3070
398,NZ_OX366355,1,1135212,1138282,+,3070
398,NZ_CP046922,1,1229272,1232342,-,3070
398,NZ_OX366370,1,133137,136171,+,3034
398,NZ_OX366385,1,494171,497212,-,3041
398,NZ_OX366399,1,180014,183084,-,3070
398,NZ_OX366395,1,321095,324139,-,3044
398,NZ_OX366396,1,460234,463304,+,3070
398,NZ_OX366351,1,226031,229101,+,3070
398,NZ_OX366381,1,1202093,1205163,+,3070
398,NZ_OX366342,1,1303676,1306710,-,3034
398,NZ_OX366369,1,176262,179331,-,3069
398,NZ_OX366356,1,211785,214855,-,3070
398,NZ_OX366377,1,182247,185317,-,3070
398,NZ_OX366388,1,1623856,1626926,-,3070
398,NZ_OX366357,1,567736,570739,+,3003
398,NZ_CP072012,1,1133364,1136434,+,3070
398,NZ_OX366398,1,829037,832107,-,3070
398,NC_002978,6,1167467,1170537,-,3070
398,NZ_OX366389,1,67356,70426,+,3070
398,NZ_OX366397,1,179635,182705,-,3070
398,NZ_OX366378,1,1085667,1088737,-,3070
398,NZ_CP090903,1,1167471,1170541,-,3070
398,NZ_OX366374,1,659812,662853,-,3041
398,NZ_CP090901,1,1167471,1170541,-,3070
398,NZ_CP046923,1,1145520,1148590,-,3070
398,NZ_CP069055,1,1167425,1170495,-,3070
398,NZ_CP072670,1,1167297,1170367,-,3070
398,NZ_CP090899,1,1167471,1170541,-,3070
398,NZ_CP046924,1,1166458,1169528,-,3070
398,NZ_OX366348,1,1068593,1071663,+,3070
398,NZ_CP046921,1,1229272,1232342,-,3070
398,NZ_OX366338,1,252187,255157,-,2970
398,NZ_CP054557,1,635970,639040,+,3070
398,NZ_CP072669,1,1167317,1170387,-,3070
398,NC_021089,1,1196170,1199240,-,3070
399,NZ_OX366376,1,1291122,1292360,+,1238
399,NZ_OX366393,1,683209,684447,+,1238
399,NZ_OX366372,1,346412,347650,+,1238
399,NZ_CP072672,1,854842,856112,+,1270
399,NZ_CP069060,1,698763,700033,+,1270
399,NZ_CP072667,1,854816,856086,+,1270
399,NZ_CP072671,1,854824,856094,+,1270
399,NZ_CP072668,1,854811,856081,+,1270
399,NZ_CP072666,1,854824,856094,+,1270
399,NZ_CP090902,1,854976,856246,+,1270
399,NZ_CP090948,1,854976,856246,+,1270
399,NZ_CP069052,1,956038,957308,-,1270
399,NZ_CP076228,1,852723,853993,+,1270
399,NZ_CP042445,1,854964,856234,+,1270
399,NZ_CP042904,1,891768,893039,-,1271
399,NC_012416,1,927350,928621,-,1271
399,NZ_CP069053,1,698771,700041,+,1270
399,NZ_CP042446,1,854976,856246,+,1270
399,NZ_CP041215,1,1291284,1292555,+,1271
399,NZ_OX366353,1,796352,797623,-,1271
399,NZ_OX366387,1,1757668,1758939,+,1271
399,NZ_OX366368,1,1301137,1302407,+,1270
399,NZ_OX366379,1,1253805,1255075,-,1270
399,NZ_CP091195,1,1049090,1050360,-,1270
399,NZ_OX366375,1,1221520,1222791,+,1271
399,NZ_CP046925,1,854824,856094,+,1270
399,NZ_OX366318,1,1154035,1155305,+,1270
399,NZ_OX366319,1,126527,127798,+,1271
399,NZ_OX366332,1,1200668,1201939,+,1271
399,NZ_CP110359,1,346963,348234,+,1271
399,NZ_OU953855,1,992900,994132,-,1232
399,NZ_OU953855,1,1649063,1650295,-,1232
399,NZ_OX366272,1,212686,213957,+,1271
399,NZ_OX366347,1,1260112,1261383,-,1271
399,NZ_OU909470,1,229067,230305,+,1238
399,NZ_OX366363,1,925264,926496,+,1232
399,NZ_OX366364,1,354179,355417,+,1238
399,NZ_OX366359,1,1083029,1084300,-,1271
399,NZ_OX366349,1,1328819,1330057,+,1238
399,NZ_OX366380,1,443334,444596,-,1262
399,NZ_OX366344,1,1292072,1293310,+,1238
399,NZ_CP090900,1,854976,856246,+,1270
399,NZ_OX366352,1,1183863,1185134,-,1271
399,NZ_OX366362,1,455171,456443,-,1272
399,NZ_OX366400,1,1017072,1018342,+,1270
399,NZ_OX366327,1,1153768,1155039,+,1271
399,NZ_OX366367,1,1037869,1039107,+,1238
399,NZ_CP042444,1,855411,856681,+,1270
399,NZ_OX366326,1,1361745,1363015,+,1270
399,NZ_CP037426,1,647348,648619,+,1271
399,NZ_OX366339,1,821252,822522,-,1270
399,NZ_OX366355,1,1325489,1326760,+,1271
399,NZ_CP046922,1,916880,918150,+,1270
399,NZ_OX366370,1,137273,138511,+,1238
399,NZ_OX366385,1,490834,492096,-,1262
399,NZ_OX366399,1,1255197,1256467,+,1270
399,NZ_OX366395,1,1266860,1268092,-,1232
399,NZ_OX366396,1,66467,67737,+,1270
399,NZ_OX366351,1,1308171,1309441,+,1270
399,NZ_OX366381,1,238033,239304,+,1271
399,NZ_OX366342,1,1301215,1302453,-,1238
399,NZ_OX366369,1,1349207,1350478,+,1271
399,NZ_OX366356,1,1080650,1081921,-,1271
399,NZ_OX366377,1,1071834,1073105,-,1271
399,NZ_OX366388,1,57181,58451,-,1270
399,NZ_OX366357,1,397610,398848,+,1238
399,NZ_CP072012,1,709886,711156,-,1270
399,NZ_OX366398,1,335813,337084,+,1271
399,NC_002978,6,854976,856246,+,1270
399,NZ_OX366389,1,1228635,1229906,+,1271
399,NZ_OX366397,1,1477439,1478710,-,1271
399,NZ_OX366378,1,179154,180424,+,1270
399,NZ_CP090903,1,854976,856246,+,1270
399,NZ_OX366374,1,209146,210384,-,1238
399,NZ_CP090901,1,854976,856246,+,1270
399,NZ_CP046923,1,833128,834398,+,1270
399,NZ_CP069055,1,949611,950881,-,1270
399,NZ_CP072670,1,854816,856086,+,1270
399,NZ_CP090899,1,854976,856246,+,1270
399,NZ_CP046924,1,854066,855336,+,1270
399,NZ_OX366348,1,125050,126320,-,1270
399,NZ_CP046921,1,916880,918150,+,1270
399,NZ_OX366338,1,188152,189384,+,1232
399,NZ_CP054557,1,948250,949520,-,1270
399,NZ_CP072669,1,854824,856094,+,1270
399,NC_021089,1,851014,852285,+,1271
400,NZ_OX366376,1,1292361,1295567,+,3206
400,NZ_OX366393,1,684448,687654,+,3206
400,NZ_OX366372,1,347651,350857,+,3206
400,NZ_CP072672,1,856113,859323,+,3210
400,NZ_CP069060,1,700034,703244,+,3210
400,NZ_CP072667,1,856087,859297,+,3210
400,NZ_CP072671,1,856095,859305,+,3210
400,NZ_CP072668,1,856082,859292,+,3210
400,NZ_CP072666,1,856095,859305,+,3210
400,NZ_CP090902,1,856247,859457,+,3210
400,NZ_CP090948,1,856247,859457,+,3210
400,NZ_CP069052,1,952827,956036,-,3209
400,NZ_CP076228,1,853994,857204,+,3210
400,NZ_CP042445,1,856235,859445,+,3210
400,NZ_CP042904,1,888571,891766,-,3195
400,NC_012416,1,924153,927348,-,3195
400,NZ_CP069053,1,700042,703252,+,3210
400,NZ_CP042446,1,856247,859457,+,3210
400,NZ_CP041215,1,1292556,1295770,+,3214
400,NZ_OX366353,1,793137,796350,-,3213
400,NZ_OX366387,1,1758940,1762155,+,3215
400,NZ_OX366368,1,1302408,1305618,+,3210
400,NZ_OX366379,1,1250594,1253803,-,3209
400,NZ_CP091195,1,1045894,1049088,-,3194
400,NZ_OX366375,1,1222792,1225990,+,3198
400,NZ_CP046925,1,856095,859305,+,3210
400,NZ_OX366318,1,1155306,1158526,+,3220
400,NZ_OX366319,1,127799,130990,+,3191
400,NZ_OX366332,1,1201940,1205154,+,3214
400,NZ_CP110359,1,348235,351419,+,3184
400,NZ_OU953855,1,989702,992898,-,3196
400,NZ_OU953855,1,1645865,1649061,-,3196
400,NZ_OX366272,1,213958,217142,+,3184
400,NZ_OX366347,1,1256927,1260110,-,3183
400,NZ_OU909470,1,231204,234412,+,3208
400,NZ_OX366363,1,926497,929700,+,3203
400,NZ_OX366364,1,355418,358626,+,3208
400,NZ_OX366359,1,1079814,1083027,-,3213
400,NZ_OX366349,1,1330058,1333260,+,3202
400,NZ_OX366380,1,440124,443332,-,3208
400,NZ_OX366344,1,1293311,1296519,+,3208
400,NZ_CP090900,1,856247,859457,+,3210
400,NZ_OX366352,1,1180648,1183861,-,3213
400,NZ_OX366362,1,451956,455169,-,3213
400,NZ_OX366400,1,1018343,1021563,+,3220
400,NZ_OX366327,1,1155040,1158247,+,3207
400,NZ_OX366367,1,1039108,1042292,+,3184
400,NZ_CP042444,1,856682,859892,+,3210
400,NZ_OX366326,1,1363016,1366236,+,3220
400,NZ_CP037426,1,648620,651818,+,3198
400,NZ_OX366339,1,818056,821250,-,3194
400,NZ_OX366355,1,1326761,1329952,+,3191
400,NZ_CP046922,1,918151,921361,+,3210
400,NZ_OX366370,1,138512,141720,+,3208
400,NZ_OX366385,1,487624,490832,-,3208
400,NZ_OX366399,1,1256468,1259678,+,3210
400,NZ_OX366395,1,1263642,1266858,-,3216
400,NZ_OX366396,1,67738,70933,+,3195
400,NZ_OX366351,1,1309442,1312662,+,3220
400,NZ_OX366381,1,239305,242496,+,3191
400,NZ_OX366342,1,1298008,1301213,-,3205
400,NZ_OX366369,1,1350479,1353670,+,3191
400,NZ_OX366356,1,1077458,1080648,-,3190
400,NZ_OX366377,1,1068620,1071832,-,3212
400,NZ_OX366388,1,53983,57179,-,3196
400,NZ_OX366357,1,398849,402068,+,3219
400,NZ_CP072012,1,706675,709884,-,3209
400,NZ_OX366398,1,337085,340298,+,3213
400,NC_002978,6,856247,859457,+,3210
400,NZ_OX366389,1,1229907,1233120,+,3213
400,NZ_OX366397,1,1474224,1477437,-,3213
400,NZ_OX366378,1,180425,183620,+,3195
400,NZ_CP090903,1,856247,859457,+,3210
400,NZ_OX366374,1,205936,209144,-,3208
400,NZ_CP090901,1,856247,859457,+,3210
400,NZ_CP046923,1,834399,837609,+,3210
400,NZ_CP069055,1,946400,949609,-,3209
400,NZ_CP072670,1,856087,859297,+,3210
400,NZ_CP090899,1,856247,859457,+,3210
400,NZ_CP046924,1,855337,858547,+,3210
400,NZ_OX366348,1,121839,125048,-,3209
400,NZ_CP046921,1,918151,921361,+,3210
400,NZ_OX366338,1,189385,192591,+,3206
400,NZ_CP054557,1,945039,948248,-,3209
400,NZ_CP072669,1,856095,859305,+,3210
400,NC_021089,1,852286,855500,+,3214
401,NZ_OX366376,1,1295770,1296702,+,932
401,NZ_OX366393,1,687857,688789,+,932
401,NZ_OX366372,1,351060,351992,+,932
401,NZ_CP072672,1,859490,860422,+,932
401,NZ_CP069060,1,703411,704343,+,932
401,NZ_CP072667,1,859464,860396,+,932
401,NZ_CP072671,1,859472,860404,+,932
401,NZ_CP072668,1,859459,860391,+,932
401,NZ_CP072666,1,859472,860404,+,932
401,NZ_CP090902,1,859624,860556,+,932
401,NZ_CP090948,1,859624,860556,+,932
401,NZ_CP069052,1,951728,952660,-,932
401,NZ_CP076228,1,857371,858303,+,932
401,NZ_CP042445,1,859612,860544,+,932
401,NZ_CP042904,1,887472,888404,-,932
401,NC_012416,1,923054,923986,-,932
401,NZ_CP069053,1,703419,704351,+,932
401,NZ_CP042446,1,859624,860556,+,932
401,NZ_CP041215,1,1295937,1296869,+,932
401,NZ_OX366353,1,792038,792970,-,932
401,NZ_OX366387,1,1762322,1763254,+,932
401,NZ_OX366368,1,1305785,1306717,+,932
401,NZ_OX366379,1,1249495,1250427,-,932
401,NZ_CP091195,1,1044689,1045622,-,933
401,NZ_OX366375,1,1226157,1227089,+,932
401,NZ_CP046925,1,859472,860404,+,932
401,NZ_OX366318,1,1158798,1159730,+,932
401,NZ_OX366319,1,131280,132212,+,932
401,NZ_OX366332,1,1205321,1206253,+,932
401,NZ_CP110359,1,351586,352518,+,932
401,NZ_OU953855,1,988376,989308,-,932
401,NZ_OU953855,1,1644539,1645471,-,932
401,NZ_OX366272,1,217309,218241,+,932
401,NZ_OX366347,1,1255792,1256724,-,932
401,NZ_OU909470,1,234684,235612,+,928
401,NZ_OX366363,1,929972,930904,+,932
401,NZ_OX366364,1,358802,359734,+,932
401,NZ_OX366359,1,1078715,1079647,-,932
401,NZ_OX366349,1,1333541,1334460,+,919
401,NZ_OX366380,1,438924,439852,-,928
401,NZ_OX366344,1,1296722,1297623,+,901
401,NZ_CP090900,1,859624,860556,+,932
401,NZ_OX366352,1,1179549,1180481,-,932
401,NZ_OX366362,1,450659,451591,-,932
401,NZ_OX366400,1,1021835,1022767,+,932
401,NZ_OX366327,1,1158519,1159451,+,932
401,NZ_OX366367,1,1042716,1043648,+,932
401,NZ_CP042444,1,860059,860991,+,932
401,NZ_OX366326,1,1366508,1367440,+,932
401,NZ_CP037426,1,651985,652917,+,932
401,NZ_OX366339,1,816739,817671,-,932
401,NZ_OX366355,1,1330242,1331174,+,932
401,NZ_CP046922,1,921528,922460,+,932
401,NZ_OX366370,1,141923,142815,+,892
401,NZ_OX366385,1,486424,487352,-,928
401,NZ_OX366399,1,1259845,1260777,+,932
401,NZ_OX366395,1,1262438,1263370,-,932
401,NZ_OX366396,1,71318,72250,+,932
401,NZ_OX366351,1,1312934,1313866,+,932
401,NZ_OX366381,1,242786,243718,+,932
401,NZ_OX366342,1,1296873,1297805,-,932
401,NZ_OX366369,1,1353960,1354892,+,932
401,NZ_OX366356,1,1076359,1077291,-,932
401,NZ_OX366377,1,1067521,1068453,-,932
401,NZ_OX366388,1,52968,53816,-,848
401,NZ_OX366357,1,402340,403272,+,932
401,NZ_CP072012,1,705576,706508,-,932
401,NZ_OX366398,1,340465,341397,+,932
401,NC_002978,6,859624,860556,+,932
401,NZ_OX366389,1,1233287,1234219,+,932
401,NZ_OX366397,1,1473125,1474057,-,932
401,NZ_OX366378,1,183892,184824,+,932
401,NZ_CP090903,1,859624,860556,+,932
401,NZ_OX366374,1,204732,205664,-,932
401,NZ_CP090901,1,859624,860556,+,932
401,NZ_CP046923,1,837776,838708,+,932
401,NZ_CP069055,1,945301,946233,-,932
401,NZ_CP072670,1,859464,860396,+,932
401,NZ_CP090899,1,859624,860556,+,932
401,NZ_CP046924,1,858714,859646,+,932
401,NZ_OX366348,1,120740,121672,-,932
401,NZ_CP046921,1,921528,922460,+,932
401,NZ_OX366338,1,192872,193804,+,932
401,NZ_CP054557,1,943940,944872,-,932
401,NZ_CP072669,1,859472,860404,+,932
401,NC_021089,1,855667,856599,+,932
402,NZ_OX366376,1,1296858,1297452,+,594
402,NZ_OX366393,1,688945,689539,+,594
402,NZ_OX366372,1,352148,352742,+,594
402,NZ_CP072672,1,860578,861172,+,594
402,NZ_CP069060,1,704499,705093,+,594
402,NZ_CP072667,1,860552,861146,+,594
402,NZ_CP072671,1,860560,861154,+,594
402,NZ_CP072668,1,860547,861141,+,594
402,NZ_CP072666,1,860560,861154,+,594
402,NZ_CP090902,1,860712,861306,+,594
402,NZ_CP090948,1,860712,861306,+,594
402,NZ_CP069052,1,950977,951572,-,595
402,NZ_CP076228,1,858459,859053,+,594
402,NZ_CP042445,1,860700,861294,+,594
402,NZ_CP042904,1,886730,887316,-,586
402,NC_012416,1,922312,922898,-,586
402,NZ_CP069053,1,704507,705101,+,594
402,NZ_CP042446,1,860712,861306,+,594
402,NZ_CP041215,1,1297025,1297619,+,594
402,NZ_OX366353,1,791296,791882,-,586
402,NZ_OX366387,1,1763410,1763995,+,585
402,NZ_OX366368,1,1306873,1307467,+,594
402,NZ_OX366379,1,1248744,1249339,-,595
402,NZ_CP091195,1,1043938,1044533,-,595
402,NZ_OX366375,1,1227245,1227839,+,594
402,NZ_CP046925,1,860560,861154,+,594
402,NZ_OX366318,1,1159886,1160480,+,594
402,NZ_OX366319,1,132368,132962,+,594
402,NZ_OX366332,1,1206409,1207003,+,594
402,NZ_CP110359,1,352674,353268,+,594
402,NZ_OU953855,1,987625,988220,-,595
402,NZ_OU953855,1,1643788,1644383,-,595
402,NZ_OX366272,1,218397,218991,+,594
402,NZ_OX366347,1,1255041,1255636,-,595
402,NZ_OU909470,1,235768,236353,+,585
402,NZ_OX366363,1,931060,931654,+,594
402,NZ_OX366364,1,359890,360475,+,585
402,NZ_OX366359,1,1077973,1078559,-,586
402,NZ_OX366349,1,1334616,1335210,+,594
402,NZ_OX366380,1,438182,438768,-,586
402,NZ_OX366344,1,1297779,1298373,+,594
402,NZ_CP090900,1,860712,861306,+,594
402,NZ_OX366352,1,1178798,1179393,-,595
402,NZ_OX366362,1,449908,450503,-,595
402,NZ_OX366400,1,1022923,1023517,+,594
402,NZ_OX366327,1,1159607,1160217,+,610
402,NZ_OX366367,1,1043804,1044389,+,585
402,NZ_CP042444,1,861147,861741,+,594
402,NZ_OX366326,1,1367596,1368190,+,594
402,NZ_CP037426,1,653073,653667,+,594
402,NZ_OX366339,1,815997,816579,-,582
402,NZ_OX366355,1,1331330,1331924,+,594
402,NZ_CP046922,1,922616,923210,+,594
402,NZ_OX366370,1,142971,143565,+,594
402,NZ_OX366385,1,485682,486268,-,586
402,NZ_OX366399,1,1260933,1261527,+,594
402,NZ_OX366395,1,1261687,1262282,-,595
402,NZ_OX366396,1,72410,72991,+,581
402,NZ_OX366351,1,1314022,1314616,+,594
402,NZ_OX366381,1,243874,244468,+,594
402,NZ_OX366342,1,1296095,1296660,-,565
402,NZ_OX366369,1,1355048,1355642,+,594
402,NZ_OX366356,1,1075608,1076203,-,595
402,NZ_OX366377,1,1066770,1067365,-,595
402,NZ_OX366388,1,50596,51178,-,582
402,NZ_OX366357,1,403428,404022,+,594
402,NZ_CP072012,1,704825,705420,-,595
402,NZ_OX366398,1,341553,342147,+,594
402,NC_002978,6,860712,861306,+,594
402,NZ_OX366389,1,1234375,1234969,+,594
402,NZ_OX366397,1,1472383,1472969,-,586
402,NZ_OX366378,1,184980,185574,+,594
402,NZ_CP090903,1,860712,861306,+,594
402,NZ_OX366374,1,203981,204576,-,595
402,NZ_CP090901,1,860712,861306,+,594
402,NZ_CP046923,1,838864,839458,+,594
402,NZ_CP069055,1,944550,945145,-,595
402,NZ_CP072670,1,860552,861146,+,594
402,NZ_CP090899,1,860712,861306,+,594
402,NZ_CP046924,1,859802,860396,+,594
402,NZ_OX366348,1,119989,120584,-,595
402,NZ_CP046921,1,922616,923210,+,594
402,NZ_OX366338,1,193966,194554,+,588
402,NZ_CP054557,1,943189,943784,-,595
402,NZ_CP072669,1,860560,861154,+,594
402,NC_021089,1,856755,857340,+,585
403,NZ_OX366376,1,1297774,1299115,+,1341
403,NZ_OX366393,1,689861,691202,+,1341
403,NZ_OX366372,1,353064,354405,+,1341
403,NZ_CP072672,1,1113401,1114779,-,1378
403,NZ_CP069060,1,959957,961335,-,1378
403,NZ_CP072667,1,1113375,1114753,-,1378
403,NZ_CP072671,1,1113383,1114761,-,1378
403,NZ_CP072668,1,1113370,1114748,-,1378
403,NZ_CP072666,1,1113383,1114761,-,1378
403,NZ_CP090902,1,1113535,1114913,-,1378
403,NZ_CP090948,1,1113533,1114911,-,1378
403,NZ_CP069052,1,1036179,1037557,+,1378
403,NZ_CP076228,1,1128072,1129450,-,1378
403,NZ_CP042445,1,1113523,1114901,-,1378
403,NZ_CP042904,1,1184748,1186126,-,1378
403,NC_012416,1,1229963,1231341,-,1378
403,NZ_CP069053,1,959989,961367,-,1378
403,NZ_CP042446,1,1113533,1114911,-,1378
403,NZ_CP041215,1,137335,138712,-,1377
403,NZ_OX366353,1,697680,699058,+,1378
403,NZ_OX366387,1,153284,154662,-,1378
403,NZ_OX366368,1,126389,127767,-,1378
403,NZ_OX366379,1,126487,127865,-,1378
403,NZ_CP091195,1,1268667,1270045,-,1378
403,NZ_OX366375,1,128223,129600,-,1377
403,NZ_CP046925,1,1113383,1114761,-,1378
403,NZ_OX366318,1,121224,122601,-,1377
403,NZ_OX366319,1,1075735,1077113,+,1378
403,NZ_OX366332,1,124927,126304,-,1377
403,NZ_CP110359,1,109483,110860,-,1377
403,NZ_OU953855,1,168568,169946,+,1378
403,NZ_OX366272,1,80429,81806,-,1377
403,NZ_OX366347,1,234311,235689,-,1378
403,NZ_OU909470,1,236704,238045,+,1341
403,NZ_OX366363,1,1102581,1103959,+,1378
403,NZ_OX366364,1,236639,237981,+,1342
403,NZ_OX366359,1,123992,125369,-,1377
403,NZ_OX366349,1,1336632,1337969,+,1337
403,NZ_OX366380,1,435161,436545,-,1384
403,NZ_OX366344,1,1298695,1300036,+,1341
403,NZ_CP090900,1,1113536,1114914,-,1378
403,NZ_OX366352,1,1565102,1566479,+,1377
403,NZ_OX366362,1,562371,563712,+,1341
403,NZ_OX366400,1,50573,51950,+,1377
403,NZ_OX366327,1,123866,125244,-,1378
403,NZ_OX366367,1,1251483,1252825,-,1342
403,NZ_CP042444,1,1114889,1116267,-,1378
403,NZ_OX366326,1,124930,126307,-,1377
403,NZ_CP037426,1,1016378,1017756,+,1378
403,NZ_OX366339,1,1320287,1321666,+,1379
403,NZ_OX366355,1,1192848,1194226,+,1378
403,NZ_CP046922,1,1175347,1176725,-,1378
403,NZ_OX366370,1,143845,145186,+,1341
403,NZ_OX366385,1,156454,157840,-,1386
403,NZ_OX366399,1,125890,127268,-,1378
403,NZ_OX366395,1,266367,267744,-,1377
403,NZ_OX366396,1,671454,672834,-,1380
403,NZ_OX366351,1,132345,133722,-,1377
403,NZ_OX366381,1,1257772,1259150,+,1378
403,NZ_OX366342,1,1294433,1295774,-,1341
403,NZ_OX366369,1,122150,123527,-,1377
403,NZ_OX366356,1,157349,158726,-,1377
403,NZ_OX366377,1,128637,130015,-,1378
403,NZ_OX366388,1,1716605,1717983,-,1378
403,NZ_OX366357,1,629580,630955,-,1375
403,NZ_CP072012,1,1189180,1190558,+,1378
403,NZ_OX366398,1,775427,776805,-,1378
403,NC_002978,6,1113533,1114911,-,1378
403,NZ_OX366389,1,122657,124035,+,1378
403,NZ_OX366397,1,124718,126095,-,1377
403,NZ_OX366378,1,69246,70624,-,1378
403,NZ_CP090903,1,1113536,1114914,-,1378
403,NZ_OX366374,1,68484,69861,-,1377
403,NZ_CP090901,1,1113536,1114914,-,1378
403,NZ_CP046923,1,1091595,1092973,-,1378
403,NZ_CP069055,1,1113305,1114683,-,1378
403,NZ_CP072670,1,1113363,1114741,-,1378
403,NZ_CP090899,1,1113536,1114914,-,1378
403,NZ_CP046924,1,1112533,1113911,-,1378
403,NZ_OX366348,1,1163440,1164818,-,1378
403,NZ_CP046921,1,1175347,1176725,-,1378
403,NZ_OX366338,1,604353,605732,+,1379
403,NZ_CP054557,1,694827,696205,+,1378
403,NZ_CP072669,1,1113383,1114761,-,1378
403,NC_021089,1,1140901,1142278,-,1377
404,NZ_OX366376,1,1301355,1301972,+,617
404,NZ_OX366393,1,693667,694284,+,617
404,NZ_OX366372,1,356645,357262,+,617
404,NZ_OX366349,1,1340196,1340791,+,595
404,NZ_OX366344,1,1302288,1302867,+,579
404,NZ_OX366342,1,1291577,1292193,-,616
405,NZ_OX366376,1,1302090,1303146,+,1056
405,NZ_OX366393,1,694402,695457,+,1055
405,NZ_OX366372,1,357380,358436,+,1056
405,NZ_OX366362,1,303888,304930,+,1042
405,NZ_OX366370,1,148311,149368,+,1057
405,NZ_OX366342,1,1290403,1291459,-,1056
406,NZ_OX366376,1,1306390,1306916,+,526
406,NZ_OX366393,1,698659,699185,+,526
406,NZ_OX366372,1,361668,362194,+,526
406,NZ_OU909470,1,245699,246214,+,515
406,NZ_OX366349,1,973862,974389,-,527
406,NZ_OX366344,1,1307196,1307722,+,526
406,NZ_OX366370,1,1234316,1234842,+,526
406,NZ_OX366395,1,258806,259333,-,527
406,NZ_OX366342,1,1286673,1287200,-,527
406,NZ_OX366338,1,615835,616361,+,526
407,NZ_OX366376,1,1308453,1309316,+,863
407,NZ_OX366393,1,700722,701585,+,863
407,NZ_OX366372,1,363731,364594,+,863
407,NZ_CP072672,1,1106241,1107107,-,866
407,NZ_CP069060,1,952798,953664,-,866
407,NZ_CP072667,1,1106215,1107081,-,866
407,NZ_CP072671,1,1106223,1107089,-,866
407,NZ_CP072668,1,1106210,1107076,-,866
407,NZ_CP072666,1,1106223,1107089,-,866
407,NZ_CP090902,1,1106375,1107241,-,866
407,NZ_CP090948,1,1106373,1107239,-,866
407,NZ_CP069052,1,1043850,1044716,+,866
407,NZ_CP076228,1,1120892,1121758,-,866
407,NZ_CP042445,1,1106363,1107229,-,866
407,NZ_CP042904,1,1177479,1178345,-,866
407,NC_012416,1,1222694,1223560,-,866
407,NZ_CP069053,1,952830,953696,-,866
407,NZ_CP042446,1,1106373,1107239,-,866
407,NZ_CP041215,1,73660,74526,+,866
407,NZ_OX366353,1,705360,706226,+,866
407,NZ_OX366387,1,145036,145902,-,866
407,NZ_OX366368,1,119229,120095,-,866
407,NZ_OX366379,1,119327,120193,-,866
407,NZ_CP091195,1,1261885,1262751,-,866
407,NZ_OX366375,1,121045,121911,-,866
407,NZ_CP046925,1,1106223,1107089,-,866
407,NZ_OX366318,1,114052,114918,-,866
407,NZ_OX366319,1,1082818,1083684,+,866
407,NZ_OX366332,1,117761,118627,-,866
407,NZ_CP110359,1,102321,103187,-,866
407,NZ_OU953855,1,1490925,1491791,+,866
407,NZ_OX366272,1,73868,74734,-,866
407,NZ_OX366347,1,226046,226912,-,866
407,NZ_OU909470,1,247380,248206,+,826
407,NZ_OX366363,1,1112163,1113029,+,866
407,NZ_OX366364,1,87789,88655,+,866
407,NZ_OX366359,1,116826,117692,-,866
407,NZ_OX366349,1,970126,970989,-,863
407,NZ_OX366380,1,781463,782307,-,844
407,NZ_OX366344,1,1309148,1310014,+,866
407,NZ_CP090900,1,1106376,1107242,-,866
407,NZ_OX366352,1,1572778,1573644,+,866
407,NZ_OX366362,1,307184,308047,+,863
407,NZ_OX366400,1,59107,59973,+,866
407,NZ_OX366327,1,116706,117572,-,866
407,NZ_OX366367,1,1468018,1468884,-,866
407,NZ_CP042444,1,1107729,1108595,-,866
407,NZ_OX366326,1,117758,118624,-,866
407,NZ_CP037426,1,1024068,1024934,+,866
407,NZ_OX366339,1,1327270,1328136,-,866
407,NZ_OX366355,1,1199927,1200793,+,866
407,NZ_CP046922,1,1168187,1169053,-,866
407,NZ_OX366370,1,564287,565141,+,854
407,NZ_OX366385,1,9395,10239,+,844
407,NZ_OX366399,1,118730,119596,-,866
407,NZ_OX366395,1,256445,257311,-,866
407,NZ_OX366396,1,663335,664201,-,866
407,NZ_OX366351,1,125173,126039,-,866
407,NZ_OX366381,1,1264855,1265721,+,866
407,NZ_OX366342,1,1284272,1285135,-,863
407,NZ_OX366369,1,115579,116445,-,866
407,NZ_OX366356,1,113200,114066,-,866
407,NZ_OX366377,1,121477,122343,-,866
407,NZ_OX366388,1,1709824,1710690,-,866
407,NZ_OX366357,1,1109818,1110684,+,866
407,NZ_CP072012,1,1196873,1197739,+,866
407,NZ_OX366398,1,768267,769133,-,866
407,NC_002978,6,1106373,1107239,-,866
407,NZ_OX366389,1,130896,131762,+,866
407,NZ_OX366397,1,117552,118418,-,866
407,NZ_OX366378,1,62472,63338,-,866
407,NZ_CP090903,1,1106376,1107242,-,866
407,NZ_OX366374,1,319017,319883,+,866
407,NZ_CP090901,1,1106376,1107242,-,866
407,NZ_CP046923,1,1084435,1085301,-,866
407,NZ_CP069055,1,1106145,1107011,-,866
407,NZ_CP072670,1,1106203,1107069,-,866
407,NZ_CP090899,1,1106376,1107242,-,866
407,NZ_CP046924,1,1105373,1106239,-,866
407,NZ_OX366348,1,1156268,1157134,-,866
407,NZ_CP046921,1,1168187,1169053,-,866
407,NZ_OX366338,1,617714,618580,+,866
407,NZ_CP054557,1,901322,902188,-,866
407,NZ_CP072669,1,1106223,1107089,-,866
407,NC_021089,1,1133735,1134601,-,866
408,NZ_OX366376,1,1309319,1310008,+,689
408,NZ_OX366393,1,701588,702277,+,689
408,NZ_OX366372,1,364597,365286,+,689
408,NZ_CP072672,1,1105560,1106238,-,678
408,NZ_CP069060,1,952117,952795,-,678
408,NZ_CP072667,1,1105534,1106212,-,678
408,NZ_CP072671,1,1105542,1106220,-,678
408,NZ_CP072668,1,1105529,1106207,-,678
408,NZ_CP072666,1,1105542,1106220,-,678
408,NZ_CP090902,1,1105694,1106372,-,678
408,NZ_CP090948,1,1105692,1106370,-,678
408,NZ_CP069052,1,1044719,1045397,+,678
408,NZ_CP076228,1,1120211,1120889,-,678
408,NZ_CP042445,1,1105682,1106360,-,678
408,NZ_CP042904,1,1176917,1177476,-,559
408,NC_012416,1,1222132,1222691,-,559
408,NZ_CP069053,1,952149,952827,-,678
408,NZ_CP042446,1,1105692,1106370,-,678
408,NZ_CP041215,1,74529,75207,+,678
408,NZ_OX366353,1,706229,706907,+,678
408,NZ_OX366387,1,144355,145033,-,678
408,NZ_OX366368,1,118548,119226,-,678
408,NZ_OX366379,1,118646,119324,-,678
408,NZ_CP091195,1,1261204,1261882,-,678
408,NZ_OX366375,1,120364,121042,-,678
408,NZ_CP046925,1,1105542,1106220,-,678
408,NZ_OX366318,1,113371,114049,-,678
408,NZ_OX366319,1,1083687,1084365,+,678
408,NZ_OX366332,1,117080,117758,-,678
408,NZ_CP110359,1,101633,102318,-,685
408,NZ_OU953855,1,1491794,1492479,+,685
408,NZ_OX366272,1,73180,73865,-,685
408,NZ_OX366347,1,225358,226043,-,685
408,NZ_OU909470,1,248244,248794,+,550
408,NZ_OX366363,1,1113048,1113598,+,550
408,NZ_OX366364,1,88658,89217,+,559
408,NZ_OX366359,1,116145,116823,-,678
408,NZ_OX366349,1,969434,970123,-,689
408,NZ_OX366380,1,780027,780577,-,550
408,NZ_OX366344,1,1310017,1310576,+,559
408,NZ_CP090900,1,1105695,1106373,-,678
408,NZ_OX366352,1,1573647,1574325,+,678
408,NZ_OX366362,1,308050,308736,+,686
408,NZ_OX366400,1,59976,60654,+,678
408,NZ_OX366327,1,116144,116703,-,559
408,NZ_OX366367,1,1467456,1468015,-,559
408,NZ_CP042444,1,1107048,1107726,-,678
408,NZ_OX366326,1,117077,117755,-,678
408,NZ_CP037426,1,1024937,1025615,+,678
408,NZ_OX366339,1,1326589,1327267,-,678
408,NZ_OX366355,1,1200796,1201474,+,678
408,NZ_CP046922,1,1167506,1168184,-,678
408,NZ_OX366370,1,565144,565703,+,559
408,NZ_OX366385,1,10259,10809,+,550
408,NZ_OX366399,1,118049,118727,-,678
408,NZ_OX366395,1,255764,256442,-,678
408,NZ_OX366396,1,662654,663332,-,678
408,NZ_OX366351,1,124492,125170,-,678
408,NZ_OX366381,1,1265724,1266402,+,678
408,NZ_OX366342,1,1283580,1284269,-,689
408,NZ_OX366369,1,114898,115576,-,678
408,NZ_OX366356,1,112519,113197,-,678
408,NZ_OX366377,1,120908,121474,-,566
408,NZ_OX366388,1,1709143,1709821,-,678
408,NZ_OX366357,1,1110703,1111244,+,541
408,NZ_CP072012,1,1197742,1198420,+,678
408,NZ_OX366398,1,767698,768264,-,566
408,NC_002978,6,1105692,1106370,-,678
408,NZ_OX366389,1,131765,132331,+,566
408,NZ_OX366397,1,116871,117549,-,678
408,NZ_OX366378,1,61791,62469,-,678
408,NZ_CP090903,1,1105695,1106373,-,678
408,NZ_OX366374,1,319886,320564,+,678
408,NZ_CP090901,1,1105695,1106373,-,678
408,NZ_CP046923,1,1083754,1084432,-,678
408,NZ_CP069055,1,1105464,1106142,-,678
408,NZ_CP072670,1,1105522,1106200,-,678
408,NZ_CP090899,1,1105695,1106373,-,678
408,NZ_CP046924,1,1104692,1105370,-,678
408,NZ_OX366348,1,1155711,1156265,-,554
408,NZ_CP046921,1,1167506,1168184,-,678
408,NZ_OX366338,1,618583,619261,+,678
408,NZ_CP054557,1,900765,901319,-,554
408,NZ_CP072669,1,1105542,1106220,-,678
408,NC_021089,1,1133054,1133732,-,678
409,NZ_OX366376,1,1310238,1311800,+,1562
409,NZ_OX366393,1,702507,704069,+,1562
409,NZ_OX366372,1,365516,367078,+,1562
409,NZ_CP072672,1,1103768,1105334,-,1566
409,NZ_CP069060,1,950325,951891,-,1566
409,NZ_CP072667,1,1103742,1105308,-,1566
409,NZ_CP072671,1,1103750,1105316,-,1566
409,NZ_CP072668,1,1103737,1105303,-,1566
409,NZ_CP072666,1,1103750,1105316,-,1566
409,NZ_CP090902,1,1103902,1105468,-,1566
409,NZ_CP090948,1,1103900,1105466,-,1566
409,NZ_CP069052,1,1045623,1047189,+,1566
409,NZ_CP076228,1,1118419,1119985,-,1566
409,NZ_CP042445,1,1103890,1105456,-,1566
409,NZ_CP042904,1,1175125,1176691,-,1566
409,NC_012416,1,1220340,1221906,-,1566
409,NZ_CP069053,1,950357,951923,-,1566
409,NZ_CP042446,1,1103900,1105466,-,1566
409,NZ_CP041215,1,75433,76999,+,1566
409,NZ_OX366353,1,707133,708699,+,1566
409,NZ_OX366387,1,142563,144129,-,1566
409,NZ_OX366368,1,116756,118322,-,1566
409,NZ_OX366379,1,116854,118420,-,1566
409,NZ_CP091195,1,1259412,1260978,-,1566
409,NZ_OX366375,1,118572,120138,-,1566
409,NZ_CP046925,1,1103750,1105316,-,1566
409,NZ_OX366318,1,111579,113145,-,1566
409,NZ_OX366319,1,1084591,1086157,+,1566
409,NZ_OX366332,1,115288,116854,-,1566
409,NZ_CP110359,1,99849,101410,-,1561
409,NZ_OU953855,1,1492698,1494264,+,1566
409,NZ_OX366272,1,71395,72961,-,1566
409,NZ_OX366347,1,223573,225139,-,1566
409,NZ_OU909470,1,250051,251612,+,1561
409,NZ_OX366363,1,1113817,1115383,+,1566
409,NZ_OX366364,1,89448,91010,+,1562
409,NZ_OX366359,1,114353,115919,-,1566
409,NZ_OX366349,1,967642,969190,-,1548
409,NZ_OX366380,1,647696,649257,-,1561
409,NZ_OX366344,1,1310806,1312368,+,1562
409,NZ_CP090900,1,1103903,1105469,-,1566
409,NZ_OX366352,1,1574551,1576117,+,1566
409,NZ_OX366362,1,308962,310479,+,1517
409,NZ_OX366400,1,60880,62446,+,1566
409,NZ_OX366327,1,114352,115918,-,1566
409,NZ_OX366367,1,1465663,1467225,-,1562
409,NZ_CP042444,1,1105256,1106822,-,1566
409,NZ_OX366326,1,115285,116851,-,1566
409,NZ_CP037426,1,1025841,1027407,+,1566
409,NZ_OX366339,1,1324797,1326363,-,1566
409,NZ_OX366355,1,1201700,1203266,+,1566
409,NZ_CP046922,1,1165714,1167280,-,1566
409,NZ_OX366370,1,565933,567493,+,1560
409,NZ_OX366385,1,910067,911628,+,1561
409,NZ_OX366399,1,116257,117823,-,1566
409,NZ_OX366395,1,253972,255534,-,1562
409,NZ_OX366396,1,660862,662428,-,1566
409,NZ_OX366351,1,122700,124266,-,1566
409,NZ_OX366381,1,1266628,1268194,+,1566
409,NZ_OX366342,1,1281788,1283350,-,1562
409,NZ_OX366369,1,113106,114672,-,1566
409,NZ_OX366356,1,110727,112293,-,1566
409,NZ_OX366377,1,119123,120689,-,1566
409,NZ_OX366388,1,1707351,1708917,-,1566
409,NZ_OX366357,1,1111460,1113020,+,1560
409,NZ_CP072012,1,1198646,1200212,+,1566
409,NZ_OX366398,1,765913,767479,-,1566
409,NC_002978,6,1103900,1105466,-,1566
409,NZ_OX366389,1,132550,134116,+,1566
409,NZ_OX366397,1,115079,116645,-,1566
409,NZ_OX366378,1,59999,61565,-,1566
409,NZ_CP090903,1,1103903,1105469,-,1566
409,NZ_OX366374,1,320783,322349,+,1566
409,NZ_CP090901,1,1103903,1105469,-,1566
409,NZ_CP046923,1,1081962,1083528,-,1566
409,NZ_CP069055,1,1103672,1105238,-,1566
409,NZ_CP072670,1,1103730,1105296,-,1566
409,NZ_CP090899,1,1103903,1105469,-,1566
409,NZ_CP046924,1,1102900,1104466,-,1566
409,NZ_OX366348,1,1153933,1155495,-,1562
409,NZ_CP046921,1,1165714,1167280,-,1566
409,NZ_OX366338,1,619487,621053,+,1566
409,NZ_CP054557,1,898987,900549,-,1562
409,NZ_CP072669,1,1103750,1105316,-,1566
409,NC_021089,1,1131262,1132828,-,1566
410,NZ_OX366376,1,1313797,1315520,+,1723
410,NZ_OX366393,1,706078,707801,+,1723
410,NZ_OX366372,1,369087,370810,+,1723
410,NZ_CP072672,1,1054729,1056443,+,1714
410,NZ_CP069060,1,900697,902411,+,1714
410,NZ_CP072667,1,1054703,1056417,+,1714
410,NZ_CP072671,1,1054711,1056425,+,1714
410,NZ_CP072668,1,1054698,1056412,+,1714
410,NZ_CP072666,1,1054711,1056425,+,1714
410,NZ_CP090902,1,1054863,1056577,+,1714
410,NZ_CP090948,1,1054861,1056575,+,1714
410,NZ_CP069052,1,752217,753931,-,1714
410,NZ_CP076228,1,916497,918211,+,1714
410,NZ_CP042445,1,1054851,1056565,+,1714
410,NZ_CP042904,1,1318997,1320711,+,1714
410,NC_012416,1,1363695,1365409,+,1714
410,NZ_CP069053,1,900705,902419,+,1714
410,NZ_CP042446,1,1054861,1056575,+,1714
410,NZ_CP041215,1,1383216,1384930,-,1714
410,NZ_OX366353,1,435750,437464,-,1714
410,NZ_OX366387,1,430333,432047,-,1714
410,NZ_OX366368,1,67163,68877,+,1714
410,NZ_OX366379,1,67181,68895,+,1714
410,NZ_CP091195,1,697087,698801,-,1714
410,NZ_OX366375,1,112699,114413,-,1714
410,NZ_CP046925,1,1054711,1056425,+,1714
410,NZ_OX366318,1,65243,66957,+,1714
410,NZ_OX366319,1,1089412,1091126,+,1714
410,NZ_OX366332,1,110320,112034,-,1714
410,NZ_CP110359,1,401385,403099,-,1714
410,NZ_OU953855,1,409568,411282,-,1714
410,NZ_OX366272,1,162566,164280,+,1714
410,NZ_OX366347,1,52517,54188,-,1671
410,NZ_OU909470,1,618294,620008,+,1714
410,NZ_OX366363,1,876291,878005,+,1714
410,NZ_OX366364,1,93148,94854,+,1706
410,NZ_OX366359,1,109401,111115,-,1714
410,NZ_OX366349,1,963923,965646,-,1723
410,NZ_OX366380,1,222154,223868,+,1714
410,NZ_OX366344,1,1315742,1317465,+,1723
410,NZ_CP090900,1,1054863,1056577,+,1714
410,NZ_OX366352,1,1579371,1581085,+,1714
410,NZ_OX366362,1,312741,314455,+,1714
410,NZ_OX366400,1,107517,109231,-,1714
410,NZ_OX366327,1,109309,111023,-,1714
410,NZ_OX366367,1,1459573,1461279,-,1706
410,NZ_CP042444,1,1056217,1057931,+,1714
410,NZ_OX366326,1,68572,70286,+,1714
410,NZ_CP037426,1,1030645,1032359,+,1714
410,NZ_OX366339,1,982060,983774,+,1714
410,NZ_OX366355,1,1206520,1208234,+,1714
410,NZ_CP046922,1,1116780,1118494,+,1714
410,NZ_OX366370,1,450393,452116,+,1723
410,NZ_OX366385,1,634786,636500,-,1714
410,NZ_OX366399,1,66672,68386,+,1714
410,NZ_OX366395,1,1542894,1544608,-,1714
410,NZ_OX366396,1,1049678,1051392,+,1714
410,NZ_OX366351,1,75963,77677,+,1714
410,NZ_OX366381,1,1271448,1273162,+,1714
410,NZ_OX366342,1,1278056,1279779,-,1723
410,NZ_OX366369,1,67596,69310,+,1714
410,NZ_OX366356,1,65127,66841,+,1714
410,NZ_OX366377,1,65782,67496,+,1714
410,NZ_OX366388,1,108070,109784,-,1714
410,NZ_OX366357,1,203573,205287,+,1714
410,NZ_CP072012,1,940337,942051,-,1714
410,NZ_OX366398,1,537141,538855,+,1714
410,NC_002978,6,1054861,1056575,+,1714
410,NZ_OX366389,1,183941,185655,-,1714
410,NZ_OX366397,1,34833,36547,-,1714
410,NZ_OX366378,1,31110,32824,+,1714
410,NZ_CP090903,1,1054863,1056577,+,1714
410,NZ_OX366374,1,277377,279091,+,1714
410,NZ_CP090901,1,1054863,1056577,+,1714
410,NZ_CP046923,1,1033028,1034742,+,1714
410,NZ_CP069055,1,1006031,1007745,+,1714
410,NZ_CP072670,1,1054691,1056405,+,1714
410,NZ_CP090899,1,1054863,1056577,+,1714
410,NZ_CP046924,1,1053966,1055680,+,1714
410,NZ_OX366348,1,106682,108396,-,1714
410,NZ_CP046921,1,1116780,1118494,+,1714
410,NZ_OX366338,1,832325,834039,-,1714
410,NZ_OX366338,1,1022795,1024509,-,1714
410,NZ_CP054557,1,847853,849567,+,1714
410,NZ_CP072669,1,1054711,1056425,+,1714
410,NC_021089,1,1082964,1084678,+,1714
411,NZ_OX366376,1,1318317,1318873,+,556
411,NZ_OX366393,1,710607,711163,+,556
411,NZ_OX366372,1,373615,374171,+,556
411,NZ_OU909470,1,622790,623337,+,547
411,NZ_OX366380,1,226595,227142,+,547
411,NZ_OX366344,1,1319590,1320146,+,556
411,NZ_OX366385,1,175823,176365,+,542
412,NZ_OX366376,1,1321684,1324142,+,2458
412,NZ_OX366393,1,714415,716873,+,2458
412,NZ_OX366372,1,377522,379980,+,2458
412,NZ_CP072672,1,1056947,1059398,+,2451
412,NZ_CP069060,1,902915,905365,+,2450
412,NZ_CP072667,1,1056921,1059372,+,2451
412,NZ_CP072671,1,1056929,1059380,+,2451
412,NZ_CP072668,1,1056916,1059367,+,2451
412,NZ_CP072666,1,1056929,1059380,+,2451
412,NZ_CP090902,1,1057081,1059532,+,2451
412,NZ_CP090948,1,1057079,1059530,+,2451
412,NZ_CP069052,1,749263,751713,-,2450
412,NZ_CP076228,1,945867,948318,-,2451
412,NZ_CP042445,1,1057069,1059520,+,2451
412,NZ_CP042904,1,1321215,1323666,+,2451
412,NC_012416,1,1365913,1368364,+,2451
412,NZ_CP069053,1,902923,905373,+,2450
412,NZ_CP042446,1,1057079,1059530,+,2451
412,NZ_CP041215,1,119475,121926,-,2451
412,NZ_OX366353,1,1244644,1247095,+,2451
412,NZ_OX366387,1,427364,429829,-,2465
412,NZ_OX366368,1,69381,71832,+,2451
412,NZ_OX366379,1,69399,71850,+,2451
412,NZ_CP091195,1,694118,696583,-,2465
412,NZ_OX366375,1,109744,112195,-,2451
412,NZ_CP046925,1,1056929,1059380,+,2451
412,NZ_OX366318,1,67461,69912,+,2451
412,NZ_OX366319,1,1091630,1094081,+,2451
412,NZ_OX366332,1,106283,108734,-,2451
412,NZ_CP110359,1,398477,400942,-,2465
412,NZ_OU953855,1,406613,409064,-,2451
412,NZ_OX366272,1,164784,167249,+,2465
412,NZ_OX366347,1,49664,52108,-,2444
412,NZ_OU909470,1,626325,628779,+,2454
412,NZ_OX366363,1,878509,880960,+,2451
412,NZ_OX366364,1,95228,97680,+,2452
412,NZ_OX366359,1,105356,107807,-,2451
412,NZ_OX366349,1,953772,956230,-,2458
412,NZ_OX366380,1,230131,232577,+,2446
412,NZ_OX366344,1,1323317,1325775,+,2458
412,NZ_CP090900,1,1057081,1059532,+,2451
412,NZ_OX366352,1,1582679,1585130,+,2451
412,NZ_OX366362,1,319819,322227,+,2408
412,NZ_OX366400,1,104562,107013,-,2451
412,NZ_OX366327,1,106353,108804,-,2451
412,NZ_OX366367,1,1456747,1459199,-,2452
412,NZ_CP042444,1,1058435,1060886,+,2451
412,NZ_OX366326,1,70790,73241,+,2451
412,NZ_CP037426,1,1034703,1037154,+,2451
412,NZ_OX366339,1,965113,967564,-,2451
412,NZ_OX366355,1,1208738,1211189,+,2451
412,NZ_CP046922,1,1118998,1121449,+,2451
412,NZ_OX366370,1,456012,458470,+,2458
412,NZ_OX366385,1,180306,182752,+,2446
412,NZ_OX366399,1,68890,71341,+,2451
412,NZ_OX366395,1,1535484,1537919,-,2435
412,NZ_OX366396,1,1051896,1054347,+,2451
412,NZ_OX366351,1,78181,80632,+,2451
412,NZ_OX366381,1,1273666,1276117,+,2451
412,NZ_OX366342,1,1270388,1272846,-,2458
412,NZ_OX366369,1,69814,72265,+,2451
412,NZ_OX366356,1,67413,69864,+,2451
412,NZ_OX366377,1,68000,70451,+,2451
412,NZ_OX366388,1,105040,107505,-,2465
412,NZ_OX366357,1,205790,208255,+,2465
412,NZ_CP072012,1,937382,939833,-,2451
412,NZ_OX366398,1,539359,541810,+,2451
412,NC_002978,6,1057079,1059530,+,2451
412,NZ_OX366389,1,180986,183437,-,2451
412,NZ_OX366397,1,69826,72277,+,2451
412,NZ_OX366378,1,33328,35793,+,2465
412,NZ_CP090903,1,1057081,1059532,+,2451
412,NZ_OX366374,1,279595,282060,+,2465
412,NZ_CP090901,1,1057081,1059532,+,2451
412,NZ_CP046923,1,1035246,1037697,+,2451
412,NZ_CP069055,1,860056,862507,+,2451
412,NZ_CP072670,1,1056909,1059360,+,2451
412,NZ_CP090899,1,1057081,1059532,+,2451
412,NZ_CP046924,1,1056184,1058635,+,2451
412,NZ_OX366348,1,103727,106178,-,2451
412,NZ_CP046921,1,1118998,1121449,+,2451
412,NZ_OX366338,1,1411687,1414142,+,2455
412,NZ_CP054557,1,850071,852522,+,2451
412,NZ_CP072669,1,1056929,1059380,+,2451
412,NC_021089,1,1086271,1088722,+,2451
413,NZ_OX366376,1,1324233,1327747,+,3514
413,NZ_OX366393,1,716964,720478,+,3514
413,NZ_OX366372,1,380071,383585,+,3514
413,NZ_CP072672,1,1059480,1063002,+,3522
413,NZ_CP069060,1,905447,908969,+,3522
413,NZ_CP072667,1,1059454,1062976,+,3522
413,NZ_CP072671,1,1059462,1062984,+,3522
413,NZ_CP072668,1,1059449,1062971,+,3522
413,NZ_CP072666,1,1059462,1062984,+,3522
413,NZ_CP090902,1,1059614,1063136,+,3522
413,NZ_CP090948,1,1059612,1063134,+,3522
413,NZ_CP069052,1,745659,749181,-,3522
413,NZ_CP076228,1,942263,945785,-,3522
413,NZ_CP042445,1,1059602,1063124,+,3522
413,NZ_CP042904,1,1323748,1327270,+,3522
413,NC_012416,1,1368446,1371968,+,3522
413,NZ_CP069053,1,905455,908977,+,3522
413,NZ_CP042446,1,1059612,1063134,+,3522
413,NZ_CP041215,1,115871,119393,-,3522
413,NZ_OX366353,1,1247177,1250699,+,3522
413,NZ_OX366387,1,423760,427282,-,3522
413,NZ_OX366368,1,71914,75436,+,3522
413,NZ_OX366379,1,71932,75454,+,3522
413,NZ_CP091195,1,690514,694036,-,3522
413,NZ_OX366375,1,106140,109662,-,3522
413,NZ_CP046925,1,1059462,1062984,+,3522
413,NZ_OX366318,1,69994,73516,+,3522
413,NZ_OX366319,1,1094163,1097685,+,3522
413,NZ_OX366332,1,102679,106201,-,3522
413,NZ_CP110359,1,394881,398395,-,3514
413,NZ_OU953855,1,402784,406306,-,3522
413,NZ_OX366272,1,167331,170845,+,3514
413,NZ_OX366347,1,46051,49573,-,3522
413,NZ_OU909470,1,628866,632380,+,3514
413,NZ_OX366363,1,881042,884564,+,3522
413,NZ_OX366364,1,97771,101293,+,3522
413,NZ_OX366359,1,101752,105274,-,3522
413,NZ_OX366349,1,950167,953681,-,3514
413,NZ_OX366380,1,232664,236178,+,3514
413,NZ_OX366344,1,1325866,1329380,+,3514
413,NZ_CP090900,1,1059614,1063136,+,3522
413,NZ_OX366352,1,1585212,1588734,+,3522
413,NZ_OX366362,1,1344985,1348481,+,3496
413,NZ_OX366400,1,100958,104480,-,3522
413,NZ_OX366327,1,102749,106271,-,3522
413,NZ_OX366367,1,1453165,1456656,-,3491
413,NZ_CP042444,1,1060968,1064490,+,3522
413,NZ_OX366326,1,73323,76845,+,3522
413,NZ_CP037426,1,1037236,1040758,+,3522
413,NZ_OX366339,1,961509,965031,-,3522
413,NZ_OX366355,1,1211271,1214793,+,3522
413,NZ_CP046922,1,1121531,1125053,+,3522
413,NZ_OX366370,1,458561,462075,+,3514
413,NZ_OX366385,1,182839,186353,+,3514
413,NZ_OX366399,1,71423,74945,+,3522
413,NZ_OX366395,1,1531880,1535402,-,3522
413,NZ_OX366396,1,1054429,1057951,+,3522
413,NZ_OX366351,1,80714,84236,+,3522
413,NZ_OX366381,1,1276199,1279721,+,3522
413,NZ_OX366342,1,1266783,1270297,-,3514
413,NZ_OX366369,1,72347,75869,+,3522
413,NZ_OX366356,1,69946,73468,+,3522
413,NZ_OX366377,1,70533,74055,+,3522
413,NZ_OX366388,1,101436,104958,-,3522
413,NZ_OX366357,1,208337,211854,+,3517
413,NZ_CP072012,1,933778,937300,-,3522
413,NZ_OX366398,1,541892,545414,+,3522
413,NC_002978,6,1059612,1063134,+,3522
413,NZ_OX366389,1,177382,180904,-,3522
413,NZ_OX366397,1,72359,75881,+,3522
413,NZ_OX366378,1,35875,39397,+,3522
413,NZ_CP090903,1,1059614,1063136,+,3522
413,NZ_OX366374,1,282142,285664,+,3522
413,NZ_CP090901,1,1059614,1063136,+,3522
413,NZ_CP046923,1,1037779,1041301,+,3522
413,NZ_CP069055,1,862589,866111,+,3522
413,NZ_CP072670,1,1059442,1062964,+,3522
413,NZ_CP090899,1,1059614,1063136,+,3522
413,NZ_CP046924,1,1058717,1062239,+,3522
413,NZ_OX366348,1,100123,103645,-,3522
413,NZ_CP046921,1,1121531,1125053,+,3522
413,NZ_OX366338,1,1414236,1417742,+,3506
413,NZ_CP054557,1,852604,856126,+,3522
413,NZ_CP072669,1,1059462,1062984,+,3522
413,NC_021089,1,1088804,1092326,+,3522
414,NZ_OX366376,1,1327748,1329136,+,1388
414,NZ_OX366393,1,720479,721874,+,1395
414,NZ_OX366372,1,383586,384981,+,1395
414,NZ_CP072672,1,1063003,1064390,+,1387
414,NZ_CP069060,1,908970,910357,+,1387
414,NZ_CP072667,1,1062977,1064364,+,1387
414,NZ_CP072671,1,1062985,1064372,+,1387
414,NZ_CP072668,1,1062972,1064359,+,1387
414,NZ_CP072666,1,1062985,1064372,+,1387
414,NZ_CP090902,1,1063137,1064524,+,1387
414,NZ_CP090948,1,1063135,1064522,+,1387
414,NZ_CP069052,1,744270,745657,-,1387
414,NZ_CP076228,1,940874,942261,-,1387
414,NZ_CP042445,1,1063125,1064512,+,1387
414,NZ_CP042904,1,1327271,1328666,+,1395
414,NC_012416,1,1371969,1373364,+,1395
414,NZ_CP069053,1,908978,910365,+,1387
414,NZ_CP042446,1,1063135,1064522,+,1387
414,NZ_CP041215,1,114475,115869,-,1394
414,NZ_OX366353,1,1250700,1252094,+,1394
414,NZ_OX366387,1,422363,423758,-,1395
414,NZ_OX366368,1,75437,76824,+,1387
414,NZ_OX366379,1,75455,76842,+,1387
414,NZ_CP091195,1,689117,690512,-,1395
414,NZ_OX366375,1,104743,106138,-,1395
414,NZ_CP046925,1,1062985,1064372,+,1387
414,NZ_OX366318,1,73517,74920,+,1403
414,NZ_OX366319,1,1097686,1099081,+,1395
414,NZ_OX366332,1,101283,102677,-,1394
414,NZ_CP110359,1,393484,394879,-,1395
414,NZ_OU953855,1,401395,402782,-,1387
414,NZ_OX366272,1,170846,172241,+,1395
414,NZ_OX366347,1,44654,46049,-,1395
414,NZ_OU909470,1,632381,633768,+,1387
414,NZ_OX366363,1,884565,885952,+,1387
414,NZ_OX366364,1,101294,102666,+,1372
414,NZ_OX366359,1,100356,101750,-,1394
414,NZ_OX366349,1,948778,950165,-,1387
414,NZ_OX366380,1,236179,237566,+,1387
414,NZ_OX366344,1,1329381,1330776,+,1395
414,NZ_CP090900,1,1063137,1064524,+,1387
414,NZ_OX366352,1,1588735,1590129,+,1394
414,NZ_OX366362,1,1348482,1349876,+,1394
414,NZ_OX366400,1,99553,100956,-,1403
414,NZ_OX366327,1,101352,102747,-,1395
414,NZ_OX366367,1,1451760,1453087,-,1327
414,NZ_CP042444,1,1064491,1065878,+,1387
414,NZ_OX366326,1,76846,78249,+,1403
414,NZ_CP037426,1,1040759,1042154,+,1395
414,NZ_OX366339,1,960112,961507,-,1395
414,NZ_OX366355,1,1214794,1216189,+,1395
414,NZ_CP046922,1,1125054,1126441,+,1387
414,NZ_OX366370,1,462076,463471,+,1395
414,NZ_OX366385,1,186354,187741,+,1387
414,NZ_OX366399,1,74946,76333,+,1387
414,NZ_OX366395,1,1530484,1531878,-,1394
414,NZ_OX366396,1,1057952,1059347,+,1395
414,NZ_OX366351,1,84237,85640,+,1403
414,NZ_OX366381,1,1279722,1281117,+,1395
414,NZ_OX366342,1,1265386,1266781,-,1395
414,NZ_OX366369,1,75870,77265,+,1395
414,NZ_OX366356,1,73469,74864,+,1395
414,NZ_OX366377,1,74056,75459,+,1403
414,NZ_OX366388,1,100039,101434,-,1395
414,NZ_OX366357,1,211871,213254,+,1383
414,NZ_CP072012,1,932389,933776,-,1387
414,NZ_OX366398,1,545415,546818,+,1403
414,NC_002978,6,1063135,1064522,+,1387
414,NZ_OX366389,1,175977,177380,-,1403
414,NZ_OX366397,1,75882,77276,+,1394
414,NZ_OX366378,1,39398,40793,+,1395
414,NZ_CP090903,1,1063137,1064524,+,1387
414,NZ_OX366374,1,285665,287060,+,1395
414,NZ_CP090901,1,1063137,1064524,+,1387
414,NZ_CP046923,1,1041302,1042689,+,1387
414,NZ_CP069055,1,866112,867499,+,1387
414,NZ_CP072670,1,1062965,1064352,+,1387
414,NZ_CP090899,1,1063137,1064524,+,1387
414,NZ_CP046924,1,1062240,1063627,+,1387
414,NZ_OX366348,1,98734,100121,-,1387
414,NZ_CP046921,1,1125054,1126441,+,1387
414,NZ_OX366338,1,1418602,1420007,+,1405
414,NZ_CP054557,1,856127,857514,+,1387
414,NZ_CP072669,1,1062985,1064372,+,1387
414,NC_021089,1,1092327,1093721,+,1394
415,NZ_OX366376,1,1330049,1331620,+,1571
415,NZ_OX366393,1,722780,724351,+,1571
415,NZ_OX366372,1,385887,387458,+,1571
415,NZ_CP072672,1,1065957,1067532,+,1575
415,NZ_CP069060,1,911924,913499,+,1575
415,NZ_CP072667,1,1065931,1067506,+,1575
415,NZ_CP072671,1,1065939,1067514,+,1575
415,NZ_CP072668,1,1065926,1067501,+,1575
415,NZ_CP072666,1,1065939,1067514,+,1575
415,NZ_CP090902,1,1066091,1067666,+,1575
415,NZ_CP090948,1,1066089,1067664,+,1575
415,NZ_CP069052,1,741129,742704,-,1575
415,NZ_CP076228,1,937737,939312,-,1575
415,NZ_CP042445,1,1066079,1067654,+,1575
415,NZ_CP042904,1,1329574,1331146,+,1572
415,NC_012416,1,1374272,1375844,+,1572
415,NZ_CP069053,1,911932,913507,+,1575
415,NZ_CP042446,1,1066089,1067664,+,1575
415,NZ_CP041215,1,111375,112958,-,1583
415,NZ_OX366353,1,1253612,1255195,+,1583
415,NZ_OX366387,1,419242,420826,-,1584
415,NZ_OX366368,1,78391,79966,+,1575
415,NZ_OX366379,1,78409,79984,+,1575
415,NZ_CP091195,1,753244,754817,-,1573
415,NZ_OX366375,1,102262,103834,-,1572
415,NZ_CP046925,1,1065939,1067514,+,1575
415,NZ_OX366318,1,76457,78041,+,1584
415,NZ_OX366319,1,1099991,1101573,+,1582
415,NZ_OX366332,1,98183,99766,-,1583
415,NZ_CP110359,1,390384,391968,-,1584
415,NZ_OU953855,1,398245,399829,-,1584
415,NZ_OX366272,1,173763,175347,+,1584
415,NZ_OX366347,1,41559,43140,-,1581
415,NZ_OU909470,1,635326,636901,+,1575
415,NZ_OX366363,1,887519,889094,+,1575
415,NZ_OX366364,1,198819,200401,-,1582
415,NZ_OX366359,1,97256,98839,-,1583
415,NZ_OX366349,1,946285,947865,-,1580
415,NZ_OX366380,1,239157,240730,+,1573
415,NZ_OX366344,1,1332469,1334039,+,1570
415,NZ_CP090900,1,1066091,1067666,+,1575
415,NZ_OX366352,1,1591647,1593230,+,1583
415,NZ_OX366362,1,1351383,1352958,+,1575
415,NZ_OX366400,1,96433,98017,-,1584
415,NZ_OX366327,1,98247,99831,-,1584
415,NZ_OX366367,1,1374857,1376439,-,1582
415,NZ_CP042444,1,1067445,1069020,+,1575
415,NZ_OX366326,1,79786,81370,+,1584
415,NZ_CP037426,1,1043064,1044636,+,1572
415,NZ_OX366339,1,953600,955184,-,1584
415,NZ_OX366355,1,1217099,1218681,+,1582
415,NZ_CP046922,1,1128008,1129583,+,1575
415,NZ_OX366370,1,168731,170280,+,1549
415,NZ_OX366385,1,190181,191754,+,1573
415,NZ_OX366399,1,77900,79475,+,1575
415,NZ_OX366395,1,1527998,1529582,-,1584
415,NZ_OX366396,1,1466716,1468300,-,1584
415,NZ_OX366351,1,87177,88761,+,1584
415,NZ_OX366381,1,1282027,1283609,+,1582
415,NZ_OX366342,1,1262910,1264481,-,1571
415,NZ_OX366369,1,78175,79757,+,1582
415,NZ_OX366356,1,76335,77919,+,1584
415,NZ_OX366377,1,77026,78601,+,1575
415,NZ_OX366388,1,97227,98800,-,1573
415,NZ_OX366357,1,1074449,1076033,-,1584
415,NZ_CP072012,1,926407,927982,-,1575
415,NZ_OX366398,1,548385,549960,+,1575
415,NC_002978,6,1066089,1067664,+,1575
415,NZ_OX366389,1,172836,174411,-,1575
415,NZ_OX366397,1,78794,80377,+,1583
415,NZ_OX366378,1,24815,26388,+,1573
415,NZ_CP090903,1,1066091,1067666,+,1575
415,NZ_OX366374,1,287962,289537,+,1575
415,NZ_CP090901,1,1066091,1067666,+,1575
415,NZ_CP046923,1,1044256,1045831,+,1575
415,NZ_CP069055,1,869067,870642,+,1575
415,NZ_CP072670,1,1065919,1067494,+,1575
415,NZ_CP090899,1,1066091,1067666,+,1575
415,NZ_CP046924,1,1065194,1066769,+,1575
415,NZ_OX366348,1,94675,96249,-,1574
415,NZ_CP046921,1,1128008,1129583,+,1575
415,NZ_OX366338,1,1420909,1422493,+,1584
415,NZ_CP054557,1,859935,861509,+,1574
415,NZ_CP072669,1,1065939,1067514,+,1575
415,NC_021089,1,1095239,1096822,+,1583
416,NZ_OX366376,1,1332681,1334058,+,1377
416,NZ_OX366393,1,725638,727015,+,1377
416,NZ_OX366372,1,388425,389802,+,1377
416,NZ_CP072672,1,740364,741741,-,1377
416,NZ_CP069060,1,583305,584682,-,1377
416,NZ_CP072667,1,740346,741723,-,1377
416,NZ_CP072671,1,740346,741723,-,1377
416,NZ_CP072668,1,740333,741710,-,1377
416,NZ_CP072666,1,740346,741723,-,1377
416,NZ_CP090902,1,740498,741875,-,1377
416,NZ_CP090948,1,740498,741875,-,1377
416,NZ_CP069052,1,1134295,1135672,-,1377
416,NZ_CP076228,1,797977,799354,+,1377
416,NZ_CP042445,1,740486,741863,-,1377
416,NZ_CP042904,1,620307,621684,-,1377
416,NC_012416,1,655962,657339,-,1377
416,NZ_CP069053,1,583313,584690,-,1377
416,NZ_CP042446,1,740498,741875,-,1377
416,NZ_CP041215,1,938857,940234,+,1377
416,NZ_OX366353,1,102399,103776,+,1377
416,NZ_OX366387,1,712528,713905,+,1377
416,NZ_OX366368,1,1186208,1187585,-,1377
416,NZ_OX366379,1,1105723,1107100,-,1377
416,NZ_CP091195,1,1513471,1514806,+,1335
416,NZ_OX366375,1,1032487,1033864,-,1377
416,NZ_CP046925,1,740346,741723,-,1377
416,NZ_OX366318,1,1037665,1039042,-,1377
416,NZ_OX366319,1,180643,182020,+,1377
416,NZ_OX366332,1,1123691,1125068,-,1377
416,NZ_CP110359,1,464954,466331,+,1377
416,NZ_OU953855,1,228940,230317,+,1377
416,NZ_OX366272,1,1362538,1363915,-,1377
416,NZ_OX366347,1,171807,173184,-,1377
416,NZ_OU909470,1,1035322,1036701,+,1379
416,NZ_OX366363,1,1201440,1202817,+,1377
416,NZ_OX366364,1,194443,195801,-,1358
416,NZ_OX366359,1,951492,952869,-,1377
416,NZ_OX366349,1,941412,942789,-,1377
416,NZ_OX366380,1,72539,73914,-,1375
416,NZ_OX366344,1,1335008,1336385,+,1377
416,NZ_CP090900,1,740498,741875,-,1377
416,NZ_OX366352,1,1263098,1264475,+,1377
416,NZ_OX366362,1,412395,413771,+,1376
416,NZ_OX366400,1,900915,902292,-,1377
416,NZ_OX366327,1,1037304,1038681,-,1377
416,NZ_OX366367,1,1372001,1373359,-,1358
416,NZ_CP042444,1,740933,742310,-,1377
416,NZ_OX366326,1,1245148,1246525,-,1377
416,NZ_CP037426,1,830200,831577,-,1377
416,NZ_OX366339,1,853263,854640,-,1377
416,NZ_OX366355,1,205013,206390,+,1377
416,NZ_CP046922,1,802311,803688,-,1377
416,NZ_OX366370,1,171171,172548,+,1377
416,NZ_OX366385,1,49430,50805,+,1375
416,NZ_OX366399,1,1140351,1141728,-,1377
416,NZ_OX366395,1,1339721,1341098,+,1377
416,NZ_OX366396,1,1347362,1348739,+,1377
416,NZ_OX366351,1,1191573,1192950,-,1377
416,NZ_OX366381,1,291504,292881,+,1377
416,NZ_OX366342,1,1260472,1261849,-,1377
416,NZ_OX366369,1,1227678,1229055,-,1377
416,NZ_OX366356,1,944712,946047,-,1335
416,NZ_OX366377,1,1189070,1190447,+,1377
416,NZ_OX366388,1,221480,222815,-,1335
416,NZ_OX366357,1,1023932,1025309,-,1377
416,NZ_CP072012,1,1439986,1441363,+,1377
416,NZ_OX366398,1,218960,220337,-,1377
416,NC_002978,6,740498,741875,-,1377
416,NZ_OX366389,1,1135599,1136976,+,1377
416,NZ_OX366397,1,1345192,1346569,-,1377
416,NZ_OX366378,1,567890,569225,+,1335
416,NZ_CP090903,1,740498,741875,-,1377
416,NZ_OX366374,1,47323,48700,+,1377
416,NZ_CP090901,1,740498,741875,-,1377
416,NZ_CP046923,1,718559,719936,-,1377
416,NZ_CP069055,1,739828,741205,-,1377
416,NZ_CP072670,1,740338,741715,-,1377
416,NZ_CP090899,1,740498,741875,-,1377
416,NZ_CP046924,1,739497,740874,-,1377
416,NZ_OX366348,1,240249,241626,+,1377
416,NZ_CP046921,1,802311,803688,-,1377
416,NZ_OX366338,1,323008,324385,-,1377
416,NZ_CP054557,1,1066983,1068360,+,1377
416,NZ_CP072669,1,740346,741723,-,1377
416,NC_021089,1,773929,775306,-,1377
417,NZ_OX366376,1,1334129,1335100,+,971
417,NZ_OX366393,1,727086,728057,+,971
417,NZ_OX366372,1,389873,390844,+,971
417,NZ_CP072672,1,737749,738736,-,987
417,NZ_CP069060,1,579202,580189,-,987
417,NZ_CP072667,1,737731,738718,-,987
417,NZ_CP072671,1,737731,738718,-,987
417,NZ_CP072668,1,737718,738705,-,987
417,NZ_CP072666,1,737731,738718,-,987
417,NZ_CP090902,1,737883,738870,-,987
417,NZ_CP090948,1,737883,738870,-,987
417,NZ_CP069052,1,1130192,1131179,-,987
417,NZ_CP076228,1,733574,734561,-,987
417,NZ_CP042445,1,737871,738858,-,987
417,NZ_CP042904,1,617317,618304,-,987
417,NC_012416,1,652972,653959,-,987
417,NZ_CP069053,1,579210,580197,-,987
417,NZ_CP042446,1,737883,738870,-,987
417,NZ_CP041215,1,943212,944199,+,987
417,NZ_OX366353,1,105287,106274,+,987
417,NZ_OX366387,1,715908,716895,+,987
417,NZ_OX366368,1,1182072,1183059,-,987
417,NZ_OX366379,1,1102538,1103525,-,987
417,NZ_CP091195,1,1516854,1517841,+,987
417,NZ_OX366375,1,1029302,1030289,-,987
417,NZ_CP046925,1,737731,738718,-,987
417,NZ_OX366318,1,1032853,1033840,-,987
417,NZ_OX366319,1,183456,184443,+,987
417,NZ_OX366332,1,1120212,1121199,-,987
417,NZ_CP110359,1,468142,469129,+,987
417,NZ_OU953855,1,232398,233385,+,987
417,NZ_OX366272,1,1359821,1360808,-,987
417,NZ_OX366347,1,168688,169675,-,987
417,NZ_OU909470,1,1036770,1037741,+,971
417,NZ_OX366363,1,1205015,1206002,+,987
417,NZ_OX366364,1,190954,191941,-,987
417,NZ_OX366359,1,949069,950056,-,987
417,NZ_OX366349,1,940370,941341,-,971
417,NZ_OX366380,1,71495,72466,-,971
417,NZ_OX366344,1,1336456,1337427,+,971
417,NZ_CP090900,1,737883,738870,-,987
417,NZ_OX366352,1,1266481,1267468,+,987
417,NZ_OX366362,1,1057683,1058670,+,987
417,NZ_OX366400,1,896100,897087,-,987
417,NZ_OX366327,1,1034119,1035106,-,987
417,NZ_OX366367,1,1368904,1369891,-,987
417,NZ_CP042444,1,738420,739407,-,987
417,NZ_OX366326,1,1239485,1240472,-,987
417,NZ_CP037426,1,827489,828476,-,987
417,NZ_OX366339,1,850372,851359,-,987
417,NZ_OX366355,1,207727,208714,+,987
417,NZ_CP046922,1,799597,800584,-,987
417,NZ_OX366370,1,172619,173590,+,971
417,NZ_OX366385,1,50878,51849,+,971
417,NZ_OX366399,1,1137166,1138153,-,987
417,NZ_OX366395,1,1342732,1343719,+,987
417,NZ_OX366396,1,1350448,1351435,+,987
417,NZ_OX366351,1,1186761,1187748,-,987
417,NZ_OX366381,1,294317,295304,+,987
417,NZ_OX366342,1,1259430,1260401,-,971
417,NZ_OX366369,1,1224298,1225285,-,987
417,NZ_OX366356,1,941677,942664,-,987
417,NZ_OX366377,1,1193852,1194839,+,987
417,NZ_OX366388,1,218250,219237,-,987
417,NZ_OX366357,1,1021806,1022793,-,987
417,NZ_CP072012,1,1443562,1444549,+,987
417,NZ_OX366398,1,678294,679281,+,987
417,NC_002978,6,737883,738870,-,987
417,NZ_OX366389,1,1139174,1140161,+,987
417,NZ_OX366397,1,1341323,1342310,-,987
417,NZ_OX366378,1,571174,572161,+,987
417,NZ_CP090903,1,737883,738870,-,987
417,NZ_OX366374,1,51779,52766,+,987
417,NZ_CP090901,1,737883,738870,-,987
417,NZ_CP046923,1,715845,716832,-,987
417,NZ_CP069055,1,736837,737824,-,987
417,NZ_CP072670,1,737723,738710,-,987
417,NZ_CP090899,1,737883,738870,-,987
417,NZ_CP046924,1,736783,737770,-,987
417,NZ_OX366348,1,244122,245109,+,987
417,NZ_CP046921,1,799597,800584,-,987
417,NZ_OX366338,1,318844,319831,-,987
417,NZ_CP054557,1,1070360,1071347,+,987
417,NZ_CP072669,1,737731,738718,-,987
417,NC_021089,1,770744,771731,-,987
418,NZ_OX366376,1,1341459,1343578,+,2119
418,NZ_OX366393,1,734869,736984,+,2115
418,NZ_OX366372,1,397203,399322,+,2119
418,NZ_CP072672,1,966279,968384,+,2105
418,NZ_CP069060,1,811227,813347,+,2120
418,NZ_CP072667,1,966253,968358,+,2105
418,NZ_CP072671,1,966261,968366,+,2105
418,NZ_CP072668,1,966248,968353,+,2105
418,NZ_CP072666,1,966261,968366,+,2105
418,NZ_CP090902,1,966413,968518,+,2105
418,NZ_CP090948,1,966413,968518,+,2105
418,NZ_CP069052,1,842723,844844,-,2121
418,NZ_CP076228,1,1015400,1017521,-,2121
418,NZ_CP042445,1,966401,968506,+,2105
418,NZ_CP042904,1,990147,992268,+,2121
418,NC_012416,1,1029241,1031362,+,2121
418,NZ_CP069053,1,811235,813355,+,2120
418,NZ_CP042446,1,966411,968516,+,2105
418,NZ_CP041215,1,19882,22004,-,2122
418,NZ_OX366353,1,1046765,1048887,-,2122
418,NZ_OX366387,1,1539211,1541332,+,2121
418,NZ_OX366368,1,1411901,1414021,+,2120
418,NZ_OX366379,1,1331346,1333466,+,2120
418,NZ_CP091195,1,1105344,1107466,-,2122
418,NZ_OX366375,1,1243932,1246054,-,2122
418,NZ_CP046925,1,966261,968366,+,2105
418,NZ_OX366318,1,1262682,1264803,+,2121
418,NZ_OX366319,1,1192542,1194663,+,2121
418,NZ_OX366332,1,1345981,1348102,+,2121
418,NZ_CP110359,1,199090,201213,+,2123
418,NZ_OU953855,1,485144,487265,+,2121
418,NZ_OX366272,1,149798,151921,+,2123
418,NZ_OX366347,1,1409257,1411368,+,2111
418,NZ_OU909470,1,890068,892337,+,2269
418,NZ_OX366363,1,984076,986197,+,2121
418,NZ_OX366364,1,1278840,1281113,-,2273
418,NZ_OX366359,1,1175700,1177821,+,2121
418,NZ_OX366349,1,661520,663639,+,2119
418,NZ_OX366380,1,888777,891047,-,2270
418,NZ_OX366344,1,357967,360086,+,2119
418,NZ_CP090900,1,966413,968518,+,2105
418,NZ_OX366352,1,1669708,1671829,+,2121
418,NZ_OX366362,1,279845,282107,+,2262
418,NZ_OX366400,1,1119703,1121824,+,2121
418,NZ_OX366327,1,1259498,1261619,+,2121
418,NZ_OX366367,1,1510911,1513030,+,2119
418,NZ_CP042444,1,966848,968953,+,2105
418,NZ_OX366326,1,1471932,1474053,+,2121
418,NZ_CP037426,1,670778,672900,-,2122
418,NZ_OX366339,1,107681,109822,+,2141
418,NZ_OX366355,1,1282417,1284539,-,2122
418,NZ_CP046922,1,1028309,1030414,+,2105
418,NZ_OX366370,1,736958,739078,-,2120
418,NZ_OX366385,1,1005398,1007668,+,2270
418,NZ_OX366399,1,1364962,1367082,+,2120
418,NZ_OX366395,1,1316954,1319080,+,2126
418,NZ_OX366396,1,78781,80922,+,2141
418,NZ_OX366351,1,1415803,1417924,+,2121
418,NZ_OX366381,1,1101489,1103610,+,2121
418,NZ_OX366342,1,692240,694359,+,2119
418,NZ_OX366369,1,1371638,1373760,-,2122
418,NZ_OX366356,1,1128488,1130609,+,2121
418,NZ_OX366377,1,996691,998813,-,2122
418,NZ_OX366388,1,1791192,1793312,+,2120
418,NZ_OX366357,1,184490,186616,+,2126
418,NZ_CP072012,1,1228305,1230425,+,2120
418,NZ_OX366398,1,447996,450117,+,2121
418,NC_002978,6,966413,968518,+,2105
418,NZ_OX366389,1,1344408,1346529,+,2121
418,NZ_OX366397,1,1572337,1574458,+,2121
418,NZ_OX366378,1,1279346,1281467,+,2121
418,NZ_CP090903,1,966413,968518,+,2105
418,NZ_OX366374,1,1218691,1220926,-,2235
418,NZ_CP090901,1,966413,968518,+,2105
418,NZ_CP046923,1,944557,946662,+,2105
418,NZ_CP069055,1,1073721,1075842,-,2121
418,NZ_CP072670,1,966253,968358,+,2105
418,NZ_CP090899,1,966413,968518,+,2105
418,NZ_CP046924,1,965495,967600,+,2105
418,NZ_OX366348,1,1243734,1245855,+,2121
418,NZ_CP046921,1,1028309,1030414,+,2105
418,NZ_OX366338,1,1088460,1090581,+,2121
418,NZ_CP054557,1,761433,763554,+,2121
418,NZ_CP072669,1,966261,968366,+,2105
418,NC_021089,1,995795,997916,+,2121
419,NZ_OX366376,1,1343580,1344358,+,778
419,NZ_OX366393,1,736986,737764,+,778
419,NZ_OX366372,1,399324,400102,+,778
419,NZ_CP072672,1,968386,969167,+,781
419,NZ_CP069060,1,813349,814130,+,781
419,NZ_CP072667,1,968360,969141,+,781
419,NZ_CP072671,1,968368,969149,+,781
419,NZ_CP072668,1,968355,969136,+,781
419,NZ_CP072666,1,968368,969149,+,781
419,NZ_CP090902,1,968520,969301,+,781
419,NZ_CP090948,1,968520,969301,+,781
419,NZ_CP069052,1,841941,842722,-,781
419,NZ_CP076228,1,1014618,1015399,-,781
419,NZ_CP042445,1,968508,969289,+,781
419,NZ_CP042904,1,992270,993051,+,781
419,NC_012416,1,1031364,1032145,+,781
419,NZ_CP069053,1,813357,814138,+,781
419,NZ_CP042446,1,968518,969299,+,781
419,NZ_CP041215,1,19112,19881,-,769
419,NZ_OX366353,1,1045995,1046764,-,769
419,NZ_OX366387,1,1541334,1542103,+,769
419,NZ_OX366368,1,1414023,1414804,+,781
419,NZ_OX366379,1,1333468,1334249,+,781
419,NZ_CP091195,1,1104574,1105343,-,769
419,NZ_OX366375,1,1243162,1243931,-,769
419,NZ_CP046925,1,968368,969149,+,781
419,NZ_OX366318,1,1264805,1265574,+,769
419,NZ_OX366319,1,1194665,1195434,+,769
419,NZ_OX366332,1,1348104,1348873,+,769
419,NZ_CP110359,1,201215,201986,+,771
419,NZ_OU953855,1,487267,488044,+,777
419,NZ_OX366272,1,151923,152694,+,771
419,NZ_OX366347,1,1411370,1412141,+,771
419,NZ_OU909470,1,892339,893064,+,725
419,NZ_OX366363,1,986199,986968,+,769
419,NZ_OX366364,1,1278058,1278839,-,781
419,NZ_OX366359,1,1177823,1178592,+,769
419,NZ_OX366349,1,663641,664506,+,865
419,NZ_OX366380,1,888051,888776,-,725
419,NZ_OX366344,1,360088,360953,+,865
419,NZ_CP090900,1,968520,969301,+,781
419,NZ_OX366352,1,1671831,1672600,+,769
419,NZ_OX366362,1,282109,282878,+,769
419,NZ_OX366400,1,1121826,1122595,+,769
419,NZ_OX366327,1,1261621,1262389,+,768
419,NZ_OX366367,1,1513032,1513813,+,781
419,NZ_CP042444,1,968955,969736,+,781
419,NZ_OX366326,1,1474055,1474824,+,769
419,NZ_CP037426,1,670008,670777,-,769
419,NZ_OX366339,1,111779,112493,+,714
419,NZ_OX366355,1,1281647,1282416,-,769
419,NZ_CP046922,1,1030416,1031197,+,781
419,NZ_OX366370,1,736157,736957,-,800
419,NZ_OX366385,1,1007670,1008395,+,725
419,NZ_OX366399,1,1367084,1367865,+,781
419,NZ_OX366395,1,1319082,1319863,+,781
419,NZ_OX366396,1,22722,23436,-,714
419,NZ_OX366351,1,1417926,1418695,+,769
419,NZ_OX366381,1,1103612,1104381,+,769
419,NZ_OX366342,1,694361,695139,+,778
419,NZ_OX366369,1,1370868,1371637,-,769
419,NZ_OX366356,1,1130611,1131380,+,769
419,NZ_OX366377,1,995921,996690,-,769
419,NZ_OX366388,1,1793314,1794095,+,781
419,NZ_OX366357,1,186618,187394,+,776
419,NZ_CP072012,1,1230427,1231208,+,781
419,NZ_OX366398,1,450119,450888,+,769
419,NC_002978,6,968520,969301,+,781
419,NZ_OX366389,1,1346531,1347300,+,769
419,NZ_OX366397,1,1574460,1575229,+,769
419,NZ_OX366378,1,1281469,1282238,+,769
419,NZ_CP090903,1,968520,969301,+,781
419,NZ_OX366374,1,1217756,1218690,-,934
419,NZ_CP090901,1,968520,969301,+,781
419,NZ_CP046923,1,946664,947445,+,781
419,NZ_CP069055,1,1072939,1073720,-,781
419,NZ_CP072670,1,968360,969141,+,781
419,NZ_CP090899,1,968520,969301,+,781
419,NZ_CP046924,1,967602,968383,+,781
419,NZ_OX366348,1,1245857,1246626,+,769
419,NZ_CP046921,1,1030416,1031197,+,781
419,NZ_OX366338,1,1090583,1091350,+,767
419,NZ_CP054557,1,763556,764325,+,769
419,NZ_CP072669,1,968368,969149,+,781
419,NC_021089,1,997918,998687,+,769
420,NZ_OX366376,1,1346047,1347133,+,1086
420,NZ_OX366393,1,739454,740541,+,1087
420,NZ_OX366372,1,401791,402879,+,1088
420,NZ_OX366342,1,696829,697919,+,1090
421,NZ_OX366376,1,1348282,1349154,+,872
421,NZ_OX366393,1,741690,742562,+,872
421,NZ_OX366372,1,404028,404900,+,872
421,NZ_CP072672,1,1254198,1255070,+,872
421,NZ_CP069060,1,1395548,1396420,+,872
421,NZ_CP072667,1,1254172,1255044,+,872
421,NZ_CP072671,1,1254180,1255052,+,872
421,NZ_CP072668,1,1254167,1255039,+,872
421,NZ_CP072666,1,1254180,1255052,+,872
421,NZ_CP090902,1,1254333,1255205,+,872
421,NZ_CP090948,1,1254331,1255203,+,872
421,NZ_CP069052,1,1339848,1340720,+,872
421,NZ_CP076228,1,1276149,1277021,+,872
421,NZ_CP042445,1,1253985,1254857,+,872
421,NZ_CP042904,1,1385028,1385900,+,872
421,NC_012416,1,1428237,1429109,+,872
421,NZ_CP069053,1,1380846,1381718,+,872
421,NZ_CP042446,1,1254330,1255202,+,872
421,NZ_CP041215,1,592876,593748,-,872
421,NZ_OX366353,1,726248,727120,+,872
421,NZ_OX366387,1,586110,586982,-,872
421,NZ_OX366368,1,268467,269339,+,872
421,NZ_OX366379,1,269485,270357,+,872
421,NZ_OX366375,1,286516,287388,+,872
421,NZ_CP046925,1,1254180,1255052,+,872
421,NZ_OX366318,1,359327,360199,+,872
421,NZ_OX366319,1,933523,934395,-,872
421,NZ_OX366332,1,267028,267900,+,872
421,NZ_CP110359,1,1294733,1295596,+,863
421,NZ_OX366272,1,228119,228982,-,863
421,NZ_OX366347,1,377097,377960,+,863
421,NZ_OU909470,1,155392,156264,+,872
421,NZ_OX366363,1,668686,669558,-,872
421,NZ_OX366364,1,474513,475366,-,853
421,NZ_OX366359,1,265618,266490,+,872
421,NZ_OX366349,1,666227,667099,+,872
421,NZ_OX366380,1,471467,472335,-,868
421,NZ_OX366344,1,362674,363546,+,872
421,NZ_CP090900,1,1254335,1255207,+,872
421,NZ_OX366352,1,1423473,1424345,-,872
421,NZ_OX366400,1,269197,270069,+,872
421,NZ_OX366367,1,1299898,1300752,-,854
421,NZ_CP042444,1,1255686,1256558,+,872
421,NZ_OX366326,1,525613,526485,-,872
421,NZ_CP037426,1,1338378,1339250,+,872
421,NZ_OX366339,1,1304878,1305716,+,838
421,NZ_OX366355,1,1047462,1048334,-,872
421,NZ_CP046922,1,1317054,1317926,+,872
421,NZ_OX366370,1,322257,323129,-,872
421,NZ_OX366385,1,520610,521478,-,868
421,NZ_OX366399,1,267969,268841,+,872
421,NZ_OX366395,1,412408,413254,+,846
421,NZ_OX366396,1,327230,328102,+,872
421,NZ_OX366351,1,278646,279518,+,872
421,NZ_OX366381,1,1331042,1331914,+,872
421,NZ_OX366342,1,699068,699940,+,872
421,NZ_OX366369,1,262729,263601,+,872
421,NZ_OX366356,1,297172,298044,+,872
421,NZ_OX366377,1,316703,317575,-,872
421,NZ_OX366357,1,1277521,1278393,-,872
421,NZ_CP072012,1,1048606,1049478,-,872
421,NZ_OX366398,1,924345,925217,-,872
421,NC_002978,6,1254331,1255203,+,872
421,NZ_OX366389,1,324306,325178,+,872
421,NZ_OX366397,1,266882,267754,+,872
421,NZ_CP090903,1,1254335,1255207,+,872
421,NZ_OX366374,1,235639,236502,-,863
421,NZ_CP090901,1,1254335,1255207,+,872
421,NZ_CP046923,1,1233302,1234174,+,872
421,NZ_CP069055,1,1255006,1255878,+,872
421,NZ_CP072670,1,1254160,1255032,+,872
421,NZ_CP090899,1,1254335,1255207,+,872
421,NZ_CP046924,1,1254240,1255112,+,872
421,NZ_OX366348,1,983201,984073,-,872
421,NZ_CP046921,1,1317054,1317926,+,872
421,NZ_OX366338,1,379667,380530,+,863
421,NZ_CP054557,1,700395,701267,+,872
421,NZ_CP072669,1,1254183,1255055,+,872
421,NC_021089,1,1282332,1283204,+,872
422,NZ_OX366376,1,1350092,1350644,+,552
422,NZ_OX366393,1,743500,744052,+,552
422,NZ_OX366372,1,405838,406390,+,552
422,NZ_OX366342,1,700878,701430,+,552
423,NZ_OX366376,1,1351619,1353402,+,1783
423,NZ_OX366393,1,745026,746809,+,1783
423,NZ_OX366372,1,407356,409139,+,1783
423,NZ_CP072672,1,1228486,1230125,+,1639
423,NZ_CP069060,1,1369385,1371024,+,1639
423,NZ_CP072667,1,1228460,1230099,+,1639
423,NZ_CP072671,1,1228468,1230107,+,1639
423,NZ_CP072668,1,1228455,1230094,+,1639
423,NZ_CP072666,1,1228468,1230107,+,1639
423,NZ_CP090902,1,1228621,1230260,+,1639
423,NZ_CP090948,1,1228619,1230258,+,1639
423,NZ_CP069052,1,1313685,1315324,+,1639
423,NZ_CP076228,1,1249216,1250855,+,1639
423,NZ_CP042445,1,1228608,1230247,+,1639
423,NZ_CP042904,1,1357502,1359141,+,1639
423,NC_012416,1,1400710,1402349,+,1639
423,NZ_CP069053,1,1354683,1356322,+,1639
423,NZ_CP042446,1,1228618,1230257,+,1639
423,NZ_CP041215,1,619275,620916,-,1641
423,NZ_OX366353,1,559469,561110,+,1641
423,NZ_OX366387,1,612305,613944,-,1639
423,NZ_OX366368,1,241903,243542,+,1639
423,NZ_OX366379,1,242921,244560,+,1639
423,NZ_CP091195,1,893016,894655,-,1639
423,NZ_OX366375,1,259718,261357,+,1639
423,NZ_CP046925,1,1228468,1230107,+,1639
423,NZ_OX366318,1,332284,333923,+,1639
423,NZ_OX366319,1,960464,962105,-,1641
423,NZ_OX366332,1,239784,241425,+,1641
423,NZ_CP110359,1,1268006,1269645,+,1639
423,NZ_OU953855,1,759275,760914,+,1639
423,NZ_OX366272,1,1125909,1127548,-,1639
423,NZ_OX366347,1,351113,352752,+,1639
423,NZ_OU909470,1,406302,408157,+,1855
423,NZ_OX366363,1,696266,697905,-,1639
423,NZ_OX366364,1,122833,124474,-,1641
423,NZ_OX366359,1,238623,240264,+,1641
423,NZ_OX366349,1,669576,671359,+,1783
423,NZ_OX366380,1,915243,917026,+,1783
423,NZ_OX366344,1,365954,367737,+,1783
423,NZ_CP090900,1,1228623,1230262,+,1639
423,NZ_OX366352,1,1449973,1451614,-,1641
423,NZ_OX366362,1,76576,78217,+,1641
423,NZ_OX366400,1,241265,242904,+,1639
423,NZ_OX366327,1,242865,244504,+,1639
423,NZ_OX366367,1,1430522,1432158,+,1636
423,NZ_CP042444,1,1229974,1231613,+,1639
423,NZ_OX366326,1,552542,554181,-,1639
423,NZ_CP037426,1,1211401,1213040,+,1639
423,NZ_OX366339,1,1294668,1296307,-,1639
423,NZ_OX366355,1,1075284,1076925,-,1641
423,NZ_CP046922,1,1290423,1292062,+,1639
423,NZ_OX366370,1,465772,467515,+,1743
423,NZ_OX366385,1,1209601,1211312,+,1711
423,NZ_OX366399,1,241405,243044,+,1639
423,NZ_OX366395,1,354943,356584,-,1641
423,NZ_OX366396,1,246713,248352,+,1639
423,NZ_OX366351,1,166944,168583,-,1639
423,NZ_OX366381,1,1144120,1145761,-,1641
423,NZ_OX366342,1,702405,704188,+,1783
423,NZ_OX366369,1,235662,237303,+,1641
423,NZ_OX366356,1,272737,274376,+,1639
423,NZ_OX366377,1,342156,343795,-,1639
423,NZ_OX366388,1,1539885,1541524,-,1639
423,NZ_OX366357,1,665947,667586,+,1639
423,NZ_CP072012,1,1074507,1076146,-,1639
423,NZ_OX366398,1,950679,952318,-,1639
423,NC_002978,6,1228619,1230258,+,1639
423,NZ_OX366389,1,298382,300021,+,1639
423,NZ_OX366397,1,239489,241130,+,1641
423,NZ_OX366378,1,1021174,1022813,+,1639
423,NZ_CP090903,1,1228623,1230262,+,1639
423,NZ_OX366374,1,325486,327125,-,1639
423,NZ_CP090901,1,1228623,1230262,+,1639
423,NZ_CP046923,1,1206671,1208310,+,1639
423,NZ_CP069055,1,1228621,1230260,+,1639
423,NZ_CP072670,1,1228448,1230087,+,1639
423,NZ_CP090899,1,1228623,1230262,+,1639
423,NZ_CP046924,1,1227609,1229248,+,1639
423,NZ_OX366348,1,1009652,1011291,-,1639
423,NZ_CP046921,1,1290423,1292062,+,1639
423,NZ_OX366338,1,411623,413264,-,1641
423,NZ_CP054557,1,575235,576874,-,1639
423,NZ_CP072669,1,1228471,1230110,+,1639
423,NC_021089,1,1254941,1256582,+,1641
424,NZ_OX366376,1,1354683,1355891,+,1208
424,NZ_OX366393,1,748090,749298,+,1208
424,NZ_OX366372,1,410420,411628,+,1208
424,NZ_CP072672,1,58737,59945,-,1208
424,NZ_CP069060,1,48750,49958,+,1208
424,NZ_CP072667,1,58737,59945,-,1208
424,NZ_CP072671,1,58737,59945,-,1208
424,NZ_CP072668,1,58737,59945,-,1208
424,NZ_CP072666,1,58737,59945,-,1208
424,NZ_CP090902,1,58889,60097,-,1208
424,NZ_CP090948,1,58889,60097,-,1208
424,NZ_CP069052,1,60699,61907,-,1208
424,NZ_CP076228,1,59688,60896,-,1208
424,NZ_CP042445,1,58889,60097,-,1208
424,NZ_CP042904,1,56106,57314,-,1208
424,NC_012416,1,56107,57315,-,1208
424,NZ_CP069053,1,48750,49958,+,1208
424,NZ_CP042446,1,58889,60097,-,1208
424,NZ_CP041215,1,462696,463904,+,1208
424,NZ_OX366353,1,357076,358284,-,1208
424,NZ_OX366387,1,1327563,1328771,+,1208
424,NZ_OX366368,1,339962,341170,-,1208
424,NZ_OX366379,1,340980,342188,-,1208
424,NZ_CP091195,1,967790,968998,-,1208
424,NZ_OX366375,1,427191,428399,+,1208
424,NZ_CP046925,1,58737,59945,-,1208
424,NZ_OX366318,1,435048,436256,-,1208
424,NZ_OX366319,1,857155,858363,+,1208
424,NZ_OX366332,1,336291,337499,-,1208
424,NZ_CP110359,1,57640,58848,-,1208
424,NZ_OU953855,1,950139,951347,-,1208
424,NZ_OX366272,1,444035,445243,-,1208
424,NZ_OX366347,1,448560,449760,-,1200
424,NZ_OU909470,1,1269528,1270708,-,1180
424,NZ_OX366363,1,590103,591311,+,1208
424,NZ_OX366364,1,1114159,1115367,+,1208
424,NZ_OX366359,1,335200,336408,-,1208
424,NZ_OX366349,1,672628,673836,+,1208
424,NZ_OX366380,1,918670,919878,+,1208
424,NZ_OX366344,1,369018,370226,+,1208
424,NZ_CP090900,1,58889,60097,-,1208
424,NZ_OX366352,1,997130,998338,+,1208
424,NZ_OX366362,1,1323313,1324521,-,1208
424,NZ_OX366400,1,767827,769035,-,1208
424,NZ_OX366327,1,488053,489261,-,1208
424,NZ_OX366367,1,190047,191255,-,1208
424,NZ_CP042444,1,58890,60098,-,1208
424,NZ_OX366326,1,451594,452802,+,1208
424,NZ_CP037426,1,540803,542011,+,1208
424,NZ_OX366339,1,142513,143721,-,1208
424,NZ_OX366355,1,955545,956753,-,1208
424,NZ_CP046922,1,58723,59931,-,1208
424,NZ_OX366370,1,159437,160654,-,1217
424,NZ_OX366385,1,1212956,1214164,+,1208
424,NZ_OX366399,1,339464,340672,-,1208
424,NZ_OX366395,1,781816,783024,-,1208
424,NZ_OX366396,1,382649,383857,+,1208
424,NZ_OX366351,1,354852,356060,-,1208
424,NZ_OX366381,1,87099,88307,-,1208
424,NZ_OX366342,1,705469,706677,+,1208
424,NZ_OX366369,1,336827,338035,-,1208
424,NZ_OX366356,1,367907,369115,-,1208
424,NZ_OX366377,1,202211,203419,+,1208
424,NZ_OX366388,1,1441075,1442283,+,1208
424,NZ_OX366357,1,1040775,1041983,-,1208
424,NZ_CP072012,1,976790,977998,+,1208
424,NZ_OX366398,1,847299,848507,+,1208
424,NC_002978,6,58889,60097,-,1208
424,NZ_OX366389,1,402403,403611,-,1208
424,NZ_OX366397,1,336570,337778,-,1208
424,NZ_OX366378,1,946748,947956,+,1208
424,NZ_CP090903,1,58889,60097,-,1208
424,NZ_OX366374,1,1089458,1090647,+,1189
424,NZ_CP090901,1,58889,60097,-,1208
424,NZ_CP046923,1,58723,59931,-,1208
424,NZ_CP069055,1,56852,58060,-,1208
424,NZ_CP072670,1,58737,59945,-,1208
424,NZ_CP090899,1,58889,60097,-,1208
424,NZ_CP046924,1,58723,59931,-,1208
424,NZ_OX366348,1,910738,911946,+,1208
424,NZ_CP046921,1,58723,59931,-,1208
424,NZ_OX366338,1,156308,157516,-,1208
424,NZ_CP054557,1,464726,465934,-,1208
424,NZ_CP072669,1,58737,59945,-,1208
424,NC_021089,1,55321,56529,-,1208
425,NZ_OX366376,1,1356525,1359165,+,2640
425,NZ_OX366393,1,749932,752572,+,2640
425,NZ_OX366372,1,412262,414902,+,2640
425,NZ_CP072672,1,55480,58094,-,2614
425,NZ_CP069060,1,50601,53215,+,2614
425,NZ_CP072667,1,55480,58094,-,2614
425,NZ_CP072671,1,55480,58094,-,2614
425,NZ_CP072668,1,55480,58094,-,2614
425,NZ_CP072666,1,55480,58094,-,2614
425,NZ_CP090902,1,55632,58246,-,2614
425,NZ_CP090948,1,55632,58246,-,2614
425,NZ_CP069052,1,57442,60056,-,2614
425,NZ_CP076228,1,56431,59045,-,2614
425,NZ_CP042445,1,55632,58246,-,2614
425,NZ_CP042904,1,52849,55463,-,2614
425,NC_012416,1,52850,55464,-,2614
425,NZ_CP069053,1,50601,53215,+,2614
425,NZ_CP042446,1,55632,58246,-,2614
425,NZ_CP041215,1,464481,467095,+,2614
425,NZ_OX366353,1,353885,356499,-,2614
425,NZ_OX366387,1,1329414,1332028,+,2614
425,NZ_OX366368,1,336705,339319,-,2614
425,NZ_OX366379,1,337723,340337,-,2614
425,NZ_CP091195,1,964533,967147,-,2614
425,NZ_OX366375,1,429042,431647,+,2605
425,NZ_CP046925,1,55480,58094,-,2614
425,NZ_OX366318,1,431791,434405,-,2614
425,NZ_OX366319,1,859006,861620,+,2614
425,NZ_OX366332,1,333100,335714,-,2614
425,NZ_CP110359,1,54383,56997,-,2614
425,NZ_OU953855,1,946882,949496,-,2614
425,NZ_OX366272,1,440778,443392,-,2614
425,NZ_OX366347,1,445303,447917,-,2614
425,NZ_OU909470,1,1266292,1268923,-,2631
425,NZ_OX366363,1,591906,594520,+,2614
425,NZ_OX366364,1,1116028,1118678,+,2650
425,NZ_OX366359,1,332009,334623,-,2614
425,NZ_OX366349,1,674470,677110,+,2640
425,NZ_OX366380,1,920455,923086,+,2631
425,NZ_OX366344,1,370860,373500,+,2640
425,NZ_CP090900,1,55632,58246,-,2614
425,NZ_OX366352,1,998915,1001520,+,2605
425,NZ_OX366362,1,1320105,1322700,-,2595
425,NZ_OX366400,1,764570,767184,-,2614
425,NZ_OX366327,1,484796,487410,-,2614
425,NZ_OX366367,1,186736,189386,-,2650
425,NZ_CP042444,1,55633,58247,-,2614
425,NZ_OX366326,1,453445,456059,+,2614
425,NZ_CP037426,1,542654,545259,+,2605
425,NZ_OX366339,1,139256,141870,-,2614
425,NZ_OX366355,1,952288,954902,-,2614
425,NZ_CP046922,1,55466,58080,-,2614
425,NZ_OX366370,1,156187,158797,-,2610
425,NZ_OX366385,1,1214741,1217372,+,2631
425,NZ_OX366399,1,336207,338821,-,2614
425,NZ_OX366395,1,778607,781221,-,2614
425,NZ_OX366396,1,384500,387114,+,2614
425,NZ_OX366351,1,351595,354209,-,2614
425,NZ_OX366381,1,83842,86456,-,2614
425,NZ_OX366342,1,707311,709951,+,2640
425,NZ_OX366369,1,333570,336184,-,2614
425,NZ_OX366356,1,364659,367264,-,2605
425,NZ_OX366377,1,204062,206676,+,2614
425,NZ_OX366388,1,1442926,1445540,+,2614
425,NZ_OX366357,1,1037549,1040132,-,2583
425,NZ_CP072012,1,978641,981255,+,2614
425,NZ_OX366398,1,849150,851764,+,2614
425,NC_002978,6,55632,58246,-,2614
425,NZ_OX366389,1,399146,401760,-,2614
425,NZ_OX366397,1,333379,335993,-,2614
425,NZ_OX366378,1,948599,951213,+,2614
425,NZ_CP090903,1,55632,58246,-,2614
425,NZ_OX366374,1,1091270,1093893,+,2623
425,NZ_CP090901,1,55632,58246,-,2614
425,NZ_CP046923,1,55466,58080,-,2614
425,NZ_CP069055,1,53595,56209,-,2614
425,NZ_CP072670,1,55480,58094,-,2614
425,NZ_CP090899,1,55632,58246,-,2614
425,NZ_CP046924,1,55466,58080,-,2614
425,NZ_OX366348,1,912589,915203,+,2614
425,NZ_CP046921,1,55466,58080,-,2614
425,NZ_OX366338,1,153052,155665,-,2613
425,NZ_CP054557,1,461470,464083,-,2613
425,NZ_CP072669,1,55480,58094,-,2614
425,NC_021089,1,52130,54744,-,2614
426,NZ_OX366376,1,1359814,1361683,+,1869
426,NZ_OX366393,1,753221,755089,+,1868
426,NZ_OX366372,1,415551,417418,+,1867
426,NZ_OX366342,1,710600,712468,+,1868
427,NZ_OX366376,1,1362860,1365581,+,2721
427,NZ_OX366393,1,756266,758987,+,2721
427,NZ_OX366372,1,418595,421316,+,2721
427,NZ_CP072672,1,1225726,1228456,-,2730
427,NZ_CP069060,1,1366625,1369355,-,2730
427,NZ_CP072667,1,1225700,1228430,-,2730
427,NZ_CP072671,1,1225708,1228438,-,2730
427,NZ_CP072668,1,1225695,1228425,-,2730
427,NZ_CP072666,1,1225708,1228438,-,2730
427,NZ_CP090902,1,1225861,1228591,-,2730
427,NZ_CP090948,1,1225859,1228589,-,2730
427,NZ_CP069052,1,1310925,1313655,-,2730
427,NZ_CP076228,1,1246456,1249186,-,2730
427,NZ_CP042445,1,1225848,1228578,-,2730
427,NZ_CP042904,1,1354741,1357472,-,2731
427,NC_012416,1,1397949,1400680,-,2731
427,NZ_CP069053,1,1351923,1354653,-,2730
427,NZ_CP042446,1,1225858,1228588,-,2730
427,NZ_CP041215,1,620940,623670,+,2730
427,NZ_OX366353,1,556715,559445,-,2730
427,NZ_OX366387,1,613974,616705,+,2731
427,NZ_OX366368,1,239143,241873,-,2730
427,NZ_OX366379,1,240161,242891,-,2730
427,NZ_CP091195,1,894685,897407,+,2722
427,NZ_OX366375,1,256957,259688,-,2731
427,NZ_CP046925,1,1225708,1228438,-,2730
427,NZ_OX366318,1,329524,332254,-,2730
427,NZ_OX366319,1,962129,964858,+,2729
427,NZ_OX366332,1,237030,239760,-,2730
427,NZ_CP110359,1,1265246,1267976,-,2730
427,NZ_OU953855,1,756515,759245,-,2730
427,NZ_OX366272,1,1127578,1130308,+,2730
427,NZ_OX366347,1,348353,351083,-,2730
427,NZ_OU909470,1,1261739,1264444,-,2705
427,NZ_OX366363,1,697935,700665,+,2730
427,NZ_OX366364,1,124498,127217,+,2719
427,NZ_OX366359,1,235869,238599,-,2730
427,NZ_OX366349,1,678965,681649,+,2684
427,NZ_OX366380,1,924934,927639,+,2705
427,NZ_OX366344,1,375350,378034,+,2684
427,NZ_CP090900,1,1225863,1228593,-,2730
427,NZ_OX366352,1,1451638,1454368,+,2730
427,NZ_OX366362,1,73833,76552,-,2719
427,NZ_OX366400,1,238505,241235,-,2730
427,NZ_OX366327,1,240114,242835,-,2721
427,NZ_OX366367,1,1427779,1430498,-,2719
427,NZ_CP042444,1,1227214,1229944,-,2730
427,NZ_OX366326,1,554211,556941,+,2730
427,NZ_CP037426,1,1208640,1211371,-,2731
427,NZ_OX366339,1,1296337,1299059,+,2722
427,NZ_OX366355,1,1076949,1079678,+,2729
427,NZ_CP046922,1,1287663,1290393,-,2730
427,NZ_OX366370,1,151603,154324,-,2721
427,NZ_OX366385,1,1219220,1221925,+,2705
427,NZ_OX366399,1,238645,241375,-,2730
427,NZ_OX366395,1,356608,359337,+,2729
427,NZ_OX366396,1,243961,246683,-,2722
427,NZ_OX366351,1,168613,171343,+,2730
427,NZ_OX366381,1,1145785,1148514,+,2729
427,NZ_OX366342,1,713645,716366,+,2721
427,NZ_OX366369,1,232909,235638,-,2729
427,NZ_OX366356,1,269976,272707,-,2731
427,NZ_OX366377,1,343825,346555,+,2730
427,NZ_OX366388,1,1541554,1544276,+,2722
427,NZ_OX366357,1,663187,665917,-,2730
427,NZ_CP072012,1,1076176,1078906,+,2730
427,NZ_OX366398,1,952348,955078,+,2730
427,NC_002978,6,1225859,1228589,-,2730
427,NZ_OX366389,1,295622,298352,-,2730
427,NZ_OX366397,1,236735,239465,-,2730
427,NZ_OX366378,1,1018422,1021144,-,2722
427,NZ_CP090903,1,1225863,1228593,-,2730
427,NZ_OX366374,1,327155,329885,+,2730
427,NZ_CP090901,1,1225863,1228593,-,2730
427,NZ_CP046923,1,1203911,1206641,-,2730
427,NZ_CP069055,1,1225861,1228591,-,2730
427,NZ_CP072670,1,1225688,1228418,-,2730
427,NZ_CP090899,1,1225863,1228593,-,2730
427,NZ_CP046924,1,1224849,1227579,-,2730
427,NZ_OX366348,1,1011321,1014051,+,2730
427,NZ_CP046921,1,1287663,1290393,-,2730
427,NZ_OX366338,1,413288,416007,+,2719
427,NZ_CP054557,1,576904,579634,+,2730
427,NZ_CP072669,1,1225711,1228441,-,2730
427,NC_021089,1,1252187,1254917,-,2730
428,NZ_OX366376,1,1365716,1366379,+,663
428,NZ_OX366393,1,759122,759785,+,663
428,NZ_OX366372,1,421451,422114,+,663
428,NZ_OU909470,1,1260925,1261591,-,666
428,NZ_OX366380,1,927787,928452,+,665
428,NZ_OX366344,1,378236,378887,+,651
428,NZ_OX366362,1,258793,259456,+,663
428,NZ_OX366385,1,1222073,1222725,+,652
428,NZ_OX366342,1,716501,717164,+,663
429,NZ_OX366376,1,1366873,1368221,+,1348
429,NZ_OX366393,1,760279,761627,+,1348
429,NZ_OX366372,1,422608,423956,+,1348
429,NZ_OU909470,1,1259070,1260431,-,1361
429,NZ_OX366349,1,682822,684170,+,1348
429,NZ_OX366380,1,928946,930306,+,1360
429,NZ_OX366344,1,379384,380723,+,1339
429,NZ_OX366362,1,259950,261298,+,1348
429,NZ_OX366370,1,373679,375245,-,1566
429,NZ_OX366385,1,1224086,1225449,+,1363
429,NZ_OX366342,1,717658,719006,+,1348
430,NZ_OX366376,1,1368223,1369358,+,1135
430,NZ_OX366393,1,761629,762810,+,1181
430,NZ_OX366372,1,423958,425139,+,1181
430,NZ_OU909470,1,1257887,1259069,-,1182
430,NZ_OX366349,1,684172,685329,+,1157
430,NZ_OX366380,1,930308,931460,+,1152
430,NZ_OX366344,1,380725,381906,+,1181
430,NZ_OX366362,1,261300,262501,+,1201
430,NZ_OX366370,1,372497,373678,-,1181
430,NZ_OX366385,1,1226296,1227447,+,1151
430,NZ_OX366342,1,719008,720189,+,1181
431,NZ_OX366376,1,1369360,1371161,+,1801
431,NZ_OX366393,1,762812,764613,+,1801
431,NZ_OX366372,1,425141,426942,+,1801
431,NZ_CP072672,1,1223906,1225708,-,1802
431,NZ_CP069060,1,1364805,1366607,-,1802
431,NZ_CP072667,1,1223880,1225682,-,1802
431,NZ_CP072671,1,1223888,1225690,-,1802
431,NZ_CP072668,1,1223875,1225677,-,1802
431,NZ_CP072666,1,1223888,1225690,-,1802
431,NZ_CP090902,1,1224041,1225843,-,1802
431,NZ_CP090948,1,1224039,1225841,-,1802
431,NZ_CP069052,1,1309105,1310907,-,1802
431,NZ_CP076228,1,1244636,1246438,-,1802
431,NZ_CP042445,1,1224028,1225830,-,1802
431,NZ_CP042904,1,1352921,1354723,-,1802
431,NC_012416,1,1396129,1397931,-,1802
431,NZ_CP069053,1,1350103,1351905,-,1802
431,NZ_CP042446,1,1224038,1225840,-,1802
431,NZ_CP041215,1,623689,625491,+,1802
431,NZ_OX366353,1,554894,556696,-,1802
431,NZ_OX366387,1,616724,618526,+,1802
431,NZ_OX366368,1,237323,239125,-,1802
431,NZ_OX366379,1,238341,240143,-,1802
431,NZ_CP091195,1,897425,899227,+,1802
431,NZ_OX366375,1,255137,256939,-,1802
431,NZ_CP046925,1,1223888,1225690,-,1802
431,NZ_OX366318,1,327704,329506,-,1802
431,NZ_OX366319,1,964876,966678,+,1802
431,NZ_OX366332,1,235209,237011,-,1802
431,NZ_CP110359,1,1263426,1265228,-,1802
431,NZ_OU953855,1,754695,756497,-,1802
431,NZ_OX366272,1,1130326,1132128,+,1802
431,NZ_OX366347,1,346533,348335,-,1802
431,NZ_OU909470,1,1256085,1257886,-,1801
431,NZ_OX366363,1,700683,702485,+,1802
431,NZ_OX366364,1,127236,129030,+,1794
431,NZ_OX366359,1,234049,235850,-,1801
431,NZ_OX366349,1,685331,687132,+,1801
431,NZ_OX366380,1,931462,933263,+,1801
431,NZ_OX366344,1,381908,383709,+,1801
431,NZ_CP090900,1,1224043,1225845,-,1802
431,NZ_OX366352,1,1454387,1456189,+,1802
431,NZ_OX366362,1,262515,264285,+,1770
431,NZ_OX366400,1,236685,238487,-,1802
431,NZ_OX366327,1,238294,240096,-,1802
431,NZ_OX366367,1,1425966,1427760,-,1794
431,NZ_CP042444,1,1225394,1227196,-,1802
431,NZ_OX366326,1,556959,558761,+,1802
431,NZ_CP037426,1,1206820,1208622,-,1802
431,NZ_OX366339,1,1299077,1300879,+,1802
431,NZ_OX366355,1,1079696,1081498,+,1802
431,NZ_CP046922,1,1285843,1287645,-,1802
431,NZ_OX366370,1,370695,372496,-,1801
431,NZ_OX366385,1,1227449,1229250,+,1801
431,NZ_OX366399,1,236825,238627,-,1802
431,NZ_OX366395,1,359355,361157,+,1802
431,NZ_OX366396,1,242141,243943,-,1802
431,NZ_OX366351,1,171361,173163,+,1802
431,NZ_OX366381,1,1148532,1150334,+,1802
431,NZ_OX366342,1,720191,721992,+,1801
431,NZ_OX366369,1,231089,232891,-,1802
431,NZ_OX366356,1,268156,269958,-,1802
431,NZ_OX366377,1,346573,348375,+,1802
431,NZ_OX366388,1,1544294,1546088,+,1794
431,NZ_OX366357,1,661367,663169,-,1802
431,NZ_CP072012,1,1078924,1080726,+,1802
431,NZ_OX366398,1,955096,956898,+,1802
431,NC_002978,6,1224039,1225841,-,1802
431,NZ_OX366389,1,293802,295604,-,1802
431,NZ_OX366397,1,234914,236716,-,1802
431,NZ_OX366378,1,1016602,1018404,-,1802
431,NZ_CP090903,1,1224043,1225845,-,1802
431,NZ_OX366374,1,329903,331700,+,1797
431,NZ_CP090901,1,1224043,1225845,-,1802
431,NZ_CP046923,1,1202091,1203893,-,1802
431,NZ_CP069055,1,1224041,1225843,-,1802
431,NZ_CP072670,1,1223868,1225670,-,1802
431,NZ_CP090899,1,1224043,1225845,-,1802
431,NZ_CP046924,1,1223029,1224831,-,1802
431,NZ_OX366348,1,1014069,1015871,+,1802
431,NZ_CP046921,1,1285843,1287645,-,1802
431,NZ_OX366338,1,416025,417822,+,1797
431,NZ_CP054557,1,579652,581454,+,1802
431,NZ_CP072669,1,1223891,1225693,-,1802
431,NC_021089,1,1250366,1252168,-,1802
432,NZ_OX366376,1,1371303,1372564,+,1261
432,NZ_OX366393,1,764755,766016,+,1261
432,NZ_OX366372,1,427084,428345,+,1261
432,NZ_CP072672,1,1222502,1223764,-,1262
432,NZ_CP069060,1,1363401,1364663,-,1262
432,NZ_CP072667,1,1222476,1223738,-,1262
432,NZ_CP072671,1,1222484,1223746,-,1262
432,NZ_CP072668,1,1222471,1223733,-,1262
432,NZ_CP072666,1,1222484,1223746,-,1262
432,NZ_CP090902,1,1222637,1223899,-,1262
432,NZ_CP090948,1,1222635,1223897,-,1262
432,NZ_CP069052,1,1307701,1308963,-,1262
432,NZ_CP076228,1,1243232,1244494,-,1262
432,NZ_CP042445,1,1222624,1223886,-,1262
432,NZ_CP042904,1,1350027,1351289,-,1262
432,NC_012416,1,1394725,1395987,-,1262
432,NZ_CP069053,1,1348699,1349961,-,1262
432,NZ_CP042446,1,1222634,1223896,-,1262
432,NZ_CP041215,1,625542,626764,+,1222
432,NZ_OX366353,1,553620,554843,-,1223
432,NZ_OX366387,1,618668,619925,+,1257
432,NZ_OX366368,1,235919,237181,-,1262
432,NZ_OX366379,1,236937,238199,-,1262
432,NZ_CP091195,1,899369,900630,+,1261
432,NZ_OX366375,1,253737,254986,-,1249
432,NZ_CP046925,1,1222484,1223746,-,1262
432,NZ_OX366318,1,326300,327562,-,1262
432,NZ_OX366319,1,966820,968077,+,1257
432,NZ_OX366332,1,233935,235158,-,1223
432,NZ_CP110359,1,1262152,1263383,-,1231
432,NZ_OU953855,1,753421,754652,-,1231
432,NZ_OX366272,1,1132171,1133401,+,1230
432,NZ_OX366347,1,345259,346490,-,1231
432,NZ_OU909470,1,1254811,1256042,-,1231
432,NZ_OX366363,1,702528,703758,+,1230
432,NZ_OX366364,1,129073,130303,+,1230
432,NZ_OX366359,1,232775,233998,-,1223
432,NZ_OX366349,1,687274,688535,+,1261
432,NZ_OX366380,1,933306,934536,+,1230
432,NZ_OX366344,1,383851,385124,+,1273
432,NZ_CP090900,1,1222639,1223901,-,1262
432,NZ_OX366352,1,1456240,1457462,+,1222
432,NZ_OX366362,1,264350,265555,+,1205
432,NZ_OX366400,1,235281,236543,-,1262
432,NZ_OX366327,1,236890,238152,-,1262
432,NZ_OX366367,1,1424692,1425923,-,1231
432,NZ_CP042444,1,1223990,1225252,-,1262
432,NZ_OX366326,1,558903,560164,+,1261
432,NZ_CP037426,1,1205420,1206669,-,1249
432,NZ_OX366339,1,1268273,1269535,-,1262
432,NZ_OX366355,1,1081640,1082897,+,1257
432,NZ_CP046922,1,1284439,1285701,-,1262
432,NZ_OX366370,1,369406,370652,-,1246
432,NZ_OX366385,1,1229293,1230523,+,1230
432,NZ_OX366399,1,235421,236683,-,1262
432,NZ_OX366395,1,361209,362446,+,1237
432,NZ_OX366396,1,240737,241999,-,1262
432,NZ_OX366351,1,173305,174566,+,1261
432,NZ_OX366381,1,1150476,1151733,+,1257
432,NZ_OX366342,1,722134,723395,+,1261
432,NZ_OX366369,1,229689,230947,-,1258
432,NZ_OX366356,1,266756,268005,-,1249
432,NZ_OX366377,1,348517,349778,+,1261
432,NZ_OX366388,1,1546230,1547491,+,1261
432,NZ_OX366357,1,659963,661225,-,1262
432,NZ_CP072012,1,1080868,1082129,+,1261
432,NZ_OX366398,1,957040,958301,+,1261
432,NC_002978,6,1222635,1223897,-,1262
432,NZ_OX366389,1,292398,293660,-,1262
432,NZ_OX366397,1,233640,234863,-,1223
432,NZ_OX366378,1,1015198,1016460,-,1262
432,NZ_CP090903,1,1222639,1223901,-,1262
432,NZ_OX366374,1,331765,332982,+,1217
432,NZ_CP090901,1,1222639,1223901,-,1262
432,NZ_CP046923,1,1200687,1201949,-,1262
432,NZ_CP069055,1,1222637,1223899,-,1262
432,NZ_CP072670,1,1222464,1223726,-,1262
432,NZ_CP090899,1,1222639,1223901,-,1262
432,NZ_CP046924,1,1221625,1222887,-,1262
432,NZ_OX366348,1,1016013,1017274,+,1261
432,NZ_CP046921,1,1284439,1285701,-,1262
432,NZ_OX366338,1,417887,419092,+,1205
432,NZ_CP054557,1,581596,582857,+,1261
432,NZ_CP072669,1,1222487,1223749,-,1262
432,NC_021089,1,1249092,1250315,-,1223
433,NZ_OX366376,1,1372835,1373781,+,946
433,NZ_OX366393,1,766287,767233,+,946
433,NZ_OX366372,1,428616,429561,+,945
433,NZ_OX366349,1,688806,689653,+,847
433,NZ_OX366342,1,723666,724612,+,946
434,NZ_OX366376,1,1373784,1375423,+,1639
434,NZ_OX366393,1,767236,768873,+,1637
434,NZ_OX366372,1,429564,431203,+,1639
434,NZ_OX366349,1,689656,691279,+,1623
434,NZ_OX366362,1,267213,268938,+,1725
434,NZ_OX366342,1,724615,726254,+,1639
435,NZ_OX366376,1,1375642,1377436,+,1794
435,NZ_OX366393,1,769092,770886,+,1794
435,NZ_OX366372,1,431422,433216,+,1794
435,NZ_CP072672,1,1217653,1219455,-,1802
435,NZ_CP069060,1,1358552,1360354,-,1802
435,NZ_CP072667,1,1217627,1219429,-,1802
435,NZ_CP072671,1,1217635,1219437,-,1802
435,NZ_CP072668,1,1217622,1219424,-,1802
435,NZ_CP072666,1,1217635,1219437,-,1802
435,NZ_CP090902,1,1217788,1219590,-,1802
435,NZ_CP090948,1,1217786,1219588,-,1802
435,NZ_CP069052,1,1302852,1304654,-,1802
435,NZ_CP076228,1,1238383,1240185,-,1802
435,NZ_CP042445,1,1217775,1219577,-,1802
435,NZ_CP042904,1,1345179,1346981,-,1802
435,NC_012416,1,1389877,1391679,-,1802
435,NZ_CP069053,1,1343850,1345652,-,1802
435,NZ_CP042446,1,1217785,1219587,-,1802
435,NZ_CP041215,1,630649,632451,+,1802
435,NZ_OX366353,1,547985,549787,-,1802
435,NZ_OX366387,1,623970,625772,+,1802
435,NZ_OX366368,1,231070,232872,-,1802
435,NZ_OX366379,1,232088,233890,-,1802
435,NZ_CP091195,1,903678,905480,+,1802
435,NZ_OX366375,1,248320,250122,-,1802
435,NZ_CP046925,1,1217635,1219437,-,1802
435,NZ_OX366318,1,321451,323253,-,1802
435,NZ_OX366319,1,971696,973498,+,1802
435,NZ_OX366332,1,228249,230051,-,1802
435,NZ_CP110359,1,1255930,1257732,-,1802
435,NZ_OU953855,1,748132,749900,-,1768
435,NZ_OX366272,1,1137817,1139619,+,1802
435,NZ_OX366347,1,340480,342291,-,1811
435,NZ_OU909470,1,1249447,1251254,-,1807
435,NZ_OX366363,1,707806,709608,+,1802
435,NZ_OX366364,1,133347,135158,+,1811
435,NZ_OX366359,1,227082,228884,-,1802
435,NZ_OX366349,1,691498,693292,+,1794
435,NZ_OX366380,1,937937,939745,+,1808
435,NZ_OX366344,1,388419,390213,+,1794
435,NZ_CP090900,1,1217790,1219592,-,1802
435,NZ_OX366352,1,1461347,1463149,+,1802
435,NZ_OX366362,1,269141,270941,+,1800
435,NZ_OX366400,1,230432,232234,-,1802
435,NZ_OX366327,1,230674,232476,-,1802
435,NZ_OX366367,1,1419839,1421650,-,1811
435,NZ_CP042444,1,1219141,1220943,-,1802
435,NZ_OX366326,1,563200,565002,+,1802
435,NZ_CP037426,1,864989,866791,+,1802
435,NZ_OX366339,1,1259998,1261800,-,1802
435,NZ_OX366355,1,1086516,1088318,+,1802
435,NZ_CP046922,1,1279590,1281392,-,1802
435,NZ_OX366370,1,364328,366138,-,1810
435,NZ_OX366385,1,1235625,1237433,+,1808
435,NZ_OX366399,1,230572,232374,-,1802
435,NZ_OX366395,1,365509,367318,+,1809
435,NZ_OX366396,1,232758,234560,-,1802
435,NZ_OX366351,1,177602,179404,+,1802
435,NZ_OX366381,1,1155352,1157154,+,1802
435,NZ_OX366342,1,726473,728267,+,1794
435,NZ_OX366369,1,224269,226071,-,1802
435,NZ_OX366356,1,260245,262047,-,1802
435,NZ_OX366377,1,352826,354628,+,1802
435,NZ_OX366388,1,1550974,1552769,+,1795
435,NZ_OX366357,1,654413,656208,-,1795
435,NZ_CP072012,1,1085177,1086979,+,1802
435,NZ_OX366398,1,961349,963151,+,1802
435,NC_002978,6,1217786,1219588,-,1802
435,NZ_OX366389,1,287549,289351,-,1802
435,NZ_OX366397,1,227955,229757,-,1802
435,NZ_OX366378,1,1010349,1012151,-,1802
435,NZ_CP090903,1,1217790,1219592,-,1802
435,NZ_OX366374,1,712348,714159,-,1811
435,NZ_CP090901,1,1217790,1219592,-,1802
435,NZ_CP046923,1,1195838,1197640,-,1802
435,NZ_CP069055,1,1217788,1219590,-,1802
435,NZ_CP072670,1,1217615,1219417,-,1802
435,NZ_CP090899,1,1217790,1219592,-,1802
435,NZ_CP046924,1,1216776,1218578,-,1802
435,NZ_OX366348,1,1020309,1022111,+,1802
435,NZ_CP046921,1,1279590,1281392,-,1802
435,NZ_OX366338,1,423571,425357,+,1786
435,NZ_CP054557,1,585902,587704,+,1802
435,NZ_CP072669,1,1217638,1219440,-,1802
435,NC_021089,1,1244395,1246197,-,1802
436,NZ_OX366376,1,1381561,1383552,+,1991
436,NZ_OX366393,1,1169156,1171147,+,1991
436,NZ_OX366372,1,942204,944195,+,1991
436,NZ_CP072672,1,922142,924181,+,2039
436,NZ_CP069060,1,726790,728829,+,2039
436,NZ_CP072667,1,922116,924155,+,2039
436,NZ_CP072671,1,922124,924163,+,2039
436,NZ_CP072668,1,922111,924150,+,2039
436,NZ_CP072666,1,922124,924163,+,2039
436,NZ_CP090902,1,922276,924315,+,2039
436,NZ_CP090948,1,922276,924315,+,2039
436,NZ_CP069052,1,912345,914384,+,2039
436,NZ_CP076228,1,965097,967136,+,2039
436,NZ_CP042445,1,922264,924303,+,2039
436,NZ_CP042904,1,944773,946812,+,2039
436,NC_012416,1,982382,984421,+,2039
436,NZ_CP069053,1,741695,743734,-,2039
436,NZ_CP042446,1,922274,924313,+,2039
436,NZ_CP041215,1,63409,65448,-,2039
436,NZ_OX366353,1,1227071,1229110,-,2039
436,NZ_OX366387,1,1724347,1726386,+,2039
436,NZ_OX366368,1,1367672,1369711,+,2039
436,NZ_OX366379,1,1287165,1289204,+,2039
436,NZ_CP091195,1,1146197,1148236,-,2039
436,NZ_OX366375,1,1145367,1147406,+,2039
436,NZ_CP046925,1,922124,924163,+,2039
436,NZ_OX366318,1,1221448,1223487,+,2039
436,NZ_OX366319,1,1149764,1151803,+,2039
436,NZ_OX366332,1,1305134,1307173,+,2039
436,NZ_CP110359,1,169529,171566,-,2037
436,NZ_OU953855,1,1518297,1520320,+,2023
436,NZ_OX366272,1,126185,128224,+,2039
436,NZ_OX366347,1,1366482,1368521,+,2039
436,NZ_OU909470,1,523678,525671,+,1993
436,NZ_OX366363,1,942979,945018,+,2039
436,NZ_OX366364,1,537479,539495,+,2016
436,NZ_OX366359,1,1134940,1136979,+,2039
436,NZ_OX366349,1,1242815,1244806,-,1991
436,NZ_OX366380,1,1095042,1097035,+,1993
436,NZ_OX366344,1,727108,729099,-,1991
436,NZ_CP090900,1,922276,924315,+,2039
436,NZ_OX366352,1,149118,151157,-,2039
436,NZ_OX366362,1,1424231,1426180,-,1949
436,NZ_OX366400,1,1077626,1079665,+,2039
436,NZ_OX366327,1,1217960,1219999,+,2039
436,NZ_OX366367,1,53222,55238,+,2016
436,NZ_CP042444,1,922711,924750,+,2039
436,NZ_OX366326,1,1428993,1431032,+,2039
436,NZ_CP037426,1,1112683,1114722,+,2039
436,NZ_OX366339,1,48580,50619,+,2039
436,NZ_OX366355,1,133121,135160,-,2039
436,NZ_CP046922,1,984172,986211,+,2039
436,NZ_OX366370,1,759630,761616,-,1986
436,NZ_OX366385,1,663871,665864,-,1993
436,NZ_OX366399,1,1320781,1322820,+,2039
436,NZ_OX366395,1,1179833,1181872,+,2039
436,NZ_OX366396,1,160736,162775,+,2039
436,NZ_OX366351,1,1374569,1376608,+,2039
436,NZ_OX366381,1,1057873,1059912,+,2039
436,NZ_OX366342,1,1468585,1470576,-,1991
436,NZ_OX366369,1,1414474,1416513,-,2039
436,NZ_OX366356,1,1090427,1092403,+,1976
436,NZ_OX366377,1,1042968,1045007,-,2039
436,NZ_OX366388,1,1681175,1683214,-,2039
436,NZ_OX366357,1,1305955,1307994,-,2039
436,NZ_CP072012,1,272109,274148,+,2039
436,NZ_OX366398,1,404335,406374,+,2039
436,NC_002978,6,922276,924315,+,2039
436,NZ_OX366389,1,1299395,1301434,+,2039
436,NZ_OX366397,1,1531466,1533505,+,2039
436,NZ_OX366378,1,1238613,1240652,+,2039
436,NZ_CP090903,1,922276,924315,+,2039
436,NZ_OX366374,1,930617,932656,+,2039
436,NZ_CP090901,1,922276,924315,+,2039
436,NZ_CP046923,1,900420,902459,+,2039
436,NZ_CP069055,1,920845,922884,-,2039
436,NZ_CP072670,1,922116,924155,+,2039
436,NZ_CP090899,1,922276,924315,+,2039
436,NZ_CP046924,1,921358,923397,+,2039
436,NZ_OX366348,1,1201242,1203281,+,2039
436,NZ_CP046921,1,984172,986211,+,2039
436,NZ_OX366338,1,933016,935055,+,2039
436,NZ_CP054557,1,919358,921397,-,2039
436,NZ_CP072669,1,922124,924163,+,2039
436,NC_021089,1,954946,956985,+,2039
437,NZ_OX366376,1,1383554,1384546,+,992
437,NZ_OX366393,1,1171149,1172141,+,992
437,NZ_OX366372,1,944197,945189,+,992
437,NZ_OX366349,1,1241836,1242813,-,977
437,NZ_OX366344,1,726129,727106,-,977
437,NZ_OX366342,1,1467606,1468583,-,977
438,NZ_OX366376,1,1385090,1390651,+,5561
438,NZ_OX366393,1,1172685,1178246,+,5561
438,NZ_OX366372,1,945733,951294,+,5561
438,NZ_CP072672,1,924870,930426,+,5556
438,NZ_CP069060,1,729518,735074,+,5556
438,NZ_CP072667,1,924844,930400,+,5556
438,NZ_CP072671,1,924852,930408,+,5556
438,NZ_CP072668,1,924839,930395,+,5556
438,NZ_CP072666,1,924852,930408,+,5556
438,NZ_CP090902,1,925004,930560,+,5556
438,NZ_CP090948,1,925004,930560,+,5556
438,NZ_CP069052,1,915073,920629,+,5556
438,NZ_CP076228,1,967845,973409,+,5564
438,NZ_CP042445,1,924992,930548,+,5556
438,NZ_CP042904,1,947526,953099,+,5573
438,NC_012416,1,985135,990708,+,5573
438,NZ_CP069053,1,735450,741006,-,5556
438,NZ_CP042446,1,925002,930558,+,5556
438,NZ_CP041215,1,57163,62730,-,5567
438,NZ_OX366353,1,1220825,1226392,-,5567
438,NZ_OX366387,1,1728958,1734522,+,5564
438,NZ_OX366368,1,1370420,1375984,+,5564
438,NZ_OX366379,1,1289913,1295477,+,5564
438,NZ_CP091195,1,1140299,1145864,-,5565
438,NZ_OX366375,1,1149105,1154669,+,5564
438,NZ_CP046925,1,924852,930408,+,5556
438,NZ_OX366318,1,1224176,1229740,+,5564
438,NZ_OX366319,1,1154375,1159939,+,5564
438,NZ_OX366332,1,1307852,1313419,+,5567
438,NZ_CP110359,1,163630,169194,-,5564
438,NZ_OU953855,1,640547,646111,-,5564
438,NZ_OX366272,1,128557,134121,+,5564
438,NZ_OX366347,1,1368854,1374418,+,5564
438,NZ_OU909470,1,526373,531943,+,5570
438,NZ_OX366363,1,945351,950915,+,5564
438,NZ_OX366364,1,539828,545393,+,5565
438,NZ_OX366359,1,1137658,1143225,+,5567
438,NZ_OX366349,1,1235691,1241255,-,5564
438,NZ_OX366380,1,1100235,1105808,+,5573
438,NZ_OX366344,1,720003,725567,-,5564
438,NZ_CP090900,1,925004,930560,+,5556
438,NZ_OX366352,1,142872,148439,-,5567
438,NZ_OX366362,1,1418567,1424140,-,5573
438,NZ_OX366400,1,1080354,1085918,+,5564
438,NZ_OX366327,1,1220332,1225896,+,5564
438,NZ_OX366367,1,56892,62465,+,5573
438,NZ_CP042444,1,925439,930995,+,5556
438,NZ_OX366326,1,1431721,1437285,+,5564
438,NZ_CP037426,1,1261141,1266705,+,5564
438,NZ_OX366339,1,51319,56883,+,5564
438,NZ_OX366355,1,1317118,1322682,-,5564
438,NZ_CP046922,1,986900,992456,+,5556
438,NZ_OX366370,1,753746,759307,-,5561
438,NZ_OX366385,1,657591,663164,-,5573
438,NZ_OX366399,1,1323529,1329093,+,5564
438,NZ_OX366395,1,1182594,1188153,+,5559
438,NZ_OX366396,1,163475,169039,+,5564
438,NZ_OX366351,1,1377297,1382861,+,5564
438,NZ_OX366381,1,1063322,1068886,+,5564
438,NZ_OX366342,1,1461485,1467046,-,5561
438,NZ_OX366369,1,1406338,1411902,-,5564
438,NZ_OX366356,1,1093222,1098786,+,5564
438,NZ_OX366377,1,1036695,1042259,-,5564
438,NZ_OX366388,1,1675278,1680842,-,5564
438,NZ_OX366357,1,1299685,1305249,-,5564
438,NZ_CP072012,1,274857,280421,+,5564
438,NZ_OX366398,1,407083,412647,+,5564
438,NC_002978,6,925004,930560,+,5556
438,NZ_OX366389,1,1302143,1307707,+,5564
438,NZ_OX366397,1,1534184,1539751,+,5567
438,NZ_OX366378,1,1240985,1246549,+,5564
438,NZ_CP090903,1,925004,930560,+,5556
438,NZ_OX366374,1,519723,525287,-,5564
438,NZ_CP090901,1,925004,930560,+,5556
438,NZ_CP046923,1,903148,908704,+,5556
438,NZ_CP069055,1,914572,920136,-,5564
438,NZ_CP072670,1,924844,930400,+,5556
438,NZ_CP090899,1,925004,930560,+,5556
438,NZ_CP046924,1,924086,929642,+,5556
438,NZ_OX366348,1,1203990,1209554,+,5564
438,NZ_CP046921,1,986900,992456,+,5556
438,NZ_OX366338,1,935784,941348,+,5564
438,NZ_CP054557,1,722596,728160,+,5564
438,NZ_CP072669,1,924852,930408,+,5556
438,NC_021089,1,957664,963231,+,5567
439,NZ_OX366376,1,1391031,1391920,+,889
439,NZ_OX366393,1,1178626,1179515,+,889
439,NZ_OX366372,1,951674,952563,+,889
439,NZ_CP072672,1,931124,932013,+,889
439,NZ_CP069060,1,735772,736661,+,889
439,NZ_CP072667,1,931098,931987,+,889
439,NZ_CP072671,1,931106,931995,+,889
439,NZ_CP072668,1,931093,931982,+,889
439,NZ_CP072666,1,931106,931995,+,889
439,NZ_CP090902,1,931258,932147,+,889
439,NZ_CP090948,1,931258,932147,+,889
439,NZ_CP069052,1,921327,922216,+,889
439,NZ_CP076228,1,974107,974996,+,889
439,NZ_CP042445,1,931246,932135,+,889
439,NZ_CP042904,1,953626,954515,+,889
439,NC_012416,1,991235,992124,+,889
439,NZ_CP069053,1,733863,734752,-,889
439,NZ_CP042446,1,931256,932145,+,889
439,NZ_CP041215,1,55747,56636,-,889
439,NZ_OX366353,1,1219409,1220298,-,889
439,NZ_OX366387,1,1735220,1736109,+,889
439,NZ_OX366368,1,1376682,1377571,+,889
439,NZ_OX366379,1,1296175,1297064,+,889
439,NZ_CP091195,1,1138712,1139565,-,853
439,NZ_OX366375,1,1155182,1156071,+,889
439,NZ_CP046925,1,931106,931995,+,889
439,NZ_OX366318,1,1230275,1231164,+,889
439,NZ_OX366319,1,1160463,1161352,+,889
439,NZ_OX366332,1,1313946,1314835,+,889
439,NZ_CP110359,1,162035,162924,-,889
439,NZ_OU953855,1,639285,640170,-,885
439,NZ_OX366272,1,134827,135716,+,889
439,NZ_OX366347,1,1375132,1376000,+,868
439,NZ_OU909470,1,532467,533349,+,882
439,NZ_OX366363,1,951439,952328,+,889
439,NZ_OX366364,1,545830,546715,+,885
439,NZ_OX366359,1,1143752,1144641,+,889
439,NZ_OX366349,1,1234425,1235314,-,889
439,NZ_OX366380,1,1106332,1107221,+,889
439,NZ_OX366344,1,718737,719626,-,889
439,NZ_CP090900,1,931258,932147,+,889
439,NZ_OX366352,1,141456,142345,-,889
439,NZ_OX366362,1,1416980,1417869,-,889
439,NZ_OX366400,1,1086453,1087342,+,889
439,NZ_OX366327,1,1226280,1227169,+,889
439,NZ_OX366367,1,63163,64048,+,885
439,NZ_CP042444,1,931693,932582,+,889
439,NZ_OX366326,1,1437820,1438709,+,889
439,NZ_CP037426,1,1267218,1268107,+,889
439,NZ_OX366339,1,57581,58463,+,882
439,NZ_OX366355,1,1315705,1316594,-,889
439,NZ_CP046922,1,993154,994043,+,889
439,NZ_OX366370,1,751253,752142,-,889
439,NZ_OX366385,1,656178,657067,-,889
439,NZ_OX366399,1,1329791,1330680,+,889
439,NZ_OX366395,1,1188859,1189748,+,889
439,NZ_OX366396,1,169737,170619,+,882
439,NZ_OX366351,1,1383396,1384285,+,889
439,NZ_OX366381,1,1069410,1070299,+,889
439,NZ_OX366342,1,1460216,1461105,-,889
439,NZ_OX366369,1,1404925,1405814,-,889
439,NZ_OX366356,1,1099310,1100199,+,889
439,NZ_OX366377,1,1035271,1036160,-,889
439,NZ_OX366388,1,1673691,1674544,-,853
439,NZ_OX366357,1,1298271,1299161,-,890
439,NZ_CP072012,1,281119,282008,+,889
439,NZ_OX366398,1,413182,414071,+,889
439,NC_002978,6,931258,932147,+,889
439,NZ_OX366389,1,1308242,1309131,+,889
439,NZ_OX366397,1,1540278,1541167,+,889
439,NZ_OX366378,1,1247255,1248136,+,881
439,NZ_CP090903,1,931258,932147,+,889
439,NZ_OX366374,1,518307,519196,-,889
439,NZ_CP090901,1,931258,932147,+,889
439,NZ_CP046923,1,909402,910291,+,889
439,NZ_CP069055,1,912985,913874,-,889
439,NZ_CP072670,1,931098,931987,+,889
439,NZ_CP090899,1,931258,932147,+,889
439,NZ_CP046924,1,930340,931229,+,889
439,NZ_OX366348,1,1210089,1210978,+,889
439,NZ_CP046921,1,993154,994043,+,889
439,NZ_OX366338,1,942054,942943,+,889
439,NZ_CP054557,1,728695,729584,+,889
439,NZ_CP072669,1,931106,931995,+,889
439,NC_021089,1,963758,964647,+,889
440,NZ_OX366376,1,1393885,1394429,+,544
440,NZ_OX366393,1,1181480,1182025,+,545
440,NZ_OX366372,1,954528,955072,+,544
440,NZ_OX366344,1,716248,716792,-,544
440,NZ_OX366342,1,1457706,1458250,-,544
441,NZ_OX366376,1,1395207,1396493,+,1286
441,NZ_OX366393,1,1182803,1184089,+,1286
441,NZ_OX366372,1,955850,957136,+,1286
441,NZ_CP072672,1,935223,936509,+,1286
441,NZ_CP069060,1,780176,781462,+,1286
441,NZ_CP072667,1,935197,936483,+,1286
441,NZ_CP072671,1,935205,936491,+,1286
441,NZ_CP072668,1,935192,936478,+,1286
441,NZ_CP072666,1,935205,936491,+,1286
441,NZ_CP090902,1,935357,936643,+,1286
441,NZ_CP090948,1,935357,936643,+,1286
441,NZ_CP069052,1,874608,875895,-,1287
441,NZ_CP076228,1,1068706,1069993,-,1287
441,NZ_CP042445,1,935345,936631,+,1286
441,NZ_CP042904,1,957633,958919,+,1286
441,NC_012416,1,995243,996545,+,1302
441,NZ_CP069053,1,780184,781470,+,1286
441,NZ_CP042446,1,935355,936641,+,1286
441,NZ_CP041215,1,49515,50811,-,1296
441,NZ_OX366353,1,1214885,1216181,-,1296
441,NZ_OX366387,1,1739300,1740586,+,1286
441,NZ_OX366368,1,1380781,1382067,+,1286
441,NZ_OX366379,1,1300274,1301560,+,1286
441,NZ_CP091195,1,1134760,1136047,-,1287
441,NZ_OX366375,1,1276394,1277681,-,1287
441,NZ_CP046925,1,935205,936491,+,1286
441,NZ_OX366318,1,1233887,1235173,+,1286
441,NZ_OX366319,1,1164531,1165817,+,1286
441,NZ_OX366332,1,1318063,1319358,+,1295
441,NZ_CP110359,1,157508,158795,-,1287
441,NZ_OU953855,1,1693618,1694904,+,1286
441,NZ_OX366272,1,63825,65112,-,1287
441,NZ_OX366347,1,1379070,1380356,+,1286
441,NZ_OU909470,1,536679,537965,+,1286
441,NZ_OX366363,1,955564,956850,+,1286
441,NZ_OX366364,1,550010,551295,+,1285
441,NZ_OX366359,1,1147869,1149164,+,1295
441,NZ_OX366349,1,1229861,1231148,-,1287
441,NZ_OX366380,1,1110258,1111544,+,1286
441,NZ_OX366344,1,714184,715471,-,1287
441,NZ_CP090900,1,935357,936643,+,1286
441,NZ_OX366352,1,136932,138228,-,1296
441,NZ_OX366362,1,5388,6674,+,1286
441,NZ_OX366400,1,1090916,1092202,+,1286
441,NZ_OX366327,1,1230383,1231669,+,1286
441,NZ_OX366367,1,67259,68544,+,1285
441,NZ_CP042444,1,935792,937078,+,1286
441,NZ_OX366326,1,1443133,1444419,+,1286
441,NZ_CP037426,1,805584,806871,-,1287
441,NZ_OX366339,1,61727,63013,+,1286
441,NZ_OX366355,1,1311239,1312526,-,1287
441,NZ_CP046922,1,997253,998539,+,1286
441,NZ_OX366370,1,834412,835658,+,1246
441,NZ_OX366385,1,651007,652294,-,1287
441,NZ_OX366399,1,1333890,1335176,+,1286
441,NZ_OX366395,1,1215398,1216685,-,1287
441,NZ_OX366396,1,175754,177040,+,1286
441,NZ_OX366351,1,1387008,1388294,+,1286
441,NZ_OX366381,1,1073478,1074764,+,1286
441,NZ_OX366342,1,1455642,1456929,-,1287
441,NZ_OX366369,1,1400460,1401747,-,1287
441,NZ_OX366356,1,1101313,1102599,+,1286
441,NZ_OX366377,1,1029975,1031262,-,1287
441,NZ_OX366388,1,1668754,1670041,-,1287
441,NZ_OX366357,1,1293767,1295054,-,1287
441,NZ_CP072012,1,285218,286504,+,1286
441,NZ_OX366398,1,418080,419366,+,1286
441,NC_002978,6,935357,936643,+,1286
441,NZ_OX366389,1,1312288,1313574,+,1286
441,NZ_OX366397,1,1544395,1545690,+,1295
441,NZ_OX366378,1,1250801,1252087,+,1286
441,NZ_CP090903,1,935357,936643,+,1286
441,NZ_OX366374,1,515546,516833,-,1287
441,NZ_CP090901,1,935357,936643,+,1286
441,NZ_CP046923,1,913501,914787,+,1286
441,NZ_CP069055,1,908488,909775,-,1287
441,NZ_CP072670,1,935197,936483,+,1286
441,NZ_CP090899,1,935357,936643,+,1286
441,NZ_CP046924,1,934439,935725,+,1286
441,NZ_OX366348,1,1214136,1215422,+,1286
441,NZ_CP046921,1,997253,998539,+,1286
441,NZ_OX366338,1,704725,706021,-,1296
441,NZ_CP054557,1,732960,734246,+,1286
441,NZ_CP072669,1,935205,936491,+,1286
441,NC_021089,1,967875,969170,+,1295
442,NZ_OX366376,1,1396495,1398848,+,2353
442,NZ_OX366393,1,1184091,1186444,+,2353
442,NZ_OX366372,1,957138,959491,+,2353
442,NZ_CP072672,1,936511,938864,+,2353
442,NZ_CP069060,1,781464,783817,+,2353
442,NZ_CP072667,1,936485,938838,+,2353
442,NZ_CP072671,1,936493,938846,+,2353
442,NZ_CP072668,1,936480,938833,+,2353
442,NZ_CP072666,1,936493,938846,+,2353
442,NZ_CP090902,1,936645,938998,+,2353
442,NZ_CP090948,1,936645,938998,+,2353
442,NZ_CP069052,1,872254,874607,-,2353
442,NZ_CP076228,1,1066352,1068705,-,2353
442,NZ_CP042445,1,936633,938986,+,2353
442,NZ_CP042904,1,958921,961274,+,2353
442,NC_012416,1,998064,1000376,+,2312
442,NZ_CP069053,1,781472,783825,+,2353
442,NZ_CP042446,1,936643,938996,+,2353
442,NZ_CP041215,1,47161,49514,-,2353
442,NZ_OX366353,1,1212531,1214884,-,2353
442,NZ_OX366387,1,1740588,1742941,+,2353
442,NZ_OX366368,1,1382069,1384422,+,2353
442,NZ_OX366379,1,1301562,1303915,+,2353
442,NZ_CP091195,1,1132406,1134759,-,2353
442,NZ_OX366375,1,1274040,1276393,-,2353
442,NZ_CP046925,1,936493,938846,+,2353
442,NZ_OX366318,1,1235175,1237528,+,2353
442,NZ_OX366319,1,1165819,1168172,+,2353
442,NZ_OX366332,1,1319360,1321713,+,2353
442,NZ_CP110359,1,155154,157507,-,2353
442,NZ_OU953855,1,1694906,1697259,+,2353
442,NZ_OX366272,1,61471,63824,-,2353
442,NZ_OX366347,1,1380358,1382711,+,2353
442,NZ_OU909470,1,537967,540316,+,2349
442,NZ_OX366363,1,956852,959205,+,2353
442,NZ_OX366364,1,551297,553650,+,2353
442,NZ_OX366359,1,1149166,1151519,+,2353
442,NZ_OX366349,1,1227507,1229860,-,2353
442,NZ_OX366380,1,1111546,1113895,+,2349
442,NZ_OX366344,1,711831,714183,-,2352
442,NZ_CP090900,1,936645,938998,+,2353
442,NZ_OX366352,1,134578,136931,-,2353
442,NZ_OX366362,1,6676,9029,+,2353
442,NZ_OX366400,1,1092204,1094557,+,2353
442,NZ_OX366327,1,1231671,1234024,+,2353
442,NZ_OX366367,1,68546,70899,+,2353
442,NZ_CP042444,1,937080,939433,+,2353
442,NZ_OX366326,1,1444421,1446774,+,2353
442,NZ_CP037426,1,803230,805583,-,2353
442,NZ_OX366339,1,63015,65368,+,2353
442,NZ_OX366355,1,1308885,1311238,-,2353
442,NZ_CP046922,1,998541,1000894,+,2353
442,NZ_OX366370,1,835660,838013,+,2353
442,NZ_OX366385,1,648657,651006,-,2349
442,NZ_OX366399,1,1335178,1337531,+,2353
442,NZ_OX366395,1,1213044,1215397,-,2353
442,NZ_OX366396,1,177042,179395,+,2353
442,NZ_OX366351,1,1388296,1390649,+,2353
442,NZ_OX366381,1,1074766,1077119,+,2353
442,NZ_OX366342,1,1453288,1455641,-,2353
442,NZ_OX366369,1,1398106,1400459,-,2353
442,NZ_OX366356,1,1102601,1104954,+,2353
442,NZ_OX366377,1,1027621,1029974,-,2353
442,NZ_OX366388,1,1666400,1668753,-,2353
442,NZ_OX366357,1,1291413,1293766,-,2353
442,NZ_CP072012,1,286506,288859,+,2353
442,NZ_OX366398,1,419368,421721,+,2353
442,NC_002978,6,936645,938998,+,2353
442,NZ_OX366389,1,1313576,1315929,+,2353
442,NZ_OX366397,1,1545692,1548045,+,2353
442,NZ_OX366378,1,1252089,1254442,+,2353
442,NZ_CP090903,1,936645,938998,+,2353
442,NZ_OX366374,1,513192,515545,-,2353
442,NZ_CP090901,1,936645,938998,+,2353
442,NZ_CP046923,1,914789,917142,+,2353
442,NZ_CP069055,1,906134,908487,-,2353
442,NZ_CP072670,1,936485,938838,+,2353
442,NZ_CP090899,1,936645,938998,+,2353
442,NZ_CP046924,1,935727,938080,+,2353
442,NZ_OX366348,1,1215424,1217777,+,2353
442,NZ_CP046921,1,998541,1000894,+,2353
442,NZ_OX366338,1,702371,704724,-,2353
442,NZ_CP054557,1,734248,736601,+,2353
442,NZ_CP072669,1,936493,938846,+,2353
442,NC_021089,1,969172,971525,+,2353
443,NZ_OX366376,1,1399256,1399920,+,664
443,NZ_OX366393,1,1186852,1187516,+,664
443,NZ_OX366372,1,959899,960563,+,664
443,NZ_CP072672,1,939417,939999,+,582
443,NZ_CP069060,1,784370,784952,+,582
443,NZ_CP072667,1,939391,939973,+,582
443,NZ_CP072671,1,939399,939981,+,582
443,NZ_CP072668,1,939386,939968,+,582
443,NZ_CP072666,1,939399,939981,+,582
443,NZ_CP090902,1,939551,940133,+,582
443,NZ_CP090948,1,939551,940133,+,582
443,NZ_CP069052,1,871119,871701,-,582
443,NZ_CP076228,1,1065217,1065799,-,582
443,NZ_CP042445,1,939539,940121,+,582
443,NZ_CP042904,1,961735,962317,+,582
443,NC_012416,1,1000837,1001419,+,582
443,NZ_CP069053,1,784378,784960,+,582
443,NZ_CP042446,1,939549,940131,+,582
443,NZ_CP041215,1,46003,46676,-,673
443,NZ_OX366353,1,1211373,1212046,-,673
443,NZ_OX366387,1,1744508,1745181,+,673
443,NZ_OX366368,1,1384975,1385557,+,582
443,NZ_OX366379,1,1304468,1305050,+,582
443,NZ_CP091195,1,1131271,1131853,-,582
443,NZ_OX366375,1,1272973,1273555,-,582
443,NZ_CP046925,1,939399,939981,+,582
443,NZ_OX366318,1,1238013,1238595,+,582
443,NZ_OX366319,1,1168725,1169307,+,582
443,NZ_OX366332,1,1322198,1322871,+,673
443,NZ_CP110359,1,154087,154669,-,582
443,NZ_OU953855,1,1697812,1698394,+,582
443,NZ_OX366272,1,60404,60986,-,582
443,NZ_OX366347,1,1383110,1383692,+,582
443,NZ_OU909470,1,540750,541423,+,673
443,NZ_OX366363,1,959758,960429,+,671
443,NZ_OX366364,1,52190,52863,-,673
443,NZ_OX366359,1,1152004,1152677,+,673
443,NZ_OX366349,1,1225004,1225668,-,664
443,NZ_OX366380,1,1114329,1114855,+,526
443,NZ_OX366344,1,709775,710439,-,664
443,NZ_CP090900,1,939551,940133,+,582
443,NZ_OX366352,1,133420,134093,-,673
443,NZ_OX366362,1,9503,10085,+,582
443,NZ_OX366400,1,1095042,1095624,+,582
443,NZ_OX366327,1,1234509,1235182,+,673
443,NZ_OX366367,1,1337045,1337718,-,673
443,NZ_CP042444,1,939986,940568,+,582
443,NZ_OX366326,1,1447259,1447841,+,582
443,NZ_CP037426,1,802163,802745,-,582
443,NZ_OX366339,1,65853,66526,+,673
443,NZ_OX366355,1,1307750,1308332,-,582
443,NZ_CP046922,1,1001447,1002029,+,582
443,NZ_OX366370,1,838356,839020,+,664
443,NZ_OX366385,1,647550,648223,-,673
443,NZ_OX366399,1,1338084,1338666,+,582
443,NZ_OX366395,1,1211820,1212491,-,671
443,NZ_OX366396,1,179880,180553,+,673
443,NZ_OX366351,1,1391134,1391716,+,582
443,NZ_OX366381,1,1077672,1078254,+,582
443,NZ_OX366342,1,1452216,1452880,-,664
443,NZ_OX366369,1,1396971,1397553,-,582
443,NZ_OX366356,1,1105439,1106021,+,582
443,NZ_OX366377,1,1026554,1027136,-,582
443,NZ_OX366388,1,1665174,1665847,-,673
443,NZ_OX366357,1,1290189,1290860,-,671
443,NZ_CP072012,1,289412,289994,+,582
443,NZ_OX366398,1,422206,422788,+,582
443,NC_002978,6,939551,940133,+,582
443,NZ_OX366389,1,1316414,1316996,+,582
443,NZ_OX366397,1,1548530,1549203,+,673
443,NZ_OX366378,1,1254995,1255577,+,582
443,NZ_CP090903,1,939551,940133,+,582
443,NZ_OX366374,1,512099,512639,-,540
443,NZ_CP090901,1,939551,940133,+,582
443,NZ_CP046923,1,917695,918277,+,582
443,NZ_CP069055,1,904999,905581,-,582
443,NZ_CP072670,1,939391,939973,+,582
443,NZ_CP090899,1,939551,940133,+,582
443,NZ_CP046924,1,938633,939215,+,582
443,NZ_OX366348,1,1218330,1218912,+,582
443,NZ_CP046921,1,1001447,1002029,+,582
443,NZ_OX366338,1,701236,701818,-,582
443,NZ_CP054557,1,737154,737736,+,582
443,NZ_CP072669,1,939399,939981,+,582
443,NC_021089,1,972010,972683,+,673
444,NZ_OX366376,1,1399921,1400759,+,838
444,NZ_OX366393,1,1187517,1188355,+,838
444,NZ_OX366372,1,960564,961402,+,838
444,NZ_CP072672,1,940000,940838,+,838
444,NZ_CP069060,1,784953,785791,+,838
444,NZ_CP072667,1,939974,940812,+,838
444,NZ_CP072671,1,939982,940820,+,838
444,NZ_CP072668,1,939969,940807,+,838
444,NZ_CP072666,1,939982,940820,+,838
444,NZ_CP090902,1,940134,940972,+,838
444,NZ_CP090948,1,940134,940972,+,838
444,NZ_CP069052,1,870280,871117,-,837
444,NZ_CP076228,1,1064378,1065215,-,837
444,NZ_CP042445,1,940122,940960,+,838
444,NZ_CP042904,1,962318,963156,+,838
444,NC_012416,1,1001420,1002258,+,838
444,NZ_CP069053,1,784961,785799,+,838
444,NZ_CP042446,1,940132,940970,+,838
444,NZ_CP041215,1,45164,46001,-,837
444,NZ_OX366353,1,1210534,1211371,-,837
444,NZ_OX366387,1,1745182,1746020,+,838
444,NZ_OX366368,1,1385558,1386396,+,838
444,NZ_OX366379,1,1305051,1305889,+,838
444,NZ_CP091195,1,1130432,1131269,-,837
444,NZ_OX366375,1,1272134,1272971,-,837
444,NZ_CP046925,1,939982,940820,+,838
444,NZ_OX366318,1,1238596,1239434,+,838
444,NZ_OX366319,1,1169308,1170146,+,838
444,NZ_OX366332,1,1322872,1323710,+,838
444,NZ_CP110359,1,153248,154085,-,837
444,NZ_OU953855,1,1698395,1699233,+,838
444,NZ_OX366272,1,59565,60402,-,837
444,NZ_OX366347,1,1383693,1384531,+,838
444,NZ_OU909470,1,541424,542262,+,838
444,NZ_OX366363,1,960430,961268,+,838
444,NZ_OX366364,1,51351,52188,-,837
444,NZ_OX366359,1,1152678,1153516,+,838
444,NZ_OX366349,1,1224165,1225002,-,837
444,NZ_OX366380,1,1114906,1115744,+,838
444,NZ_OX366344,1,708936,709773,-,837
444,NZ_CP090900,1,940134,940972,+,838
444,NZ_OX366352,1,132581,133418,-,837
444,NZ_OX366362,1,10086,10924,+,838
444,NZ_OX366400,1,1095625,1096463,+,838
444,NZ_OX366327,1,1235183,1236021,+,838
444,NZ_OX366367,1,1336206,1337043,-,837
444,NZ_CP042444,1,940569,941407,+,838
444,NZ_OX366326,1,1447842,1448680,+,838
444,NZ_CP037426,1,801324,802161,-,837
444,NZ_OX366339,1,66527,67365,+,838
444,NZ_OX366355,1,1306911,1307748,-,837
444,NZ_CP046922,1,1002030,1002868,+,838
444,NZ_OX366370,1,839021,839859,+,838
444,NZ_OX366385,1,646711,647548,-,837
444,NZ_OX366399,1,1338667,1339505,+,838
444,NZ_OX366395,1,1210981,1211818,-,837
444,NZ_OX366396,1,180554,181392,+,838
444,NZ_OX366351,1,1391717,1392555,+,838
444,NZ_OX366381,1,1078255,1079093,+,838
444,NZ_OX366342,1,1451377,1452214,-,837
444,NZ_OX366369,1,1396132,1396969,-,837
444,NZ_OX366356,1,1106022,1106860,+,838
444,NZ_OX366377,1,1025715,1026552,-,837
444,NZ_OX366388,1,1664335,1665172,-,837
444,NZ_OX366357,1,1289350,1290187,-,837
444,NZ_CP072012,1,289995,290833,+,838
444,NZ_OX366398,1,422789,423627,+,838
444,NC_002978,6,940134,940972,+,838
444,NZ_OX366389,1,1316997,1317835,+,838
444,NZ_OX366397,1,1549204,1550042,+,838
444,NZ_OX366378,1,1255578,1256416,+,838
444,NZ_CP090903,1,940134,940972,+,838
444,NZ_OX366374,1,509421,510274,-,853
444,NZ_CP090901,1,940134,940972,+,838
444,NZ_CP046923,1,918278,919116,+,838
444,NZ_CP069055,1,904160,904997,-,837
444,NZ_CP072670,1,939974,940812,+,838
444,NZ_CP090899,1,940134,940972,+,838
444,NZ_CP046924,1,939216,940054,+,838
444,NZ_OX366348,1,1218913,1219751,+,838
444,NZ_CP046921,1,1002030,1002868,+,838
444,NZ_OX366338,1,700397,701234,-,837
444,NZ_CP054557,1,737737,738575,+,838
444,NZ_CP072669,1,939982,940820,+,838
444,NC_021089,1,972684,973522,+,838
445,NZ_OX366376,1,1401241,1402520,+,1279
445,NZ_OX366393,1,1188837,1190116,+,1279
445,NZ_OX366372,1,961884,963163,+,1279
445,NZ_CP072672,1,941518,942797,+,1279
445,NZ_CP069060,1,786471,787750,+,1279
445,NZ_CP072667,1,941492,942771,+,1279
445,NZ_CP072671,1,941500,942779,+,1279
445,NZ_CP072668,1,941487,942766,+,1279
445,NZ_CP072666,1,941500,942779,+,1279
445,NZ_CP090902,1,941652,942931,+,1279
445,NZ_CP090948,1,941652,942931,+,1279
445,NZ_CP069052,1,868321,869600,-,1279
445,NZ_CP076228,1,1062419,1063698,-,1279
445,NZ_CP042445,1,941640,942919,+,1279
445,NZ_CP042904,1,963638,964911,+,1273
445,NC_012416,1,1002740,1004013,+,1273
445,NZ_CP069053,1,786479,787758,+,1279
445,NZ_CP042446,1,941650,942929,+,1279
445,NZ_CP041215,1,43409,44682,-,1273
445,NZ_OX366353,1,1208779,1210052,-,1273
445,NZ_OX366387,1,1746502,1747781,+,1279
445,NZ_OX366368,1,1387076,1388355,+,1279
445,NZ_OX366379,1,1306569,1307848,+,1279
445,NZ_CP091195,1,1128470,1129743,-,1273
445,NZ_OX366375,1,1270373,1271652,-,1279
445,NZ_CP046925,1,941500,942779,+,1279
445,NZ_OX366318,1,1240114,1241402,+,1288
445,NZ_OX366319,1,1170628,1171907,+,1279
445,NZ_OX366332,1,1324192,1325465,+,1273
445,NZ_CP110359,1,151271,152550,-,1279
445,NZ_OU953855,1,1699922,1701201,+,1279
445,NZ_OX366272,1,57588,58867,-,1279
445,NZ_OX366347,1,1385211,1386490,+,1279
445,NZ_OU909470,1,542951,544230,+,1279
445,NZ_OX366363,1,961948,963227,+,1279
445,NZ_OX366364,1,49375,50659,-,1284
445,NZ_OX366359,1,1153998,1155271,+,1273
445,NZ_OX366349,1,1222404,1223683,-,1279
445,NZ_OX366380,1,1116226,1117497,+,1271
445,NZ_OX366344,1,707175,708454,-,1279
445,NZ_CP090900,1,941652,942931,+,1279
445,NZ_OX366352,1,130826,132099,-,1273
445,NZ_OX366362,1,11406,12685,+,1279
445,NZ_OX366400,1,1097143,1098431,+,1288
445,NZ_OX366327,1,1236503,1237782,+,1279
445,NZ_OX366367,1,1334230,1335517,-,1287
445,NZ_CP042444,1,942087,943366,+,1279
445,NZ_OX366326,1,1449360,1450648,+,1288
445,NZ_CP037426,1,799563,800842,-,1279
445,NZ_OX366339,1,67847,69126,+,1279
445,NZ_OX366355,1,1305150,1306429,-,1279
445,NZ_CP046922,1,1003548,1004827,+,1279
445,NZ_OX366370,1,840341,841629,+,1288
445,NZ_OX366385,1,644958,646229,-,1271
445,NZ_OX366399,1,1340185,1341464,+,1279
445,NZ_OX366395,1,1209005,1210292,-,1287
445,NZ_OX366396,1,181874,183153,+,1279
445,NZ_OX366351,1,1393235,1394523,+,1288
445,NZ_OX366381,1,1079575,1080854,+,1279
445,NZ_OX366342,1,1449616,1450895,-,1279
445,NZ_OX366369,1,1394371,1395650,-,1279
445,NZ_OX366356,1,1107342,1108621,+,1279
445,NZ_OX366377,1,1023747,1025026,-,1279
445,NZ_OX366388,1,1662574,1663853,-,1279
445,NZ_OX366357,1,572565,573815,+,1250
445,NZ_CP072012,1,291513,292792,+,1279
445,NZ_OX366398,1,424316,425595,+,1279
445,NC_002978,6,941652,942931,+,1279
445,NZ_OX366389,1,1318524,1319803,+,1279
445,NZ_OX366397,1,1550524,1551797,+,1273
445,NZ_OX366378,1,1257105,1258378,+,1273
445,NZ_CP090903,1,941652,942931,+,1279
445,NZ_OX366374,1,507444,508723,-,1279
445,NZ_CP090901,1,941652,942931,+,1279
445,NZ_CP046923,1,919796,921075,+,1279
445,NZ_CP069055,1,902201,903480,-,1279
445,NZ_CP072670,1,941492,942771,+,1279
445,NZ_CP090899,1,941652,942931,+,1279
445,NZ_CP046924,1,940734,942013,+,1279
445,NZ_OX366348,1,1220431,1221710,+,1279
445,NZ_CP046921,1,1003548,1004827,+,1279
445,NZ_OX366338,1,698636,699915,-,1279
445,NZ_CP054557,1,739255,740534,+,1279
445,NZ_CP072669,1,941500,942779,+,1279
445,NC_021089,1,974004,975277,+,1273
446,NZ_OX366376,1,1404663,1405416,+,753
446,NZ_OX366393,1,1192004,1192757,+,753
446,NZ_OX366372,1,965051,965804,+,753
446,NZ_OX366380,1,1119356,1120104,+,748
446,NZ_OX366342,1,1447030,1447783,-,753
446,NZ_OX366357,1,40666,41407,+,741
447,NZ_OX366376,1,1405548,1407653,+,2105
447,NZ_OX366393,1,1192889,1194994,+,2105
447,NZ_OX366372,1,965936,968041,+,2105
447,NZ_CP072672,1,842007,844118,-,2111
447,NZ_CP069060,1,685824,687935,-,2111
447,NZ_CP072667,1,841989,844100,-,2111
447,NZ_CP072671,1,841989,844100,-,2111
447,NZ_CP072668,1,841976,844087,-,2111
447,NZ_CP072666,1,841989,844100,-,2111
447,NZ_CP090902,1,842141,844252,-,2111
447,NZ_CP090948,1,842141,844252,-,2111
447,NZ_CP069052,1,1236814,1238925,-,2111
447,NZ_CP076228,1,840057,842168,-,2111
447,NZ_CP042445,1,842129,844240,-,2111
447,NZ_CP042904,1,869724,871835,-,2111
447,NC_012416,1,906225,908336,-,2111
447,NZ_CP069053,1,685832,687943,-,2111
447,NZ_CP042446,1,842141,844252,-,2111
447,NZ_CP041215,1,1335311,1337434,-,2123
447,NZ_OX366353,1,263562,265685,+,2123
447,NZ_OX366387,1,1505239,1507350,-,2111
447,NZ_OX366368,1,1288182,1290293,-,2111
447,NZ_OX366379,1,1207699,1209810,-,2111
447,NZ_CP091195,1,84879,86989,+,2110
447,NZ_OX366375,1,1207881,1209983,-,2102
447,NZ_CP046925,1,841989,844100,-,2111
447,NZ_OX366318,1,1141370,1143481,-,2111
447,NZ_OX366319,1,112156,114267,-,2111
447,NZ_OX366332,1,1244051,1246174,-,2123
447,NZ_CP110359,1,331754,333877,-,2123
447,NZ_OU953855,1,797759,799882,+,2123
447,NZ_OX366272,1,1304269,1306392,-,2123
447,NZ_OX366347,1,89170,91293,+,2123
447,NZ_OU909470,1,546998,549089,+,2091
447,NZ_OX366363,1,839828,841939,-,2111
447,NZ_OX366364,1,288261,290292,+,2031
447,NZ_OX366359,1,1039035,1041158,+,2123
447,NZ_OX366349,1,204828,206937,+,2109
447,NZ_OX366380,1,1120590,1122722,+,2132
447,NZ_OX366344,1,702147,704256,-,2109
447,NZ_CP090900,1,842141,844252,-,2111
447,NZ_OX366352,1,210061,212184,+,2123
447,NZ_OX366362,1,360513,362636,-,2123
447,NZ_OX366400,1,1004386,1006497,-,2111
447,NZ_OX366327,1,1143143,1145254,-,2111
447,NZ_OX366367,1,93119,95226,+,2107
447,NZ_CP042444,1,842576,844687,-,2111
447,NZ_OX366326,1,1348995,1351106,-,2111
447,NZ_CP037426,1,913370,915472,+,2102
447,NZ_OX366339,1,988738,990849,+,2111
447,NZ_OX366355,1,117989,120100,-,2111
447,NZ_CP046922,1,903954,906065,-,2111
447,NZ_OX366370,1,843957,846045,+,2088
447,NZ_OX366385,1,640963,643095,-,2132
447,NZ_OX366399,1,1242327,1244438,-,2111
447,NZ_OX366395,1,1269045,1271168,+,2123
447,NZ_OX366396,1,1270937,1273048,-,2111
447,NZ_OX366351,1,1295421,1297532,-,2111
447,NZ_OX366381,1,223636,225747,-,2111
447,NZ_OX366342,1,1444793,1446898,-,2105
447,NZ_OX366369,1,1334750,1336861,-,2111
447,NZ_OX366356,1,1049448,1051601,-,2153
447,NZ_OX366377,1,1083546,1085657,+,2111
447,NZ_OX366388,1,179047,181158,-,2111
447,NZ_OX366357,1,41861,43983,+,2122
447,NZ_CP072012,1,1334207,1336318,+,2111
447,NZ_OX366398,1,322410,324521,-,2111
447,NC_002978,6,842141,844252,-,2111
447,NZ_OX366389,1,1216084,1218195,-,2111
447,NZ_OX366397,1,1433366,1435489,+,2123
447,NZ_OX366378,1,1129779,1131889,-,2110
447,NZ_CP090903,1,842141,844252,-,2111
447,NZ_OX366374,1,134033,136156,-,2123
447,NZ_CP090901,1,842141,844252,-,2111
447,NZ_CP046923,1,820202,822313,-,2111
447,NZ_CP069055,1,841391,843502,-,2111
447,NZ_CP072670,1,841981,844092,-,2111
447,NZ_CP090899,1,842141,844252,-,2111
447,NZ_CP046924,1,841140,843251,-,2111
447,NZ_OX366348,1,136574,138685,+,2111
447,NZ_CP046921,1,903954,906065,-,2111
447,NZ_OX366338,1,1324513,1326636,-,2123
447,NZ_CP054557,1,960578,962664,+,2086
447,NZ_CP072669,1,841989,844100,-,2111
447,NC_021089,1,893704,895827,-,2123
448,NZ_OX366376,1,1407795,1409359,+,1564
448,NZ_OX366393,1,1195136,1196700,+,1564
448,NZ_OX366372,1,968183,969747,+,1564
448,NZ_CP072672,1,840347,841857,-,1510
448,NZ_CP069060,1,684164,685674,-,1510
448,NZ_CP072667,1,840329,841839,-,1510
448,NZ_CP072671,1,840329,841839,-,1510
448,NZ_CP072668,1,840316,841826,-,1510
448,NZ_CP072666,1,840329,841839,-,1510
448,NZ_CP090902,1,840481,841991,-,1510
448,NZ_CP090948,1,840481,841991,-,1510
448,NZ_CP069052,1,1235154,1236664,-,1510
448,NZ_CP076228,1,838397,839907,-,1510
448,NZ_CP042445,1,840469,841979,-,1510
448,NZ_CP042904,1,868064,869574,-,1510
448,NC_012416,1,904565,906075,-,1510
448,NZ_CP069053,1,684172,685682,-,1510
448,NZ_CP042446,1,840481,841991,-,1510
448,NZ_CP041215,1,1333651,1335161,-,1510
448,NZ_OX366353,1,265835,267345,+,1510
448,NZ_OX366387,1,1503579,1505089,-,1510
448,NZ_OX366368,1,1286522,1288032,-,1510
448,NZ_OX366379,1,1206039,1207549,-,1510
448,NZ_CP091195,1,87140,88650,+,1510
448,NZ_OX366375,1,1206221,1207731,-,1510
448,NZ_CP046925,1,840329,841839,-,1510
448,NZ_OX366318,1,1139710,1141220,-,1510
448,NZ_OX366319,1,110496,112006,-,1510
448,NZ_OX366332,1,1242391,1243901,-,1510
448,NZ_CP110359,1,330094,331604,-,1510
448,NZ_OU953855,1,800032,801542,+,1510
448,NZ_OX366272,1,1302609,1304119,-,1510
448,NZ_OX366347,1,91444,92953,+,1509
448,NZ_OU909470,1,549239,550749,+,1510
448,NZ_OX366363,1,838168,839678,-,1510
448,NZ_OX366364,1,648439,649949,-,1510
448,NZ_OX366359,1,1041308,1042818,+,1510
448,NZ_OX366349,1,207079,208643,+,1564
448,NZ_OX366380,1,1122872,1124382,+,1510
448,NZ_OX366344,1,700441,702005,-,1564
448,NZ_CP090900,1,840481,841991,-,1510
448,NZ_OX366352,1,212334,213844,+,1510
448,NZ_OX366362,1,358582,360092,-,1510
448,NZ_OX366400,1,1002726,1004236,-,1510
448,NZ_OX366327,1,1141483,1142993,-,1510
448,NZ_OX366367,1,95696,97206,+,1510
448,NZ_CP042444,1,840916,842426,-,1510
448,NZ_OX366326,1,1347335,1348845,-,1510
448,NZ_CP037426,1,915622,917132,+,1510
448,NZ_OX366339,1,990999,992509,+,1510
448,NZ_OX366355,1,116329,117839,-,1510
448,NZ_CP046922,1,902294,903804,-,1510
448,NZ_OX366370,1,846188,847697,+,1509
448,NZ_OX366385,1,639303,640813,-,1510
448,NZ_OX366399,1,1240667,1242177,-,1510
448,NZ_OX366395,1,1271589,1273099,+,1510
448,NZ_OX366396,1,1269277,1270787,-,1510
448,NZ_OX366351,1,1293761,1295271,-,1510
448,NZ_OX366381,1,221976,223486,-,1510
448,NZ_OX366342,1,1443087,1444651,-,1564
448,NZ_OX366369,1,1333090,1334600,-,1510
448,NZ_OX366356,1,1047788,1049298,-,1510
448,NZ_OX366377,1,1085807,1087317,+,1510
448,NZ_OX366388,1,177387,178897,-,1510
448,NZ_OX366357,1,44895,46405,+,1510
448,NZ_CP072012,1,1336468,1337978,+,1510
448,NZ_OX366398,1,320750,322260,-,1510
448,NC_002978,6,840481,841991,-,1510
448,NZ_OX366389,1,1214424,1215934,-,1510
448,NZ_OX366397,1,1435639,1437149,+,1510
448,NZ_OX366378,1,1128118,1129628,-,1510
448,NZ_CP090903,1,840481,841991,-,1510
448,NZ_OX366374,1,132373,133883,-,1510
448,NZ_CP090901,1,840481,841991,-,1510
448,NZ_CP046923,1,818542,820052,-,1510
448,NZ_CP069055,1,839731,841241,-,1510
448,NZ_CP072670,1,840321,841831,-,1510
448,NZ_CP090899,1,840481,841991,-,1510
448,NZ_CP046924,1,839480,840990,-,1510
448,NZ_OX366348,1,138835,140345,+,1510
448,NZ_CP046921,1,902294,903804,-,1510
448,NZ_OX366338,1,1322853,1324363,-,1510
448,NZ_CP054557,1,963743,965253,+,1510
448,NZ_CP072669,1,840329,841839,-,1510
448,NC_021089,1,892044,893554,-,1510
449,NZ_OX366376,1,1409779,1411308,+,1529
449,NZ_OX366393,1,1197120,1198649,+,1529
449,NZ_OX366372,1,970167,971696,+,1529
449,NZ_CP072672,1,484528,486126,+,1598
449,NZ_CP069060,1,76857,78455,-,1598
449,NZ_CP072667,1,484510,486108,+,1598
449,NZ_CP072671,1,484510,486108,+,1598
449,NZ_CP072668,1,484497,486095,+,1598
449,NZ_CP072666,1,484510,486108,+,1598
449,NZ_CP090902,1,484662,486260,+,1598
449,NZ_CP090948,1,484662,486260,+,1598
449,NZ_CP069052,1,395667,397265,-,1598
449,NZ_CP076228,1,226418,228016,-,1598
449,NZ_CP042445,1,484662,486260,+,1598
449,NZ_CP042904,1,248848,250446,-,1598
449,NC_012416,1,251431,253029,-,1598
449,NZ_CP069053,1,468822,470420,+,1598
449,NZ_CP042446,1,484662,486260,+,1598
449,NZ_CP041215,1,1248279,1249877,+,1598
449,NZ_OX366353,1,1290500,1292098,+,1598
449,NZ_OX366387,1,1097010,1098608,-,1598
449,NZ_OX366368,1,747583,749181,-,1598
449,NZ_OX366379,1,703788,705386,-,1598
449,NZ_CP091195,1,72020,73605,-,1585
449,NZ_OX366375,1,785742,787340,-,1598
449,NZ_CP046925,1,484510,486108,+,1598
449,NZ_OX366318,1,654732,656328,-,1596
449,NZ_OX366319,1,635435,637033,+,1598
449,NZ_OX366332,1,876718,878316,+,1598
449,NZ_CP110359,1,966566,968164,+,1598
449,NZ_OU953855,1,609076,610674,+,1598
449,NZ_OX366272,1,537352,538950,+,1598
449,NZ_OX366347,1,1002075,1003673,+,1598
449,NZ_OU909470,1,551154,552658,+,1504
449,NZ_OX366363,1,259030,260628,+,1598
449,NZ_OX366364,1,526291,527833,-,1542
449,NZ_OX366359,1,541837,543435,-,1598
449,NZ_OX366349,1,209063,210592,+,1529
449,NZ_OX366380,1,1124787,1126316,+,1529
449,NZ_OX366344,1,698476,700005,-,1529
449,NZ_CP090900,1,484662,486260,+,1598
449,NZ_OX366352,1,605748,607346,+,1598
449,NZ_OX366362,1,516023,517624,+,1601
449,NZ_OX366400,1,596024,597620,+,1596
449,NZ_OX366327,1,704922,706511,-,1589
449,NZ_OX366367,1,1213967,1215509,-,1542
449,NZ_CP042444,1,485163,486761,+,1598
449,NZ_OX366326,1,749556,751152,-,1596
449,NZ_CP037426,1,269043,270641,+,1598
449,NZ_OX366339,1,379577,381175,-,1598
449,NZ_OX366355,1,701583,703181,+,1598
449,NZ_CP046922,1,477272,478870,-,1598
449,NZ_OX366370,1,848290,849819,+,1529
449,NZ_OX366385,1,545611,547132,+,1521
449,NZ_OX366399,1,673371,674969,-,1598
449,NZ_OX366395,1,646667,648265,-,1598
449,NZ_OX366396,1,781372,782970,-,1598
449,NZ_OX366351,1,571389,572985,-,1596
449,NZ_OX366381,1,910000,911598,+,1598
449,NZ_OX366342,1,1441138,1442667,-,1529
449,NZ_OX366369,1,814113,815711,+,1598
449,NZ_OX366356,1,726543,728141,+,1598
449,NZ_OX366377,1,861492,863088,-,1596
449,NZ_OX366388,1,709571,711169,+,1598
449,NZ_OX366357,1,296954,298552,-,1598
449,NZ_CP072012,1,583358,584956,+,1598
449,NZ_OX366398,1,638015,639611,-,1596
449,NC_002978,6,484662,486260,+,1598
449,NZ_OX366389,1,732707,734303,-,1596
449,NZ_OX366397,1,972660,974258,+,1598
449,NZ_OX366378,1,283271,284856,+,1585
449,NZ_CP090903,1,484662,486260,+,1598
449,NZ_OX366374,1,846388,847934,+,1546
449,NZ_CP090901,1,484662,486260,+,1598
449,NZ_CP046923,1,393520,395118,-,1598
449,NZ_CP069055,1,523262,524860,+,1598
449,NZ_CP072670,1,484502,486100,+,1598
449,NZ_CP090899,1,484662,486260,+,1598
449,NZ_CP046924,1,414458,416056,-,1598
449,NZ_OX366348,1,439520,441118,-,1598
449,NZ_CP046921,1,477272,478870,-,1598
449,NZ_OX366338,1,626244,627842,-,1598
449,NZ_CP054557,1,20140,21738,-,1598
449,NZ_CP072669,1,484510,486108,+,1598
449,NC_021089,1,335026,336624,-,1598
450,NZ_OX366376,1,1412468,1415080,+,2612
450,NZ_OX366393,1,1200112,1202724,+,2612
450,NZ_OX366372,1,972957,975569,+,2612
450,NZ_CP072672,1,833101,835743,+,2642
450,NZ_CP069060,1,676918,679560,+,2642
450,NZ_CP072667,1,833083,835725,+,2642
450,NZ_CP072671,1,833083,835725,+,2642
450,NZ_CP072668,1,833070,835712,+,2642
450,NZ_CP072666,1,833083,835725,+,2642
450,NZ_CP090902,1,833235,835877,+,2642
450,NZ_CP090948,1,833235,835877,+,2642
450,NZ_CP069052,1,1227908,1230550,+,2642
450,NZ_CP076228,1,831153,833795,+,2642
450,NZ_CP042445,1,833223,835865,+,2642
450,NZ_CP042904,1,860978,863629,+,2651
450,NC_012416,1,897479,900130,+,2651
450,NZ_CP069053,1,676926,679568,+,2642
450,NZ_CP042446,1,833235,835877,+,2642
450,NZ_CP041215,1,1326617,1329259,+,2642
450,NZ_OX366353,1,271787,274428,-,2641
450,NZ_OX366387,1,1497024,1499666,+,2642
450,NZ_OX366368,1,1279276,1281918,+,2642
450,NZ_OX366379,1,1198793,1201435,+,2642
450,NZ_CP091195,1,95524,98165,-,2641
450,NZ_OX366375,1,1199142,1201793,+,2651
450,NZ_CP046925,1,833083,835725,+,2642
450,NZ_OX366318,1,1132644,1135286,+,2642
450,NZ_OX366319,1,103501,106143,+,2642
450,NZ_OX366332,1,1235260,1237902,+,2642
450,NZ_CP110359,1,322520,325162,+,2642
450,NZ_OU953855,1,855816,858458,+,2642
450,NZ_OX366272,1,1292958,1295627,+,2669
450,NZ_OX366347,1,100109,102750,-,2641
450,NZ_OU909470,1,553528,556186,+,2658
450,NZ_OX366363,1,830329,832971,+,2642
450,NZ_OX366364,1,528111,530780,+,2669
450,NZ_OX366359,1,1047163,1049804,-,2641
450,NZ_OX366349,1,576881,579575,-,2694
450,NZ_OX366380,1,1128524,1131167,+,2643
450,NZ_OX366344,1,694893,697581,-,2688
450,NZ_CP090900,1,833235,835877,+,2642
450,NZ_OX366352,1,219723,222364,-,2641
450,NZ_OX366362,1,351752,354363,+,2611
450,NZ_OX366400,1,995678,998320,+,2642
450,NZ_OX366327,1,1134228,1136870,+,2642
450,NZ_OX366367,1,1215805,1218456,+,2651
450,NZ_CP042444,1,833670,836312,+,2642
450,NZ_OX366326,1,1340269,1342911,+,2642
450,NZ_CP037426,1,922480,925130,-,2650
450,NZ_OX366339,1,998103,1000767,-,2664
450,NZ_OX366355,1,109334,111976,+,2642
450,NZ_CP046922,1,895048,897690,+,2642
450,NZ_OX366370,1,850632,853341,+,2709
450,NZ_OX366385,1,452472,455115,-,2643
450,NZ_OX366399,1,1233421,1236063,+,2642
450,NZ_OX366395,1,1278060,1280701,-,2641
450,NZ_OX366396,1,1261947,1264611,+,2664
450,NZ_OX366351,1,1286695,1289337,+,2642
450,NZ_OX366381,1,214981,217623,+,2642
450,NZ_OX366342,1,1437272,1439885,-,2613
450,NZ_OX366369,1,1326095,1328737,+,2642
450,NZ_OX366356,1,1041233,1043875,+,2642
450,NZ_OX366377,1,1091629,1094306,-,2677
450,NZ_OX366388,1,319751,322393,+,2642
450,NZ_OX366357,1,1114620,1117289,+,2669
450,NZ_CP072012,1,1343501,1346142,-,2641
450,NZ_OX366398,1,313760,316438,+,2678
450,NC_002978,6,833235,835877,+,2642
450,NZ_OX366389,1,1207434,1210112,+,2678
450,NZ_OX366397,1,1441590,1444231,-,2641
450,NZ_OX366378,1,322256,324898,+,2642
450,NZ_CP090903,1,833235,835877,+,2642
450,NZ_OX366374,1,428480,431149,+,2669
450,NZ_CP090901,1,833235,835877,+,2642
450,NZ_CP046923,1,811296,813938,+,2642
450,NZ_CP069055,1,832486,835128,+,2642
450,NZ_CP072670,1,833075,835717,+,2642
450,NZ_CP090899,1,833235,835877,+,2642
450,NZ_CP046924,1,832234,834876,+,2642
450,NZ_OX366348,1,144945,147586,-,2641
450,NZ_CP046921,1,895048,897690,+,2642
450,NZ_OX366338,1,1315279,1317900,+,2621
450,NZ_CP054557,1,969900,972541,-,2641
450,NZ_CP072669,1,833083,835725,+,2642
450,NC_021089,1,884935,887603,+,2668
451,NZ_OX366376,1,1415089,1417280,+,2191
451,NZ_OX366393,1,1202733,1204924,+,2191
451,NZ_OX366372,1,975578,977769,+,2191
451,NZ_CP072672,1,835744,837904,+,2160
451,NZ_CP069060,1,679561,681721,+,2160
451,NZ_CP072667,1,835726,837886,+,2160
451,NZ_CP072671,1,835726,837886,+,2160
451,NZ_CP072668,1,835713,837873,+,2160
451,NZ_CP072666,1,835726,837886,+,2160
451,NZ_CP090902,1,835878,838038,+,2160
451,NZ_CP090948,1,835878,838038,+,2160
451,NZ_CP069052,1,1230551,1232711,+,2160
451,NZ_CP076228,1,833796,835956,+,2160
451,NZ_CP042445,1,835866,838026,+,2160
451,NZ_CP042904,1,863630,865790,+,2160
451,NC_012416,1,900131,902291,+,2160
451,NZ_CP069053,1,679569,681729,+,2160
451,NZ_CP042446,1,835878,838038,+,2160
451,NZ_CP041215,1,1329260,1331420,+,2160
451,NZ_OX366353,1,269626,271785,-,2159
451,NZ_OX366387,1,1499667,1501827,+,2160
451,NZ_OX366368,1,1281919,1284079,+,2160
451,NZ_OX366379,1,1201436,1203596,+,2160
451,NZ_CP091195,1,93363,95522,-,2159
451,NZ_OX366375,1,1201794,1203954,+,2160
451,NZ_CP046925,1,835726,837886,+,2160
451,NZ_OX366318,1,1135287,1137447,+,2160
451,NZ_OX366319,1,106144,108304,+,2160
451,NZ_OX366332,1,1237903,1240063,+,2160
451,NZ_CP110359,1,325163,327323,+,2160
451,NZ_OU953855,1,858459,860619,+,2160
451,NZ_OX366272,1,1295628,1297788,+,2160
451,NZ_OX366347,1,96593,98718,-,2125
451,NZ_OU909470,1,556187,558347,+,2160
451,NZ_OX366363,1,832972,835132,+,2160
451,NZ_OX366364,1,270164,272309,+,2145
451,NZ_OX366359,1,1045002,1047161,-,2159
451,NZ_OX366349,1,574682,576873,-,2191
451,NZ_OX366380,1,1131168,1133378,+,2210
451,NZ_OX366344,1,692701,694885,-,2184
451,NZ_CP090900,1,835878,838038,+,2160
451,NZ_OX366352,1,217562,219721,-,2159
451,NZ_OX366362,1,354372,356556,+,2184
451,NZ_OX366400,1,998321,1000481,+,2160
451,NZ_OX366327,1,1136871,1139031,+,2160
451,NZ_OX366367,1,75836,77983,+,2147
451,NZ_CP042444,1,836313,838473,+,2160
451,NZ_OX366326,1,1342912,1345072,+,2160
451,NZ_CP037426,1,920319,922478,-,2159
451,NZ_OX366339,1,995920,998095,-,2175
451,NZ_OX366355,1,111977,114137,+,2160
451,NZ_CP046922,1,897691,899851,+,2160
451,NZ_OX366370,1,853350,855541,+,2191
451,NZ_OX366385,1,450261,452470,-,2209
451,NZ_OX366399,1,1236064,1238224,+,2160
451,NZ_OX366395,1,1275899,1278058,-,2159
451,NZ_OX366396,1,1264620,1266795,+,2175
451,NZ_OX366351,1,1289338,1291498,+,2160
451,NZ_OX366381,1,217624,219784,+,2160
451,NZ_OX366342,1,1435073,1437264,-,2191
451,NZ_OX366369,1,1328738,1330898,+,2160
451,NZ_OX366356,1,1043876,1046036,+,2160
451,NZ_OX366377,1,1089468,1091627,-,2159
451,NZ_OX366388,1,322394,324554,+,2160
451,NZ_OX366357,1,1117290,1119450,+,2160
451,NZ_CP072012,1,1341340,1343499,-,2159
451,NZ_OX366398,1,316439,318599,+,2160
451,NC_002978,6,835878,838038,+,2160
451,NZ_OX366389,1,1210113,1212273,+,2160
451,NZ_OX366397,1,1439429,1441588,-,2159
451,NZ_OX366378,1,324899,327059,+,2160
451,NZ_CP090903,1,835878,838038,+,2160
451,NZ_OX366374,1,128209,130334,+,2125
451,NZ_CP090901,1,835878,838038,+,2160
451,NZ_CP046923,1,813939,816099,+,2160
451,NZ_CP069055,1,835129,837289,+,2160
451,NZ_CP072670,1,835718,837878,+,2160
451,NZ_CP090899,1,835878,838038,+,2160
451,NZ_CP046924,1,834877,837037,+,2160
451,NZ_OX366348,1,142784,144943,-,2159
451,NZ_CP046921,1,897691,899851,+,2160
451,NZ_OX366338,1,1317901,1320061,+,2160
451,NZ_CP054557,1,967739,969898,-,2159
451,NZ_CP072669,1,835726,837886,+,2160
451,NC_021089,1,887604,889764,+,2160
452,NZ_OX366376,1,1417322,1418851,+,1529
452,NZ_OX366393,1,1204966,1206495,+,1529
452,NZ_OX366372,1,977811,979340,+,1529
452,NZ_CP072672,1,837946,839475,+,1529
452,NZ_CP069060,1,681763,683292,+,1529
452,NZ_CP072667,1,837928,839457,+,1529
452,NZ_CP072671,1,837928,839457,+,1529
452,NZ_CP072668,1,837915,839444,+,1529
452,NZ_CP072666,1,837928,839457,+,1529
452,NZ_CP090902,1,838080,839609,+,1529
452,NZ_CP090948,1,838080,839609,+,1529
452,NZ_CP069052,1,1232753,1234282,+,1529
452,NZ_CP076228,1,835998,837527,+,1529
452,NZ_CP042445,1,838068,839597,+,1529
452,NZ_CP042904,1,865832,867361,+,1529
452,NC_012416,1,902333,903862,+,1529
452,NZ_CP069053,1,681771,683300,+,1529
452,NZ_CP042446,1,838080,839609,+,1529
452,NZ_CP041215,1,1331462,1332991,+,1529
452,NZ_OX366353,1,268055,269584,-,1529
452,NZ_OX366387,1,1501869,1503394,+,1525
452,NZ_OX366368,1,1284121,1285650,+,1529
452,NZ_OX366379,1,1203638,1205167,+,1529
452,NZ_CP091195,1,91514,93043,-,1529
452,NZ_OX366375,1,1203996,1205525,+,1529
452,NZ_CP046925,1,837928,839457,+,1529
452,NZ_OX366318,1,1137489,1139018,+,1529
452,NZ_OX366319,1,108346,109875,+,1529
452,NZ_OX366332,1,1240105,1241634,+,1529
452,NZ_CP110359,1,327653,329182,+,1529
452,NZ_OU953855,1,860661,862190,+,1529
452,NZ_OX366272,1,1298118,1299647,+,1529
452,NZ_OX366347,1,95022,96551,-,1529
452,NZ_OU909470,1,558667,560196,+,1529
452,NZ_OX366363,1,835174,836703,+,1529
452,NZ_OX366364,1,272358,273896,+,1538
452,NZ_OX366359,1,1043431,1044960,-,1529
452,NZ_OX366349,1,573111,574640,-,1529
452,NZ_OX366380,1,1133708,1135237,+,1529
452,NZ_OX366344,1,691130,692654,-,1524
452,NZ_CP090900,1,838080,839609,+,1529
452,NZ_OX366352,1,215991,217520,-,1529
452,NZ_OX366362,1,356605,358134,+,1529
452,NZ_OX366400,1,1000523,1002052,+,1529
452,NZ_OX366327,1,1139073,1140602,+,1529
452,NZ_OX366367,1,78032,79570,+,1538
452,NZ_CP042444,1,838515,840044,+,1529
452,NZ_OX366326,1,1345114,1346643,+,1529
452,NZ_CP037426,1,918748,920277,-,1529
452,NZ_OX366339,1,994349,995878,-,1529
452,NZ_OX366355,1,114179,115708,+,1529
452,NZ_CP046922,1,899893,901422,+,1529
452,NZ_OX366370,1,855583,857112,+,1529
452,NZ_OX366385,1,447320,448849,-,1529
452,NZ_OX366399,1,1238266,1239795,+,1529
452,NZ_OX366395,1,1274033,1275561,-,1528
452,NZ_OX366396,1,1266837,1268366,+,1529
452,NZ_OX366351,1,1291540,1293069,+,1529
452,NZ_OX366381,1,219826,221355,+,1529
452,NZ_OX366342,1,1433502,1435031,-,1529
452,NZ_OX366369,1,1330940,1332469,+,1529
452,NZ_OX366356,1,1046078,1047603,+,1525
452,NZ_OX366377,1,1087897,1089426,-,1529
452,NZ_OX366388,1,324874,326403,+,1529
452,NZ_OX366357,1,1119788,1121317,+,1529
452,NZ_CP072012,1,1338850,1340364,-,1514
452,NZ_OX366398,1,318641,320170,+,1529
452,NC_002978,6,838080,839609,+,1529
452,NZ_OX366389,1,1212315,1213844,+,1529
452,NZ_OX366397,1,1437858,1439387,-,1529
452,NZ_OX366378,1,327379,328908,+,1529
452,NZ_CP090903,1,838080,839609,+,1529
452,NZ_OX366374,1,130654,132176,+,1522
452,NZ_CP090901,1,838080,839609,+,1529
452,NZ_CP046923,1,816141,817670,+,1529
452,NZ_CP069055,1,837331,838860,+,1529
452,NZ_CP072670,1,837920,839449,+,1529
452,NZ_CP090899,1,838080,839609,+,1529
452,NZ_CP046924,1,837079,838608,+,1529
452,NZ_OX366348,1,141213,142742,-,1529
452,NZ_CP046921,1,899893,901422,+,1529
452,NZ_OX366338,1,1321143,1322656,+,1513
452,NZ_CP054557,1,966168,967697,-,1529
452,NZ_CP072669,1,837928,839457,+,1529
452,NC_021089,1,889806,891335,+,1529
453,NZ_OX366376,1,1420072,1421451,+,1379
453,NZ_OX366393,1,1207538,1208917,+,1379
453,NZ_OX366372,1,980562,981941,+,1379
453,NZ_CP072672,1,416131,417497,-,1366
453,NZ_CP069060,1,404746,406112,-,1366
453,NZ_CP072667,1,416113,417479,-,1366
453,NZ_CP072671,1,416113,417479,-,1366
453,NZ_CP072668,1,416100,417466,-,1366
453,NZ_CP072666,1,416113,417479,-,1366
453,NZ_CP090902,1,416265,417631,-,1366
453,NZ_CP090948,1,416265,417631,-,1366
453,NZ_CP069052,1,465307,466673,+,1366
453,NZ_CP076228,1,295383,296749,+,1366
453,NZ_CP042445,1,416265,417631,-,1366
453,NZ_CP042904,1,330901,332280,+,1379
453,NC_012416,1,331992,333371,+,1379
453,NZ_CP069053,1,141165,142531,+,1366
453,NZ_CP042446,1,416265,417631,-,1366
453,NZ_CP041215,1,1174007,1175373,-,1366
453,NZ_OX366353,1,391034,392400,-,1366
453,NZ_OX366387,1,1135528,1136903,+,1375
453,NZ_OX366368,1,816286,817652,+,1366
453,NZ_OX366379,1,773777,775143,+,1366
453,NZ_CP091195,1,194147,195448,-,1301
453,NZ_OX366375,1,522291,523657,-,1366
453,NZ_CP046925,1,416113,417479,-,1366
453,NZ_OX366318,1,724952,726327,+,1375
453,NZ_OX366319,1,513973,515343,+,1370
453,NZ_OX366332,1,804681,806047,-,1366
453,NZ_CP110359,1,763012,764391,+,1379
453,NZ_OU953855,1,1061188,1062563,-,1375
453,NZ_OX366272,1,459013,460392,-,1379
453,NZ_OX366347,1,928925,930304,-,1379
453,NZ_OU909470,1,562858,564258,+,1400
453,NZ_OX366363,1,185402,186772,-,1370
453,NZ_OX366364,1,669697,671007,-,1310
453,NZ_OX366359,1,613196,614562,+,1366
453,NZ_OX366349,1,567453,568832,-,1379
453,NZ_OX366380,1,1137336,1138736,+,1400
453,NZ_OX366344,1,688704,690070,-,1366
453,NZ_CP090900,1,416265,417631,-,1366
453,NZ_OX366352,1,474312,475678,-,1366
453,NZ_OX366362,1,1340058,1341572,-,1514
453,NZ_OX366400,1,520183,521558,-,1375
453,NZ_OX366327,1,779061,780440,+,1379
453,NZ_OX366367,1,888583,889893,+,1310
453,NZ_CP042444,1,416766,418132,-,1366
453,NZ_OX366326,1,819776,821151,+,1375
453,NZ_CP037426,1,192202,193568,-,1366
453,NZ_OX366339,1,598103,599473,+,1370
453,NZ_OX366355,1,453057,454427,-,1370
453,NZ_CP046922,1,545902,547268,+,1366
453,NZ_OX366370,1,857761,859149,+,1388
453,NZ_OX366385,1,561240,562640,+,1400
453,NZ_OX366399,1,743361,744727,+,1366
453,NZ_OX366395,1,815568,816866,-,1298
453,NZ_OX366396,1,886804,888174,+,1370
453,NZ_OX366351,1,644262,645637,+,1375
453,NZ_OX366381,1,671575,672945,+,1370
453,NZ_OX366342,1,1430900,1432279,-,1379
453,NZ_OX366369,1,744973,746343,-,1370
453,NZ_OX366356,1,654372,655738,-,1366
453,NZ_OX366377,1,937556,938931,+,1375
453,NZ_OX366388,1,614981,616282,-,1301
453,NZ_OX366357,1,613739,615118,+,1379
453,NZ_CP072012,1,515185,516551,-,1366
453,NZ_OX366398,1,177991,179366,-,1375
453,NC_002978,6,416265,417631,-,1366
453,NZ_OX366389,1,842898,844273,+,1375
453,NZ_OX366397,1,822387,823753,-,1366
453,NZ_OX366378,1,367551,368852,+,1301
453,NZ_CP090903,1,416265,417631,-,1366
453,NZ_OX366374,1,490859,492169,+,1310
453,NZ_CP090901,1,416265,417631,-,1366
453,NZ_CP046923,1,462150,463516,+,1366
453,NZ_CP069055,1,453981,455347,-,1366
453,NZ_CP072670,1,416105,417471,-,1366
453,NZ_CP090899,1,416265,417631,-,1366
453,NZ_CP046924,1,483088,484454,+,1366
453,NZ_OX366348,1,512595,513961,+,1366
453,NZ_CP046921,1,545902,547268,+,1366
453,NZ_OX366338,1,544620,545999,-,1379
453,NZ_CP054557,1,163959,165325,-,1366
453,NZ_CP072669,1,416113,417479,-,1366
453,NC_021089,1,472514,473880,+,1366
454,NZ_OX366376,1,1421857,1422380,+,523
454,NZ_OX366393,1,1209327,1209850,+,523
454,NZ_OX366372,1,982351,982874,+,523
454,NZ_CP072672,1,415190,415728,-,538
454,NZ_CP069060,1,403805,404343,-,538
454,NZ_CP072667,1,415172,415710,-,538
454,NZ_CP072671,1,415172,415710,-,538
454,NZ_CP072668,1,415159,415697,-,538
454,NZ_CP072666,1,415172,415710,-,538
454,NZ_CP090902,1,415324,415862,-,538
454,NZ_CP090948,1,415324,415862,-,538
454,NZ_CP069052,1,467076,467613,+,537
454,NZ_CP076228,1,297152,297691,+,539
454,NZ_CP042445,1,415324,415862,-,538
454,NZ_CP069053,1,142934,143471,+,537
454,NZ_CP042446,1,415324,415862,-,538
454,NZ_CP041215,1,1173066,1173604,-,538
454,NZ_OX366353,1,390093,390631,-,538
454,NZ_OX366387,1,1137306,1137843,+,537
454,NZ_OX366368,1,818053,818590,+,537
454,NZ_OX366379,1,775546,776083,+,537
454,NZ_CP046925,1,415172,415710,-,538
454,NZ_OX366332,1,803740,804278,-,538
454,NZ_CP110359,1,764791,765328,+,537
454,NZ_OU953855,1,1058719,1059257,-,538
454,NZ_OX366272,1,458075,458613,-,538
454,NZ_OX366359,1,614965,615502,+,537
454,NZ_OX366349,1,566502,567041,-,539
454,NZ_CP090900,1,415324,415862,-,538
454,NZ_OX366352,1,473371,473909,-,538
454,NZ_OX366367,1,890293,890827,+,534
454,NZ_CP042444,1,415825,416363,-,538
454,NZ_CP046922,1,547671,548208,+,537
454,NZ_OX366399,1,745130,745667,+,537
454,NZ_OX366342,1,1429966,1430490,-,524
454,NZ_OX366356,1,653418,653968,-,550
454,NZ_OX366357,1,615518,616055,+,537
454,NZ_CP072012,1,514244,514782,-,538
454,NC_002978,6,415324,415862,-,538
454,NZ_OX366397,1,821446,821984,-,538
454,NZ_CP090903,1,415324,415862,-,538
454,NZ_CP090901,1,415324,415862,-,538
454,NZ_CP046923,1,463919,464456,+,537
454,NZ_CP069055,1,453040,453578,-,538
454,NZ_CP072670,1,415164,415702,-,538
454,NZ_CP090899,1,415324,415862,-,538
454,NZ_CP046924,1,484857,485394,+,537
454,NZ_OX366348,1,514364,514901,+,537
454,NZ_CP046921,1,547671,548208,+,537
454,NZ_CP054557,1,163018,163556,-,538
454,NZ_CP072669,1,415172,415710,-,538
454,NC_021089,1,474283,474820,+,537
455,NZ_OX366376,1,1422382,1426268,+,3886
455,NZ_OX366393,1,1209852,1213738,+,3886
455,NZ_OX366372,1,982876,986762,+,3886
455,NZ_CP072672,1,411310,415189,-,3879
455,NZ_CP069060,1,399925,403804,-,3879
455,NZ_CP072667,1,411292,415171,-,3879
455,NZ_CP072671,1,411292,415171,-,3879
455,NZ_CP072668,1,411279,415158,-,3879
455,NZ_CP072666,1,411292,415171,-,3879
455,NZ_CP090902,1,411444,415323,-,3879
455,NZ_CP090948,1,411444,415323,-,3879
455,NZ_CP069052,1,467615,471494,+,3879
455,NZ_CP076228,1,297693,301572,+,3879
455,NZ_CP042445,1,411444,415323,-,3879
455,NZ_CP042904,1,333172,337047,+,3875
455,NC_012416,1,334263,338138,+,3875
455,NZ_CP069053,1,143473,147352,+,3879
455,NZ_CP042446,1,411444,415323,-,3879
455,NZ_CP041215,1,1169186,1173065,-,3879
455,NZ_OX366353,1,386213,390092,-,3879
455,NZ_OX366387,1,1137845,1141847,+,4002
455,NZ_OX366368,1,818592,822471,+,3879
455,NZ_OX366379,1,776085,779964,+,3879
455,NZ_CP091195,1,189587,193458,-,3871
455,NZ_OX366375,1,517308,521405,-,4097
455,NZ_CP046925,1,411292,415171,-,3879
455,NZ_OX366318,1,727236,731333,+,4097
455,NZ_OX366319,1,516185,520278,+,4093
455,NZ_OX366332,1,799860,803739,-,3879
455,NZ_CP110359,1,765330,769217,+,3887
455,NZ_OU953855,1,1054839,1058718,-,3879
455,NZ_OX366272,1,454186,458074,-,3888
455,NZ_OX366347,1,924203,928083,-,3880
455,NZ_OU909470,1,565133,569155,+,4022
455,NZ_OX366363,1,180689,184560,-,3871
455,NZ_OX366364,1,664886,668743,-,3857
455,NZ_OX366359,1,615504,619383,+,3879
455,NZ_OX366349,1,562555,566477,-,3922
455,NZ_OX366380,1,1139611,1143633,+,4022
455,NZ_OX366344,1,683917,687799,-,3882
455,NZ_CP090900,1,411444,415323,-,3879
455,NZ_OX366352,1,469491,473370,-,3879
455,NZ_OX366362,1,1335019,1339103,-,4084
455,NZ_OX366400,1,515177,519274,-,4097
455,NZ_OX366327,1,781332,785000,+,3668
455,NZ_OX366367,1,890829,894691,+,3862
455,NZ_CP042444,1,411945,415824,-,3879
455,NZ_OX366326,1,822055,826152,+,4097
455,NZ_CP037426,1,187219,191316,-,4097
455,NZ_OX366339,1,600579,604447,+,3868
455,NZ_OX366355,1,448122,452215,-,4093
455,NZ_CP046922,1,548210,552089,+,3879
455,NZ_OX366370,1,308183,312070,-,3887
455,NZ_OX366385,1,564362,568384,+,4022
455,NZ_OX366399,1,745669,749548,+,3879
455,NZ_OX366395,1,810579,814676,-,4097
455,NZ_OX366396,1,889280,893148,+,3868
455,NZ_OX366351,1,646546,650643,+,4097
455,NZ_OX366381,1,673787,677880,+,4093
455,NZ_OX366342,1,1426079,1429965,-,3886
455,NZ_OX366369,1,740038,744131,-,4093
455,NZ_OX366356,1,649250,653417,-,4167
455,NZ_OX366377,1,939840,943724,+,3884
455,NZ_OX366388,1,610268,614139,-,3871
455,NZ_OX366357,1,616057,620158,+,4101
455,NZ_CP072012,1,510364,514243,-,3879
455,NZ_OX366398,1,173198,177082,-,3884
455,NC_002978,6,411444,415323,-,3879
455,NZ_OX366389,1,845182,849066,+,3884
455,NZ_OX366397,1,817566,821445,-,3879
455,NZ_OX366378,1,369694,373565,+,3871
455,NZ_CP090903,1,411444,415323,-,3879
455,NZ_OX366374,1,493059,497147,+,4088
455,NZ_CP090901,1,411444,415323,-,3879
455,NZ_CP046923,1,464458,468337,+,3879
455,NZ_CP069055,1,449160,453039,-,3879
455,NZ_CP072670,1,411284,415163,-,3879
455,NZ_CP090899,1,411444,415323,-,3879
455,NZ_CP046924,1,485396,489275,+,3879
455,NZ_OX366348,1,514903,519004,+,4101
455,NZ_CP046921,1,548210,552089,+,3879
455,NZ_OX366338,1,539632,543728,-,4096
455,NZ_CP054557,1,158916,163017,-,4101
455,NZ_CP072669,1,411292,415171,-,3879
455,NC_021089,1,474822,478701,+,3879
456,NZ_OX366376,1,1426269,1426877,+,608
456,NZ_OX366393,1,1213739,1214347,+,608
456,NZ_OX366372,1,986763,987371,+,608
456,NZ_CP072672,1,410700,411308,-,608
456,NZ_CP069060,1,399315,399923,-,608
456,NZ_CP072667,1,410682,411290,-,608
456,NZ_CP072671,1,410682,411290,-,608
456,NZ_CP072668,1,410669,411277,-,608
456,NZ_CP072666,1,410682,411290,-,608
456,NZ_CP090902,1,410834,411442,-,608
456,NZ_CP090948,1,410834,411442,-,608
456,NZ_CP069052,1,471495,472103,+,608
456,NZ_CP076228,1,301573,302181,+,608
456,NZ_CP042445,1,410834,411442,-,608
456,NZ_CP042904,1,337048,337656,+,608
456,NC_012416,1,338139,338747,+,608
456,NZ_CP069053,1,147353,147961,+,608
456,NZ_CP042446,1,410834,411442,-,608
456,NZ_CP041215,1,1168585,1169184,-,599
456,NZ_OX366353,1,385612,386211,-,599
456,NZ_OX366387,1,1141848,1142456,+,608
456,NZ_OX366368,1,822472,823080,+,608
456,NZ_OX366379,1,779965,780573,+,608
456,NZ_CP091195,1,188977,189585,-,608
456,NZ_OX366375,1,516698,517306,-,608
456,NZ_CP046925,1,410682,411290,-,608
456,NZ_OX366318,1,731334,731942,+,608
456,NZ_OX366319,1,520279,520887,+,608
456,NZ_OX366332,1,799259,799858,-,599
456,NZ_CP110359,1,769218,769826,+,608
456,NZ_OU953855,1,1054229,1054837,-,608
456,NZ_OX366272,1,453576,454184,-,608
456,NZ_OX366347,1,923593,924201,-,608
456,NZ_OU909470,1,569156,569756,+,600
456,NZ_OX366363,1,180079,180687,-,608
456,NZ_OX366364,1,664276,664884,-,608
456,NZ_OX366359,1,619384,619983,+,599
456,NZ_OX366349,1,561945,562553,-,608
456,NZ_OX366380,1,1143634,1144242,+,608
456,NZ_OX366344,1,683307,683915,-,608
456,NZ_CP090900,1,410834,411442,-,608
456,NZ_OX366352,1,468891,469489,-,598
456,NZ_OX366362,1,1334409,1335017,-,608
456,NZ_OX366400,1,514567,515175,-,608
456,NZ_OX366327,1,785001,785609,+,608
456,NZ_OX366367,1,894692,895300,+,608
456,NZ_CP042444,1,411335,411943,-,608
456,NZ_OX366326,1,826153,826761,+,608
456,NZ_CP037426,1,186609,187217,-,608
456,NZ_OX366339,1,604448,605056,+,608
456,NZ_OX366355,1,447512,448120,-,608
456,NZ_CP046922,1,552090,552698,+,608
456,NZ_OX366370,1,307573,308181,-,608
456,NZ_OX366385,1,568385,568993,+,608
456,NZ_OX366399,1,749549,750157,+,608
456,NZ_OX366395,1,809978,810577,-,599
456,NZ_OX366396,1,893149,893877,+,728
456,NZ_OX366351,1,650644,651252,+,608
456,NZ_OX366381,1,677881,678489,+,608
456,NZ_OX366342,1,1425469,1426077,-,608
456,NZ_OX366369,1,739428,740036,-,608
456,NZ_OX366356,1,648640,649248,-,608
456,NZ_OX366377,1,943725,944333,+,608
456,NZ_OX366388,1,609658,610266,-,608
456,NZ_OX366357,1,620159,620767,+,608
456,NZ_CP072012,1,509650,510362,-,712
456,NZ_OX366398,1,172588,173196,-,608
456,NC_002978,6,410834,411442,-,608
456,NZ_OX366389,1,849067,849675,+,608
456,NZ_OX366397,1,816965,817564,-,599
456,NZ_OX366378,1,373566,374174,+,608
456,NZ_CP090903,1,410834,411442,-,608
456,NZ_CP090901,1,410834,411442,-,608
456,NZ_CP046923,1,468338,468946,+,608
456,NZ_CP069055,1,448550,449158,-,608
456,NZ_CP072670,1,410674,411282,-,608
456,NZ_CP090899,1,410834,411442,-,608
456,NZ_CP046924,1,489276,489884,+,608
456,NZ_OX366348,1,519005,519613,+,608
456,NZ_CP046921,1,552090,552698,+,608
456,NZ_OX366338,1,539022,539630,-,608
456,NZ_CP054557,1,158306,158914,-,608
456,NZ_CP072669,1,410682,411290,-,608
456,NC_021089,1,478702,479301,+,599
457,NZ_OX366376,1,1427046,1429324,+,2278
457,NZ_OX366393,1,1214516,1216794,+,2278
457,NZ_OX366372,1,987540,989818,+,2278
457,NZ_CP072672,1,408264,410532,-,2268
457,NZ_CP069060,1,396879,399147,-,2268
457,NZ_CP072667,1,408246,410514,-,2268
457,NZ_CP072671,1,408246,410514,-,2268
457,NZ_CP072668,1,408233,410501,-,2268
457,NZ_CP072666,1,408246,410514,-,2268
457,NZ_CP090902,1,408398,410666,-,2268
457,NZ_CP090948,1,408398,410666,-,2268
457,NZ_CP069052,1,472272,474540,+,2268
457,NZ_CP076228,1,302350,304618,+,2268
457,NZ_CP042445,1,408398,410666,-,2268
457,NZ_CP042904,1,337825,340093,+,2268
457,NC_012416,1,338916,341184,+,2268
457,NZ_CP069053,1,148130,150398,+,2268
457,NZ_CP042446,1,408398,410666,-,2268
457,NZ_CP041215,1,1166149,1168417,-,2268
457,NZ_OX366353,1,383176,385444,-,2268
457,NZ_OX366387,1,1142625,1144902,+,2277
457,NZ_OX366368,1,823249,825517,+,2268
457,NZ_OX366379,1,780742,783010,+,2268
457,NZ_CP091195,1,186533,188809,-,2276
457,NZ_OX366375,1,514253,516530,-,2277
457,NZ_CP046925,1,408246,410514,-,2268
457,NZ_OX366318,1,732111,734388,+,2277
457,NZ_OX366319,1,521056,523321,+,2265
457,NZ_OX366332,1,796823,799091,-,2268
457,NZ_CP110359,1,769995,772271,+,2276
457,NZ_OU953855,1,1051785,1054061,-,2276
457,NZ_OX366272,1,451132,453408,-,2276
457,NZ_OX366347,1,921149,923425,-,2276
457,NZ_OU909470,1,569925,572155,+,2230
457,NZ_OX366363,1,177643,179911,-,2268
457,NZ_OX366364,1,661824,664108,-,2284
457,NZ_OX366359,1,620152,622420,+,2268
457,NZ_OX366349,1,559499,561777,-,2278
457,NZ_OX366380,1,1144411,1146679,+,2268
457,NZ_OX366344,1,680861,683139,-,2278
457,NZ_CP090900,1,408398,410666,-,2268
457,NZ_OX366352,1,466455,468723,-,2268
457,NZ_OX366362,1,1331973,1334241,-,2268
457,NZ_OX366400,1,512122,514399,-,2277
457,NZ_OX366327,1,785778,788055,+,2277
457,NZ_OX366367,1,895469,897753,+,2284
457,NZ_CP042444,1,408899,411167,-,2268
457,NZ_OX366326,1,826930,829207,+,2277
457,NZ_CP037426,1,184164,186441,-,2277
457,NZ_OX366339,1,605225,607487,+,2262
457,NZ_OX366355,1,445067,447344,-,2277
457,NZ_CP046922,1,552867,555135,+,2268
457,NZ_OX366370,1,305126,307405,-,2279
457,NZ_OX366385,1,569162,571430,+,2268
457,NZ_OX366399,1,750326,752594,+,2268
457,NZ_OX366395,1,807533,809810,-,2277
457,NZ_OX366396,1,895666,897928,+,2262
457,NZ_OX366351,1,651421,653698,+,2277
457,NZ_OX366381,1,678658,680935,+,2277
457,NZ_OX366342,1,1423023,1425301,-,2278
457,NZ_OX366369,1,736983,739260,-,2277
457,NZ_OX366356,1,646195,648472,-,2277
457,NZ_OX366377,1,944502,946770,+,2268
457,NZ_OX366388,1,607214,609490,-,2276
457,NZ_OX366357,1,620936,623205,+,2269
457,NZ_CP072012,1,507214,509482,-,2268
457,NZ_OX366398,1,170152,172420,-,2268
457,NC_002978,6,408398,410666,-,2268
457,NZ_OX366389,1,849844,852112,+,2268
457,NZ_OX366397,1,814529,816797,-,2268
457,NZ_OX366378,1,374343,376619,+,2276
457,NZ_CP090903,1,408398,410666,-,2268
457,NZ_OX366374,1,1183629,1185877,+,2248
457,NZ_CP090901,1,408398,410666,-,2268
457,NZ_CP046923,1,469115,471383,+,2268
457,NZ_CP069055,1,446114,448382,-,2268
457,NZ_CP072670,1,408238,410506,-,2268
457,NZ_CP090899,1,408398,410666,-,2268
457,NZ_CP046924,1,490053,492321,+,2268
457,NZ_OX366348,1,519782,522059,+,2277
457,NZ_CP046921,1,552867,555135,+,2268
457,NZ_OX366338,1,536578,538854,-,2276
457,NZ_CP054557,1,155861,158138,-,2277
457,NZ_CP072669,1,408246,410514,-,2268
457,NC_021089,1,479470,481738,+,2268
458,NZ_OX366376,1,1429747,1430649,+,902
458,NZ_OX366393,1,1217217,1218119,+,902
458,NZ_OX366372,1,990241,991143,+,902
458,NZ_CP072672,1,406971,407873,-,902
458,NZ_CP069060,1,395586,396488,-,902
458,NZ_CP072667,1,406953,407855,-,902
458,NZ_CP072671,1,406953,407855,-,902
458,NZ_CP072668,1,406940,407842,-,902
458,NZ_CP072666,1,406953,407855,-,902
458,NZ_CP090902,1,407105,408007,-,902
458,NZ_CP090948,1,407105,408007,-,902
458,NZ_CP069052,1,474931,475833,+,902
458,NZ_CP076228,1,305035,305937,+,902
458,NZ_CP042445,1,407105,408007,-,902
458,NZ_CP042904,1,340485,341386,+,901
458,NC_012416,1,341576,342477,+,901
458,NZ_CP069053,1,150789,151691,+,902
458,NZ_CP042446,1,407105,408007,-,902
458,NZ_CP041215,1,1164838,1165739,-,901
458,NZ_OX366353,1,381852,382753,-,901
458,NZ_OX366387,1,1145325,1146227,+,902
458,NZ_OX366368,1,825908,826810,+,902
458,NZ_OX366379,1,783401,784303,+,902
458,NZ_CP091195,1,185208,186110,-,902
458,NZ_OX366375,1,512960,513862,-,902
458,NZ_CP046925,1,406953,407855,-,902
458,NZ_OX366318,1,734780,735681,+,901
458,NZ_OX366319,1,523724,524626,+,902
458,NZ_OX366332,1,795512,796413,-,901
458,NZ_CP110359,1,772694,773596,+,902
458,NZ_OU953855,1,1050460,1051362,-,902
458,NZ_OX366272,1,449807,450709,-,902
458,NZ_OX366347,1,919824,920726,-,902
458,NZ_OU909470,1,572578,573480,+,902
458,NZ_OX366363,1,176350,177251,-,901
458,NZ_OX366364,1,660527,661406,-,879
458,NZ_OX366359,1,622830,623731,+,901
458,NZ_OX366349,1,558182,559084,-,902
458,NZ_OX366380,1,1147102,1148004,+,902
458,NZ_OX366344,1,679536,680438,-,902
458,NZ_CP090900,1,407105,408007,-,902
458,NZ_OX366352,1,465144,466045,-,901
458,NZ_OX366362,1,645088,645969,-,881
458,NZ_OX366400,1,510829,511730,-,901
458,NZ_OX366327,1,788447,789348,+,901
458,NZ_OX366367,1,898171,899066,+,895
458,NZ_CP042444,1,407606,408508,-,902
458,NZ_OX366326,1,829599,830500,+,901
458,NZ_CP037426,1,182871,183773,-,902
458,NZ_OX366339,1,610798,611700,+,902
458,NZ_OX366355,1,443774,444676,-,902
458,NZ_CP046922,1,555526,556428,+,902
458,NZ_OX366370,1,303809,304711,-,902
458,NZ_OX366385,1,571853,572755,+,902
458,NZ_OX366399,1,752985,753887,+,902
458,NZ_OX366395,1,805999,806901,-,902
458,NZ_OX366396,1,1066431,1067333,+,902
458,NZ_OX366351,1,654090,654991,+,901
458,NZ_OX366381,1,681339,682241,+,902
458,NZ_OX366342,1,1421698,1422600,-,902
458,NZ_OX366369,1,735690,736592,-,902
458,NZ_OX366356,1,644870,645772,-,902
458,NZ_OX366377,1,947162,948063,+,901
458,NZ_OX366388,1,605889,606791,-,902
458,NZ_OX366357,1,765738,766640,+,902
458,NZ_CP072012,1,505921,506823,-,902
458,NZ_OX366398,1,168859,169760,-,901
458,NC_002978,6,407105,408007,-,902
458,NZ_OX366389,1,852504,853405,+,901
458,NZ_OX366397,1,813218,814119,-,901
458,NZ_OX366378,1,377042,377944,+,902
458,NZ_CP090903,1,407105,408007,-,902
458,NZ_OX366374,1,295393,296295,+,902
458,NZ_CP090901,1,407105,408007,-,902
458,NZ_CP046923,1,471774,472676,+,902
458,NZ_CP069055,1,444821,445723,-,902
458,NZ_CP072670,1,406945,407847,-,902
458,NZ_CP090899,1,407105,408007,-,902
458,NZ_CP046924,1,492712,493614,+,902
458,NZ_OX366348,1,522290,523191,+,901
458,NZ_CP046921,1,555526,556428,+,902
458,NZ_OX366338,1,524735,525637,+,902
458,NZ_CP054557,1,154568,155469,-,901
458,NZ_CP072669,1,406953,407855,-,902
458,NC_021089,1,482148,483049,+,901
459,NZ_OX366376,1,1430767,1432054,+,1287
459,NZ_OX366393,1,1218237,1219524,+,1287
459,NZ_OX366372,1,991261,992548,+,1287
459,NZ_CP072672,1,405623,406853,-,1230
459,NZ_CP069060,1,394238,395468,-,1230
459,NZ_CP072667,1,405605,406835,-,1230
459,NZ_CP072671,1,405605,406835,-,1230
459,NZ_CP072668,1,405592,406822,-,1230
459,NZ_CP072666,1,405605,406835,-,1230
459,NZ_CP090902,1,405757,406987,-,1230
459,NZ_CP090948,1,405757,406987,-,1230
459,NZ_CP069052,1,475951,477181,+,1230
459,NZ_CP076228,1,306055,307285,+,1230
459,NZ_CP042445,1,405757,406987,-,1230
459,NZ_CP042904,1,341504,342734,+,1230
459,NC_012416,1,342595,343825,+,1230
459,NZ_CP069053,1,151809,153039,+,1230
459,NZ_CP042446,1,405757,406987,-,1230
459,NZ_CP041215,1,1163490,1164720,-,1230
459,NZ_OX366353,1,380504,381734,-,1230
459,NZ_OX366387,1,1146345,1147575,+,1230
459,NZ_OX366368,1,826928,828158,+,1230
459,NZ_OX366379,1,784421,785651,+,1230
459,NZ_CP091195,1,183860,185090,-,1230
459,NZ_OX366375,1,511612,512842,-,1230
459,NZ_CP046925,1,405605,406835,-,1230
459,NZ_OX366318,1,735799,737029,+,1230
459,NZ_OX366319,1,524744,525974,+,1230
459,NZ_OX366332,1,794164,795394,-,1230
459,NZ_CP110359,1,773714,774944,+,1230
459,NZ_OU953855,1,1049112,1050342,-,1230
459,NZ_OX366272,1,448459,449689,-,1230
459,NZ_OX366347,1,918476,919706,-,1230
459,NZ_OU909470,1,578310,579496,+,1186
459,NZ_OX366363,1,175002,176232,-,1230
459,NZ_OX366364,1,659157,660387,-,1230
459,NZ_OX366359,1,623849,625079,+,1230
459,NZ_OX366349,1,556777,558064,-,1287
459,NZ_OX366380,1,1148122,1149352,+,1230
459,NZ_OX366344,1,678131,679418,-,1287
459,NZ_CP090900,1,405757,406987,-,1230
459,NZ_OX366352,1,463796,465026,-,1230
459,NZ_OX366362,1,643738,644968,-,1230
459,NZ_OX366400,1,509481,510711,-,1230
459,NZ_OX366327,1,789466,790696,+,1230
459,NZ_OX366367,1,899190,900420,+,1230
459,NZ_CP042444,1,406258,407488,-,1230
459,NZ_OX366326,1,830618,831848,+,1230
459,NZ_CP037426,1,181523,182753,-,1230
459,NZ_OX366339,1,611818,613048,+,1230
459,NZ_OX366355,1,442426,443656,-,1230
459,NZ_CP046922,1,556546,557776,+,1230
459,NZ_OX366370,1,302404,303691,-,1287
459,NZ_OX366385,1,572873,574103,+,1230
459,NZ_OX366399,1,754005,755235,+,1230
459,NZ_OX366395,1,804651,805881,-,1230
459,NZ_OX366396,1,1067451,1068681,+,1230
459,NZ_OX366351,1,655109,656339,+,1230
459,NZ_OX366381,1,682359,683589,+,1230
459,NZ_OX366342,1,1420293,1421580,-,1287
459,NZ_OX366369,1,734342,735572,-,1230
459,NZ_OX366356,1,643522,644752,-,1230
459,NZ_OX366377,1,948181,949411,+,1230
459,NZ_OX366388,1,604541,605771,-,1230
459,NZ_OX366357,1,766758,767988,+,1230
459,NZ_CP072012,1,504573,505803,-,1230
459,NZ_OX366398,1,167511,168741,-,1230
459,NC_002978,6,405757,406987,-,1230
459,NZ_OX366389,1,853523,854753,+,1230
459,NZ_OX366397,1,811870,813100,-,1230
459,NZ_OX366378,1,378062,379292,+,1230
459,NZ_CP090903,1,405757,406987,-,1230
459,NZ_OX366374,1,296413,297643,+,1230
459,NZ_CP090901,1,405757,406987,-,1230
459,NZ_CP046923,1,472794,474024,+,1230
459,NZ_CP069055,1,443473,444703,-,1230
459,NZ_CP072670,1,405597,406827,-,1230
459,NZ_CP090899,1,405757,406987,-,1230
459,NZ_CP046924,1,493732,494962,+,1230
459,NZ_OX366348,1,523309,524539,+,1230
459,NZ_CP046921,1,556546,557776,+,1230
459,NZ_OX366338,1,525755,526985,+,1230
459,NZ_CP054557,1,153220,154450,-,1230
459,NZ_CP072669,1,405605,406835,-,1230
459,NC_021089,1,483167,484397,+,1230
460,NZ_OX366376,1,1435593,1438251,+,2658
460,NZ_OX366393,1,1223063,1225721,+,2658
460,NZ_OX366372,1,996087,998745,+,2658
460,NZ_CP072672,1,399678,402336,-,2658
460,NZ_CP069060,1,388293,390951,-,2658
460,NZ_CP072667,1,399660,402318,-,2658
460,NZ_CP072671,1,399660,402318,-,2658
460,NZ_CP072668,1,399647,402305,-,2658
460,NZ_CP072666,1,399660,402318,-,2658
460,NZ_CP090902,1,399812,402470,-,2658
460,NZ_CP090948,1,399812,402470,-,2658
460,NZ_CP069052,1,480468,483126,+,2658
460,NZ_CP076228,1,310572,313230,+,2658
460,NZ_CP042445,1,399812,402470,-,2658
460,NZ_CP042904,1,346021,348655,+,2634
460,NC_012416,1,347112,349746,+,2634
460,NZ_CP069053,1,156326,158984,+,2658
460,NZ_CP042446,1,399812,402470,-,2658
460,NZ_CP041215,1,1157366,1160024,-,2658
460,NZ_OX366353,1,374380,377038,-,2658
460,NZ_OX366387,1,1151012,1153670,+,2658
460,NZ_OX366368,1,831445,834103,+,2658
460,NZ_OX366379,1,788938,791596,+,2658
460,NZ_CP091195,1,177638,180320,-,2682
460,NZ_OX366375,1,505395,508053,-,2658
460,NZ_CP046925,1,399660,402318,-,2658
460,NZ_OX366318,1,740609,743267,+,2658
460,NZ_OX366319,1,529411,532069,+,2658
460,NZ_OX366332,1,788040,790698,-,2658
460,NZ_CP110359,1,778485,781143,+,2658
460,NZ_OU953855,1,1042805,1045487,-,2682
460,NZ_OX366272,1,913439,916121,-,2682
460,NZ_OX366347,1,912169,914851,-,2682
460,NZ_OU909470,1,584013,586647,+,2634
460,NZ_OX366363,1,168779,171461,-,2682
460,NZ_OX366364,1,653065,655610,-,2545
460,NZ_OX366359,1,628545,631203,+,2658
460,NZ_OX366349,1,550571,553229,-,2658
460,NZ_OX366380,1,1153034,1155692,+,2658
460,NZ_OX366344,1,671447,674105,-,2658
460,NZ_CP090900,1,399812,402470,-,2658
460,NZ_OX366352,1,457672,460330,-,2658
460,NZ_OX366362,1,637545,640196,-,2651
460,NZ_OX366400,1,503243,505901,-,2658
460,NZ_OX366327,1,794022,796647,+,2625
460,NZ_OX366367,1,904004,906562,+,2558
460,NZ_CP042444,1,400313,402971,-,2658
460,NZ_OX366326,1,835428,838086,+,2658
460,NZ_CP037426,1,175327,177985,-,2658
460,NZ_OX366339,1,616566,619224,+,2658
460,NZ_OX366355,1,436331,438989,-,2658
460,NZ_CP046922,1,561063,563721,+,2658
460,NZ_OX366370,1,296276,298922,-,2646
460,NZ_OX366385,1,577785,580443,+,2658
460,NZ_OX366399,1,758522,761180,+,2658
460,NZ_OX366395,1,798350,801008,-,2658
460,NZ_OX366396,1,1072199,1074857,+,2658
460,NZ_OX366351,1,659919,662577,+,2658
460,NZ_OX366381,1,687026,689684,+,2658
460,NZ_OX366342,1,1414096,1416754,-,2658
460,NZ_OX366369,1,728247,730905,-,2658
460,NZ_OX366356,1,637323,639981,-,2658
460,NZ_OX366377,1,952952,955610,+,2658
460,NZ_OX366388,1,598319,601001,-,2682
460,NZ_OX366357,1,772733,775391,+,2658
460,NZ_CP072012,1,498628,501286,-,2658
460,NZ_OX366398,1,161312,163970,-,2658
460,NC_002978,6,399812,402470,-,2658
460,NZ_OX366389,1,858294,860952,+,2658
460,NZ_OX366397,1,805746,808404,-,2658
460,NZ_OX366378,1,382832,385514,+,2682
460,NZ_CP090903,1,399812,402470,-,2658
460,NZ_OX366374,1,301188,303845,+,2657
460,NZ_CP090901,1,399812,402470,-,2658
460,NZ_CP046923,1,477311,479969,+,2658
460,NZ_CP069055,1,437528,440186,-,2658
460,NZ_CP072670,1,399652,402310,-,2658
460,NZ_CP090899,1,399812,402470,-,2658
460,NZ_CP046924,1,498249,500907,+,2658
460,NZ_OX366348,1,528119,530777,+,2658
460,NZ_CP046921,1,561063,563721,+,2658
460,NZ_OX366338,1,530257,532938,+,2681
460,NZ_CP054557,1,146982,149640,-,2658
460,NZ_CP072669,1,399660,402318,-,2658
460,NC_021089,1,487863,490521,+,2658
461,NZ_OX366376,1,1438611,1439998,+,1387
461,NZ_OX366393,1,1226081,1227468,+,1387
461,NZ_OX366372,1,999105,1000492,+,1387
461,NZ_CP072672,1,396453,397871,-,1418
461,NZ_CP069060,1,385067,386485,-,1418
461,NZ_CP072667,1,396435,397853,-,1418
461,NZ_CP072671,1,396435,397853,-,1418
461,NZ_CP072668,1,396422,397840,-,1418
461,NZ_CP072666,1,396435,397853,-,1418
461,NZ_CP090902,1,396587,398005,-,1418
461,NZ_CP090948,1,396587,398005,-,1418
461,NZ_CP069052,1,484934,486352,+,1418
461,NZ_CP076228,1,315038,316456,+,1418
461,NZ_CP042445,1,396587,398005,-,1418
461,NZ_CP042904,1,350463,351881,+,1418
461,NC_012416,1,351554,352972,+,1418
461,NZ_CP069053,1,160792,162210,+,1418
461,NZ_CP042446,1,396587,398005,-,1418
461,NZ_CP041215,1,1154146,1155558,-,1412
461,NZ_OX366353,1,371160,372572,-,1412
461,NZ_OX366387,1,1155476,1156894,+,1418
461,NZ_OX366368,1,835911,837329,+,1418
461,NZ_OX366379,1,793404,794822,+,1418
461,NZ_CP091195,1,174416,175834,-,1418
461,NZ_OX366375,1,502169,503587,-,1418
461,NZ_CP046925,1,396435,397853,-,1418
461,NZ_OX366318,1,745075,746493,+,1418
461,NZ_OX366319,1,533877,535294,+,1417
461,NZ_OX366332,1,784820,786232,-,1412
461,NZ_CP110359,1,782951,784369,+,1418
461,NZ_OU953855,1,75959,77377,-,1418
461,NZ_OX366272,1,1053921,1055332,+,1411
461,NZ_OX366347,1,908943,910361,-,1418
461,NZ_OU909470,1,586981,588368,+,1387
461,NZ_OX366363,1,165559,166971,-,1412
461,NZ_OX366364,1,651264,652698,-,1434
461,NZ_OX366359,1,633011,634423,+,1412
461,NZ_OX366349,1,548824,550211,-,1387
461,NZ_OX366380,1,1157518,1158888,+,1370
461,NZ_OX366344,1,669700,671087,-,1387
461,NZ_CP090900,1,396587,398005,-,1418
461,NZ_OX366352,1,454452,455864,-,1412
461,NZ_OX366362,1,911538,912942,-,1404
461,NZ_OX366400,1,500017,501435,-,1418
461,NZ_OX366327,1,798458,799874,+,1416
461,NZ_OX366367,1,907051,908519,+,1468
461,NZ_CP042444,1,397088,398506,-,1418
461,NZ_OX366326,1,839894,841312,+,1418
461,NZ_CP037426,1,172101,173519,-,1418
461,NZ_OX366339,1,621032,622450,+,1418
461,NZ_OX366355,1,433105,434523,-,1418
461,NZ_CP046922,1,565528,566946,+,1418
461,NZ_OX366370,1,294781,296174,-,1393
461,NZ_OX366385,1,582269,583639,+,1370
461,NZ_OX366399,1,762988,764406,+,1418
461,NZ_OX366395,1,794876,796292,-,1416
461,NZ_OX366396,1,1076665,1078083,+,1418
461,NZ_OX366351,1,664385,665803,+,1418
461,NZ_OX366381,1,691492,692910,+,1418
461,NZ_OX366342,1,1412349,1413736,-,1387
461,NZ_OX366369,1,725021,726439,-,1418
461,NZ_OX366356,1,633993,635515,-,1522
461,NZ_OX366377,1,957418,958836,+,1418
461,NZ_OX366388,1,595093,596511,-,1418
461,NZ_OX366357,1,777264,778680,+,1416
461,NZ_CP072012,1,495402,496820,-,1418
461,NZ_OX366398,1,158086,159504,-,1418
461,NC_002978,6,396587,398005,-,1418
461,NZ_OX366389,1,862760,864178,+,1418
461,NZ_OX366397,1,802526,803938,-,1412
461,NZ_OX366378,1,387322,388740,+,1418
461,NZ_CP090903,1,396587,398005,-,1418
461,NZ_OX366374,1,306506,307924,+,1418
461,NZ_CP090901,1,396587,398005,-,1418
461,NZ_CP046923,1,481776,483194,+,1418
461,NZ_CP069055,1,434302,435720,-,1418
461,NZ_CP072670,1,396427,397845,-,1418
461,NZ_CP090899,1,396587,398005,-,1418
461,NZ_CP046924,1,502714,504132,+,1418
461,NZ_OX366348,1,532585,534003,+,1418
461,NZ_CP046921,1,565528,566946,+,1418
461,NZ_OX366338,1,839768,841186,+,1418
461,NZ_CP054557,1,143756,145174,-,1418
461,NZ_CP072669,1,396435,397853,-,1418
461,NC_021089,1,492329,493741,+,1412
462,NZ_OX366376,1,1440142,1441645,+,1503
462,NZ_OX366393,1,1227612,1229115,+,1503
462,NZ_OX366372,1,1000636,1002139,+,1503
462,NZ_CP072672,1,394171,395664,-,1493
462,NZ_CP069060,1,382785,384278,-,1493
462,NZ_CP072667,1,394153,395646,-,1493
462,NZ_CP072671,1,394153,395646,-,1493
462,NZ_CP072668,1,394140,395633,-,1493
462,NZ_CP072666,1,394153,395646,-,1493
462,NZ_CP090902,1,394305,395798,-,1493
462,NZ_CP090948,1,394305,395798,-,1493
462,NZ_CP069052,1,487141,488634,+,1493
462,NZ_CP076228,1,316539,318032,+,1493
462,NZ_CP042445,1,394305,395798,-,1493
462,NZ_CP042904,1,352336,353829,+,1493
462,NC_012416,1,353427,354920,+,1493
462,NZ_CP069053,1,162999,164492,+,1493
462,NZ_CP042446,1,394305,395798,-,1493
462,NZ_CP041215,1,1152235,1153728,-,1493
462,NZ_OX366353,1,369249,370742,-,1493
462,NZ_OX366387,1,1158765,1160258,+,1493
462,NZ_OX366368,1,838118,839611,+,1493
462,NZ_OX366379,1,795611,797104,+,1493
462,NZ_CP091195,1,171085,172579,-,1494
462,NZ_OX366375,1,499887,501380,-,1493
462,NZ_CP046925,1,394153,395646,-,1493
462,NZ_OX366318,1,747282,748775,+,1493
462,NZ_OX366319,1,536083,537576,+,1493
462,NZ_OX366332,1,782909,784402,-,1493
462,NZ_CP110359,1,784452,785945,+,1493
462,NZ_OU953855,1,1510098,1511591,-,1493
462,NZ_OX366272,1,826052,827545,+,1493
462,NZ_OX366347,1,907367,908860,-,1493
462,NZ_OU909470,1,588512,590015,+,1503
462,NZ_OX366363,1,161868,163361,-,1493
462,NZ_OX366364,1,292201,293704,+,1503
462,NZ_OX366359,1,634841,636334,+,1493
462,NZ_OX366349,1,547177,548680,-,1503
462,NZ_OX366380,1,1158971,1160445,+,1474
462,NZ_OX366344,1,668053,669556,-,1503
462,NZ_CP090900,1,394305,395798,-,1493
462,NZ_OX366352,1,452541,454034,-,1493
462,NZ_OX366362,1,831798,833301,-,1503
462,NZ_OX366400,1,497735,499228,-,1493
462,NZ_OX366327,1,800329,801822,+,1493
462,NZ_OX366367,1,908940,910443,+,1503
462,NZ_CP042444,1,394806,396299,-,1493
462,NZ_OX366326,1,842101,843594,+,1493
462,NZ_CP037426,1,169819,171312,-,1493
462,NZ_OX366339,1,409401,410894,+,1493
462,NZ_OX366355,1,430823,432316,-,1493
462,NZ_CP046922,1,567735,569228,+,1493
462,NZ_OX366370,1,293134,294637,-,1503
462,NZ_OX366385,1,583722,585196,+,1474
462,NZ_OX366399,1,765195,766688,+,1493
462,NZ_OX366395,1,792971,794464,-,1493
462,NZ_OX366396,1,1128912,1130405,+,1493
462,NZ_OX366351,1,666592,668085,+,1493
462,NZ_OX366381,1,693699,695192,+,1493
462,NZ_OX366342,1,1410702,1412205,-,1503
462,NZ_OX366369,1,722739,724232,-,1493
462,NZ_OX366356,1,630688,632181,-,1493
462,NZ_OX366377,1,959625,961118,+,1493
462,NZ_OX366388,1,592419,593913,-,1494
462,NZ_OX366357,1,779048,780541,+,1493
462,NZ_CP072012,1,493120,494613,-,1493
462,NZ_OX366398,1,155804,157297,-,1493
462,NC_002978,6,394305,395798,-,1493
462,NZ_OX366389,1,864924,866417,+,1493
462,NZ_OX366397,1,800615,802108,-,1493
462,NZ_OX366378,1,390577,392071,+,1494
462,NZ_CP090903,1,394305,395798,-,1493
462,NZ_OX366374,1,308007,309500,+,1493
462,NZ_CP090901,1,394305,395798,-,1493
462,NZ_CP046923,1,483983,485476,+,1493
462,NZ_CP069055,1,432020,433513,-,1493
462,NZ_CP072670,1,394145,395638,-,1493
462,NZ_CP090899,1,394305,395798,-,1493
462,NZ_CP046924,1,504921,506414,+,1493
462,NZ_OX366348,1,534792,536285,+,1493
462,NZ_CP046921,1,567735,569228,+,1493
462,NZ_OX366338,1,841619,843112,+,1493
462,NZ_CP054557,1,141474,142967,-,1493
462,NZ_CP072669,1,394153,395646,-,1493
462,NC_021089,1,494159,495652,+,1493
463,NZ_OX366376,1,1444386,1446621,+,2235
463,NZ_OX366380,1,908331,910548,+,2217
464,NZ_OX366376,1,1446882,1447591,+,709
464,NZ_OX366380,1,910560,911275,+,715
465,NZ_OX366376,1,1450317,1450968,+,651
465,NZ_OX366319,1,12013,12664,-,651
465,NZ_OX366319,1,51854,52506,-,652
465,NZ_OX366319,1,69431,70082,-,651
465,NZ_OX366319,1,133730,134381,+,651
465,NZ_OX366319,1,145664,146315,-,651
465,NZ_OX366319,1,247653,248304,-,651
465,NZ_OX366319,1,258062,258713,+,651
465,NZ_OX366319,1,342125,342777,+,652
465,NZ_OX366319,1,365979,366630,-,651
465,NZ_OX366319,1,375787,376438,+,651
465,NZ_OX366319,1,395443,396093,-,650
465,NZ_OX366319,1,409435,410087,+,652
465,NZ_OX366319,1,454442,455073,-,631
465,NZ_OX366319,1,461253,461904,+,651
465,NZ_OX366319,1,464925,465578,-,653
465,NZ_OX366319,1,484068,484720,-,652
465,NZ_OX366319,1,489802,490453,-,651
465,NZ_OX366319,1,549169,549820,+,651
465,NZ_OX366319,1,588511,589160,-,649
465,NZ_OX366319,1,612467,613120,+,653
465,NZ_OX366319,1,654528,655179,-,651
465,NZ_OX366319,1,678094,678745,-,651
465,NZ_OX366319,1,748969,749600,+,631
465,NZ_OX366319,1,867997,868647,+,650
465,NZ_OX366319,1,878481,879132,+,651
465,NZ_OX366319,1,880424,881075,-,651
465,NZ_OX366319,1,936125,936776,-,651
465,NZ_OX366319,1,956027,956678,+,651
465,NZ_OX366319,1,1146624,1147275,+,651
465,NZ_OX366319,1,1210833,1211485,-,652
465,NZ_OX366319,1,1241468,1242119,-,651
465,NZ_CP037426,1,631300,631951,+,651
465,NZ_OX366355,1,55729,56381,-,652
465,NZ_OX366355,1,74310,74961,+,651
465,NZ_OX366355,1,139607,140258,-,651
465,NZ_OX366355,1,170429,171080,+,651
465,NZ_OX366355,1,282318,282969,+,651
465,NZ_OX366355,1,335424,336075,-,651
465,NZ_OX366355,1,351178,351829,-,651
465,NZ_OX366355,1,352655,353306,+,651
465,NZ_OX366355,1,376395,377046,-,651
465,NZ_OX366355,1,383227,383878,+,651
465,NZ_OX366355,1,387877,388530,-,653
465,NZ_OX366355,1,415363,416013,-,650
465,NZ_OX366355,1,476995,477646,+,651
465,NZ_OX366355,1,481313,481965,+,652
465,NZ_OX366355,1,501477,502108,+,631
465,NZ_OX366355,1,548896,549548,-,652
465,NZ_OX366355,1,599493,600144,-,651
465,NZ_OX366355,1,625404,626057,+,653
465,NZ_OX366355,1,721642,722293,-,651
465,NZ_OX366355,1,766508,767157,-,649
465,NZ_OX366355,1,894244,894875,+,631
465,NZ_OX366355,1,982551,983202,+,651
465,NZ_OX366355,1,994140,994791,-,651
465,NZ_OX366355,1,1050064,1050715,-,651
465,NZ_OX366355,1,1051956,1052607,+,651
465,NZ_OX366355,1,1071782,1072433,+,651
465,NZ_OX366355,1,1264714,1265366,+,652
465,NZ_OX366355,1,1333670,1334321,+,651
465,NZ_OX366355,1,1347170,1347821,+,651
465,NZ_OX366381,1,53755,54407,-,652
465,NZ_OX366381,1,135519,136150,+,631
465,NZ_OX366381,1,163335,163986,-,651
465,NZ_OX366381,1,180911,181562,-,651
465,NZ_OX366381,1,245236,245887,+,651
465,NZ_OX366381,1,368085,368736,+,651
465,NZ_OX366381,1,411475,412125,+,650
465,NZ_OX366381,1,453406,454054,+,648
465,NZ_OX366381,1,523206,523857,-,651
465,NZ_OX366381,1,569755,570407,+,652
465,NZ_OX366381,1,614846,615477,-,631
465,NZ_OX366381,1,642624,643274,-,650
465,NZ_OX366381,1,648356,649007,-,651
465,NZ_OX366381,1,710002,710654,+,652
465,NZ_OX366381,1,729296,729949,+,653
465,NZ_OX366381,1,732970,733621,-,651
465,NZ_OX366381,1,739802,740453,+,651
465,NZ_OX366381,1,755733,756384,+,651
465,NZ_OX366381,1,825535,826184,-,649
465,NZ_OX366381,1,829368,830019,-,651
465,NZ_OX366381,1,830845,831496,+,651
465,NZ_OX366381,1,870242,870893,-,651
465,NZ_OX366381,1,886932,887585,+,653
465,NZ_OX366381,1,929093,929744,-,651
465,NZ_OX366381,1,1054733,1055384,+,651
465,NZ_OX366381,1,1060815,1061466,+,651
465,NZ_OX366381,1,1119780,1120432,-,652
465,NZ_OX366381,1,1139683,1140334,+,651
465,NZ_OX366381,1,1328661,1329312,+,651
465,NZ_OX366381,1,1384585,1385236,+,651
465,NZ_OX366381,1,1396174,1396825,-,651
465,NZ_OX366369,1,13921,14572,-,651
465,NZ_OX366369,1,241089,241740,-,651
465,NZ_OX366369,1,315792,316443,+,651
465,NZ_OX366369,1,432945,433596,-,651
465,NZ_OX366369,1,437897,438561,+,664
465,NZ_OX366369,1,563722,564373,+,651
465,NZ_OX366369,1,585288,585940,-,652
465,NZ_OX366369,1,646157,646808,-,651
465,NZ_OX366369,1,833284,833935,-,651
465,NZ_OX366369,1,964636,965288,-,652
465,NZ_OX366369,1,983550,984201,+,651
465,NZ_OX366369,1,1101694,1102345,-,651
465,NZ_OX366369,1,1112636,1113287,-,651
465,NZ_OX366369,1,1274711,1275364,+,653
465,NZ_OX366369,1,1287321,1287973,-,652
465,NZ_OX366369,1,1419002,1419653,-,651
465,NZ_OX366397,1,483149,483800,-,651
466,NZ_OX366376,1,1451777,1453106,+,1329
466,NZ_CP110359,1,613112,614442,-,1330
466,NZ_CP037426,1,634010,635339,+,1329
466,NZ_OX366374,1,1191121,1192459,-,1338
467,NZ_OX366376,1,1454064,1455570,+,1506
467,NZ_CP110359,1,610649,612154,-,1505
467,NZ_CP037426,1,636295,637801,+,1506
467,NZ_OX366374,1,1188658,1190163,-,1505
468,NZ_OX366376,1,1455571,1456150,+,579
468,NZ_CP110359,1,610069,610647,-,578
468,NZ_CP037426,1,637802,638381,+,579
469,NZ_OX366376,1,1470278,1470940,+,662
469,NZ_OX366344,1,777963,778625,+,662
469,NZ_OX366370,1,711841,712503,-,662
470,NZ_OX366376,1,1475497,1476438,+,941
470,NZ_OX366372,1,149078,150018,-,940
470,NZ_OX366372,1,193935,194876,+,941
470,NZ_CP069060,1,1075382,1076332,-,950
470,NZ_CP069060,1,1196149,1197099,-,950
470,NZ_CP069052,1,643068,644018,-,950
470,NZ_CP069053,1,1076334,1077284,-,950
470,NZ_OX366353,1,976846,977793,-,947
470,NZ_OX366387,1,80596,81536,-,940
470,NZ_OX366368,1,585038,585979,+,941
470,NZ_OX366379,1,646169,647110,+,941
470,NZ_CP091195,1,558730,559672,+,942
470,NZ_OX366319,1,294633,295573,-,940
470,NZ_OX366332,1,607762,608703,+,941
470,NZ_OX366347,1,690410,691350,-,940
470,NZ_OX366349,1,1047342,1048282,-,940
470,NZ_OX366352,1,510573,511513,-,940
470,NZ_OX366367,1,357640,358580,-,940
470,NZ_OX366326,1,292835,293776,+,941
470,NZ_OX366395,1,179418,180358,-,940
470,NZ_OX366396,1,136188,137128,-,940
470,NZ_OX366351,1,876885,877826,+,941
470,NZ_OX366381,1,404656,405596,-,940
470,NZ_OX366369,1,1034595,1035537,-,942
470,NZ_OX366388,1,888002,888943,+,941
470,NZ_OX366388,1,1083827,1084768,+,941
470,NZ_CP072012,1,763819,764760,-,941
470,NZ_OX366398,1,1298248,1299189,+,941
470,NZ_OX366397,1,558820,559762,+,942
471,NZ_OX366376,1,1486736,1487618,+,882
471,NZ_OX366393,1,955724,956648,+,924
471,NZ_OX366372,1,1392483,1393407,+,924
471,NZ_CP072672,1,1153595,1154491,+,896
471,NZ_CP069060,1,1004191,1005048,+,857
471,NZ_CP072667,1,1153569,1154465,+,896
471,NZ_CP072671,1,1153577,1154473,+,896
471,NZ_CP072668,1,1153564,1154460,+,896
471,NZ_CP072666,1,1153577,1154473,+,896
471,NZ_CP090902,1,1153729,1154625,+,896
471,NZ_CP090948,1,1153727,1154623,+,896
471,NZ_CP069052,1,992466,993323,-,857
471,NZ_CP076228,1,1172320,1173185,+,865
471,NZ_CP042445,1,1153717,1154613,+,896
471,NZ_CP042904,1,1230694,1231590,+,896
471,NC_012416,1,1275910,1276806,+,896
471,NZ_CP069053,1,1004223,1005080,+,857
471,NZ_CP042446,1,1153727,1154623,+,896
471,NZ_CP041215,1,177525,178421,+,896
471,NZ_OX366353,1,658367,659263,-,896
471,NZ_OX366387,1,193119,194014,+,895
471,NZ_OX366368,1,166773,167669,+,896
471,NZ_OX366379,1,166871,167767,+,896
471,NZ_CP091195,1,1208453,1209349,+,896
471,NZ_OX366375,1,168830,169734,+,904
471,NZ_CP046925,1,1153577,1154473,+,896
471,NZ_OX366318,1,162901,163797,+,896
471,NZ_OX366319,1,1034448,1035352,-,904
471,NZ_OX366332,1,165113,166009,+,896
471,NZ_CP110359,1,1191266,1192162,+,896
471,NZ_OU953855,1,1716965,1717861,+,896
471,NZ_OX366272,1,264035,264931,+,896
471,NZ_OX366347,1,277512,278408,+,896
471,NZ_OU909470,1,721837,722752,+,915
471,NZ_OX366363,1,773195,774085,-,890
471,NZ_OX366364,1,230413,231337,+,924
471,NZ_OX366359,1,164239,165135,+,896
471,NZ_OX366349,1,324242,325166,+,924
471,NZ_OX366380,1,176940,177846,+,906
471,NZ_OX366344,1,263428,264352,+,924
471,NZ_CP090900,1,1153730,1154626,+,896
471,NZ_OX366352,1,1525397,1526293,-,896
471,NZ_OX366362,1,1093913,1094838,-,925
471,NZ_OX366400,1,166020,166916,+,896
471,NZ_OX366327,1,164501,165416,+,915
471,NZ_OX366367,1,1406018,1406942,+,924
471,NZ_CP042444,1,1155083,1155979,+,896
471,NZ_OX366326,1,166623,167519,+,896
471,NZ_CP037426,1,975249,976122,-,873
471,NZ_OX366339,1,1189822,1190718,+,896
471,NZ_OX366355,1,1151223,1152127,-,904
471,NZ_CP046922,1,1215532,1216428,+,896
471,NZ_OX366370,1,1174466,1175390,-,924
471,NZ_OX366385,1,44240,45146,+,906
471,NZ_OX366399,1,166274,167170,+,896
471,NZ_OX366395,1,307448,308344,+,896
471,NZ_OX366396,1,39893,40789,+,896
471,NZ_OX366351,1,241945,242841,-,896
471,NZ_OX366381,1,1218104,1219008,-,904
471,NZ_OX366342,1,327105,328029,-,924
471,NZ_OX366369,1,162292,163196,+,904
471,NZ_OX366356,1,198032,198928,+,896
471,NZ_OX366377,1,168508,169404,+,896
471,NZ_OX366388,1,1610271,1611167,+,896
471,NZ_OX366357,1,394191,395060,+,869
471,NZ_CP072012,1,1149278,1150174,-,896
471,NZ_OX366398,1,815298,816194,+,896
471,NC_002978,6,1153727,1154623,+,896
471,NZ_OX366389,1,83268,84164,-,896
471,NZ_OX366397,1,164811,165707,+,896
471,NZ_OX366378,1,1148995,1149891,-,896
471,NZ_CP090903,1,1153730,1154626,+,896
471,NZ_OX366374,1,107847,108743,+,896
471,NZ_CP090901,1,1153730,1154626,+,896
471,NZ_CP046923,1,1131780,1132676,+,896
471,NZ_CP069055,1,1153685,1154581,+,896
471,NZ_CP072670,1,1153557,1154453,+,896
471,NZ_CP090899,1,1153730,1154626,+,896
471,NZ_CP046924,1,1152718,1153614,+,896
471,NZ_OX366348,1,1084423,1085288,-,865
471,NZ_CP046921,1,1215532,1216428,+,896
471,NZ_OX366338,1,236578,237482,+,904
471,NZ_CP054557,1,651802,652667,-,865
471,NZ_CP072669,1,1153577,1154473,+,896
471,NC_021089,1,1181346,1182242,+,896
472,NZ_OX366376,1,1487619,1489106,+,1487
472,NZ_OX366393,1,956649,958136,+,1487
472,NZ_OX366372,1,1393408,1394895,+,1487
472,NZ_CP072672,1,1154492,1155987,+,1495
472,NZ_CP069060,1,1005049,1006544,+,1495
472,NZ_CP072667,1,1154466,1155961,+,1495
472,NZ_CP072671,1,1154474,1155969,+,1495
472,NZ_CP072668,1,1154461,1155956,+,1495
472,NZ_CP072666,1,1154474,1155969,+,1495
472,NZ_CP090902,1,1154626,1156121,+,1495
472,NZ_CP090948,1,1154624,1156119,+,1495
472,NZ_CP069052,1,990970,992464,-,1494
472,NZ_CP076228,1,1173186,1174698,+,1512
472,NZ_CP042445,1,1154614,1156109,+,1495
472,NZ_CP042904,1,1231591,1233086,+,1495
472,NC_012416,1,1276807,1278302,+,1495
472,NZ_CP069053,1,1005081,1006576,+,1495
472,NZ_CP042446,1,1154624,1156119,+,1495
472,NZ_CP041215,1,178422,179917,+,1495
472,NZ_OX366353,1,656871,658365,-,1494
472,NZ_OX366387,1,194015,195506,+,1491
472,NZ_OX366368,1,167670,169165,+,1495
472,NZ_OX366379,1,167768,169263,+,1495
472,NZ_CP091195,1,1209350,1210845,+,1495
472,NZ_OX366375,1,169735,171230,+,1495
472,NZ_CP046925,1,1154474,1155969,+,1495
472,NZ_OX366318,1,163798,165293,+,1495
472,NZ_OX366319,1,1032952,1034446,-,1494
472,NZ_OX366332,1,166010,167505,+,1495
472,NZ_CP110359,1,1192163,1193658,+,1495
472,NZ_OU953855,1,1717862,1719357,+,1495
472,NZ_OX366272,1,264932,266427,+,1495
472,NZ_OX366347,1,278409,279900,+,1491
472,NZ_OU909470,1,722753,724243,+,1490
472,NZ_OX366363,1,771699,773193,-,1494
472,NZ_OX366364,1,231338,232825,+,1487
472,NZ_OX366359,1,165136,166631,+,1495
472,NZ_OX366349,1,325167,326654,+,1487
472,NZ_OX366380,1,177847,179337,+,1490
472,NZ_OX366344,1,264353,265844,+,1491
472,NZ_CP090900,1,1154627,1156122,+,1495
472,NZ_OX366352,1,1523901,1525395,-,1494
472,NZ_OX366362,1,1092426,1093911,-,1485
472,NZ_OX366400,1,166917,168412,+,1495
472,NZ_OX366327,1,165417,166912,+,1495
472,NZ_OX366367,1,1406943,1408430,+,1487
472,NZ_CP042444,1,1155980,1157475,+,1495
472,NZ_OX366326,1,167520,169015,+,1495
472,NZ_CP037426,1,973753,975247,-,1494
472,NZ_OX366339,1,1190719,1192214,+,1495
472,NZ_OX366355,1,1149727,1151221,-,1494
472,NZ_CP046922,1,1216429,1217924,+,1495
472,NZ_OX366370,1,1172974,1174464,-,1490
472,NZ_OX366385,1,45147,46637,+,1490
472,NZ_OX366399,1,167171,168666,+,1495
472,NZ_OX366395,1,308345,309840,+,1495
472,NZ_OX366396,1,40790,42285,+,1495
472,NZ_OX366351,1,240449,241943,-,1494
472,NZ_OX366381,1,1216608,1218102,-,1494
472,NZ_OX366342,1,325617,327103,-,1486
472,NZ_OX366369,1,163197,164692,+,1495
472,NZ_OX366356,1,198929,200424,+,1495
472,NZ_OX366377,1,169405,170900,+,1495
472,NZ_OX366388,1,1611168,1612663,+,1495
472,NZ_OX366357,1,927154,928664,+,1510
472,NZ_CP072012,1,1147782,1149276,-,1494
472,NZ_OX366398,1,816195,817690,+,1495
472,NC_002978,6,1154624,1156119,+,1495
472,NZ_OX366389,1,81772,83266,-,1494
472,NZ_OX366397,1,165708,167203,+,1495
472,NZ_OX366378,1,1147499,1148993,-,1494
472,NZ_CP090903,1,1154627,1156122,+,1495
472,NZ_OX366374,1,108744,110239,+,1495
472,NZ_CP090901,1,1154627,1156122,+,1495
472,NZ_CP046923,1,1132677,1134172,+,1495
472,NZ_CP069055,1,1154582,1156077,+,1495
472,NZ_CP072670,1,1154454,1155949,+,1495
472,NZ_CP090899,1,1154627,1156122,+,1495
472,NZ_CP046924,1,1153615,1155110,+,1495
472,NZ_OX366348,1,1082927,1084421,-,1494
472,NZ_CP046921,1,1216429,1217924,+,1495
472,NZ_OX366338,1,237483,238978,+,1495
472,NZ_CP054557,1,650306,651800,-,1494
472,NZ_CP072669,1,1154474,1155969,+,1495
472,NC_021089,1,1182243,1183738,+,1495
473,NZ_OX366376,1,1491285,1493991,+,2706
473,NZ_OX366393,1,960313,962986,+,2673
473,NZ_OX366372,1,1396746,1399459,+,2713
473,NZ_CP072672,1,1023941,1026654,+,2713
473,NZ_CP069060,1,869677,872390,+,2713
473,NZ_CP072667,1,1023915,1026628,+,2713
473,NZ_CP072671,1,1023923,1026636,+,2713
473,NZ_CP072668,1,1023910,1026623,+,2713
473,NZ_CP072666,1,1023923,1026636,+,2713
473,NZ_CP090902,1,1024075,1026788,+,2713
473,NZ_CP090948,1,1024073,1026786,+,2713
473,NZ_CP069052,1,783681,786394,-,2713
473,NZ_CP076228,1,885869,888582,+,2713
473,NZ_CP042445,1,1024063,1026776,+,2713
473,NZ_CP042904,1,1146375,1149070,+,2695
473,NC_012416,1,1190100,1192795,+,2695
473,NZ_CP069053,1,869685,872398,+,2713
473,NZ_CP042446,1,1024073,1026786,+,2713
473,NZ_CP041215,1,1413827,1416514,-,2687
473,NZ_OX366353,1,1091112,1093798,-,2686
473,NZ_OX366387,1,40175,42870,+,2695
473,NZ_OX366368,1,35458,38171,+,2713
473,NZ_OX366379,1,35476,38189,+,2713
473,NZ_CP091195,1,76764,79477,-,2713
473,NZ_OX366375,1,36383,39096,+,2713
473,NZ_CP046925,1,1023923,1026636,+,2713
473,NZ_OX366318,1,34631,37344,+,2713
473,NZ_OX366319,1,36211,38924,+,2713
473,NZ_OX366332,1,35927,38614,+,2687
473,NZ_CP110359,1,430989,433702,-,2713
473,NZ_OU953855,1,118608,121321,-,2713
473,NZ_OX366272,1,1169308,1172021,+,2713
473,NZ_OX366347,1,80899,83612,-,2713
473,NZ_OU909470,1,793655,796332,-,2677
473,NZ_OX366363,1,847233,849946,+,2713
473,NZ_OX366364,1,165081,167799,-,2718
473,NZ_OX366359,1,35931,38618,+,2687
473,NZ_OX366349,1,328880,331593,+,2713
473,NZ_OX366380,1,243409,246122,+,2713
473,NZ_OX366344,1,268054,270767,+,2713
473,NZ_CP090900,1,1024075,1026788,+,2713
473,NZ_OX366352,1,38499,41186,+,2687
473,NZ_OX366362,1,211307,214020,+,2713
473,NZ_OX366400,1,136765,139478,-,2713
473,NZ_OX366327,1,36705,39400,+,2695
473,NZ_OX366367,1,1194301,1197014,+,2713
473,NZ_CP042444,1,1025429,1028142,+,2713
473,NZ_OX366326,1,37960,40673,+,2713
473,NZ_CP037426,1,1283801,1286514,+,2713
473,NZ_OX366339,1,1115672,1118357,-,2685
473,NZ_OX366355,1,40008,42721,+,2713
473,NZ_CP046922,1,1085971,1088684,+,2713
473,NZ_OX366370,1,1167099,1169812,-,2713
473,NZ_OX366385,1,878389,881102,+,2713
473,NZ_OX366399,1,35454,38167,+,2713
473,NZ_OX366395,1,52134,54847,-,2713
473,NZ_OX366396,1,1445315,1448010,-,2695
473,NZ_OX366351,1,42873,45586,+,2713
473,NZ_OX366381,1,38034,40747,+,2713
473,NZ_OX366342,1,320704,323417,-,2713
473,NZ_OX366369,1,37024,39737,+,2713
473,NZ_OX366356,1,34299,37117,+,2818
473,NZ_OX366377,1,35064,37777,+,2713
473,NZ_OX366388,1,185888,188601,+,2713
473,NZ_OX366357,1,808311,811023,-,2712
473,NZ_CP072012,1,1286143,1288856,+,2713
473,NZ_OX366398,1,506423,509136,+,2713
473,NC_002978,6,1024073,1026786,+,2713
473,NZ_OX366389,1,214579,217292,-,2713
473,NZ_OX366397,1,64569,67256,-,2687
473,NZ_OX366378,1,1137292,1140005,+,2713
473,NZ_CP090903,1,1024075,1026788,+,2713
473,NZ_OX366374,1,453473,456178,+,2705
473,NZ_CP090901,1,1024075,1026788,+,2713
473,NZ_CP046923,1,1002219,1004932,+,2713
473,NZ_CP069055,1,975301,978014,+,2713
473,NZ_CP072670,1,1023915,1026628,+,2713
473,NZ_CP090899,1,1024075,1026788,+,2713
473,NZ_CP046924,1,1023157,1025870,+,2713
473,NZ_OX366348,1,35226,37939,+,2713
473,NZ_CP046921,1,1085971,1088684,+,2713
473,NZ_OX366338,1,34879,37592,+,2713
473,NZ_CP054557,1,817274,819987,+,2713
473,NZ_CP072669,1,1023923,1026636,+,2713
473,NC_021089,1,1052276,1054963,+,2687
474,NZ_OX366376,1,1494096,1494684,+,588
474,NZ_OX366393,1,1444116,1444704,+,588
474,NZ_OX366372,1,1399564,1400152,+,588
474,NZ_CP072672,1,1026749,1027338,+,589
474,NZ_CP069060,1,872485,873074,+,589
474,NZ_CP072667,1,1026723,1027312,+,589
474,NZ_CP072671,1,1026731,1027320,+,589
474,NZ_CP072668,1,1026718,1027307,+,589
474,NZ_CP072666,1,1026731,1027320,+,589
474,NZ_CP090902,1,1026883,1027472,+,589
474,NZ_CP090948,1,1026881,1027470,+,589
474,NZ_CP069052,1,782997,783586,-,589
474,NZ_CP076228,1,888677,889266,+,589
474,NZ_CP042445,1,1026871,1027460,+,589
474,NZ_CP042904,1,1149192,1149781,+,589
474,NC_012416,1,1194407,1194996,+,589
474,NZ_CP069053,1,872493,873082,+,589
474,NZ_CP042446,1,1026881,1027470,+,589
474,NZ_CP041215,1,1413116,1413705,-,589
474,NZ_OX366353,1,1090401,1090990,-,589
474,NZ_OX366387,1,42992,43581,+,589
474,NZ_OX366368,1,38266,38855,+,589
474,NZ_OX366379,1,38284,38873,+,589
474,NZ_CP091195,1,76080,76669,-,589
474,NZ_OX366375,1,39192,39780,+,588
474,NZ_CP046925,1,1026731,1027320,+,589
474,NZ_OX366318,1,37439,38028,+,589
474,NZ_OX366319,1,39019,39608,+,589
474,NZ_OX366332,1,38736,39325,+,589
474,NZ_CP110359,1,430305,430894,-,589
474,NZ_OU953855,1,117924,118513,-,589
474,NZ_OX366347,1,80215,80804,-,589
474,NZ_OU909470,1,792962,793550,-,588
474,NZ_OX366363,1,850041,850630,+,589
474,NZ_OX366364,1,164389,164978,-,589
474,NZ_OX366359,1,38740,39329,+,589
474,NZ_OX366349,1,331698,332286,+,588
474,NZ_OX366380,1,246227,246799,+,572
474,NZ_OX366344,1,270872,271460,+,588
474,NZ_CP090900,1,1026883,1027472,+,589
474,NZ_OX366352,1,41308,41897,+,589
474,NZ_OX366362,1,214133,214713,+,580
474,NZ_OX366400,1,136081,136670,-,589
474,NZ_OX366327,1,39522,40111,+,589
474,NZ_OX366367,1,1197117,1197706,+,589
474,NZ_CP042444,1,1028237,1028826,+,589
474,NZ_OX366326,1,40768,41357,+,589
474,NZ_CP037426,1,1286610,1287198,+,588
474,NZ_OX366339,1,1114951,1115540,-,589
474,NZ_OX366355,1,42816,43405,+,589
474,NZ_CP046922,1,1088779,1089368,+,589
474,NZ_OX366370,1,1166398,1166986,-,588
474,NZ_OX366385,1,881207,881780,+,573
474,NZ_OX366399,1,38262,38851,+,589
474,NZ_OX366395,1,51450,52039,-,589
474,NZ_OX366396,1,1444604,1445193,-,589
474,NZ_OX366351,1,45681,46270,+,589
474,NZ_OX366381,1,40842,41431,+,589
474,NZ_OX366342,1,320011,320599,-,588
474,NZ_OX366369,1,39832,40421,+,589
474,NZ_OX366356,1,37213,37801,+,588
474,NZ_OX366377,1,37872,38461,+,589
474,NZ_OX366388,1,188696,189285,+,589
474,NZ_OX366357,1,807627,808216,-,589
474,NZ_CP072012,1,1288951,1289540,+,589
474,NZ_OX366398,1,509231,509820,+,589
474,NC_002978,6,1026881,1027470,+,589
474,NZ_OX366389,1,213895,214484,-,589
474,NZ_OX366397,1,63858,64447,-,589
474,NZ_OX366378,1,1140100,1140689,+,589
474,NZ_CP090903,1,1026883,1027472,+,589
474,NZ_OX366374,1,456273,456862,+,589
474,NZ_CP090901,1,1026883,1027472,+,589
474,NZ_CP046923,1,1005027,1005616,+,589
474,NZ_CP069055,1,978109,978698,+,589
474,NZ_CP072670,1,1026723,1027312,+,589
474,NZ_CP090899,1,1026883,1027472,+,589
474,NZ_CP046924,1,1025965,1026554,+,589
474,NZ_OX366348,1,38034,38623,+,589
474,NZ_CP046921,1,1088779,1089368,+,589
474,NZ_OX366338,1,38703,39292,+,589
474,NZ_CP054557,1,820082,820671,+,589
474,NZ_CP072669,1,1026731,1027320,+,589
474,NC_021089,1,1055085,1055674,+,589
475,NZ_OX366376,1,1494929,1495992,+,1063
475,NZ_OX366393,1,1444949,1446012,+,1063
475,NZ_OX366372,1,1400397,1401460,+,1063
475,NZ_CP072672,1,1011931,1012994,-,1063
475,NZ_CP069060,1,857667,858730,-,1063
475,NZ_CP072667,1,1011905,1012968,-,1063
475,NZ_CP072671,1,1011913,1012976,-,1063
475,NZ_CP072668,1,1011900,1012963,-,1063
475,NZ_CP072666,1,1011913,1012976,-,1063
475,NZ_CP090902,1,1012065,1013128,-,1063
475,NZ_CP090948,1,1012064,1013127,-,1063
475,NZ_CP069052,1,797341,798404,+,1063
475,NZ_CP076228,1,873858,874921,-,1063
475,NZ_CP042445,1,1012053,1013116,-,1063
475,NZ_CP042904,1,1132511,1133574,-,1063
475,NC_012416,1,1176236,1177299,-,1063
475,NZ_CP069053,1,857675,858738,-,1063
475,NZ_CP042446,1,1012063,1013126,-,1063
475,NZ_CP041215,1,1428270,1429333,+,1063
475,NZ_OX366353,1,1105544,1106607,+,1063
475,NZ_OX366387,1,25079,26142,-,1063
475,NZ_OX366368,1,23448,24511,-,1063
475,NZ_OX366379,1,23466,24529,-,1063
475,NZ_CP091195,1,1069000,1070063,+,1063
475,NZ_OX366375,1,22123,23186,-,1063
475,NZ_CP046925,1,1011913,1012976,-,1063
475,NZ_OX366318,1,21695,22758,-,1063
475,NZ_OX366319,1,21247,22310,-,1063
475,NZ_OX366332,1,23117,24180,-,1063
475,NZ_CP110359,1,244483,245546,-,1063
475,NZ_OU953855,1,584747,585810,-,1063
475,NZ_OX366272,1,23557,24620,-,1063
475,NZ_OX366347,1,1101575,1102638,-,1063
475,NZ_OU909470,1,791654,792717,-,1063
475,NZ_OX366363,1,1030628,1031691,-,1063
475,NZ_OX366364,1,163080,164143,-,1063
475,NZ_OX366359,1,23113,24176,-,1063
475,NZ_OX366349,1,332531,333594,+,1063
475,NZ_OX366380,1,247054,248117,+,1063
475,NZ_OX366344,1,271705,272768,+,1063
475,NZ_CP090900,1,1012065,1013128,-,1063
475,NZ_OX366352,1,25681,26744,-,1063
475,NZ_OX366362,1,103453,104516,-,1063
475,NZ_OX366400,1,150937,152000,+,1063
475,NZ_OX366327,1,23360,24423,-,1063
475,NZ_OX366367,1,1197952,1199015,+,1063
475,NZ_CP042444,1,1013419,1014482,-,1063
475,NZ_OX366326,1,25023,26086,-,1063
475,NZ_CP037426,1,1201218,1202281,-,1063
475,NZ_OX366339,1,25231,26294,-,1063
475,NZ_OX366355,1,25061,26124,-,1063
475,NZ_CP046922,1,1073961,1075024,-,1063
475,NZ_OX366370,1,1165090,1166153,-,1063
475,NZ_OX366385,1,882035,883098,+,1063
475,NZ_OX366399,1,23444,24507,-,1063
475,NZ_OX366395,1,66581,67628,+,1047
475,NZ_OX366396,1,557689,558752,-,1063
475,NZ_OX366351,1,29936,30999,-,1063
475,NZ_OX366381,1,23070,24133,-,1063
475,NZ_OX366342,1,318703,319766,-,1063
475,NZ_OX366369,1,23678,24741,-,1063
475,NZ_OX366356,1,20796,21859,-,1063
475,NZ_OX366377,1,23082,24145,-,1063
475,NZ_OX366388,1,25351,26414,-,1063
475,NZ_OX366357,1,358754,359817,+,1063
475,NZ_CP072012,1,1274133,1275196,-,1063
475,NZ_OX366398,1,494441,495504,-,1063
475,NC_002978,6,1012064,1013127,-,1063
475,NZ_OX366389,1,228211,229274,+,1063
475,NZ_OX366397,1,22991,24054,-,1063
475,NZ_OX366378,1,20578,21641,-,1063
475,NZ_CP090903,1,1012065,1013128,-,1063
475,NZ_OX366374,1,441928,442975,-,1047
475,NZ_CP090901,1,1012065,1013128,-,1063
475,NZ_CP046923,1,990209,991272,-,1063
475,NZ_CP069055,1,1029509,1030572,+,1063
475,NZ_CP072670,1,1011905,1012968,-,1063
475,NZ_CP090899,1,1012065,1013128,-,1063
475,NZ_CP046924,1,1011147,1012210,-,1063
475,NZ_OX366348,1,23208,24271,-,1063
475,NZ_CP046921,1,1073961,1075024,-,1063
475,NZ_OX366338,1,21802,22849,-,1047
475,NZ_CP054557,1,805256,806319,-,1063
475,NZ_CP072669,1,1011913,1012976,-,1063
475,NC_021089,1,1039458,1040521,-,1063
476,NZ_OX366376,1,1496072,1497988,+,1916
476,NZ_OX366393,1,1446092,1448008,+,1916
476,NZ_OX366372,1,1401540,1403450,+,1910
476,NZ_CP072672,1,1009921,1011828,-,1907
476,NZ_CP069060,1,855657,857564,-,1907
476,NZ_CP072667,1,1009895,1011802,-,1907
476,NZ_CP072671,1,1009903,1011810,-,1907
476,NZ_CP072668,1,1009890,1011797,-,1907
476,NZ_CP072666,1,1009903,1011810,-,1907
476,NZ_CP090902,1,1010055,1011962,-,1907
476,NZ_CP090948,1,1010054,1011961,-,1907
476,NZ_CP069052,1,798507,800414,+,1907
476,NZ_CP076228,1,871848,873755,-,1907
476,NZ_CP042445,1,1010043,1011950,-,1907
476,NZ_CP042904,1,1130500,1132408,-,1908
476,NC_012416,1,1174225,1176133,-,1908
476,NZ_CP069053,1,855665,857572,-,1907
476,NZ_CP042446,1,1010053,1011960,-,1907
476,NZ_CP041215,1,1429436,1431343,+,1907
476,NZ_OX366353,1,1106710,1108617,+,1907
476,NZ_OX366387,1,23069,24976,-,1907
476,NZ_OX366368,1,21438,23345,-,1907
476,NZ_OX366379,1,21456,23363,-,1907
476,NZ_CP091195,1,1070166,1072073,+,1907
476,NZ_OX366375,1,20113,22020,-,1907
476,NZ_CP046925,1,1009903,1011810,-,1907
476,NZ_OX366318,1,19685,21592,-,1907
476,NZ_OX366319,1,19237,21144,-,1907
476,NZ_OX366332,1,21107,23014,-,1907
476,NZ_CP110359,1,242473,244380,-,1907
476,NZ_OU953855,1,582737,584644,-,1907
476,NZ_OX366272,1,21547,23454,-,1907
476,NZ_OX366347,1,1099565,1101472,-,1907
476,NZ_OU909470,1,789658,791574,-,1916
476,NZ_OX366363,1,1028618,1030525,-,1907
476,NZ_OX366364,1,161067,162983,-,1916
476,NZ_OX366359,1,21103,23010,-,1907
476,NZ_OX366349,1,333674,335590,+,1916
476,NZ_OX366380,1,248197,250113,+,1916
476,NZ_OX366344,1,272848,274763,+,1915
476,NZ_CP090900,1,1010055,1011962,-,1907
476,NZ_OX366352,1,23671,25578,-,1907
476,NZ_OX366362,1,101451,103358,-,1907
476,NZ_OX366400,1,152103,154009,+,1906
476,NZ_OX366327,1,21350,23257,-,1907
476,NZ_OX366367,1,1199112,1201028,+,1916
476,NZ_CP042444,1,1011409,1013316,-,1907
476,NZ_OX366326,1,23014,24920,-,1906
476,NZ_CP037426,1,1199208,1201115,-,1907
476,NZ_OX366339,1,23221,25128,-,1907
476,NZ_OX366355,1,23051,24958,-,1907
476,NZ_CP046922,1,1071951,1073858,-,1907
476,NZ_OX366370,1,1163100,1165010,-,1910
476,NZ_OX366385,1,883178,885094,+,1916
476,NZ_OX366399,1,21434,23341,-,1907
476,NZ_OX366395,1,18855,20755,-,1900
476,NZ_OX366396,1,555719,557586,-,1867
476,NZ_OX366351,1,27926,29833,-,1907
476,NZ_OX366381,1,21060,22967,-,1907
476,NZ_OX366342,1,316707,318623,-,1916
476,NZ_OX366369,1,21668,23575,-,1907
476,NZ_OX366356,1,18786,20693,-,1907
476,NZ_OX366377,1,21072,22979,-,1907
476,NZ_OX366388,1,23341,25248,-,1907
476,NZ_OX366357,1,359904,361804,+,1900
476,NZ_CP072012,1,1272123,1274030,-,1907
476,NZ_OX366398,1,492431,494338,-,1907
476,NC_002978,6,1010054,1011961,-,1907
476,NZ_OX366389,1,229377,231284,+,1907
476,NZ_OX366397,1,20981,22888,-,1907
476,NZ_OX366378,1,18568,20475,-,1907
476,NZ_CP090903,1,1010055,1011962,-,1907
476,NZ_OX366374,1,433695,435595,+,1900
476,NZ_CP090901,1,1010055,1011962,-,1907
476,NZ_CP046923,1,988199,990106,-,1907
476,NZ_CP069055,1,1030675,1032582,+,1907
476,NZ_CP072670,1,1009895,1011802,-,1907
476,NZ_CP090899,1,1010055,1011962,-,1907
476,NZ_CP046924,1,1009137,1011044,-,1907
476,NZ_OX366348,1,21198,23105,-,1907
476,NZ_CP046921,1,1071951,1073858,-,1907
476,NZ_OX366338,1,15487,17387,-,1900
476,NZ_CP054557,1,803246,805153,-,1907
476,NZ_CP072669,1,1009903,1011810,-,1907
476,NC_021089,1,1037448,1039355,-,1907
477,NZ_OX366376,1,1498145,1500438,+,2293
477,NZ_OX366393,1,1448165,1450458,+,2293
477,NZ_OX366372,1,1403607,1405900,+,2293
477,NZ_CP072672,1,1007471,1009764,-,2293
477,NZ_CP069060,1,853207,855500,-,2293
477,NZ_CP072667,1,1007445,1009738,-,2293
477,NZ_CP072671,1,1007453,1009746,-,2293
477,NZ_CP072668,1,1007440,1009733,-,2293
477,NZ_CP072666,1,1007453,1009746,-,2293
477,NZ_CP090902,1,1007605,1009898,-,2293
477,NZ_CP090948,1,1007604,1009897,-,2293
477,NZ_CP069052,1,800571,802864,+,2293
477,NZ_CP076228,1,869398,871691,-,2293
477,NZ_CP042445,1,1007593,1009886,-,2293
477,NZ_CP042904,1,1128050,1130343,-,2293
477,NC_012416,1,1171775,1174068,-,2293
477,NZ_CP069053,1,853215,855508,-,2293
477,NZ_CP042446,1,1007603,1009896,-,2293
477,NZ_CP041215,1,1431500,1433794,+,2294
477,NZ_OX366353,1,1108774,1111067,+,2293
477,NZ_OX366387,1,20619,22912,-,2293
477,NZ_OX366368,1,18988,21281,-,2293
477,NZ_OX366379,1,19006,21299,-,2293
477,NZ_CP091195,1,1072230,1074523,+,2293
477,NZ_OX366375,1,17663,19956,-,2293
477,NZ_CP046925,1,1007453,1009746,-,2293
477,NZ_OX366318,1,17235,19528,-,2293
477,NZ_OX366319,1,16787,19080,-,2293
477,NZ_OX366332,1,18656,20950,-,2294
477,NZ_CP110359,1,240023,242316,-,2293
477,NZ_OU953855,1,580287,582580,-,2293
477,NZ_OX366272,1,19097,21390,-,2293
477,NZ_OX366347,1,1097115,1099408,-,2293
477,NZ_OU909470,1,787208,789501,-,2293
477,NZ_OX366363,1,1026168,1028461,-,2293
477,NZ_OX366364,1,158624,160910,-,2286
477,NZ_OX366359,1,18652,20946,-,2294
477,NZ_OX366349,1,335747,338039,+,2292
477,NZ_OX366380,1,250270,252564,+,2294
477,NZ_OX366344,1,274905,277198,+,2293
477,NZ_CP090900,1,1007605,1009898,-,2293
477,NZ_OX366352,1,21220,23514,-,2294
477,NZ_OX366362,1,99001,101294,-,2293
477,NZ_OX366400,1,154166,156459,+,2293
477,NZ_OX366327,1,18900,21193,-,2293
477,NZ_OX366367,1,1201185,1203471,+,2286
477,NZ_CP042444,1,1008959,1011252,-,2293
477,NZ_OX366326,1,20579,22872,-,2293
477,NZ_CP037426,1,1196758,1199051,-,2293
477,NZ_OX366339,1,20771,23064,-,2293
477,NZ_OX366355,1,20601,22894,-,2293
477,NZ_CP046922,1,1069501,1071794,-,2293
477,NZ_OX366370,1,1160650,1162943,-,2293
477,NZ_OX366385,1,885251,887544,+,2293
477,NZ_OX366399,1,18984,21277,-,2293
477,NZ_OX366395,1,16413,18698,-,2285
477,NZ_OX366396,1,1376459,1378752,-,2293
477,NZ_OX366351,1,25476,27769,-,2293
477,NZ_OX366381,1,18610,20903,-,2293
477,NZ_OX366342,1,314257,316550,-,2293
477,NZ_OX366369,1,19218,21511,-,2293
477,NZ_OX366356,1,16336,18629,-,2293
477,NZ_OX366377,1,18622,20915,-,2293
477,NZ_OX366388,1,20891,23184,-,2293
477,NZ_OX366357,1,361961,364254,+,2293
477,NZ_CP072012,1,1269673,1271966,-,2293
477,NZ_OX366398,1,489981,492274,-,2293
477,NC_002978,6,1007604,1009897,-,2293
477,NZ_OX366389,1,231441,233734,+,2293
477,NZ_OX366397,1,18530,20824,-,2294
477,NZ_OX366378,1,16118,18411,-,2293
477,NZ_CP090903,1,1007605,1009898,-,2293
477,NZ_OX366374,1,1234933,1237152,-,2219
477,NZ_CP090901,1,1007605,1009898,-,2293
477,NZ_CP046923,1,985749,988042,-,2293
477,NZ_CP069055,1,1032739,1035032,+,2293
477,NZ_CP072670,1,1007445,1009738,-,2293
477,NZ_CP090899,1,1007605,1009898,-,2293
477,NZ_CP046924,1,1006687,1008980,-,2293
477,NZ_OX366348,1,18748,21041,-,2293
477,NZ_CP046921,1,1069501,1071794,-,2293
477,NZ_OX366338,1,13037,15330,-,2293
477,NZ_CP054557,1,800796,803089,-,2293
477,NZ_CP072669,1,1007453,1009746,-,2293
477,NC_021089,1,1034997,1037291,-,2294
478,NZ_OX366376,1,1501328,1501934,+,606
478,NZ_OX366393,1,1451347,1451955,+,608
478,NZ_OX366372,1,1406790,1407397,+,607
478,NZ_OX366364,1,157019,157612,-,593
478,NZ_OX366342,1,312759,313367,-,608
479,NZ_OX366376,1,1502318,1503367,+,1049
479,NZ_OX366393,1,1452339,1453388,+,1049
479,NZ_OX366372,1,1407781,1408830,+,1049
479,NZ_CP072672,1,1003910,1004959,-,1049
479,NZ_CP069060,1,849646,850695,-,1049
479,NZ_CP072667,1,1003884,1004933,-,1049
479,NZ_CP072671,1,1003892,1004941,-,1049
479,NZ_CP072668,1,1003879,1004928,-,1049
479,NZ_CP072666,1,1003892,1004941,-,1049
479,NZ_CP090902,1,1004044,1005093,-,1049
479,NZ_CP090948,1,1004044,1005093,-,1049
479,NZ_CP069052,1,805376,806425,+,1049
479,NZ_CP076228,1,981004,982053,+,1049
479,NZ_CP042445,1,1004032,1005081,-,1049
479,NZ_CP042904,1,1124413,1125462,-,1049
479,NC_012416,1,1168138,1169187,-,1049
479,NZ_CP069053,1,849654,850703,-,1049
479,NZ_CP042446,1,1004042,1005091,-,1049
479,NZ_CP041215,1,1436519,1437568,+,1049
479,NZ_OX366353,1,1113792,1114841,+,1049
479,NZ_OX366387,1,17061,18110,-,1049
479,NZ_OX366368,1,15450,16499,-,1049
479,NZ_OX366379,1,15468,16517,-,1049
479,NZ_CP091195,1,1077111,1078160,+,1049
479,NZ_OX366375,1,14102,15151,-,1049
479,NZ_CP046925,1,1003892,1004941,-,1049
479,NZ_OX366318,1,12823,13872,-,1049
479,NZ_OX366319,1,13249,14298,-,1049
479,NZ_OX366332,1,14882,15931,-,1049
479,NZ_CP110359,1,236386,237435,-,1049
479,NZ_OU953855,1,576650,577699,-,1049
479,NZ_OX366272,1,15460,16509,-,1049
479,NZ_OX366347,1,1093478,1094527,-,1049
479,NZ_OU909470,1,749425,750464,-,1039
479,NZ_OX366363,1,1022531,1023580,-,1049
479,NZ_OX366364,1,155587,156629,-,1042
479,NZ_OX366359,1,14881,15930,-,1049
479,NZ_OX366349,1,340685,341734,+,1049
479,NZ_OX366380,1,255224,256263,+,1039
479,NZ_OX366344,1,279710,280759,+,1049
479,NZ_CP090900,1,1004044,1005093,-,1049
479,NZ_OX366352,1,17446,18495,-,1049
479,NZ_OX366362,1,95760,96809,-,1049
479,NZ_OX366400,1,158948,159997,+,1049
479,NZ_OX366327,1,15263,16312,-,1049
479,NZ_OX366367,1,1206080,1207122,+,1042
479,NZ_CP042444,1,1005398,1006447,-,1049
479,NZ_OX366326,1,17041,18090,-,1049
479,NZ_CP037426,1,1193197,1194246,-,1049
479,NZ_OX366339,1,17198,18247,-,1049
479,NZ_OX366355,1,17040,18089,-,1049
479,NZ_CP046922,1,1065940,1066989,-,1049
479,NZ_OX366370,1,1157441,1158480,-,1039
479,NZ_OX366385,1,891051,892090,+,1039
479,NZ_OX366399,1,15423,16472,-,1049
479,NZ_OX366395,1,12498,13557,-,1059
479,NZ_OX366396,1,1372886,1373935,-,1049
479,NZ_OX366351,1,21915,22964,-,1049
479,NZ_OX366381,1,15049,16098,-,1049
479,NZ_OX366342,1,311327,312376,-,1049
479,NZ_OX366369,1,15657,16706,-,1049
479,NZ_OX366356,1,12671,13720,-,1049
479,NZ_OX366377,1,15061,16110,-,1049
479,NZ_OX366388,1,15708,16757,-,1049
479,NZ_OX366357,1,534690,535702,+,1012
479,NZ_CP072012,1,1266112,1267161,-,1049
479,NZ_OX366398,1,486420,487469,-,1049
479,NC_002978,6,1004044,1005093,-,1049
479,NZ_OX366389,1,236246,237295,+,1049
479,NZ_OX366397,1,14756,15805,-,1049
479,NZ_OX366378,1,12481,13530,-,1049
479,NZ_CP090903,1,1004044,1005093,-,1049
479,NZ_OX366374,1,1231266,1232315,-,1049
479,NZ_CP090901,1,1004044,1005093,-,1049
479,NZ_CP046923,1,982188,983237,-,1049
479,NZ_CP069055,1,1037544,1038593,+,1049
479,NZ_CP072670,1,1003884,1004933,-,1049
479,NZ_CP090899,1,1004044,1005093,-,1049
479,NZ_CP046924,1,1003126,1004175,-,1049
479,NZ_OX366348,1,15202,16251,-,1049
479,NZ_CP046921,1,1065940,1066989,-,1049
479,NZ_OX366338,1,9125,10174,-,1049
479,NZ_CP054557,1,796407,797456,-,1049
479,NZ_CP072669,1,1003892,1004941,-,1049
479,NC_021089,1,1031223,1032272,-,1049
480,NZ_OX366376,1,1505749,1506596,+,847
480,NZ_OX366393,1,1455770,1456617,+,847
480,NZ_OX366372,1,1411212,1412059,+,847
480,NZ_CP072672,1,1001008,1001828,-,820
480,NZ_CP069060,1,846744,847564,-,820
480,NZ_CP072667,1,1000982,1001802,-,820
480,NZ_CP072671,1,1000990,1001810,-,820
480,NZ_CP072668,1,1000977,1001797,-,820
480,NZ_CP072666,1,1000990,1001810,-,820
480,NZ_CP090902,1,1001142,1001962,-,820
480,NZ_CP090948,1,1001142,1001962,-,820
480,NZ_CP069052,1,808507,809327,+,820
480,NZ_CP076228,1,984132,984952,+,820
480,NZ_CP042445,1,1001130,1001950,-,820
480,NZ_CP042904,1,1120592,1121412,-,820
480,NC_012416,1,1164317,1165137,-,820
480,NZ_CP069053,1,846752,847572,-,820
480,NZ_CP042446,1,1001140,1001960,-,820
480,NZ_OX366353,1,1116924,1117735,+,811
480,NZ_OX366387,1,13970,14747,-,777
480,NZ_OX366368,1,12548,13368,-,820
480,NZ_OX366379,1,12566,13386,-,820
480,NZ_OX366375,1,11236,12056,-,820
480,NZ_CP046925,1,1000990,1001810,-,820
480,NZ_OX366319,1,10799,11619,-,820
480,NZ_OX366332,1,11988,12799,-,811
480,NZ_CP110359,1,233547,234367,-,820
480,NZ_OU953855,1,573784,574604,-,820
480,NZ_OX366272,1,12594,13414,-,820
480,NZ_OX366347,1,5822,6642,+,820
480,NZ_OU909470,1,746383,747203,-,820
480,NZ_OX366363,1,1018725,1019536,-,811
480,NZ_OX366364,1,152375,153201,-,826
480,NZ_OX366359,1,11987,12798,-,811
480,NZ_OX366349,1,1657248,1658062,+,814
480,NZ_OX366344,1,282952,283799,+,847
480,NZ_CP090900,1,1001142,1001962,-,820
480,NZ_OX366352,1,12252,13063,-,811
480,NZ_OX366362,1,91882,92702,-,820
480,NZ_OX366327,1,12214,13034,-,820
480,NZ_OX366367,1,1209351,1210177,+,826
480,NZ_CP042444,1,1002496,1003316,-,820
480,NZ_OX366326,1,14175,14995,-,820
480,NZ_CP037426,1,1190331,1191151,-,820
480,NZ_OX366339,1,14332,15152,-,820
480,NZ_OX366355,1,14174,14994,-,820
480,NZ_CP046922,1,1063038,1063858,-,820
480,NZ_OX366370,1,1154381,1155207,-,826
480,NZ_OX366399,1,12521,13341,-,820
480,NZ_OX366395,1,9465,10285,-,820
480,NZ_OX366396,1,1370021,1370840,-,819
480,NZ_OX366351,1,15035,15855,-,820
480,NZ_OX366381,1,12183,13003,-,820
480,NZ_OX366342,1,308098,308945,-,847
480,NZ_OX366369,1,11953,12773,-,820
480,NZ_OX366356,1,9806,10617,-,811
480,NZ_OX366377,1,12186,13006,-,820
480,NZ_OX366388,1,12842,13662,-,820
480,NZ_OX366357,1,1092685,1093505,+,820
480,NZ_CP072012,1,1263211,1264031,-,820
480,NZ_OX366398,1,482667,483487,-,820
480,NC_002978,6,1001142,1001962,-,820
480,NZ_OX366389,1,240296,241116,+,820
480,NZ_OX366397,1,11862,12673,-,811
480,NZ_OX366378,1,9615,10435,-,820
480,NZ_CP090903,1,1001142,1001962,-,820
480,NZ_CP090901,1,1001142,1001962,-,820
480,NZ_CP046923,1,979286,980106,-,820
480,NZ_CP069055,1,1040421,1041241,+,820
480,NZ_CP072670,1,1000982,1001802,-,820
480,NZ_CP090899,1,1001142,1001962,-,820
480,NZ_CP046924,1,1000224,1001044,-,820
480,NZ_OX366348,1,12336,13156,-,820
480,NZ_CP046921,1,1063038,1063858,-,820
480,NZ_CP072669,1,1000990,1001810,-,820
480,NC_021089,1,1028329,1029140,-,811
481,NZ_OX366376,1,1509987,1511542,+,1555
481,NZ_OX366393,1,1460203,1461758,+,1555
481,NZ_OX366372,1,1415437,1416992,+,1555
481,NZ_CP072672,1,1115380,1116983,+,1603
481,NZ_CP069060,1,962092,963695,+,1603
481,NZ_CP072667,1,1115354,1116957,+,1603
481,NZ_CP072671,1,1115362,1116965,+,1603
481,NZ_CP072668,1,1115349,1116952,+,1603
481,NZ_CP072666,1,1115362,1116965,+,1603
481,NZ_CP090902,1,1115514,1117117,+,1603
481,NZ_CP090948,1,1115512,1117115,+,1603
481,NZ_CP069052,1,1033819,1035421,-,1602
481,NZ_CP076228,1,1130207,1131810,+,1603
481,NZ_CP042445,1,1115502,1117105,+,1603
481,NZ_CP042904,1,1186883,1188486,+,1603
481,NC_012416,1,1232098,1233701,+,1603
481,NZ_CP069053,1,962124,963727,+,1603
481,NZ_CP042446,1,1115512,1117115,+,1603
481,NZ_CP041215,1,139829,141432,+,1603
481,NZ_OX366353,1,695334,696936,-,1602
481,NZ_OX366387,1,155656,157259,+,1603
481,NZ_OX366368,1,128524,130127,+,1603
481,NZ_OX366379,1,128622,130225,+,1603
481,NZ_CP091195,1,1270806,1272409,+,1603
481,NZ_OX366375,1,130622,132179,+,1557
481,NZ_CP046925,1,1115362,1116965,+,1603
481,NZ_OX366318,1,123578,125171,+,1593
481,NZ_OX366319,1,1073128,1074731,-,1603
481,NZ_OX366332,1,127248,128851,+,1603
481,NZ_CP110359,1,111929,113532,+,1603
481,NZ_OU953855,1,504325,505921,+,1596
481,NZ_OX366272,1,82875,84478,+,1603
481,NZ_OX366347,1,236446,238049,+,1603
481,NZ_OU909470,1,1053148,1054744,+,1596
481,NZ_OX366363,1,1100209,1101811,-,1602
481,NZ_OX366364,1,1319971,1321564,+,1593
481,NZ_OX366359,1,126373,127976,+,1603
481,NZ_OX366349,1,1679781,1681338,+,1557
481,NZ_OX366380,1,262176,263764,+,1588
481,NZ_OX366344,1,747429,748986,+,1557
481,NZ_CP090900,1,1115515,1117118,+,1603
481,NZ_OX366352,1,1562555,1564157,-,1602
481,NZ_OX366362,1,1298804,1300406,-,1602
481,NZ_OX366400,1,48003,49595,-,1592
481,NZ_OX366327,1,126080,127683,+,1603
481,NZ_OX366367,1,1142916,1144515,-,1599
481,NZ_CP042444,1,1116868,1118471,+,1603
481,NZ_OX366326,1,127284,128877,+,1593
481,NZ_CP037426,1,1013775,1015378,-,1603
481,NZ_OX366339,1,1317661,1319263,-,1602
481,NZ_OX366355,1,1190241,1191844,-,1603
481,NZ_CP046922,1,1177326,1178929,+,1603
481,NZ_OX366370,1,1138968,1140563,-,1595
481,NZ_OX366385,1,231389,232977,+,1588
481,NZ_OX366399,1,128025,129628,+,1603
481,NZ_OX366395,1,268714,270321,+,1607
481,NZ_OX366396,1,673783,675386,+,1603
481,NZ_OX366351,1,134699,136292,+,1593
481,NZ_OX366381,1,1255165,1256768,-,1603
481,NZ_OX366342,1,303431,304985,-,1554
481,NZ_OX366369,1,124531,126135,+,1604
481,NZ_OX366356,1,159487,161090,+,1603
481,NZ_OX366377,1,130994,132597,+,1603
481,NZ_OX366388,1,1718752,1720355,+,1603
481,NZ_OX366357,1,1330166,1331760,-,1594
481,NZ_CP072012,1,1186820,1188422,-,1602
481,NZ_OX366398,1,777784,779387,+,1603
481,NC_002978,6,1115512,1117115,+,1603
481,NZ_OX366389,1,120075,121677,-,1602
481,NZ_OX366397,1,127079,128682,+,1603
481,NZ_OX366378,1,71385,72988,+,1603
481,NZ_CP090903,1,1115515,1117118,+,1603
481,NZ_OX366374,1,70787,72390,+,1603
481,NZ_CP090901,1,1115515,1117118,+,1603
481,NZ_CP046923,1,1093574,1095177,+,1603
481,NZ_CP069055,1,1115440,1117043,+,1603
481,NZ_CP072670,1,1115342,1116945,+,1603
481,NZ_CP090899,1,1115515,1117118,+,1603
481,NZ_CP046924,1,1114512,1116115,+,1603
481,NZ_OX366348,1,1165575,1167168,+,1593
481,NZ_CP046921,1,1177326,1178929,+,1603
481,NZ_OX366338,1,600905,602534,-,1629
481,NZ_CP054557,1,692477,694069,-,1592
481,NZ_CP072669,1,1115362,1116965,+,1603
481,NC_021089,1,1143468,1145071,+,1603
482,NZ_OX366376,1,1512508,1515591,+,3083
482,NZ_OX366393,1,1462724,1465807,+,3083
482,NZ_OX366372,1,1417958,1421041,+,3083
482,NZ_CP072672,1,1117985,1121071,+,3086
482,NZ_CP069060,1,964697,967783,+,3086
482,NZ_CP072667,1,1117959,1121045,+,3086
482,NZ_CP072671,1,1117967,1121053,+,3086
482,NZ_CP072668,1,1117954,1121040,+,3086
482,NZ_CP072666,1,1117967,1121053,+,3086
482,NZ_CP090902,1,1118119,1121205,+,3086
482,NZ_CP090948,1,1118117,1121203,+,3086
482,NZ_CP069052,1,1029731,1032817,-,3086
482,NZ_CP076228,1,1132812,1135898,+,3086
482,NZ_CP042445,1,1118107,1121193,+,3086
482,NZ_CP042904,1,1189491,1192568,+,3077
482,NC_012416,1,1234706,1237783,+,3077
482,NZ_CP069053,1,964729,967815,+,3086
482,NZ_CP042446,1,1118117,1121203,+,3086
482,NZ_CP041215,1,142434,145519,+,3085
482,NZ_OX366353,1,691247,694332,-,3085
482,NZ_OX366387,1,158445,161524,+,3079
482,NZ_OX366368,1,131129,134215,+,3086
482,NZ_OX366379,1,131227,134313,+,3086
482,NZ_CP091195,1,1273595,1276674,+,3079
482,NZ_OX366375,1,134173,137258,+,3085
482,NZ_CP046925,1,1117967,1121053,+,3086
482,NZ_OX366318,1,126201,129287,+,3086
482,NZ_OX366319,1,1069015,1072100,-,3085
482,NZ_OX366332,1,129853,132938,+,3085
482,NZ_CP110359,1,114571,117638,+,3067
482,NZ_OU953855,1,507110,510189,+,3079
482,NZ_OX366272,1,85517,88584,+,3067
482,NZ_OX366347,1,239338,242417,+,3079
482,NZ_OU909470,1,1055593,1058678,+,3085
482,NZ_OX366363,1,1096103,1099170,-,3067
482,NZ_OX366364,1,1322600,1325686,+,3086
482,NZ_OX366359,1,128978,132063,+,3085
482,NZ_OX366349,1,1682375,1685452,+,3077
482,NZ_OX366380,1,264721,267803,+,3082
482,NZ_OX366344,1,750096,753179,+,3083
482,NZ_CP090900,1,1118120,1121206,+,3086
482,NZ_OX366352,1,1558468,1561553,-,3085
482,NZ_OX366362,1,1294803,1297883,-,3080
482,NZ_OX366400,1,43326,46412,-,3086
482,NZ_OX366327,1,128685,131770,+,3085
482,NZ_OX366367,1,1138917,1142003,-,3086
482,NZ_CP042444,1,1119473,1122559,+,3086
482,NZ_OX366326,1,129907,132993,+,3086
482,NZ_CP037426,1,1009662,1012747,-,3085
482,NZ_OX366339,1,1313546,1316631,-,3085
482,NZ_OX366355,1,1186128,1189213,-,3085
482,NZ_CP046922,1,1179931,1183017,+,3086
482,NZ_OX366370,1,1134828,1137899,-,3071
482,NZ_OX366385,1,233934,237016,+,3082
482,NZ_OX366399,1,130630,133716,+,3086
482,NZ_OX366395,1,271224,274303,+,3079
482,NZ_OX366396,1,676416,679501,+,3085
482,NZ_OX366351,1,137322,140408,+,3086
482,NZ_OX366381,1,1251052,1254137,-,3085
482,NZ_OX366342,1,299382,302465,-,3083
482,NZ_OX366369,1,127163,130248,+,3085
482,NZ_OX366356,1,162120,165206,+,3086
482,NZ_OX366377,1,133599,136684,+,3085
482,NZ_OX366388,1,1722638,1725717,+,3079
482,NZ_OX366357,1,1326184,1329264,-,3080
482,NZ_CP072012,1,1182732,1185818,-,3086
482,NZ_OX366398,1,780389,783474,+,3085
482,NC_002978,6,1118117,1121203,+,3086
482,NZ_OX366389,1,115988,119073,-,3085
482,NZ_OX366397,1,129684,132769,+,3085
482,NZ_OX366378,1,74174,77253,+,3079
482,NZ_CP090903,1,1118120,1121206,+,3086
482,NZ_OX366374,1,73293,76373,+,3080
482,NZ_CP090901,1,1118120,1121206,+,3086
482,NZ_CP046923,1,1096179,1099265,+,3086
482,NZ_CP069055,1,1118045,1121131,+,3086
482,NZ_CP072670,1,1117947,1121033,+,3086
482,NZ_CP090899,1,1118120,1121206,+,3086
482,NZ_CP046924,1,1117117,1120203,+,3086
482,NZ_OX366348,1,1169078,1172164,+,3086
482,NZ_CP046921,1,1179931,1183017,+,3086
482,NZ_OX366338,1,596931,600002,-,3071
482,NZ_CP054557,1,688400,691486,-,3086
482,NZ_CP072669,1,1117967,1121053,+,3086
482,NC_021089,1,1146073,1149171,+,3098
483,NZ_OX366376,1,1518587,1519550,+,963
483,NZ_OX366393,1,1468803,1469766,+,963
483,NZ_OX366372,1,1424037,1425000,+,963
483,NZ_CP072672,1,1124055,1124984,+,929
483,NZ_CP069060,1,1001331,1002263,-,932
483,NZ_CP072667,1,1124029,1124958,+,929
483,NZ_CP072671,1,1124037,1124966,+,929
483,NZ_CP072668,1,1124024,1124953,+,929
483,NZ_CP072666,1,1124037,1124966,+,929
483,NZ_CP090902,1,1124189,1125118,+,929
483,NZ_CP090948,1,1124187,1125116,+,929
483,NZ_CP069052,1,995250,996183,+,933
483,NZ_CP076228,1,1169468,1170400,-,932
483,NZ_CP042445,1,1124177,1125106,+,929
483,NZ_CP042904,1,1195543,1196485,+,942
483,NC_012416,1,1240758,1241700,+,942
483,NZ_CP069053,1,1001363,1002295,-,932
483,NZ_CP042446,1,1124187,1125116,+,929
483,NZ_CP041215,1,148429,149381,+,952
483,NZ_OX366353,1,687393,688337,-,944
483,NZ_OX366387,1,164463,165405,+,942
483,NZ_OX366368,1,137199,138141,+,942
483,NZ_OX366379,1,137297,138239,+,942
483,NZ_CP091195,1,1279608,1280550,+,942
483,NZ_OX366375,1,140200,141145,+,945
483,NZ_CP046925,1,1124037,1124966,+,929
483,NZ_OX366318,1,132271,133222,+,951
483,NZ_OX366319,1,1065173,1066115,-,942
483,NZ_OX366332,1,135848,136800,+,952
483,NZ_CP110359,1,120560,121483,+,923
483,NZ_OU953855,1,513062,514013,+,951
483,NZ_OX366272,1,91506,92448,+,942
483,NZ_OX366347,1,245348,246290,+,942
483,NZ_OU909470,1,1061768,1062710,+,942
483,NZ_OX366363,1,1092197,1093139,-,942
483,NZ_OX366364,1,1328784,1329720,+,936
483,NZ_OX366359,1,134973,135925,+,952
483,NZ_OX366349,1,1688499,1689471,+,972
483,NZ_OX366380,1,270761,271692,+,931
483,NZ_OX366344,1,756199,757162,+,963
483,NZ_CP090900,1,1124190,1125119,+,929
483,NZ_OX366352,1,1554606,1555558,-,952
483,NZ_OX366362,1,1290763,1291717,-,954
483,NZ_OX366400,1,39391,40342,-,951
483,NZ_OX366327,1,134745,135696,+,951
483,NZ_OX366367,1,1134924,1135887,-,963
483,NZ_CP042444,1,1125543,1126472,+,929
483,NZ_OX366326,1,135977,136928,+,951
483,NZ_CP037426,1,1005775,1006720,-,945
483,NZ_OX366339,1,1156639,1157581,+,942
483,NZ_OX366355,1,1182286,1183228,-,942
483,NZ_CP046922,1,1186001,1186943,+,942
483,NZ_OX366370,1,1130780,1131743,-,963
483,NZ_OX366385,1,239974,240905,+,931
483,NZ_OX366399,1,136700,137642,+,942
483,NZ_OX366395,1,277252,278197,+,945
483,NZ_OX366396,1,682443,683385,+,942
483,NZ_OX366351,1,143392,144343,+,951
483,NZ_OX366381,1,1247210,1248152,-,942
483,NZ_OX366342,1,295423,296386,-,963
483,NZ_OX366369,1,133148,134090,+,942
483,NZ_OX366356,1,168137,169287,+,1150
483,NZ_OX366377,1,139668,140619,+,951
483,NZ_OX366388,1,1728651,1729593,+,942
483,NZ_OX366357,1,1322276,1323230,-,954
483,NZ_CP072012,1,1178806,1179748,-,942
483,NZ_OX366398,1,786458,787409,+,951
483,NC_002978,6,1124187,1125116,+,929
483,NZ_OX366389,1,112053,113004,-,951
483,NZ_OX366397,1,135679,136631,+,952
483,NZ_OX366378,1,80187,81129,+,942
483,NZ_CP090903,1,1124190,1125119,+,929
483,NZ_OX366374,1,79306,80239,+,933
483,NZ_CP090901,1,1124190,1125119,+,929
483,NZ_CP046923,1,1102249,1103191,+,942
483,NZ_CP069055,1,1124115,1125057,+,942
483,NZ_CP072670,1,1124017,1124946,+,929
483,NZ_CP090899,1,1124190,1125119,+,929
483,NZ_CP046924,1,1123187,1124129,+,942
483,NZ_OX366348,1,1116467,1117409,-,942
483,NZ_CP046921,1,1186001,1186943,+,942
483,NZ_OX366338,1,593022,593967,-,945
483,NZ_CP054557,1,684474,685416,-,942
483,NZ_CP072669,1,1124037,1124966,+,929
483,NC_021089,1,1152081,1153033,+,952
484,NZ_OX366376,1,1519556,1521043,+,1487
484,NZ_OX366393,1,1469772,1471259,+,1487
484,NZ_OX366372,1,1425006,1426493,+,1487
484,NZ_CP072672,1,1125006,1126537,+,1531
484,NZ_CP069060,1,999791,1001322,-,1531
484,NZ_CP072667,1,1124980,1126511,+,1531
484,NZ_CP072671,1,1124988,1126519,+,1531
484,NZ_CP072668,1,1124975,1126506,+,1531
484,NZ_CP072666,1,1124988,1126519,+,1531
484,NZ_CP090902,1,1125140,1126671,+,1531
484,NZ_CP090948,1,1125138,1126669,+,1531
484,NZ_CP069052,1,996192,997723,+,1531
484,NZ_CP076228,1,1167928,1169459,-,1531
484,NZ_CP042445,1,1125128,1126659,+,1531
484,NZ_CP042904,1,1196494,1198025,+,1531
484,NC_012416,1,1241709,1243240,+,1531
484,NZ_CP069053,1,999823,1001354,-,1531
484,NZ_CP042446,1,1125138,1126669,+,1531
484,NZ_CP041215,1,149390,150885,+,1495
484,NZ_OX366353,1,685881,687376,-,1495
484,NZ_OX366387,1,165414,166945,+,1531
484,NZ_OX366368,1,138150,139681,+,1531
484,NZ_OX366379,1,138248,139779,+,1531
484,NZ_CP091195,1,1280559,1282090,+,1531
484,NZ_OX366375,1,141151,142682,+,1531
484,NZ_CP046925,1,1124988,1126519,+,1531
484,NZ_OX366318,1,133231,134762,+,1531
484,NZ_OX366319,1,1063633,1065164,-,1531
484,NZ_OX366332,1,136809,138304,+,1495
484,NZ_CP110359,1,122609,124140,+,1531
484,NZ_OU953855,1,514022,515553,+,1531
484,NZ_OX366272,1,92457,93988,+,1531
484,NZ_OX366347,1,246299,247749,+,1450
484,NZ_OU909470,1,1062719,1064242,+,1523
484,NZ_OX366363,1,1090657,1092188,-,1531
484,NZ_OX366364,1,1329726,1331191,+,1465
484,NZ_OX366359,1,135934,137429,+,1495
484,NZ_OX366349,1,1689477,1690964,+,1487
484,NZ_OX366380,1,271712,273162,+,1450
484,NZ_OX366344,1,757168,758739,+,1571
484,NZ_CP090900,1,1125141,1126672,+,1531
484,NZ_OX366352,1,1553102,1554597,-,1495
484,NZ_OX366362,1,1289263,1290757,-,1494
484,NZ_OX366400,1,37851,39382,-,1531
484,NZ_OX366327,1,135705,137236,+,1531
484,NZ_OX366367,1,1133387,1134899,-,1512
484,NZ_CP042444,1,1126494,1128025,+,1531
484,NZ_OX366326,1,136937,138468,+,1531
484,NZ_CP037426,1,1004238,1005769,-,1531
484,NZ_OX366339,1,1157590,1159121,+,1531
484,NZ_OX366355,1,1180746,1182277,-,1531
484,NZ_CP046922,1,1186952,1188483,+,1531
484,NZ_OX366370,1,1129314,1130774,-,1460
484,NZ_OX366385,1,240925,242366,+,1441
484,NZ_OX366399,1,137651,139182,+,1531
484,NZ_OX366395,1,278206,279659,+,1453
484,NZ_OX366396,1,683394,684925,+,1531
484,NZ_OX366351,1,144352,145883,+,1531
484,NZ_OX366381,1,1245670,1247201,-,1531
484,NZ_OX366342,1,293930,295417,-,1487
484,NZ_OX366369,1,134099,135630,+,1531
484,NZ_OX366356,1,169296,170818,+,1522
484,NZ_OX366377,1,140628,142159,+,1531
484,NZ_OX366388,1,1729602,1731133,+,1531
484,NZ_OX366357,1,1320769,1322270,-,1501
484,NZ_CP072012,1,1177266,1178797,-,1531
484,NZ_OX366398,1,787418,788949,+,1531
484,NC_002978,6,1125138,1126669,+,1531
484,NZ_OX366389,1,110513,112044,-,1531
484,NZ_OX366397,1,136640,138135,+,1495
484,NZ_OX366378,1,81138,82669,+,1531
484,NZ_CP090903,1,1125141,1126672,+,1531
484,NZ_OX366374,1,80248,81771,+,1523
484,NZ_CP090901,1,1125141,1126672,+,1531
484,NZ_CP046923,1,1103200,1104731,+,1531
484,NZ_CP069055,1,1125066,1126597,+,1531
484,NZ_CP072670,1,1124968,1126499,+,1531
484,NZ_CP090899,1,1125141,1126672,+,1531
484,NZ_CP046924,1,1124138,1125669,+,1531
484,NZ_OX366348,1,1114927,1116458,-,1531
484,NZ_CP046921,1,1186952,1188483,+,1531
484,NZ_OX366338,1,591560,593013,-,1453
484,NZ_CP054557,1,682934,684465,-,1531
484,NZ_CP072669,1,1124988,1126519,+,1531
484,NC_021089,1,1153042,1154537,+,1495
485,NZ_OX366376,1,1522116,1523032,+,916
485,NZ_OX366393,1,1472332,1473248,+,916
485,NZ_OX366372,1,1427566,1428482,+,916
485,NZ_CP072672,1,1127718,1128634,+,916
485,NZ_CP069060,1,997693,998610,-,917
485,NZ_CP072667,1,1127692,1128608,+,916
485,NZ_CP072671,1,1127700,1128616,+,916
485,NZ_CP072668,1,1127687,1128603,+,916
485,NZ_CP072666,1,1127700,1128616,+,916
485,NZ_CP090902,1,1127852,1128768,+,916
485,NZ_CP090948,1,1127850,1128766,+,916
485,NZ_CP069052,1,998904,999820,+,916
485,NZ_CP076228,1,1165822,1166747,-,925
485,NZ_CP042445,1,1127840,1128756,+,916
485,NZ_CP042904,1,1199206,1200122,+,916
485,NC_012416,1,1244421,1245337,+,916
485,NZ_CP069053,1,997725,998642,-,917
485,NZ_CP042446,1,1127850,1128766,+,916
485,NZ_CP041215,1,152066,152982,+,916
485,NZ_OX366353,1,683783,684700,-,917
485,NZ_OX366387,1,168126,169042,+,916
485,NZ_OX366368,1,140862,141778,+,916
485,NZ_OX366379,1,140960,141876,+,916
485,NZ_CP091195,1,1283281,1284187,+,906
485,NZ_OX366375,1,143854,144770,+,916
485,NZ_CP046925,1,1127700,1128616,+,916
485,NZ_OX366318,1,135943,136859,+,916
485,NZ_OX366319,1,1059916,1060833,-,917
485,NZ_OX366332,1,139485,140401,+,916
485,NZ_CP110359,1,125321,126237,+,916
485,NZ_OU953855,1,516734,517650,+,916
485,NZ_OX366272,1,95169,96085,+,916
485,NZ_OX366347,1,248930,249851,+,921
485,NZ_OU909470,1,1065246,1066162,+,916
485,NZ_OX366363,1,1132294,1133210,+,916
485,NZ_OX366364,1,1332189,1333105,+,916
485,NZ_OX366359,1,138610,139526,+,916
485,NZ_OX366349,1,1692037,1692953,+,916
485,NZ_OX366380,1,274175,275091,+,916
485,NZ_OX366344,1,759812,760728,+,916
485,NZ_CP090900,1,1127853,1128769,+,916
485,NZ_OX366352,1,1551004,1551921,-,917
485,NZ_OX366362,1,1287264,1288179,-,915
485,NZ_OX366400,1,34114,35031,-,917
485,NZ_OX366327,1,138417,139333,+,916
485,NZ_OX366367,1,1131463,1132380,-,917
485,NZ_CP042444,1,1129206,1130122,+,916
485,NZ_OX366326,1,139649,140565,+,916
485,NZ_CP037426,1,1002149,1003066,-,917
485,NZ_OX366339,1,1161254,1162170,+,916
485,NZ_OX366355,1,1176691,1177608,-,917
485,NZ_CP046922,1,1189664,1190580,+,916
485,NZ_OX366370,1,1228456,1229365,+,909
485,NZ_OX366385,1,244877,245793,+,916
485,NZ_OX366399,1,140363,141279,+,916
485,NZ_OX366395,1,280648,281564,+,916
485,NZ_OX366396,1,686106,687022,+,916
485,NZ_OX366351,1,147064,147980,+,916
485,NZ_OX366381,1,1243572,1244489,-,917
485,NZ_OX366342,1,291940,292857,-,917
485,NZ_OX366369,1,136811,137727,+,916
485,NZ_OX366356,1,172010,172924,+,914
485,NZ_OX366377,1,143340,144256,+,916
485,NZ_OX366388,1,1732324,1733230,+,906
485,NZ_OX366357,1,368681,369550,+,869
485,NZ_CP072012,1,1175168,1176085,-,917
485,NZ_OX366398,1,790130,791046,+,916
485,NC_002978,6,1127850,1128766,+,916
485,NZ_OX366389,1,108415,109332,-,917
485,NZ_OX366397,1,139316,140232,+,916
485,NZ_OX366378,1,83860,84766,+,906
485,NZ_CP090903,1,1127853,1128769,+,916
485,NZ_OX366374,1,83026,83942,+,916
485,NZ_CP090901,1,1127853,1128769,+,916
485,NZ_CP046923,1,1105912,1106828,+,916
485,NZ_CP069055,1,1127778,1128702,+,924
485,NZ_CP072670,1,1127680,1128596,+,916
485,NZ_CP090899,1,1127853,1128769,+,916
485,NZ_CP046924,1,1126850,1127766,+,916
485,NZ_OX366348,1,1111910,1112827,-,917
485,NZ_CP046921,1,1189664,1190580,+,916
485,NZ_OX366338,1,309273,310188,-,915
485,NZ_CP054557,1,680836,681753,-,917
485,NZ_CP072669,1,1127700,1128616,+,916
485,NC_021089,1,1155718,1156634,+,916
486,NZ_OX366376,1,1523034,1523801,+,767
486,NZ_OX366393,1,1473250,1474017,+,767
486,NZ_OX366372,1,1428484,1429251,+,767
486,NZ_CP072672,1,1128636,1129403,+,767
486,NZ_CP069060,1,996925,997692,-,767
486,NZ_CP072667,1,1128610,1129377,+,767
486,NZ_CP072671,1,1128618,1129385,+,767
486,NZ_CP072668,1,1128605,1129372,+,767
486,NZ_CP072666,1,1128618,1129385,+,767
486,NZ_CP090902,1,1128770,1129537,+,767
486,NZ_CP090948,1,1128768,1129535,+,767
486,NZ_CP069052,1,999822,1000589,+,767
486,NZ_CP076228,1,1165062,1165820,-,758
486,NZ_CP042445,1,1128758,1129525,+,767
486,NZ_CP042904,1,1200124,1200890,+,766
486,NC_012416,1,1245339,1246105,+,766
486,NZ_CP069053,1,996957,997724,-,767
486,NZ_CP042446,1,1128768,1129535,+,767
486,NZ_CP041215,1,152984,153750,+,766
486,NZ_OX366353,1,683016,683782,-,766
486,NZ_OX366387,1,169044,169810,+,766
486,NZ_OX366368,1,141780,142547,+,767
486,NZ_OX366379,1,141878,142645,+,767
486,NZ_CP091195,1,1284189,1284939,+,750
486,NZ_OX366375,1,144772,145522,+,750
486,NZ_CP046925,1,1128618,1129385,+,767
486,NZ_OX366318,1,136861,137628,+,767
486,NZ_OX366319,1,1059149,1059915,-,766
486,NZ_OX366332,1,140403,141169,+,766
486,NZ_CP110359,1,126239,127006,+,767
486,NZ_OU953855,1,517652,518402,+,750
486,NZ_OX366272,1,96087,96837,+,750
486,NZ_OX366347,1,249853,250603,+,750
486,NZ_OU909470,1,1066164,1066916,+,752
486,NZ_OX366363,1,1133212,1133979,+,767
486,NZ_OX366364,1,1333107,1333861,+,754
486,NZ_OX366359,1,139528,140294,+,766
486,NZ_OX366349,1,1692955,1693722,+,767
486,NZ_OX366380,1,275093,275854,+,761
486,NZ_OX366344,1,760730,761497,+,767
486,NZ_CP090900,1,1128771,1129538,+,767
486,NZ_OX366352,1,1550237,1551003,-,766
486,NZ_OX366362,1,1286519,1287263,-,744
486,NZ_OX366400,1,33346,34113,-,767
486,NZ_OX366327,1,139335,140101,+,766
486,NZ_OX366367,1,1130708,1131462,-,754
486,NZ_CP042444,1,1130124,1130891,+,767
486,NZ_OX366326,1,140567,141334,+,767
486,NZ_CP037426,1,1001397,1002148,-,751
486,NZ_OX366339,1,1162172,1162922,+,750
486,NZ_OX366355,1,1175924,1176690,-,766
486,NZ_CP046922,1,1190582,1191349,+,767
486,NZ_OX366370,1,1230495,1231242,+,747
486,NZ_OX366385,1,245795,246556,+,761
486,NZ_OX366399,1,141281,142048,+,767
486,NZ_OX366395,1,281566,282315,+,749
486,NZ_OX366396,1,687024,687791,+,767
486,NZ_OX366351,1,147982,148749,+,767
486,NZ_OX366381,1,1242805,1243571,-,766
486,NZ_OX366342,1,291172,291939,-,767
486,NZ_OX366369,1,137729,138495,+,766
486,NZ_OX366356,1,172926,173676,+,750
486,NZ_OX366377,1,144258,145008,+,750
486,NZ_OX366388,1,1733232,1733982,+,750
486,NZ_OX366357,1,369552,370318,+,766
486,NZ_CP072012,1,1174400,1175167,-,767
486,NZ_OX366398,1,791048,791798,+,750
486,NC_002978,6,1128768,1129535,+,767
486,NZ_OX366389,1,107663,108414,-,751
486,NZ_OX366397,1,140234,141000,+,766
486,NZ_OX366378,1,84768,85518,+,750
486,NZ_CP090903,1,1128771,1129538,+,767
486,NZ_OX366374,1,83944,84694,+,750
486,NZ_CP090901,1,1128771,1129538,+,767
486,NZ_CP046923,1,1106830,1107597,+,767
486,NZ_CP069055,1,1128704,1129462,+,758
486,NZ_CP072670,1,1128598,1129365,+,767
486,NZ_CP090899,1,1128771,1129538,+,767
486,NZ_CP046924,1,1127768,1128535,+,767
486,NZ_OX366348,1,1111158,1111909,-,751
486,NZ_CP046921,1,1190582,1191349,+,767
486,NZ_OX366338,1,308522,309272,-,750
486,NZ_CP054557,1,680084,680835,-,751
486,NZ_CP072669,1,1128618,1129385,+,767
486,NC_021089,1,1156636,1157402,+,766
487,NZ_OX366376,1,1526335,1530568,+,4233
487,NZ_OX366393,1,1476550,1480783,+,4233
487,NZ_OX366372,1,1431785,1436018,+,4233
487,NZ_CP072672,1,981258,985544,+,4286
487,NZ_CP069060,1,826065,830351,+,4286
487,NZ_CP072667,1,981232,985518,+,4286
487,NZ_CP072671,1,981240,985526,+,4286
487,NZ_CP072668,1,981227,985513,+,4286
487,NZ_CP072666,1,981240,985526,+,4286
487,NZ_CP090902,1,981392,985678,+,4286
487,NZ_CP090948,1,981392,985678,+,4286
487,NZ_CP069052,1,825720,830006,-,4286
487,NZ_CP076228,1,998341,1002624,-,4283
487,NZ_CP042445,1,981380,985666,+,4286
487,NZ_CP042904,1,1006446,1010732,+,4286
487,NC_012416,1,1049003,1053289,+,4286
487,NZ_CP069053,1,826073,830359,+,4286
487,NZ_CP042446,1,981390,985676,+,4286
487,NZ_CP041215,1,3087,7177,-,4090
487,NZ_OX366353,1,1131246,1135313,-,4067
487,NZ_OX366387,1,1774215,1778501,+,4286
487,NZ_OX366368,1,1426912,1431198,+,4286
487,NZ_OX366379,1,1346357,1350643,+,4286
487,NZ_CP091195,1,1090679,1094965,-,4286
487,NZ_OX366375,1,1288009,1292295,+,4286
487,NZ_CP046925,1,981240,985526,+,4286
487,NZ_OX366318,1,1277217,1281307,+,4090
487,NZ_OX366319,1,1264435,1268721,+,4286
487,NZ_OX366332,1,1361010,1365100,+,4090
487,NZ_CP110359,1,213752,217842,+,4090
487,NZ_OU953855,1,551545,555831,+,4286
487,NZ_OX366272,1,1375867,1379957,+,4090
487,NZ_OX366347,1,1424176,1428439,+,4263
487,NZ_OU909470,1,936967,941196,-,4229
487,NZ_OX366363,1,998873,1003130,+,4257
487,NZ_OX366364,1,1348069,1352259,+,4190
487,NZ_OX366359,1,1190285,1194375,+,4090
487,NZ_OX366349,1,1696590,1700823,+,4233
487,NZ_OX366380,1,1322820,1327081,+,4261
487,NZ_OX366344,1,1347257,1351490,+,4233
487,NZ_CP090900,1,981392,985678,+,4286
487,NZ_OX366352,1,1684737,1688827,+,4090
487,NZ_OX366362,1,1478432,1482631,+,4199
487,NZ_OX366400,1,1134745,1138835,+,4090
487,NZ_OX366327,1,1275314,1279600,+,4286
487,NZ_OX366367,1,1527913,1532103,+,4190
487,NZ_CP042444,1,982746,987032,+,4286
487,NZ_OX366326,1,1486828,1490918,+,4090
487,NZ_CP037426,1,1169573,1173859,+,4286
487,NZ_OX366339,1,125076,129362,+,4286
487,NZ_OX366355,1,1370927,1375213,+,4286
487,NZ_CP046922,1,1043288,1047574,+,4286
487,NZ_OX366370,1,1266625,1270848,+,4223
487,NZ_OX366385,1,1338460,1342721,+,4261
487,NZ_OX366399,1,1379973,1384259,+,4286
487,NZ_OX366395,1,1549239,1553496,+,4257
487,NZ_OX366396,1,516024,520310,-,4286
487,NZ_OX366351,1,1431797,1435887,+,4090
487,NZ_OX366381,1,1424625,1428911,+,4286
487,NZ_OX366342,1,284406,288639,-,4233
487,NZ_OX366369,1,1471346,1475632,+,4286
487,NZ_OX366356,1,1143644,1147872,+,4228
487,NZ_OX366377,1,979441,983702,-,4261
487,NZ_OX366388,1,1803875,1808161,+,4286
487,NZ_OX366357,1,1364580,1368866,+,4286
487,NZ_CP072012,1,1243316,1247602,+,4286
487,NZ_OX366398,1,463107,467393,+,4286
487,NC_002978,6,981392,985678,+,4286
487,NZ_OX366389,1,1359471,1363757,+,4286
487,NZ_OX366397,1,1587195,1591285,+,4090
487,NZ_OX366378,1,1291847,1296133,+,4286
487,NZ_CP090903,1,981392,985678,+,4286
487,NZ_OX366374,1,383481,387680,+,4199
487,NZ_CP090901,1,981392,985678,+,4286
487,NZ_CP046923,1,959536,963822,+,4286
487,NZ_CP069055,1,1056717,1060945,-,4228
487,NZ_CP072670,1,981232,985518,+,4286
487,NZ_CP090899,1,981392,985678,+,4286
487,NZ_CP046924,1,980474,984760,+,4286
487,NZ_OX366348,1,1257835,1262061,+,4226
487,NZ_CP046921,1,1043288,1047574,+,4286
487,NZ_OX366338,1,1495422,1499679,+,4257
487,NZ_CP054557,1,776409,780691,+,4282
487,NZ_CP072669,1,981240,985526,+,4286
487,NC_021089,1,1010580,1014681,+,4101
488,NZ_OX366376,1,1530569,1532092,+,1523
488,NZ_OX366393,1,1480784,1482307,+,1523
488,NZ_OX366372,1,1436019,1437542,+,1523
488,NZ_CP072672,1,985545,987068,+,1523
488,NZ_CP069060,1,830352,831875,+,1523
488,NZ_CP072667,1,985519,987042,+,1523
488,NZ_CP072671,1,985527,987050,+,1523
488,NZ_CP072668,1,985514,987037,+,1523
488,NZ_CP072666,1,985527,987050,+,1523
488,NZ_CP090902,1,985679,987202,+,1523
488,NZ_CP090948,1,985679,987202,+,1523
488,NZ_CP069052,1,824195,825718,-,1523
488,NZ_CP076228,1,996816,998339,-,1523
488,NZ_CP042445,1,985667,987190,+,1523
488,NZ_CP042904,1,1010733,1012256,+,1523
488,NC_012416,1,1053290,1054813,+,1523
488,NZ_CP069053,1,830360,831883,+,1523
488,NZ_CP042446,1,985677,987200,+,1523
488,NZ_CP041215,1,1562,3085,-,1523
488,NZ_OX366353,1,1129721,1131244,-,1523
488,NZ_OX366387,1,1778502,1780025,+,1523
488,NZ_OX366368,1,1431199,1432722,+,1523
488,NZ_OX366379,1,1350644,1352167,+,1523
488,NZ_CP091195,1,1089154,1090677,-,1523
488,NZ_OX366375,1,1292296,1293819,+,1523
488,NZ_CP046925,1,985527,987050,+,1523
488,NZ_OX366318,1,1281308,1282831,+,1523
488,NZ_OX366319,1,1268722,1270245,+,1523
488,NZ_OX366332,1,1365101,1366624,+,1523
488,NZ_CP110359,1,217843,219366,+,1523
488,NZ_OU953855,1,555832,557355,+,1523
488,NZ_OX366272,1,1379958,1381481,+,1523
488,NZ_OX366347,1,1428440,1429963,+,1523
488,NZ_OU909470,1,935442,936965,-,1523
488,NZ_OX366363,1,1003131,1004654,+,1523
488,NZ_OX366364,1,1352260,1353783,+,1523
488,NZ_OX366359,1,1194376,1195899,+,1523
488,NZ_OX366349,1,1700824,1702347,+,1523
488,NZ_OX366380,1,1327082,1328605,+,1523
488,NZ_OX366344,1,1351491,1353014,+,1523
488,NZ_CP090900,1,985679,987202,+,1523
488,NZ_OX366352,1,1688828,1690351,+,1523
488,NZ_OX366362,1,1482632,1484155,+,1523
488,NZ_OX366400,1,1138836,1140359,+,1523
488,NZ_OX366327,1,1279601,1281124,+,1523
488,NZ_OX366367,1,1532104,1533627,+,1523
488,NZ_CP042444,1,987033,988556,+,1523
488,NZ_OX366326,1,1490919,1492442,+,1523
488,NZ_CP037426,1,1173860,1175399,+,1539
488,NZ_OX366339,1,129363,130886,+,1523
488,NZ_OX366355,1,1375214,1376737,+,1523
488,NZ_CP046922,1,1047575,1049098,+,1523
488,NZ_OX366370,1,1270849,1272372,+,1523
488,NZ_OX366385,1,1342722,1344245,+,1523
488,NZ_OX366399,1,1384260,1385783,+,1523
488,NZ_OX366395,1,1553497,1555020,+,1523
488,NZ_OX366396,1,514499,516022,-,1523
488,NZ_OX366351,1,1435888,1437411,+,1523
488,NZ_OX366381,1,1428912,1430435,+,1523
488,NZ_OX366342,1,282880,284404,-,1524
488,NZ_OX366369,1,1475633,1477156,+,1523
488,NZ_OX366356,1,1147873,1149396,+,1523
488,NZ_OX366377,1,1267591,1269129,+,1538
488,NZ_OX366388,1,1808162,1809685,+,1523
488,NZ_OX366357,1,1368867,1370390,+,1523
488,NZ_CP072012,1,1247603,1249126,+,1523
488,NZ_OX366398,1,467394,468917,+,1523
488,NC_002978,6,985679,987202,+,1523
488,NZ_OX366389,1,1363758,1365281,+,1523
488,NZ_OX366397,1,1591286,1592809,+,1523
488,NZ_OX366378,1,1296134,1297657,+,1523
488,NZ_CP090903,1,985679,987202,+,1523
488,NZ_OX366374,1,387681,389204,+,1523
488,NZ_CP090901,1,985679,987202,+,1523
488,NZ_CP046923,1,963823,965346,+,1523
488,NZ_CP069055,1,1055192,1056715,-,1523
488,NZ_CP072670,1,985519,987042,+,1523
488,NZ_CP090899,1,985679,987202,+,1523
488,NZ_CP046924,1,984761,986284,+,1523
488,NZ_OX366348,1,1262062,1263585,+,1523
488,NZ_CP046921,1,1047575,1049098,+,1523
488,NZ_OX366338,1,1499680,1501203,+,1523
488,NZ_CP054557,1,780692,782215,+,1523
488,NZ_CP072669,1,985527,987050,+,1523
488,NC_021089,1,1014682,1016205,+,1523
489,NZ_OX366376,1,1532388,1533480,+,1092
489,NZ_OX366393,1,1482603,1483695,+,1092
489,NZ_OX366372,1,1437838,1438922,+,1084
489,NZ_CP072672,1,987364,988466,+,1102
489,NZ_CP069060,1,832171,833273,+,1102
489,NZ_CP072667,1,987338,988440,+,1102
489,NZ_CP072671,1,987346,988448,+,1102
489,NZ_CP072668,1,987333,988435,+,1102
489,NZ_CP072666,1,987346,988448,+,1102
489,NZ_CP090902,1,987498,988600,+,1102
489,NZ_CP090948,1,987498,988600,+,1102
489,NZ_CP069052,1,822798,823900,-,1102
489,NZ_CP076228,1,995419,996521,-,1102
489,NZ_CP042445,1,987486,988588,+,1102
489,NZ_CP042904,1,1012552,1013654,+,1102
489,NC_012416,1,1055109,1056211,+,1102
489,NZ_CP069053,1,832179,833281,+,1102
489,NZ_CP042446,1,987496,988598,+,1102
489,NZ_CP041215,1,165,1267,-,1102
489,NZ_OX366353,1,1128324,1129426,-,1102
489,NZ_OX366387,1,1780321,1781423,+,1102
489,NZ_OX366368,1,1433018,1434120,+,1102
489,NZ_OX366379,1,1352463,1353565,+,1102
489,NZ_CP091195,1,1087757,1088859,-,1102
489,NZ_OX366375,1,1294115,1295217,+,1102
489,NZ_CP046925,1,987346,988448,+,1102
489,NZ_OX366318,1,1283127,1284229,+,1102
489,NZ_OX366319,1,1270541,1271643,+,1102
489,NZ_OX366332,1,1366920,1368022,+,1102
489,NZ_CP110359,1,219684,220764,+,1080
489,NZ_OU953855,1,557651,558753,+,1102
489,NZ_OX366272,1,1381777,1382879,+,1102
489,NZ_OX366347,1,1430259,1431361,+,1102
489,NZ_OU909470,1,934063,935147,-,1084
489,NZ_OX366363,1,1004950,1006052,+,1102
489,NZ_OX366364,1,1354079,1355171,+,1092
489,NZ_OX366359,1,1196195,1197297,+,1102
489,NZ_OX366349,1,1702643,1703727,+,1084
489,NZ_OX366380,1,1328901,1329985,+,1084
489,NZ_OX366344,1,1353310,1354402,+,1092
489,NZ_CP090900,1,987498,988600,+,1102
489,NZ_OX366352,1,1690647,1691749,+,1102
489,NZ_OX366362,1,1484451,1485550,+,1099
489,NZ_OX366400,1,1140655,1141757,+,1102
489,NZ_OX366327,1,1281420,1282522,+,1102
489,NZ_OX366367,1,1533923,1535015,+,1092
489,NZ_CP042444,1,988852,989954,+,1102
489,NZ_OX366326,1,1492738,1493840,+,1102
489,NZ_CP037426,1,1176600,1177702,+,1102
489,NZ_OX366339,1,1358407,1359487,+,1080
489,NZ_OX366355,1,1377033,1378135,+,1102
489,NZ_CP046922,1,1049394,1050496,+,1102
489,NZ_OX366370,1,1272668,1273752,+,1084
489,NZ_OX366385,1,1344541,1345625,+,1084
489,NZ_OX366399,1,1386079,1387181,+,1102
489,NZ_OX366395,1,1555316,1556421,+,1105
489,NZ_OX366396,1,1525661,1526740,+,1079
489,NZ_OX366351,1,1437707,1438809,+,1102
489,NZ_OX366381,1,1430731,1431833,+,1102
489,NZ_OX366342,1,281493,282585,-,1092
489,NZ_OX366369,1,1477452,1478554,+,1102
489,NZ_OX366356,1,1149692,1150794,+,1102
489,NZ_OX366377,1,1269425,1270527,+,1102
489,NZ_OX366388,1,1809981,1811083,+,1102
489,NZ_OX366357,1,1370686,1371793,+,1107
489,NZ_CP072012,1,1249422,1250524,+,1102
489,NZ_OX366398,1,469213,470315,+,1102
489,NC_002978,6,987498,988600,+,1102
489,NZ_OX366389,1,1365577,1366679,+,1102
489,NZ_OX366397,1,1593105,1594207,+,1102
489,NZ_OX366378,1,1297953,1299055,+,1102
489,NZ_CP090903,1,987498,988600,+,1102
489,NZ_OX366374,1,389500,390607,+,1107
489,NZ_CP090901,1,987498,988600,+,1102
489,NZ_CP046923,1,965642,966744,+,1102
489,NZ_CP069055,1,1053795,1054897,-,1102
489,NZ_CP072670,1,987338,988440,+,1102
489,NZ_CP090899,1,987498,988600,+,1102
489,NZ_CP046924,1,986580,987682,+,1102
489,NZ_OX366348,1,1263881,1264983,+,1102
489,NZ_CP046921,1,1049394,1050496,+,1102
489,NZ_OX366338,1,1501499,1502604,+,1105
489,NZ_CP054557,1,782511,783613,+,1102
489,NZ_CP072669,1,987346,988448,+,1102
489,NC_021089,1,1016501,1017603,+,1102
490,NZ_OX366393,1,269505,270116,+,611
490,NZ_CP072672,1,505044,505655,-,611
490,NZ_CP069060,1,1230435,1231045,-,610
490,NZ_CP072667,1,505026,505637,-,611
490,NZ_CP072671,1,505026,505637,-,611
490,NZ_CP072668,1,505013,505624,-,611
490,NZ_CP072666,1,505026,505637,-,611
490,NZ_CP090902,1,505178,505789,-,611
490,NZ_CP090948,1,505178,505789,-,611
490,NZ_CP069052,1,676435,677045,-,610
490,NZ_CP042445,1,505178,505789,-,611
490,NZ_CP069053,1,1110620,1111230,-,610
490,NZ_CP042446,1,505178,505789,-,611
490,NZ_CP046925,1,505026,505637,-,611
490,NZ_CP090900,1,505178,505789,-,611
490,NZ_CP042444,1,505679,506290,-,611
490,NZ_CP046922,1,394929,395540,+,611
490,NZ_CP046922,1,415867,416478,+,611
490,NZ_CP046922,1,436805,437416,+,611
490,NZ_CP046922,1,457743,458354,+,611
490,NC_002978,6,505178,505789,-,611
490,NZ_CP090903,1,505178,505789,-,611
490,NZ_CP090901,1,505178,505789,-,611
490,NZ_CP072670,1,505018,505629,-,611
490,NZ_CP090899,1,505178,505789,-,611
490,NZ_CP046924,1,394929,395540,+,611
490,NZ_CP046921,1,394929,395540,+,611
490,NZ_CP046921,1,415867,416478,+,611
490,NZ_CP046921,1,436805,437416,+,611
490,NZ_CP046921,1,457743,458354,+,611
490,NZ_CP072669,1,505026,505637,-,611
491,NZ_OX366393,1,270990,278054,+,7064
491,NZ_CP072672,1,497090,504185,-,7095
491,NZ_CP069060,1,1222298,1229571,-,7273
491,NZ_CP072667,1,497072,504167,-,7095
491,NZ_CP072671,1,497072,504167,-,7095
491,NZ_CP072668,1,497059,504154,-,7095
491,NZ_CP072666,1,497072,504167,-,7095
491,NZ_CP090902,1,497224,504319,-,7095
491,NZ_CP090948,1,497224,504319,-,7095
491,NZ_CP069052,1,668298,675571,-,7273
491,NZ_CP042445,1,497224,504319,-,7095
491,NZ_CP069053,1,1102483,1109756,-,7273
491,NZ_CP042446,1,497224,504319,-,7095
491,NZ_CP046925,1,497072,504167,-,7095
491,NZ_OU953855,1,1190970,1198044,+,7074
491,NZ_CP090900,1,497224,504319,-,7095
491,NZ_CP042444,1,497725,504820,-,7095
491,NZ_CP046922,1,396399,403494,+,7095
491,NZ_CP046922,1,417337,424432,+,7095
491,NZ_CP046922,1,438275,445370,+,7095
491,NZ_CP046922,1,459213,466308,+,7095
491,NC_002978,6,497224,504319,-,7095
491,NZ_CP090903,1,497224,504319,-,7095
491,NZ_CP090901,1,497224,504319,-,7095
491,NZ_CP072670,1,497064,504159,-,7095
491,NZ_CP090899,1,497224,504319,-,7095
491,NZ_CP046924,1,396399,403494,+,7095
491,NZ_CP046921,1,396399,403494,+,7095
491,NZ_CP046921,1,417337,424432,+,7095
491,NZ_CP046921,1,438275,445370,+,7095
491,NZ_CP046921,1,459213,466308,+,7095
491,NZ_CP072669,1,497072,504167,-,7095
492,NZ_OX366393,1,286876,287948,+,1072
492,NZ_OX366387,1,205481,206547,-,1066
492,NZ_OX366387,1,351705,352768,-,1063
492,NZ_OX366319,1,349187,350251,+,1064
492,NZ_OX366319,1,577840,578904,-,1064
492,NZ_OX366332,1,641015,642079,+,1064
492,NZ_OX366332,1,723643,724707,+,1064
492,NZ_OU953855,1,1250957,1252021,+,1064
492,NZ_OX366272,1,396193,397257,-,1064
492,NZ_OX366349,1,1185852,1186915,+,1063
492,NZ_OX366352,1,1340947,1342013,+,1066
492,NZ_OX366367,1,489754,490821,+,1067
492,NZ_OX366355,1,363890,364954,+,1064
492,NZ_OX366355,1,755837,756901,-,1064
492,NZ_OX366381,1,463662,464726,+,1064
492,NZ_OX366381,1,751787,752851,-,1064
492,NZ_OX366381,1,814864,815928,-,1064
492,NZ_OX366369,1,851474,852540,-,1066
492,NZ_OX366369,1,915227,916291,-,1064
492,NZ_OX366369,1,1006386,1007450,-,1064
492,NZ_OX366377,1,717053,718130,+,1077
492,NZ_OX366388,1,1143186,1144253,-,1067
492,NZ_OX366398,1,1234143,1235220,-,1077
492,NZ_OX366389,1,893281,894358,-,1077
492,NZ_OX366338,1,91599,92661,+,1062
492,NZ_OX366338,1,210315,211377,+,1062
492,NZ_OX366338,1,432337,433399,+,1062
492,NZ_OX366338,1,583815,584877,-,1062
492,NZ_OX366338,1,1044708,1045770,-,1062
493,NZ_OX366393,1,416500,417421,+,921
493,NZ_OX366368,1,861619,862540,+,921
493,NZ_OX366379,1,683326,684247,-,921
493,NZ_CP091195,1,40019,40940,+,921
493,NZ_OU953855,1,1254765,1255698,-,933
493,NZ_OX366399,1,788722,789643,+,921
493,NZ_OX366378,1,522426,523347,+,921
494,NZ_OX366393,1,420059,421174,+,1115
494,NZ_CP041215,1,272932,274046,-,1114
494,NZ_CP041215,1,1101001,1102115,-,1114
494,NZ_OX366353,1,885746,886860,-,1114
494,NZ_OX366387,1,128513,129628,+,1115
494,NZ_OX366362,1,708231,709345,-,1114
494,NZ_OX366369,1,973654,974769,+,1115
495,NZ_OX366393,1,429656,430513,+,857
495,NZ_OX366272,1,1011487,1012341,+,854
495,NZ_OX366363,1,21151,22011,-,860
495,NZ_OX366362,1,122022,122876,+,854
495,NZ_OX366399,1,646892,647752,-,860
495,NZ_OX366395,1,215272,216132,+,860
495,NZ_OX366395,1,1172075,1172935,+,860
495,NZ_OX366342,1,870889,871746,-,857
496,NZ_OX366393,1,431006,432738,+,1732
496,NZ_OX366342,1,868662,870395,-,1733
497,NZ_OX366393,1,817384,818086,+,702
497,NZ_OX366368,1,560171,560876,+,705
498,NZ_OX366393,1,827846,828370,+,524
498,NZ_OX366387,1,258330,258848,-,518
498,NZ_OX366387,1,322960,323478,-,518
498,NZ_OX366388,1,1117850,1118368,-,518
499,NZ_OX366393,1,830771,831478,+,707
499,NZ_CP069060,1,1207355,1208061,-,706
499,NZ_CP069052,1,653355,654061,-,706
499,NZ_CP069053,1,1087540,1088246,-,706
499,NZ_OX366387,1,255213,255920,-,707
499,NZ_OX366349,1,980431,981138,-,707
499,NZ_OX366399,1,603539,604246,+,707
499,NZ_OX366377,1,749923,750619,+,696
499,NZ_OX366388,1,876506,877213,+,707
499,NZ_OX366388,1,1072885,1073592,+,707
499,NZ_CP072012,1,843577,844274,-,697
499,NZ_OX366398,1,1280225,1280921,+,696
500,NZ_OX366393,1,840599,841338,+,739
500,NZ_OX366370,1,693097,693789,+,692
500,NZ_OX366399,1,613327,614064,+,737
500,NZ_OX366369,1,943353,944097,-,744
501,NZ_OX366393,1,849428,850745,+,1317
501,NZ_OX366369,1,935255,936619,-,1364
502,NZ_OX366393,1,883467,884132,+,665
502,NZ_OX366319,1,594876,595527,+,651
502,NZ_OX366355,1,605860,606510,+,650
502,NZ_OX366369,1,581125,581775,-,650
503,NZ_OX366393,1,892088,892734,+,646
503,NZ_OX366372,1,83580,84231,+,651
503,NZ_CP041215,1,330549,331200,-,651
503,NZ_CP110359,1,647076,647727,-,651
503,NZ_OU953855,1,1113270,1113916,-,646
503,NZ_OX366347,1,782120,782762,-,642
503,NZ_OX366347,1,1140568,1141210,-,642
503,NZ_OX366344,1,792982,793628,-,646
503,NZ_OX366352,1,493251,493902,+,651
503,NZ_OX366367,1,414452,415103,-,651
503,NZ_OX366326,1,1027090,1027741,+,651
503,NZ_CP037426,1,373270,373921,-,651
503,NZ_OX366355,1,639113,639764,+,651
503,NZ_OX366370,1,688593,689244,+,651
503,NZ_OX366370,1,1260636,1261287,+,651
503,NZ_OX366395,1,166596,167247,+,651
503,NZ_OX366395,1,498620,499252,+,632
503,NZ_OX366395,1,961553,962204,-,651
503,NZ_OX366396,1,123507,124158,+,651
503,NZ_OX366351,1,890848,891499,-,651
503,NZ_OX366381,1,508271,508922,-,651
503,NZ_OX366381,1,770668,771319,+,651
503,NZ_OX366342,1,181842,182488,-,646
503,NZ_OX366388,1,433346,433997,-,651
503,NC_021089,1,423193,423844,+,651
504,NZ_OX366393,1,895762,896477,+,715
504,NZ_OX366372,1,87279,87989,+,710
504,NZ_CP072672,1,570863,571569,-,706
504,NZ_CP069060,1,1104426,1105132,-,706
504,NZ_CP072667,1,570845,571551,-,706
504,NZ_CP072671,1,570845,571551,-,706
504,NZ_CP072668,1,570832,571538,-,706
504,NZ_CP072666,1,570845,571551,-,706
504,NZ_CP090902,1,570997,571703,-,706
504,NZ_CP090948,1,570997,571703,-,706
504,NZ_CP069052,1,550661,551367,-,706
504,NZ_CP076228,1,536008,536715,+,707
504,NZ_CP042445,1,570985,571691,-,706
504,NZ_CP069053,1,1125487,1126193,+,706
504,NZ_CP042446,1,570997,571703,-,706
504,NZ_CP041215,1,326780,327487,-,707
504,NZ_OX366387,1,489003,489697,-,694
504,NZ_OX366387,1,852286,852980,-,694
504,NZ_OX366387,1,1220803,1221497,+,694
504,NZ_OX366368,1,887269,887984,+,715
504,NZ_OX366379,1,593671,594386,-,715
504,NZ_CP091195,1,411187,411903,-,716
504,NZ_OX366375,1,459802,460517,-,715
504,NZ_CP046925,1,570845,571551,-,706
504,NZ_OX366332,1,698340,699038,-,698
504,NZ_CP110359,1,643319,644021,-,702
504,NZ_OU953855,1,1109497,1110212,-,715
504,NZ_OU953855,1,1231739,1232454,-,715
504,NZ_OX366363,1,328767,329482,+,715
504,NZ_OX366363,1,1359048,1359763,-,715
504,NZ_OX366364,1,629551,630257,-,706
504,NZ_OX366349,1,1356240,1356946,-,706
504,NZ_OX366344,1,789239,789954,-,715
504,NZ_CP090900,1,570997,571703,-,706
504,NZ_OX366352,1,796807,797513,+,706
504,NZ_CP042444,1,571534,572240,-,706
504,NZ_OX366355,1,642817,643523,+,706
504,NZ_CP046922,1,632711,633417,-,706
504,NZ_OX366399,1,1012767,1013482,+,715
504,NZ_OX366395,1,957786,958496,-,710
504,NZ_OX366369,1,562242,562948,-,706
504,NZ_OX366388,1,427959,428674,-,715
504,NZ_OX366357,1,1064231,1064946,+,715
504,NZ_CP072012,1,828032,828729,+,697
504,NC_002978,6,570997,571703,-,706
504,NZ_CP090903,1,570997,571703,-,706
504,NZ_CP090901,1,570997,571703,-,706
504,NZ_CP046923,1,548959,549665,-,706
504,NZ_CP069055,1,280172,280878,-,706
504,NZ_CP072670,1,570837,571543,-,706
504,NZ_CP090899,1,570997,571703,-,706
504,NZ_CP046924,1,569897,570603,-,706
504,NZ_OX366348,1,618267,618973,+,706
504,NZ_CP046921,1,632711,633417,-,706
504,NZ_CP072669,1,570845,571551,-,706
504,NC_021089,1,426897,427603,+,706
505,NZ_OX366393,1,900502,901029,+,527
505,NZ_OX366372,1,92017,92544,+,527
505,NZ_CP072672,1,565422,565948,-,526
505,NZ_CP069060,1,1099897,1100423,-,526
505,NZ_CP072667,1,565404,565930,-,526
505,NZ_CP072671,1,565404,565930,-,526
505,NZ_CP072668,1,565391,565917,-,526
505,NZ_CP072666,1,565404,565930,-,526
505,NZ_CP090902,1,565556,566082,-,526
505,NZ_CP090948,1,565556,566082,-,526
505,NZ_CP069052,1,546132,546658,-,526
505,NZ_CP076228,1,540740,541267,+,527
505,NZ_CP042445,1,565544,566070,-,526
505,NZ_CP069053,1,1130195,1130722,+,527
505,NZ_CP042446,1,565556,566082,-,526
505,NZ_CP041215,1,322228,322754,-,526
505,NZ_OX366387,1,484448,484974,-,526
505,NZ_OX366387,1,847731,848257,-,526
505,NZ_OX366387,1,1225525,1226052,+,527
505,NZ_OX366368,1,892009,892536,+,527
505,NZ_OX366379,1,589119,589645,-,526
505,NZ_CP091195,1,406628,407154,-,526
505,NZ_OX366375,1,491027,491554,+,527
505,NZ_CP046925,1,565404,565930,-,526
505,NZ_OX366332,1,693788,694314,-,526
505,NZ_CP110359,1,638763,639289,-,526
505,NZ_OU953855,1,1104945,1105471,-,526
505,NZ_OU953855,1,1227188,1227714,-,526
505,NZ_OX366363,1,333507,334034,+,527
505,NZ_OX366363,1,1354496,1355022,-,526
505,NZ_OX366364,1,624994,625520,-,526
505,NZ_OX366349,1,1351688,1352214,-,526
505,NZ_OX366344,1,784687,785213,-,526
505,NZ_CP090900,1,565556,566082,-,526
505,NZ_OX366352,1,886830,887356,-,526
505,NZ_CP042444,1,566093,566619,-,526
505,NZ_OX366355,1,649532,650059,+,527
505,NZ_CP046922,1,627270,627796,-,526
505,NZ_OX366399,1,1017507,1018034,+,527
505,NZ_OX366395,1,953231,953757,-,526
505,NZ_OX366369,1,557690,558216,-,526
505,NZ_OX366388,1,421415,421941,-,526
505,NZ_OX366357,1,1068974,1069501,+,527
505,NZ_CP072012,1,832754,833281,+,527
505,NC_002978,6,565556,566082,-,526
505,NZ_CP090903,1,565556,566082,-,526
505,NZ_CP090901,1,565556,566082,-,526
505,NZ_CP046923,1,543518,544044,-,526
505,NZ_CP069055,1,275619,276144,-,525
505,NZ_CP072670,1,565396,565922,-,526
505,NZ_CP090899,1,565556,566082,-,526
505,NZ_CP046924,1,564456,564982,-,526
505,NZ_OX366348,1,622998,623525,+,527
505,NZ_CP046921,1,627270,627796,-,526
505,NZ_CP072669,1,565404,565930,-,526
505,NC_021089,1,431628,432155,+,527
506,NZ_OX366393,1,910015,910622,+,607
506,NZ_CP072672,1,555648,556247,-,599
506,NZ_CP069060,1,1084004,1084607,+,603
506,NZ_CP069060,1,1089223,1089822,-,599
506,NZ_CP069060,1,1204771,1205374,+,603
506,NZ_CP072667,1,555630,556229,-,599
506,NZ_CP072671,1,555630,556229,-,599
506,NZ_CP072668,1,555617,556216,-,599
506,NZ_CP072666,1,555630,556229,-,599
506,NZ_CP090902,1,555782,556381,-,599
506,NZ_CP090948,1,555782,556381,-,599
506,NZ_CP069052,1,535438,536037,-,599
506,NZ_CP069052,1,651690,652293,+,603
506,NZ_CP076228,1,550457,551063,+,606
506,NZ_CP042445,1,555770,556369,-,599
506,NZ_CP069053,1,1084956,1085559,+,603
506,NZ_CP069053,1,1140798,1141397,+,599
506,NZ_CP042446,1,555782,556381,-,599
506,NZ_OX366387,1,253547,254154,+,607
506,NZ_CP046925,1,555630,556229,-,599
506,NZ_OU953855,1,1095146,1095745,-,599
506,NZ_OX366363,1,1341694,1342293,-,599
506,NZ_OX366364,1,615402,616009,-,607
506,NZ_OX366349,1,736048,736662,-,614
506,NZ_OX366349,1,1055832,1056439,+,607
506,NZ_OX366344,1,118360,118967,-,607
506,NZ_CP090900,1,555782,556381,-,599
506,NZ_OX366352,1,63363,63964,-,601
506,NZ_OX366352,1,874804,875403,-,599
506,NZ_OX366367,1,453625,454232,-,607
506,NZ_CP042444,1,556319,556918,-,599
506,NZ_CP037426,1,402524,403123,+,599
506,NZ_CP046922,1,617496,618095,-,599
506,NZ_OX366369,1,952078,952685,+,607
506,NZ_OX366357,1,827840,828430,+,590
506,NC_002978,6,555782,556381,-,599
506,NZ_OX366397,1,550489,551088,-,599
506,NZ_OX366397,1,625567,626174,-,607
506,NZ_CP090903,1,555782,556381,-,599
506,NZ_CP090901,1,555782,556381,-,599
506,NZ_CP046923,1,533744,534343,-,599
506,NZ_CP069055,1,265796,266403,-,607
506,NZ_CP072670,1,555622,556221,-,599
506,NZ_CP090899,1,555782,556381,-,599
506,NZ_CP046924,1,554682,555281,-,599
506,NZ_CP046921,1,617496,618095,-,599
506,NZ_CP072669,1,555630,556229,-,599
506,NC_021089,1,441355,441953,+,598
507,NZ_OX366372,1,38493,40697,+,2204
507,NZ_OX366395,1,212759,214964,-,2205
507,NZ_OX366395,1,1169562,1171767,-,2205
508,NZ_OX366372,1,41028,46179,+,5151
508,NZ_OX366395,1,207262,212512,-,5250
508,NZ_OX366395,1,1164065,1169315,-,5250
509,NZ_OX366372,1,46860,47711,+,851
509,NZ_OX366344,1,80962,81795,-,833
509,NZ_OX366395,1,205731,206582,-,851
509,NZ_OX366395,1,492873,493724,+,851
509,NZ_OX366395,1,1162534,1163385,-,851
510,NZ_OX366372,1,50370,50936,+,566
510,NZ_OX366370,1,723075,723639,-,564
511,NZ_OX366372,1,56860,57402,+,542
511,NZ_OX366344,1,91208,91750,+,542
511,NZ_OX366395,1,716651,717193,+,542
512,NZ_OX366372,1,57406,58805,+,1399
512,NZ_OX366344,1,92836,94235,+,1399
512,NZ_OX366395,1,717197,718596,+,1399
513,NZ_OX366372,1,61161,61814,+,653
513,NZ_OX366395,1,504693,505346,+,653
514,NZ_OX366372,1,62150,63245,+,1095
514,NZ_OX366395,1,505682,506777,+,1095
515,NZ_OX366372,1,63482,65782,+,2300
515,NZ_OX366395,1,488837,491232,-,2395
516,NZ_OX366372,1,112925,113607,+,682
516,NZ_OX366272,1,681061,681745,-,684
516,NZ_OX366344,1,875489,876170,-,681
516,NZ_OX366395,1,924837,925518,-,681
516,NZ_OX366357,1,1215416,1216102,+,686
516,NZ_OX366397,1,470500,471184,-,684
517,NZ_OX366372,1,114430,115228,+,798
517,NZ_OX366387,1,271097,271885,+,788
517,NZ_OX366387,1,558270,559062,+,792
517,NZ_OX366272,1,679440,680238,-,798
517,NZ_OX366347,1,1188956,1189754,-,798
517,NZ_OX366344,1,873867,874665,-,798
517,NZ_OX366352,1,117357,118151,-,794
517,NZ_OX366352,1,1389623,1390411,+,788
517,NZ_OX366399,1,582681,583479,-,798
517,NZ_OX366395,1,923216,924014,-,798
517,NZ_OX366369,1,1062417,1063215,+,798
517,NZ_OX366357,1,1216820,1217600,+,780
517,NZ_OX366397,1,468918,469677,-,759
518,NZ_OX366372,1,116496,117206,+,710
518,NZ_OX366387,1,273190,273900,+,710
518,NZ_OX366272,1,677473,678131,-,658
518,NZ_OX366347,1,1186962,1187672,-,710
518,NZ_OX366344,1,871898,872609,-,711
518,NZ_OX366352,1,115369,116027,-,658
518,NZ_OX366352,1,1391716,1392426,+,710
518,NZ_OX366399,1,580747,581458,-,711
518,NZ_OX366395,1,921238,921948,-,710
518,NZ_OX366369,1,1064489,1065199,+,710
518,NZ_OX366357,1,1218892,1219603,+,711
518,NZ_OX366397,1,466912,467623,-,711
519,NZ_OX366372,1,123570,125084,+,1514
519,NZ_OX366372,1,221073,222587,-,1514
519,NZ_OX366370,1,665387,666901,+,1514
519,NZ_OX366395,1,510729,512243,+,1514
519,NZ_OX366395,1,719869,721383,+,1514
520,NZ_OX366372,1,125351,127548,+,2197
520,NZ_OX366370,1,667159,669293,+,2134
520,NZ_OX366395,1,512510,514751,+,2241
520,NZ_OX366395,1,721650,723847,+,2197
521,NZ_OX366372,1,128411,130031,+,1620
521,NZ_OX366372,1,213614,215233,-,1619
521,NZ_OX366370,1,670154,671775,+,1621
521,NZ_OX366395,1,516813,518433,+,1620
521,NZ_OX366395,1,724710,726330,+,1620
522,NZ_OX366372,1,142478,143446,+,968
522,NZ_OX366372,1,200507,201475,-,968
522,NZ_OX366272,1,1035016,1035989,+,973
522,NZ_OX366349,1,1040744,1041712,+,968
522,NZ_OX366326,1,299405,300373,-,968
522,NZ_OX366395,1,172820,173788,+,968
522,NZ_OX366396,1,129713,130560,+,847
522,NZ_OX366351,1,883455,884423,-,968
523,NZ_OX366372,1,151734,152684,+,950
523,NZ_OX366372,1,191270,192220,-,950
523,NZ_OX366387,1,83477,84435,+,958
523,NZ_OX366332,1,605100,606043,-,943
523,NZ_OX366370,1,701531,702474,+,943
523,NZ_OX366395,1,182039,182989,+,950
523,NZ_OX366351,1,874296,875210,-,914
523,NZ_OX366398,1,1295659,1296573,-,914
524,NZ_OX366372,1,154609,155429,+,820
524,NZ_OX366372,1,188524,189345,-,821
524,NZ_OX366377,1,761509,762330,-,821
524,NZ_OX366398,1,1292868,1293689,-,821
525,NZ_OX366372,1,156284,157451,+,1167
525,NZ_OX366372,1,186503,187670,-,1167
525,NZ_OX366387,1,89704,90909,+,1205
525,NZ_OX366332,1,600408,601572,-,1164
525,NZ_OX366370,1,705940,707104,+,1164
525,NZ_OX366395,1,186505,187672,+,1167
525,NZ_OX366377,1,759488,760655,-,1167
525,NZ_OX366398,1,1290847,1292014,-,1167
526,NZ_OX366372,1,157539,158131,+,592
526,NZ_OX366372,1,185823,186415,-,592
526,NZ_OX366387,1,90997,91581,+,584
526,NZ_OX366332,1,599725,600320,-,595
526,NZ_OX366370,1,707194,707775,+,581
526,NZ_OX366395,1,187760,188358,+,598
526,NZ_OX366377,1,758802,759400,-,598
526,NZ_OX366398,1,1289310,1289908,-,598
527,NZ_OX366372,1,173734,175251,+,1517
527,NZ_OX366395,1,940193,941716,+,1523
528,NZ_CP072672,1,30170,30780,+,610
528,NZ_CP069060,1,30284,30895,+,611
528,NZ_CP072667,1,30170,30780,+,610
528,NZ_CP072671,1,30170,30780,+,610
528,NZ_CP072668,1,30170,30780,+,610
528,NZ_CP072666,1,30170,30780,+,610
528,NZ_CP090902,1,30322,30932,+,610
528,NZ_CP090948,1,30322,30932,+,610
528,NZ_CP069052,1,30284,30895,+,611
528,NZ_CP076228,1,30228,30839,+,611
528,NZ_CP042445,1,30322,30932,+,610
528,NZ_CP069053,1,30284,30895,+,611
528,NZ_CP042446,1,30322,30932,+,610
528,NZ_OX366387,1,532828,533438,+,610
528,NZ_OX366368,1,312297,312908,+,611
528,NZ_OX366379,1,313315,313926,+,611
528,NZ_CP046925,1,30170,30780,+,610
528,NZ_OX366318,1,403603,404214,+,611
528,NZ_CP110359,1,30211,30821,+,610
528,NZ_OX366272,1,886216,886825,-,609
528,NZ_OX366347,1,420966,421576,+,610
528,NZ_OX366363,1,624283,624892,-,609
528,NZ_CP090900,1,30322,30932,+,610
528,NZ_OX366400,1,312829,313440,+,611
528,NZ_CP042444,1,30322,30933,+,611
528,NZ_OX366326,1,482242,482852,-,610
528,NZ_CP046922,1,30170,30781,+,611
528,NZ_OX366399,1,311799,312410,+,611
528,NZ_OX366351,1,323129,323740,+,611
528,NZ_OX366356,1,341215,341825,+,610
528,NZ_OX366377,1,273119,273729,-,610
528,NZ_OX366357,1,710802,711411,-,609
528,NZ_CP072012,1,1005047,1005657,-,610
528,NZ_OX366398,1,879910,880520,-,610
528,NC_002978,6,30322,30932,+,610
528,NZ_OX366389,1,370321,370929,+,608
528,NZ_CP090903,1,30322,30932,+,610
528,NZ_OX366374,1,1119543,1120152,-,609
528,NZ_CP090901,1,30322,30932,+,610
528,NZ_CP046923,1,30170,30781,+,611
528,NZ_CP069055,1,30379,30990,+,611
528,NZ_CP072670,1,30170,30780,+,610
528,NZ_CP090899,1,30322,30932,+,610
528,NZ_CP046924,1,30170,30781,+,611
528,NZ_OX366348,1,938722,939332,-,610
528,NZ_CP046921,1,30170,30781,+,611
528,NZ_CP054557,1,431592,432203,+,611
528,NZ_CP072669,1,30170,30780,+,610
529,NZ_CP072672,1,86110,87245,+,1135
529,NZ_CP069060,1,96797,97934,+,1137
529,NZ_CP072667,1,86110,87245,+,1135
529,NZ_CP072671,1,86110,87245,+,1135
529,NZ_CP072668,1,86110,87245,+,1135
529,NZ_CP072666,1,86110,87245,+,1135
529,NZ_CP090902,1,86262,87397,+,1135
529,NZ_CP090948,1,86262,87397,+,1135
529,NZ_CP069052,1,142197,143334,-,1137
529,NZ_CP076228,1,90588,91724,+,1136
529,NZ_CP042445,1,86262,87397,+,1135
529,NZ_CP042904,1,154851,155988,-,1137
529,NC_012416,1,157433,158570,-,1137
529,NZ_CP069053,1,449343,450480,-,1137
529,NZ_CP042446,1,86262,87397,+,1135
529,NZ_CP041215,1,508561,509708,-,1147
529,NZ_OX366353,1,444278,445425,-,1147
529,NZ_OX366368,1,367361,368498,+,1137
529,NZ_OX366379,1,368379,369516,+,1137
529,NZ_OX366375,1,445166,446303,-,1137
529,NZ_CP046925,1,86110,87245,+,1135
529,NZ_OX366318,1,531929,533075,-,1146
529,NZ_OX366332,1,430512,431659,-,1147
529,NZ_CP110359,1,1086946,1088083,+,1137
529,NZ_OX366272,1,597576,598713,-,1137
529,NZ_OX366347,1,544193,545339,-,1146
529,NZ_OX366363,1,486719,487865,+,1146
529,NZ_OX366359,1,349672,350819,+,1147
529,NZ_CP090900,1,86262,87397,+,1135
529,NZ_OX366352,1,390010,391157,-,1147
529,NZ_OX366400,1,727471,728617,+,1146
529,NZ_OX366327,1,580474,581621,-,1147
529,NZ_CP042444,1,86263,87398,+,1135
529,NZ_OX366326,1,359281,360427,+,1146
529,NZ_CP037426,1,721356,722493,+,1137
529,NZ_CP046922,1,86096,87231,+,1135
529,NZ_OX366399,1,366863,368000,+,1137
529,NZ_OX366395,1,1475236,1476382,-,1146
529,NZ_OX366351,1,446622,447768,-,1146
529,NZ_OX366377,1,535197,536334,-,1137
529,NZ_CP072012,1,949454,950591,-,1137
529,NZ_OX366398,1,1024130,1025267,+,1137
529,NC_002978,6,86262,87397,+,1135
529,NZ_OX366389,1,532161,533298,+,1137
529,NZ_OX366397,1,421738,422885,+,1147
529,NZ_CP090903,1,86262,87397,+,1135
529,NZ_CP090901,1,86262,87397,+,1135
529,NZ_CP046923,1,86096,87231,+,1135
529,NZ_CP069055,1,137966,139103,-,1137
529,NZ_CP072670,1,86110,87245,+,1135
529,NZ_CP090899,1,86262,87397,+,1135
529,NZ_CP046924,1,86096,87231,+,1135
529,NZ_OX366348,1,821632,822778,+,1146
529,NZ_CP046921,1,86096,87231,+,1135
529,NZ_CP054557,1,1155829,1156975,-,1146
529,NZ_CP072669,1,86110,87245,+,1135
529,NC_021089,1,149855,151002,-,1147
530,NZ_CP072672,1,134143,134666,+,523
530,NZ_CP069060,1,144391,144914,+,523
530,NZ_CP072667,1,134125,134648,+,523
530,NZ_CP072671,1,134125,134648,+,523
530,NZ_CP072668,1,134125,134648,+,523
530,NZ_CP072666,1,134125,134648,+,523
530,NZ_CP090902,1,134277,134800,+,523
530,NZ_CP090948,1,134277,134800,+,523
530,NZ_CP069052,1,95217,95740,-,523
530,NZ_CP076228,1,138041,138564,+,523
530,NZ_CP042445,1,134277,134800,+,523
530,NZ_CP069053,1,402363,402886,-,523
530,NZ_CP042446,1,134277,134800,+,523
530,NZ_OX366368,1,413056,413579,+,523
530,NZ_OX366379,1,414074,414597,+,523
530,NZ_CP046925,1,134125,134648,+,523
530,NZ_OX366318,1,488573,489096,-,523
530,NZ_OU953855,1,38788,39306,-,518
530,NZ_OU953855,1,1679093,1679611,-,518
530,NZ_OX366380,1,1201076,1201599,-,523
530,NZ_CP090900,1,134277,134800,+,523
530,NZ_OX366362,1,83637,84160,+,523
530,NZ_CP042444,1,134215,134738,+,523
530,NZ_OX366326,1,406257,406780,+,523
530,NZ_CP046922,1,133970,134493,+,523
530,NZ_OX366399,1,412558,413081,+,523
530,NZ_OX366351,1,402325,402848,-,523
530,NZ_CP072012,1,335460,335983,+,523
530,NC_002978,6,134277,134800,+,523
530,NZ_CP090903,1,134277,134800,+,523
530,NZ_CP090901,1,134277,134800,+,523
530,NZ_CP046923,1,133970,134493,+,523
530,NZ_CP069055,1,91364,91887,-,523
530,NZ_CP072670,1,134125,134648,+,523
530,NZ_CP090899,1,134277,134800,+,523
530,NZ_CP046924,1,133970,134493,+,523
530,NZ_CP046921,1,133970,134493,+,523
530,NZ_CP072669,1,134125,134648,+,523
531,NZ_CP072672,1,260057,260562,+,505
531,NZ_CP072667,1,260039,260544,+,505
531,NZ_CP072671,1,260039,260544,+,505
531,NZ_CP072668,1,260039,260544,+,505
531,NZ_CP072666,1,260039,260544,+,505
531,NZ_CP090902,1,260191,260696,+,505
531,NZ_CP090948,1,260191,260696,+,505
531,NZ_CP076228,1,625721,626232,-,511
531,NZ_CP076228,1,657863,658369,-,506
531,NZ_CP042445,1,260191,260696,+,505
531,NZ_CP042446,1,260191,260696,+,505
531,NZ_OX366368,1,943829,944335,-,506
531,NZ_OX366379,1,942363,942869,-,506
531,NZ_CP046925,1,260039,260544,+,505
531,NZ_CP090900,1,260191,260696,+,505
531,NZ_CP042444,1,259773,260278,+,505
531,NZ_CP046922,1,259888,260393,+,505
531,NZ_OX366399,1,935561,936067,-,506
531,NZ_CP072012,1,123116,123621,+,505
531,NC_002978,6,260191,260696,+,505
531,NZ_CP090903,1,260191,260696,+,505
531,NZ_CP090901,1,260191,260696,+,505
531,NZ_CP046923,1,259888,260393,+,505
531,NZ_CP069055,1,621364,621870,-,506
531,NZ_CP072670,1,260039,260544,+,505
531,NZ_CP090899,1,260191,260696,+,505
531,NZ_CP046924,1,259888,260393,+,505
531,NZ_CP046921,1,259888,260393,+,505
531,NZ_CP072669,1,260039,260544,+,505
531,NC_021089,1,299654,300158,+,504
531,NC_021089,1,413611,414116,-,505
531,NC_021089,1,655394,655899,-,505
532,NZ_CP072672,1,268577,271241,+,2664
532,NZ_CP069060,1,252037,254701,+,2664
532,NZ_CP072667,1,268559,271223,+,2664
532,NZ_CP072671,1,268559,271223,+,2664
532,NZ_CP072668,1,268559,271223,+,2664
532,NZ_CP072666,1,268559,271223,+,2664
532,NZ_CP090902,1,268711,271375,+,2664
532,NZ_CP090948,1,268711,271375,+,2664
532,NZ_CP069052,1,246702,249366,+,2664
532,NZ_CP076228,1,615576,618228,-,2652
532,NZ_CP076228,1,647187,649843,-,2656
532,NZ_CP042445,1,268711,271375,+,2664
532,NZ_CP069053,1,292576,295240,-,2664
532,NZ_CP042446,1,268711,271375,+,2664
532,NZ_OX366368,1,933227,935814,-,2587
532,NZ_OX366379,1,931761,934348,-,2587
532,NZ_CP046925,1,268559,271223,+,2664
532,NZ_CP090900,1,268711,271375,+,2664
532,NZ_CP042444,1,268293,270957,+,2664
532,NZ_CP046922,1,268408,271072,+,2664
532,NZ_OX366399,1,924959,927546,-,2587
532,NZ_CP072012,1,131637,134301,+,2664
532,NC_002978,6,268711,271375,+,2664
532,NZ_CP090903,1,268711,271375,+,2664
532,NZ_CP090901,1,268711,271375,+,2664
532,NZ_CP046923,1,268408,271072,+,2664
532,NZ_CP069055,1,610612,613276,-,2664
532,NZ_CP072670,1,268559,271223,+,2664
532,NZ_CP090899,1,268711,271375,+,2664
532,NZ_CP046924,1,268408,271072,+,2664
532,NZ_CP046921,1,268408,271072,+,2664
532,NZ_CP072669,1,268559,271223,+,2664
532,NC_021089,1,308174,310838,+,2664
533,NZ_CP072672,1,271670,272544,+,874
533,NZ_CP069060,1,255130,256004,+,874
533,NZ_CP072667,1,271652,272526,+,874
533,NZ_CP072671,1,271652,272526,+,874
533,NZ_CP072668,1,271652,272526,+,874
533,NZ_CP072666,1,271652,272526,+,874
533,NZ_CP090902,1,271804,272678,+,874
533,NZ_CP090948,1,271804,272678,+,874
533,NZ_CP069052,1,249795,250669,+,874
533,NZ_CP076228,1,614275,615146,-,871
533,NZ_CP076228,1,645885,646758,-,873
533,NZ_CP042445,1,271804,272678,+,874
533,NZ_CP069053,1,291272,292146,-,874
533,NZ_CP042446,1,271804,272678,+,874
533,NZ_OX366368,1,931923,932797,-,874
533,NZ_OX366379,1,930457,931331,-,874
533,NZ_CP046925,1,271652,272526,+,874
533,NZ_CP090900,1,271804,272678,+,874
533,NZ_CP042444,1,271386,272260,+,874
533,NZ_CP046922,1,271501,272375,+,874
533,NZ_OX366399,1,923655,924529,-,874
533,NZ_CP072012,1,134730,135604,+,874
533,NC_002978,6,271804,272678,+,874
533,NZ_CP090903,1,271804,272678,+,874
533,NZ_CP090901,1,271804,272678,+,874
533,NZ_CP046923,1,271501,272375,+,874
533,NZ_CP069055,1,609308,610182,-,874
533,NZ_CP072670,1,271652,272526,+,874
533,NZ_CP090899,1,271804,272678,+,874
533,NZ_CP046924,1,271501,272375,+,874
533,NZ_CP046921,1,271501,272375,+,874
533,NZ_CP072669,1,271652,272526,+,874
533,NC_021089,1,311267,312141,+,874
534,NZ_CP072672,1,272744,273668,+,924
534,NZ_CP069060,1,256204,257140,+,936
534,NZ_CP072667,1,272726,273650,+,924
534,NZ_CP072671,1,272726,273650,+,924
534,NZ_CP072668,1,272726,273650,+,924
534,NZ_CP072666,1,272726,273650,+,924
534,NZ_CP090902,1,272878,273802,+,924
534,NZ_CP090948,1,272878,273802,+,924
534,NZ_CP069052,1,250869,251805,+,936
534,NZ_CP076228,1,613140,614075,-,935
534,NZ_CP076228,1,644753,645686,-,933
534,NZ_CP042445,1,272878,273802,+,924
534,NZ_CP069053,1,290136,291072,-,936
534,NZ_CP042446,1,272878,273802,+,924
534,NZ_OX366368,1,930787,931723,-,936
534,NZ_OX366379,1,929321,930257,-,936
534,NZ_CP046925,1,272726,273650,+,924
534,NZ_CP090900,1,272878,273802,+,924
534,NZ_CP042444,1,272460,273384,+,924
534,NZ_CP046922,1,272575,273499,+,924
534,NZ_OX366399,1,922519,923455,-,936
534,NZ_CP072012,1,135804,136740,+,936
534,NC_002978,6,272878,273802,+,924
534,NZ_CP090903,1,272878,273802,+,924
534,NZ_CP090901,1,272878,273802,+,924
534,NZ_CP046923,1,272575,273499,+,924
534,NZ_CP069055,1,608172,609108,-,936
534,NZ_CP072670,1,272726,273650,+,924
534,NZ_CP090899,1,272878,273802,+,924
534,NZ_CP046924,1,272575,273499,+,924
534,NZ_CP046921,1,272575,273499,+,924
534,NZ_CP072669,1,272726,273650,+,924
534,NC_021089,1,312341,313277,+,936
535,NZ_CP072672,1,295024,295780,+,756
535,NZ_CP069060,1,278693,279449,+,756
535,NZ_CP072667,1,295006,295762,+,756
535,NZ_CP072671,1,295006,295762,+,756
535,NZ_CP072668,1,295006,295762,+,756
535,NZ_CP072666,1,295006,295762,+,756
535,NZ_CP090902,1,295158,295914,+,756
535,NZ_CP090948,1,295158,295914,+,756
535,NZ_CP069052,1,273358,274114,+,756
535,NZ_CP076228,1,445009,445764,-,755
535,NZ_CP042445,1,295158,295914,+,756
535,NZ_CP042904,1,500436,501192,+,756
535,NC_012416,1,503755,504511,+,756
535,NZ_CP069053,1,267828,268583,-,755
535,NZ_CP042446,1,295158,295914,+,756
535,NZ_CP041215,1,811693,812448,-,755
535,NZ_OX366353,1,331541,332297,+,756
535,NZ_OX366387,1,1611199,1611954,-,755
535,NZ_OX366368,1,644797,645553,+,756
535,NZ_OX366379,1,899484,900239,-,755
535,NZ_CP091195,1,254355,255110,-,755
535,NZ_OX366375,1,721854,722609,-,755
535,NZ_CP046925,1,295006,295762,+,756
535,NZ_OX366318,1,854749,855504,-,755
535,NZ_OX366319,1,550135,550890,-,755
535,NZ_OX366332,1,978912,979668,+,756
535,NZ_CP110359,1,886510,887265,-,755
535,NZ_OU953855,1,1390821,1391577,+,756
535,NZ_OX366272,1,350091,350846,-,755
535,NZ_OX366347,1,674170,674926,+,756
535,NZ_OU909470,1,662272,663027,-,755
535,NZ_OX366363,1,58778,59534,+,756
535,NZ_OX366364,1,993207,993962,-,755
535,NZ_OX366359,1,809456,810212,+,756
535,NZ_OX366380,1,1181082,1181838,+,756
535,NZ_CP090900,1,295158,295914,+,756
535,NZ_OX366352,1,739936,740692,+,756
535,NZ_OX366362,1,1190923,1191678,-,755
535,NZ_OX366400,1,409785,410540,-,755
535,NZ_OX366327,1,895665,896421,-,756
535,NZ_OX366367,1,560629,561385,+,756
535,NZ_CP042444,1,294740,295496,+,756
535,NZ_OX366326,1,950701,951456,-,755
535,NZ_CP037426,1,567739,568494,-,755
535,NZ_OX366339,1,676518,677274,+,756
535,NZ_OX366355,1,564637,565392,-,755
535,NZ_CP046922,1,294856,295612,+,756
535,NZ_OX366370,1,899667,900422,+,755
535,NZ_OX366385,1,604049,604805,+,756
535,NZ_OX366399,1,892651,893406,-,755
535,NZ_OX366395,1,1112877,1113633,+,756
535,NZ_OX366351,1,958408,959163,-,755
535,NZ_OX366381,1,553910,554666,+,756
535,NZ_OX366369,1,622047,622803,+,756
535,NZ_OX366356,1,533901,534657,+,756
535,NZ_OX366377,1,464250,465005,-,755
535,NZ_OX366388,1,527256,528011,-,755
535,NZ_OX366357,1,989821,990577,+,756
535,NZ_CP072012,1,230476,231232,+,756
535,NZ_OX366398,1,47035,47791,+,756
535,NC_002978,6,295158,295914,+,756
535,NZ_OX366389,1,959704,960459,-,755
535,NZ_OX366397,1,1060392,1061148,+,756
535,NZ_OX366378,1,654150,654905,-,755
535,NZ_CP090903,1,295158,295914,+,756
535,NZ_CP090901,1,295158,295914,+,756
535,NZ_CP046923,1,294856,295612,+,756
535,NZ_CP069055,1,326902,327658,+,756
535,NZ_CP072670,1,294998,295754,+,756
535,NZ_CP090899,1,295158,295914,+,756
535,NZ_CP046924,1,294856,295612,+,756
535,NZ_OX366348,1,409759,410515,+,756
535,NZ_CP046921,1,294856,295612,+,756
535,NZ_OX366338,1,797218,797974,+,756
535,NZ_CP054557,1,233696,234417,-,721
535,NZ_CP072669,1,295006,295762,+,756
535,NC_021089,1,627970,628726,+,756
536,NZ_CP072672,1,348202,348837,+,635
536,NZ_CP069060,1,336997,337632,+,635
536,NZ_CP072667,1,348184,348819,+,635
536,NZ_CP072671,1,348184,348819,+,635
536,NZ_CP072668,1,348184,348819,+,635
536,NZ_CP072666,1,348184,348819,+,635
536,NZ_CP090902,1,348336,348971,+,635
536,NZ_CP090948,1,348336,348971,+,635
536,NZ_CP069052,1,331670,332305,+,635
536,NZ_CP076228,1,387468,388103,-,635
536,NZ_CP042445,1,348336,348971,+,635
536,NZ_CP042904,1,450507,451142,-,635
536,NC_012416,1,453890,454525,-,635
536,NZ_CP069053,1,209645,210280,-,635
536,NZ_CP042446,1,348336,348971,+,635
536,NZ_CP041215,1,866233,866868,+,635
536,NZ_OX366353,1,71917,72552,-,635
536,NZ_OX366387,1,1203721,1204581,-,860
536,NZ_OX366368,1,703252,703887,+,635
536,NZ_OX366379,1,843293,843928,-,635
536,NZ_OX366375,1,899293,899938,+,645
536,NZ_CP046925,1,348184,348819,+,635
536,NZ_OX366318,1,793290,793925,-,635
536,NZ_OX366319,1,451304,451939,+,635
536,NZ_OX366332,1,930486,931121,-,635
536,NZ_CP110359,1,831249,831883,-,634
536,NZ_OU953855,1,1362292,1362927,+,635
536,NZ_OX366272,1,636365,637000,-,635
536,NZ_OX366347,1,1048710,1049345,-,635
536,NZ_OU909470,1,97776,98411,+,635
536,NZ_OX366363,1,116646,117281,+,635
536,NZ_OX366359,1,761162,761797,-,635
536,NZ_OX366349,1,19727,20330,-,603
536,NZ_OX366380,1,520512,521147,-,635
536,NZ_CP090900,1,348336,348971,+,635
536,NZ_OX366352,1,689968,690603,-,635
536,NZ_OX366400,1,451822,452457,+,635
536,NZ_OX366327,1,841648,842283,-,635
536,NZ_OX366367,1,759075,759710,-,635
536,NZ_CP042444,1,348837,349472,+,635
536,NZ_OX366326,1,889745,890380,-,635
536,NZ_CP037426,1,615049,615694,+,645
536,NZ_OX366339,1,323381,324006,+,625
536,NZ_OX366355,1,504611,505246,-,635
536,NZ_CP046922,1,347980,348615,+,635
536,NZ_OX366385,1,400364,400999,-,635
536,NZ_OX366399,1,834352,834987,-,635
536,NZ_OX366395,1,767245,767880,-,635
536,NZ_OX366396,1,1390147,1390782,+,635
536,NZ_OX366351,1,713385,714020,-,635
536,NZ_OX366381,1,611708,612343,+,635
536,NZ_OX366369,1,678191,678826,+,635
536,NZ_OX366356,1,588234,588973,+,739
536,NZ_OX366377,1,404727,405362,-,635
536,NZ_OX366357,1,550502,551137,-,635
536,NZ_CP072012,1,628134,628769,-,635
536,NZ_OX366398,1,105472,106107,+,635
536,NC_002978,6,348336,348971,+,635
536,NZ_OX366389,1,508115,508750,+,635
536,NZ_OX366397,1,1011957,1012592,-,635
536,NZ_CP090903,1,348336,348971,+,635
536,NZ_CP090901,1,348336,348971,+,635
536,NZ_CP046923,1,347980,348615,+,635
536,NZ_CP069055,1,385317,385952,+,635
536,NZ_CP072670,1,348176,348811,+,635
536,NZ_CP090899,1,348336,348971,+,635
536,NZ_CP046924,1,347980,348615,+,635
536,NZ_OX366348,1,696855,697490,+,635
536,NZ_CP046921,1,347980,348615,+,635
536,NZ_OX366338,1,551539,552174,-,635
536,NZ_CP054557,1,93315,93950,+,635
536,NZ_CP072669,1,348184,348819,+,635
536,NC_021089,1,579360,579995,-,635
537,NZ_CP072672,1,364650,365267,+,617
537,NZ_CP069060,1,353436,354053,+,617
537,NZ_CP072667,1,364632,365249,+,617
537,NZ_CP072671,1,364632,365249,+,617
537,NZ_CP072668,1,364632,365249,+,617
537,NZ_CP072666,1,364632,365249,+,617
537,NZ_CP090902,1,364784,365401,+,617
537,NZ_CP090948,1,364784,365401,+,617
537,NZ_CP069052,1,348109,348726,+,617
537,NZ_CP076228,1,371091,371678,-,587
537,NZ_CP042445,1,364784,365401,+,617
537,NZ_CP069053,1,193224,193841,-,617
537,NZ_CP042446,1,364784,365401,+,617
537,NZ_CP041215,1,882819,883407,+,588
537,NZ_OX366353,1,1306552,1307140,+,588
537,NZ_OX366387,1,1189668,1190285,-,617
537,NZ_OX366368,1,719702,720319,+,617
537,NZ_OX366379,1,826861,827478,-,617
537,NZ_CP091195,1,304820,305411,-,591
537,NZ_CP046925,1,364632,365249,+,617
537,NZ_OX366318,1,777971,778588,-,617
537,NZ_OX366319,1,380776,381377,+,601
537,NZ_OX366332,1,913973,914561,-,588
537,NZ_CP110359,1,814443,815060,-,617
537,NZ_OU953855,1,1738582,1739199,-,617
537,NZ_OX366272,1,612992,613609,+,617
537,NZ_OX366347,1,1030828,1031445,-,617
537,NZ_OX366363,1,133434,134051,+,617
537,NZ_OX366359,1,744631,745219,-,588
537,NZ_CP090900,1,364784,365401,+,617
537,NZ_OX366352,1,415717,416305,+,588
537,NZ_OX366362,1,713735,714327,+,592
537,NZ_CP042444,1,365285,365902,+,617
537,NZ_OX366326,1,873575,874192,-,617
537,NZ_OX366355,1,400911,401512,+,601
537,NZ_CP046922,1,364428,365045,+,617
537,NZ_OX366399,1,817920,818537,-,617
537,NZ_OX366351,1,697215,697832,-,617
537,NZ_OX366381,1,627849,628450,+,601
537,NZ_OX366369,1,693478,694079,+,601
537,NZ_OX366356,1,604914,605531,+,617
537,NZ_OX366377,1,830031,830632,+,601
537,NZ_OX366388,1,564654,565245,+,591
537,NZ_CP072012,1,611711,612328,-,617
537,NZ_OX366398,1,122064,122665,+,601
537,NC_002978,6,364784,365401,+,617
537,NZ_OX366389,1,912116,912717,-,601
537,NZ_OX366397,1,995417,996005,-,588
537,NZ_OX366378,1,405234,405825,-,591
537,NZ_CP090903,1,364784,365401,+,617
537,NZ_CP090901,1,364784,365401,+,617
537,NZ_CP046923,1,364428,365045,+,617
537,NZ_CP069055,1,401776,402395,+,619
537,NZ_CP072670,1,364624,365241,+,617
537,NZ_CP090899,1,364784,365401,+,617
537,NZ_CP046924,1,364428,365045,+,617
537,NZ_OX366348,1,564021,564638,-,617
537,NZ_CP046921,1,364428,365045,+,617
537,NZ_CP054557,1,110827,111444,+,617
537,NZ_CP072669,1,364632,365249,+,617
537,NC_021089,1,562822,563410,-,588
538,NZ_CP072672,1,391560,392453,+,893
538,NZ_CP069060,1,380181,381074,+,893
538,NZ_CP072667,1,391542,392435,+,893
538,NZ_CP072671,1,391542,392435,+,893
538,NZ_CP072668,1,391529,392422,+,893
538,NZ_CP072666,1,391542,392435,+,893
538,NZ_CP090902,1,391694,392587,+,893
538,NZ_CP090948,1,391694,392587,+,893
538,NZ_CP069052,1,490344,491238,-,894
538,NZ_CP076228,1,319767,320661,-,894
538,NZ_CP042445,1,391694,392587,+,893
538,NZ_CP042904,1,355564,356458,-,894
538,NC_012416,1,356655,357549,-,894
538,NZ_CP069053,1,166202,167096,-,894
538,NZ_CP042446,1,391694,392587,+,893
538,NZ_CP041215,1,1149606,1150499,+,893
538,NZ_OX366353,1,366620,367513,+,893
538,NZ_OX366387,1,1162218,1163112,-,894
538,NZ_OX366368,1,841400,842294,-,894
538,NZ_OX366379,1,798839,799733,-,894
538,NZ_CP091195,1,168456,169349,+,893
538,NZ_OX366375,1,497258,498151,+,893
538,NZ_CP046925,1,391542,392435,+,893
538,NZ_OX366318,1,750510,751404,-,894
538,NZ_OX366319,1,539311,540205,-,894
538,NZ_OX366332,1,780288,781181,+,893
538,NZ_CP110359,1,787680,788574,-,894
538,NZ_OU953855,1,1507469,1508362,+,893
538,NZ_OX366272,1,829280,830174,-,894
538,NZ_OX366347,1,904738,905631,+,893
538,NZ_OX366363,1,159239,160132,+,893
538,NZ_OX366359,1,638069,638963,-,894
538,NZ_OX366380,1,1165464,1166357,+,893
538,NZ_CP090900,1,391694,392587,+,893
538,NZ_OX366352,1,449920,450813,+,893
538,NZ_OX366400,1,495106,495999,+,893
538,NZ_OX366327,1,803557,804451,-,894
538,NZ_CP042444,1,392195,393088,+,893
538,NZ_OX366326,1,845329,846223,-,894
538,NZ_CP037426,1,167190,168083,+,893
538,NZ_OX366339,1,412629,413523,-,894
538,NZ_OX366355,1,428194,429087,+,893
538,NZ_CP046922,1,570945,571839,-,894
538,NZ_OX366370,1,287336,288230,-,894
538,NZ_OX366385,1,589284,590177,+,893
538,NZ_OX366399,1,768423,769317,-,894
538,NZ_OX366396,1,1132140,1133034,-,894
538,NZ_OX366351,1,669820,670714,-,894
538,NZ_OX366381,1,696927,697821,-,894
538,NZ_OX366369,1,720117,721003,+,886
538,NZ_OX366377,1,962853,963747,-,894
538,NZ_OX366388,1,589790,590683,+,893
538,NZ_CP072012,1,490491,491384,+,893
538,NZ_OX366398,1,153175,154068,+,893
538,NC_002978,6,391694,392587,+,893
538,NZ_OX366389,1,868152,869046,-,894
538,NZ_OX366397,1,797986,798879,+,893
538,NZ_OX366378,1,393806,394700,-,894
538,NZ_CP090903,1,391694,392587,+,893
538,NZ_CP090901,1,391694,392587,+,893
538,NZ_CP046923,1,487193,488087,-,894
538,NZ_CP069055,1,429391,430284,+,893
538,NZ_CP072670,1,391534,392427,+,893
538,NZ_CP090899,1,391694,392587,+,893
538,NZ_CP046924,1,508131,509025,-,894
538,NZ_OX366348,1,538020,538914,-,894
538,NZ_CP046921,1,570945,571839,-,894
538,NZ_CP054557,1,138845,139738,+,893
538,NZ_CP072669,1,391542,392435,+,893
538,NC_021089,1,497387,498281,-,894
539,NZ_CP072672,1,398469,399162,+,693
539,NZ_CP069060,1,387094,387777,+,683
539,NZ_CP072667,1,398451,399144,+,693
539,NZ_CP072671,1,398451,399144,+,693
539,NZ_CP072668,1,398438,399131,+,693
539,NZ_CP072666,1,398451,399144,+,693
539,NZ_CP090902,1,398603,399296,+,693
539,NZ_CP090948,1,398603,399296,+,693
539,NZ_CP069052,1,483642,484325,-,683
539,NZ_CP076228,1,313746,314429,-,683
539,NZ_CP042445,1,398603,399296,+,693
539,NZ_CP042904,1,349171,349854,-,683
539,NC_012416,1,350262,350945,-,683
539,NZ_CP069053,1,159500,160183,-,683
539,NZ_CP042446,1,398603,399296,+,693
539,NZ_CP041215,1,1156167,1156850,+,683
539,NZ_OX366353,1,373181,373864,+,683
539,NZ_OX366387,1,1154184,1154867,-,683
539,NZ_OX366368,1,834619,835302,-,683
539,NZ_OX366379,1,792112,792795,-,683
539,NZ_CP091195,1,176443,177122,+,679
539,NZ_OX366375,1,504196,504879,+,683
539,NZ_CP046925,1,398451,399144,+,693
539,NZ_OX366318,1,743783,744466,-,683
539,NZ_OX366319,1,532585,533268,-,683
539,NZ_OX366332,1,786841,787524,+,683
539,NZ_CP110359,1,781659,782342,-,683
539,NZ_OU953855,1,1041606,1042289,+,683
539,NZ_OX366272,1,1052651,1053312,-,661
539,NZ_OX366347,1,910970,911653,+,683
539,NZ_OX366363,1,167580,168263,+,683
539,NZ_OX366359,1,631719,632402,-,683
539,NZ_OX366380,1,1156210,1156877,-,667
539,NZ_CP090900,1,398603,399296,+,693
539,NZ_OX366352,1,456473,457156,+,683
539,NZ_OX366400,1,502044,502727,+,683
539,NZ_OX366327,1,797163,797830,-,667
539,NZ_CP042444,1,399104,399797,+,693
539,NZ_OX366326,1,838602,839285,-,683
539,NZ_CP037426,1,174128,174811,+,683
539,NZ_OX366339,1,619740,620423,-,683
539,NZ_OX366355,1,435132,435815,+,683
539,NZ_CP046922,1,564237,564919,-,682
539,NZ_OX366385,1,580961,581628,-,667
539,NZ_OX366399,1,761696,762379,-,683
539,NZ_OX366395,1,797151,797834,+,683
539,NZ_OX366396,1,1075373,1076056,-,683
539,NZ_OX366351,1,663093,663776,-,683
539,NZ_OX366381,1,690200,690883,-,683
539,NZ_OX366369,1,727048,727731,+,683
539,NZ_OX366356,1,636124,636790,+,666
539,NZ_OX366377,1,956126,956809,-,683
539,NZ_OX366388,1,597120,597803,+,683
539,NZ_OX366357,1,775907,776590,-,683
539,NZ_CP072012,1,497429,498112,+,683
539,NZ_OX366398,1,160113,160796,+,683
539,NC_002978,6,398603,399296,+,693
539,NZ_OX366389,1,861468,862151,-,683
539,NZ_OX366397,1,804547,805230,+,683
539,NZ_OX366378,1,386030,386713,-,683
539,NZ_CP090903,1,398603,399296,+,693
539,NZ_OX366374,1,304361,305044,-,683
539,NZ_CP090901,1,398603,399296,+,693
539,NZ_CP046923,1,480485,481167,-,682
539,NZ_CP069055,1,436329,437012,+,683
539,NZ_CP072670,1,398443,399136,+,693
539,NZ_CP090899,1,398603,399296,+,693
539,NZ_CP046924,1,501423,502105,-,682
539,NZ_OX366348,1,531293,531976,-,683
539,NZ_CP046921,1,564237,564919,-,682
539,NZ_OX366338,1,533464,534147,-,683
539,NZ_CP054557,1,145783,146466,+,683
539,NZ_CP072669,1,398451,399144,+,693
539,NC_021089,1,491037,491720,-,683
540,NZ_CP072672,1,404314,404937,+,623
540,NZ_CP069060,1,392929,393552,+,623
540,NZ_CP072667,1,404296,404919,+,623
540,NZ_CP072671,1,404296,404919,+,623
540,NZ_CP072668,1,404283,404906,+,623
540,NZ_CP072666,1,404296,404919,+,623
540,NZ_CP090902,1,404448,405071,+,623
540,NZ_CP090948,1,404448,405071,+,623
540,NZ_CP069052,1,477867,478490,-,623
540,NZ_CP076228,1,307971,308594,-,623
540,NZ_CP042445,1,404448,405071,+,623
540,NZ_CP042904,1,343420,344043,-,623
540,NC_012416,1,344511,345134,-,623
540,NZ_CP069053,1,153725,154348,-,623
540,NZ_CP042446,1,404448,405071,+,623
540,NZ_CP041215,1,1162174,1162804,+,630
540,NZ_OX366353,1,379188,379818,+,630
540,NZ_OX366387,1,1148261,1148891,-,630
540,NZ_OX366368,1,828844,829467,-,623
540,NZ_OX366379,1,786337,786960,-,623
540,NZ_OX366375,1,510296,510926,+,630
540,NZ_CP046925,1,404296,404919,+,623
540,NZ_OX366319,1,526660,527290,-,630
540,NZ_OX366332,1,792848,793478,+,630
540,NZ_OX366359,1,625765,626395,-,630
540,NZ_OX366344,1,676323,676936,+,613
540,NZ_CP090900,1,404448,405071,+,623
540,NZ_OX366352,1,462480,463110,+,630
540,NZ_OX366327,1,791382,792005,-,623
540,NZ_CP042444,1,404949,405572,+,623
540,NZ_CP037426,1,180207,180837,+,630
540,NZ_OX366339,1,613734,614364,-,630
540,NZ_OX366355,1,441110,441740,+,630
540,NZ_CP046922,1,558462,559085,-,623
540,NZ_OX366399,1,755921,756544,-,623
540,NZ_OX366395,1,803329,803959,+,630
540,NZ_OX366396,1,1069367,1069997,-,630
540,NZ_OX366381,1,684275,684905,-,630
540,NZ_OX366369,1,733026,733656,+,630
540,NZ_CP072012,1,503264,503887,+,623
540,NC_002978,6,404448,405071,+,623
540,NZ_OX366397,1,810554,811184,+,630
540,NZ_CP090903,1,404448,405071,+,623
540,NZ_CP090901,1,404448,405071,+,623
540,NZ_CP046923,1,474710,475333,-,623
540,NZ_CP069055,1,442164,442787,+,623
540,NZ_CP072670,1,404288,404911,+,623
540,NZ_CP090899,1,404448,405071,+,623
540,NZ_CP046924,1,495648,496271,-,623
540,NZ_CP046921,1,558462,559085,-,623
540,NZ_CP072669,1,404296,404919,+,623
540,NC_021089,1,485083,485713,-,630
541,NZ_CP072672,1,420061,420892,+,831
541,NZ_CP069060,1,408731,409562,+,831
541,NZ_CP072667,1,420043,420874,+,831
541,NZ_CP072671,1,420043,420874,+,831
541,NZ_CP072668,1,420030,420861,+,831
541,NZ_CP072666,1,420043,420874,+,831
541,NZ_CP090902,1,420195,421026,+,831
541,NZ_CP090948,1,420195,421026,+,831
541,NZ_CP069052,1,461856,462687,-,831
541,NZ_CP076228,1,291932,292763,-,831
541,NZ_CP042445,1,420195,421026,+,831
541,NZ_CP069053,1,137714,138545,-,831
541,NZ_CP042446,1,420195,421026,+,831
541,NZ_OX366368,1,812835,813666,-,831
541,NZ_OX366379,1,770326,771157,-,831
541,NZ_CP046925,1,420043,420874,+,831
541,NZ_CP090900,1,420195,421026,+,831
541,NZ_CP042444,1,420696,421527,+,831
541,NZ_CP046922,1,542506,543337,-,831
541,NZ_OX366399,1,739910,740741,-,831
541,NZ_CP072012,1,519170,520001,+,831
541,NC_002978,6,420195,421026,+,831
541,NZ_CP090903,1,420195,421026,+,831
541,NZ_CP090901,1,420195,421026,+,831
541,NZ_CP046923,1,458754,459585,-,831
541,NZ_CP069055,1,457966,458797,+,831
541,NZ_CP072670,1,420035,420866,+,831
541,NZ_CP090899,1,420195,421026,+,831
541,NZ_CP046924,1,479692,480523,-,831
541,NZ_CP046921,1,542506,543337,-,831
541,NZ_CP072669,1,420043,420874,+,831
