block,genome,chr/contig,start,end,orientation,length
880,WOLB.0323.00014,1,972502,973580,+,1078
880,WOLB.0323.00014,1,1031908,1032986,+,1078
879,WOLB.0323.00070,1,1209252,1209988,+,736
879,WOLB.0323.00042,1,1109615,1110351,+,736
878,WOLB.0323.00070,1,801806,803605,+,1799
878,WOLB.0323.00070,1,1226416,1228215,-,1799
877,WOLB.0323.00070,1,741485,742726,+,1241
877,WOLB.0323.00014,1,982307,983556,+,1249
877,WOLB.0323.00014,1,1041713,1042962,+,1249
876,WOLB.0323.00070,1,733245,740477,+,7232
876,WOLB.0323.00014,1,973912,981145,+,7233
876,WOLB.0323.00014,1,1033318,1040551,+,7233
875,WOLB.0323.00100,1,714200,714784,+,584
875,WOLB.0323.00100,1,775434,776018,+,584
874,WOLB.0323.00007,1,1122126,1122670,+,544
874,WOLB.0323.00014,1,1321074,1321618,+,544
873,WOLB.0323.00010,1,664974,671382,+,6408
873,WOLB.0323.00010,1,1236319,1242725,+,6406
872,WOLB.0323.00010,1,503499,504178,+,679
872,WOLB.0323.00010,1,916662,917338,-,676
871,WOLB.0323.00010,1,499811,500627,+,816
871,WOLB.0323.00010,1,500634,501584,+,950
871,WOLB.0323.00010,1,501591,502439,+,848
871,WOLB.0323.00010,1,502446,503396,+,950
871,WOLB.0323.00010,1,917519,918293,-,774
871,WOLB.0323.00010,1,918398,919168,-,770
870,WOLB.0323.00010,1,497127,499809,+,2682
870,WOLB.0323.00010,1,919185,921911,-,2726
869,WOLB.0323.00010,1,493422,494094,+,672
869,WOLB.0323.00010,1,924132,924786,-,654
869,WOLB.0323.00010,1,929024,929694,-,670
868,WOLB.0323.00010,1,485654,486497,+,843
868,WOLB.0323.00010,1,488630,489474,+,844
868,WOLB.0323.00010,1,491607,492601,+,994
868,WOLB.0323.00010,1,925471,926602,-,1131
868,WOLB.0323.00010,1,930241,931372,-,1131
868,WOLB.0323.00010,1,935412,936548,-,1136
867,WOLB.0323.00018,1,906259,907211,+,952
867,WOLB.0323.00042,1,791040,791954,+,914
866,WOLB.0323.00004,1,552868,554462,+,1594
866,WOLB.0323.00011,1,1263434,1265042,+,1608
866,WOLB.0323.00032,1,61840,63434,+,1594
866,WOLB.0323.00032,1,1514842,1516437,-,1595
866,WOLB.0323.00158,1,1207335,1208929,+,1594
866,WOLB.0323.00104,1,425206,426801,-,1595
866,WOLB.0323.00149,1,1334338,1335932,+,1594
865,WOLB.0323.00122,1,1135004,1136149,+,1145
865,WOLB.0323.00010,1,938046,939196,+,1150
865,WOLB.0323.00128,1,491098,492249,-,1151
865,WOLB.0323.00070,1,1359981,1361132,+,1151
865,WOLB.0323.00042,1,598049,599194,+,1145
864,WOLB.0323.00122,1,284830,285687,+,857
864,WOLB.0323.00122,1,1288863,1289718,+,855
864,WOLB.0323.00122,1,1422894,1423751,+,857
864,WOLB.0323.00122,1,1442153,1443009,-,856
863,WOLB.0323.00043,1,1100160,1102350,+,2190
863,WOLB.0323.00014,1,1094141,1096348,+,2207
862,WOLB.0323.00043,1,616670,618540,+,1870
862,WOLB.0323.00007,1,882840,884701,+,1861
861,WOLB.0323.00043,1,472669,473321,+,652
861,WOLB.0323.00010,1,940738,941407,-,669
861,WOLB.0323.00128,1,488897,489549,+,652
861,WOLB.0323.00070,1,1362681,1363333,-,652
860,WOLB.0323.00043,1,470562,472654,+,2092
860,WOLB.0323.00010,1,941424,943508,-,2084
860,WOLB.0323.00128,1,486797,488882,+,2085
860,WOLB.0323.00070,1,1363348,1365432,-,2084
860,WOLB.0323.00014,1,1217954,1220038,-,2084
859,WOLB.0323.00043,1,456672,459082,+,2410
859,WOLB.0323.00010,1,954807,957212,-,2405
859,WOLB.0323.00128,1,483272,485681,-,2409
859,WOLB.0323.00070,1,1378302,1380711,-,2409
859,WOLB.0323.00014,1,1390278,1392687,-,2409
858,WOLB.0323.00021,1,1209626,1210314,+,688
858,WOLB.0323.00070,1,797360,798048,-,688
858,WOLB.0323.00070,1,1231973,1232661,+,688
857,WOLB.0323.00021,1,368225,368871,+,646
857,WOLB.0323.00068,1,1205978,1206623,-,645
857,WOLB.0323.00042,1,1157602,1158247,-,645
856,WOLB.0323.00021,1,367387,368224,+,837
856,WOLB.0323.00020,1,550761,551613,-,852
856,WOLB.0323.00068,1,1206625,1207462,-,837
856,WOLB.0323.00042,1,1158249,1159086,-,837
855,WOLB.0323.00021,1,364809,366499,+,1690
855,WOLB.0323.00068,1,1208349,1209928,-,1579
855,WOLB.0323.00042,1,1159973,1161553,-,1580
854,WOLB.0323.00084,1,1248997,1249591,+,594
854,WOLB.0323.00122,1,322091,322686,-,595
854,WOLB.0323.00010,1,673553,674146,+,593
854,WOLB.0323.00010,1,1244936,1245530,+,594
853,WOLB.0323.00084,1,1240704,1242160,+,1456
853,WOLB.0323.00122,1,329521,330977,-,1456
852,WOLB.0323.00084,1,160862,163216,+,2354
852,WOLB.0323.00007,1,805816,808057,+,2241
851,WOLB.0323.00133,1,233367,234396,+,1029
851,WOLB.0323.00118,1,632988,634042,-,1054
850,WOLB.0323.00030,1,1117230,1117998,+,768
850,WOLB.0323.00100,1,679468,680237,-,769
850,WOLB.0323.00100,1,740702,741471,-,769
849,WOLB.0323.00030,1,1084196,1085121,+,925
849,WOLB.0323.00007,1,1099819,1100771,+,952
849,WOLB.0323.00042,1,556094,557042,+,948
849,WOLB.0323.00014,1,866826,867766,+,940
848,WOLB.0323.00030,1,446177,451289,+,5112
848,WOLB.0323.00118,1,1097691,1102803,-,5112
847,WOLB.0323.00064,1,1444009,1447881,+,3872
847,WOLB.0323.00030,1,1119566,1123465,-,3899
846,WOLB.0323.00064,1,1441133,1443835,+,2702
846,WOLB.0323.00030,1,1123639,1126341,-,2702
845,WOLB.0323.00064,1,1370299,1371382,+,1083
845,WOLB.0323.00030,1,1536501,1537584,-,1083
844,WOLB.0323.00064,1,1226159,1226812,+,653
844,WOLB.0323.00030,1,1682888,1683541,-,653
843,WOLB.0323.00064,1,450441,451552,+,1111
843,WOLB.0323.00064,1,684082,685193,+,1111
842,WOLB.0323.00064,1,447354,449742,+,2388
842,WOLB.0323.00064,1,680995,683383,+,2388
841,WOLB.0323.00064,1,443785,445504,+,1719
841,WOLB.0323.00064,1,677426,679145,+,1719
840,WOLB.0323.00064,1,383898,384495,+,597
840,WOLB.0323.00030,1,406587,407184,-,597
840,WOLB.0323.00118,1,1091342,1091939,-,597
839,WOLB.0323.00064,1,338151,342133,+,3982
839,WOLB.0323.00010,1,424987,428785,-,3798
838,WOLB.0323.00064,1,337432,338150,+,718
838,WOLB.0323.00010,1,429049,429767,-,718
837,WOLB.0323.00064,1,332560,335649,+,3089
837,WOLB.0323.00010,1,431688,434776,-,3088
836,WOLB.0323.00024,1,2072309,2072896,+,587
836,WOLB.0323.00024,1,2142982,2143569,+,587
836,WOLB.0323.00133,1,268936,269524,-,588
835,WOLB.0323.00024,1,1641441,1642336,+,895
835,WOLB.0323.00043,1,745548,746443,+,895
835,WOLB.0323.00025,1,931331,932242,+,911
835,WOLB.0323.00010,1,549918,550813,+,895
835,WOLB.0323.00042,1,990459,991354,+,895
835,WOLB.0323.00042,1,1165495,1166390,-,895
835,WOLB.0323.00042,1,1533790,1534685,-,895
835,WOLB.0323.00042,1,1683531,1684426,-,895
834,WOLB.0323.00024,1,1556304,1556962,+,658
834,WOLB.0323.00064,1,626166,626816,+,650
834,WOLB.0323.00030,1,881011,881660,-,649
833,WOLB.0323.00024,1,923976,924591,+,615
833,WOLB.0323.00014,1,361030,361645,+,615
833,WOLB.0323.00014,1,1310976,1311591,-,615
832,WOLB.0323.00024,1,232348,233597,+,1249
832,WOLB.0323.00064,1,1235834,1237083,-,1249
832,WOLB.0323.00030,1,1672596,1673844,+,1248
832,WOLB.0323.00018,1,1215911,1216768,-,857
831,WOLB.0323.00008,1,406165,406683,+,518
831,WOLB.0323.00008,1,655051,655569,+,518
831,WOLB.0323.00008,1,732760,733277,-,517
830,WOLB.0323.00008,1,229141,230425,+,1284
830,WOLB.0323.00030,1,372751,374032,+,1281
829,WOLB.0323.00008,1,219703,220709,+,1006
829,WOLB.0323.00021,1,1214322,1215328,+,1006
829,WOLB.0323.00007,1,925616,926622,+,1006
829,WOLB.0323.00014,1,1228582,1229588,+,1006
828,WOLB.0323.00088,1,723933,725011,+,1078
828,WOLB.0323.00020,1,664829,665907,+,1078
828,WOLB.0323.00035,1,661067,662145,+,1078
828,WOLB.0323.00012,1,728035,729113,+,1078
828,WOLB.0323.00104,1,697490,698568,+,1078
828,WOLB.0323.00100,1,1046483,1047561,+,1078
827,WOLB.0323.00088,1,608004,608508,+,504
827,WOLB.0323.00020,1,541549,542053,+,504
827,WOLB.0323.00035,1,543119,543623,+,504
827,WOLB.0323.00012,1,612108,612612,+,504
827,WOLB.0323.00104,1,559781,560285,+,504
827,WOLB.0323.00100,1,866786,867290,+,504
826,WOLB.0323.00088,1,606854,607877,+,1023
826,WOLB.0323.00020,1,540399,541422,+,1023
826,WOLB.0323.00035,1,541969,542992,+,1023
826,WOLB.0323.00012,1,610958,611981,+,1023
826,WOLB.0323.00104,1,558631,559654,+,1023
826,WOLB.0323.00100,1,865636,866659,+,1023
825,WOLB.0323.00093,1,1509002,1510653,+,1651
825,WOLB.0323.00024,1,861435,863077,-,1642
825,WOLB.0323.00024,1,1705676,1707315,+,1639
824,WOLB.0323.00093,1,1508309,1509000,+,691
824,WOLB.0323.00024,1,863078,863769,-,691
823,WOLB.0323.00093,1,1489861,1490395,+,534
823,WOLB.0323.00043,1,730552,731086,+,534
823,WOLB.0323.00010,1,534964,535497,+,533
823,WOLB.0323.00007,1,1135049,1135583,+,534
823,WOLB.0323.00042,1,975415,975949,+,534
823,WOLB.0323.00042,1,1180900,1181434,-,534
823,WOLB.0323.00042,1,1549195,1549729,-,534
823,WOLB.0323.00042,1,1698936,1699470,-,534
822,WOLB.0323.00093,1,1447433,1448520,+,1087
822,WOLB.0323.00133,1,71626,72713,-,1087
821,WOLB.0323.00093,1,1402291,1402881,+,590
821,WOLB.0323.00006,1,119860,120421,-,561
820,WOLB.0323.00093,1,1400990,1401714,+,724
820,WOLB.0323.00006,1,120815,121525,-,710
819,WOLB.0323.00093,1,1371725,1372752,+,1027
819,WOLB.0323.00118,1,798880,799907,+,1027
818,WOLB.0323.00093,1,950836,952927,+,2091
818,WOLB.0323.00008,1,466615,468723,+,2108
817,WOLB.0323.00093,1,921459,922845,+,1386
817,WOLB.0323.00008,1,243200,244688,-,1488
816,WOLB.0323.00093,1,888786,889643,+,857
816,WOLB.0323.00008,1,870142,871005,-,863
815,WOLB.0323.00093,1,883226,884085,+,859
815,WOLB.0323.00008,1,877393,878251,-,858
814,WOLB.0323.00093,1,856165,856869,+,704
814,WOLB.0323.00093,1,954226,954930,+,704
813,WOLB.0323.00093,1,823672,824723,+,1051
813,WOLB.0323.00008,1,927575,928636,+,1061
812,WOLB.0323.00093,1,746578,747336,+,758
812,WOLB.0323.00008,1,598671,599420,+,749
811,WOLB.0323.00093,1,663553,664242,+,689
811,WOLB.0323.00008,1,440900,441588,-,688
810,WOLB.0323.00093,1,212260,212847,+,587
810,WOLB.0323.00093,1,458244,458830,-,586
809,WOLB.0323.00093,1,204682,205427,+,745
809,WOLB.0323.00093,1,464444,465189,-,745
808,WOLB.0323.00093,1,202336,202856,+,520
808,WOLB.0323.00093,1,467021,467548,-,527
807,WOLB.0323.00093,1,85022,85951,+,929
807,WOLB.0323.00093,1,99118,100047,-,929
807,WOLB.0323.00093,1,473986,474915,+,929
807,WOLB.0323.00093,1,753059,753988,-,929
807,WOLB.0323.00093,1,854002,854931,-,929
807,WOLB.0323.00093,1,926190,927119,-,929
807,WOLB.0323.00093,1,1154445,1155374,-,929
807,WOLB.0323.00093,1,1314719,1315648,-,929
807,WOLB.0323.00093,1,1556391,1557320,+,929
807,WOLB.0323.00093,1,1563266,1564195,-,929
807,WOLB.0323.00093,1,1695800,1696729,-,929
807,WOLB.0323.00024,1,317667,318596,+,929
807,WOLB.0323.00024,1,415939,416868,-,929
807,WOLB.0323.00024,1,1263602,1264531,+,929
807,WOLB.0323.00024,1,1416239,1417168,+,929
806,WOLB.0323.00093,1,83879,85020,+,1141
806,WOLB.0323.00093,1,100048,101187,-,1139
806,WOLB.0323.00093,1,472843,473984,+,1141
806,WOLB.0323.00093,1,753989,755128,-,1139
806,WOLB.0323.00093,1,854932,856074,-,1142
806,WOLB.0323.00093,1,927120,928262,-,1142
806,WOLB.0323.00093,1,1155375,1156517,-,1142
806,WOLB.0323.00093,1,1315649,1316791,-,1142
806,WOLB.0323.00093,1,1555248,1556389,+,1141
806,WOLB.0323.00093,1,1564196,1565338,-,1142
806,WOLB.0323.00093,1,1696730,1697869,-,1139
806,WOLB.0323.00024,1,315405,316554,+,1149
806,WOLB.0323.00024,1,416869,418003,-,1134
806,WOLB.0323.00024,1,1262460,1263600,+,1140
806,WOLB.0323.00024,1,1415097,1416237,+,1140
805,WOLB.0323.00153,1,551884,552607,+,723
805,WOLB.0323.00014,1,895281,896003,-,722
805,WOLB.0323.00014,1,1085642,1086364,-,722
804,WOLB.0323.00153,1,547913,550058,+,2145
804,WOLB.0323.00014,1,897830,899974,-,2144
803,WOLB.0323.00153,1,545792,547912,+,2120
803,WOLB.0323.00043,1,1172342,1174505,-,2163
803,WOLB.0323.00014,1,899976,902096,-,2120
802,WOLB.0323.00153,1,544011,544804,+,793
802,WOLB.0323.00043,1,1175444,1176179,-,735
802,WOLB.0323.00014,1,903083,903877,-,794
801,WOLB.0323.00153,1,542943,543845,+,902
801,WOLB.0323.00043,1,1176364,1177351,-,987
801,WOLB.0323.00014,1,904043,904945,-,902
800,WOLB.0323.00023,1,1698836,1699749,+,913
800,WOLB.0323.00153,1,505667,506577,+,910
800,WOLB.0323.00064,1,417984,418891,+,907
800,WOLB.0323.00084,1,226430,227340,+,910
800,WOLB.0323.00043,1,966153,967065,-,912
800,WOLB.0323.00122,1,1086545,1087457,-,912
800,WOLB.0323.00104,1,460843,461753,+,910
800,WOLB.0323.00070,1,872227,873138,+,911
799,WOLB.0323.00023,1,1690725,1692982,+,2257
799,WOLB.0323.00153,1,500664,502923,+,2259
799,WOLB.0323.00064,1,412843,415102,+,2259
799,WOLB.0323.00084,1,221432,223689,+,2257
799,WOLB.0323.00043,1,969827,972082,-,2255
799,WOLB.0323.00122,1,1091459,1093716,-,2257
799,WOLB.0323.00104,1,455845,458101,+,2256
798,WOLB.0323.00023,1,1598347,1599040,+,693
798,WOLB.0323.00084,1,147659,148243,-,584
797,WOLB.0323.00023,1,1596023,1597351,+,1328
797,WOLB.0323.00084,1,149239,150567,-,1328
796,WOLB.0323.00023,1,1586945,1588599,+,1654
796,WOLB.0323.00010,1,851519,853160,-,1641
795,WOLB.0323.00023,1,1584521,1585111,+,590
795,WOLB.0323.00093,1,1576372,1576962,+,590
794,WOLB.0323.00023,1,1583641,1584303,+,662
794,WOLB.0323.00093,1,1575459,1576129,+,670
793,WOLB.0323.00023,1,1512338,1512863,+,525
793,WOLB.0323.00021,1,366501,367050,-,549
793,WOLB.0323.00068,1,1207799,1208348,+,549
793,WOLB.0323.00042,1,1159423,1159972,+,549
792,WOLB.0323.00023,1,1471622,1472335,+,713
792,WOLB.0323.00023,1,1561702,1562410,+,708
791,WOLB.0323.00023,1,1464333,1470464,+,6131
791,WOLB.0323.00128,1,661282,667436,-,6154
790,WOLB.0323.00023,1,1230563,1231071,+,508
790,WOLB.0323.00021,1,289108,289616,-,508
790,WOLB.0323.00070,1,337344,337852,+,508
789,WOLB.0323.00023,1,1229225,1229749,+,524
789,WOLB.0323.00021,1,290430,290955,-,525
789,WOLB.0323.00070,1,336006,336530,+,524
788,WOLB.0323.00023,1,1228155,1229223,+,1068
788,WOLB.0323.00021,1,292442,293509,-,1067
788,WOLB.0323.00070,1,333452,334518,+,1066
787,WOLB.0323.00023,1,1227326,1227987,+,661
787,WOLB.0323.00021,1,293676,294337,-,661
787,WOLB.0323.00070,1,332623,333284,+,661
786,WOLB.0323.00023,1,1225332,1227057,+,1725
786,WOLB.0323.00021,1,294606,296332,-,1726
786,WOLB.0323.00070,1,330629,332354,+,1725
785,WOLB.0323.00023,1,1224331,1225139,+,808
785,WOLB.0323.00021,1,296525,297333,-,808
785,WOLB.0323.00070,1,329627,330436,+,809
784,WOLB.0323.00023,1,1223616,1224172,+,556
784,WOLB.0323.00021,1,297492,298048,-,556
784,WOLB.0323.00070,1,328912,329468,+,556
783,WOLB.0323.00023,1,1222348,1223139,+,791
783,WOLB.0323.00024,1,11034,11827,+,793
783,WOLB.0323.00024,1,64297,65090,+,793
783,WOLB.0323.00024,1,71096,71889,+,793
783,WOLB.0323.00024,1,95046,95839,+,793
783,WOLB.0323.00024,1,108772,109563,+,791
783,WOLB.0323.00024,1,151945,152739,-,794
783,WOLB.0323.00024,1,185541,186334,+,793
783,WOLB.0323.00024,1,212532,213324,+,792
783,WOLB.0323.00024,1,244815,245609,-,794
783,WOLB.0323.00024,1,253189,253983,-,794
783,WOLB.0323.00024,1,269068,269861,+,793
783,WOLB.0323.00024,1,387288,388081,+,793
783,WOLB.0323.00024,1,397214,398005,+,791
783,WOLB.0323.00024,1,408300,409094,-,794
783,WOLB.0323.00024,1,446107,446898,-,791
783,WOLB.0323.00024,1,456675,457468,+,793
783,WOLB.0323.00024,1,515689,516480,+,791
783,WOLB.0323.00024,1,573439,574230,+,791
783,WOLB.0323.00024,1,597847,598638,+,791
783,WOLB.0323.00024,1,613278,614070,-,792
783,WOLB.0323.00024,1,632207,632999,-,792
783,WOLB.0323.00024,1,647063,647854,+,791
783,WOLB.0323.00024,1,654185,654979,-,794
783,WOLB.0323.00024,1,666782,667576,-,794
783,WOLB.0323.00024,1,681331,682123,-,792
783,WOLB.0323.00024,1,703848,704642,-,794
783,WOLB.0323.00024,1,767890,768681,+,791
783,WOLB.0323.00024,1,828798,829590,-,792
783,WOLB.0323.00024,1,872707,873499,-,792
783,WOLB.0323.00024,1,967758,968552,-,794
783,WOLB.0323.00024,1,992822,993615,+,793
783,WOLB.0323.00024,1,995468,996262,-,794
783,WOLB.0323.00024,1,1040131,1040922,+,791
783,WOLB.0323.00024,1,1076138,1076930,-,792
783,WOLB.0323.00024,1,1082312,1083106,-,794
783,WOLB.0323.00024,1,1169619,1170411,-,792
783,WOLB.0323.00024,1,1217600,1218392,-,792
783,WOLB.0323.00024,1,1242166,1242959,+,793
783,WOLB.0323.00024,1,1395981,1396775,-,794
783,WOLB.0323.00024,1,1396973,1397735,+,762
783,WOLB.0323.00024,1,1450873,1451666,+,793
783,WOLB.0323.00024,1,1499252,1500045,+,793
783,WOLB.0323.00024,1,1514980,1515773,+,793
783,WOLB.0323.00024,1,1665692,1666486,-,794
783,WOLB.0323.00024,1,1699420,1700213,+,793
783,WOLB.0323.00024,1,1802534,1803328,-,794
783,WOLB.0323.00024,1,1813847,1814639,-,792
783,WOLB.0323.00024,1,1822501,1823295,-,794
783,WOLB.0323.00024,1,1864919,1865713,-,794
783,WOLB.0323.00024,1,1904924,1905718,-,794
783,WOLB.0323.00024,1,1910728,1911521,+,793
783,WOLB.0323.00024,1,1941733,1942527,-,794
783,WOLB.0323.00024,1,1980430,1981224,-,794
783,WOLB.0323.00024,1,1983421,1984214,+,793
783,WOLB.0323.00024,1,2016960,2017753,+,793
783,WOLB.0323.00021,1,298525,299317,-,792
783,WOLB.0323.00070,1,327644,328435,+,791
782,WOLB.0323.00023,1,1220735,1221884,+,1149
782,WOLB.0323.00021,1,299780,300929,-,1149
782,WOLB.0323.00070,1,326031,327180,+,1149
781,WOLB.0323.00023,1,1216922,1219508,+,2586
781,WOLB.0323.00021,1,302156,304743,-,2587
781,WOLB.0323.00070,1,322216,324804,+,2588
780,WOLB.0323.00023,1,1214282,1215347,+,1065
780,WOLB.0323.00021,1,304744,305810,-,1066
780,WOLB.0323.00070,1,321149,322214,+,1065
779,WOLB.0323.00023,1,1183312,1184408,+,1096
779,WOLB.0323.00093,1,174784,175880,+,1096
779,WOLB.0323.00024,1,1603573,1604669,+,1096
779,WOLB.0323.00021,1,335654,336750,-,1096
779,WOLB.0323.00070,1,708141,709261,+,1120
779,WOLB.0323.00014,1,948812,949908,+,1096
779,WOLB.0323.00014,1,1008218,1009314,+,1096
778,WOLB.0323.00023,1,657299,658547,+,1248
778,WOLB.0323.00018,1,59088,60340,+,1252
778,WOLB.0323.00010,1,1622337,1623584,-,1247
777,WOLB.0323.00023,1,455304,455845,+,541
777,WOLB.0323.00023,1,1609383,1609924,+,541
776,WOLB.0323.00023,1,309178,310285,+,1107
776,WOLB.0323.00024,1,473249,474356,-,1107
775,WOLB.0323.00023,1,302330,303035,+,705
775,WOLB.0323.00018,1,985381,986167,+,786
774,WOLB.0323.00023,1,193664,195046,+,1382
774,WOLB.0323.00093,1,229719,231102,+,1383
774,WOLB.0323.00093,1,438785,440168,-,1383
773,WOLB.0323.00023,1,189215,193552,+,4337
773,WOLB.0323.00093,1,225285,229607,+,4322
773,WOLB.0323.00093,1,440280,444602,-,4322
772,WOLB.0323.00023,1,175472,176173,+,701
772,WOLB.0323.00093,1,211572,212259,+,687
772,WOLB.0323.00093,1,458832,459518,-,686
771,WOLB.0323.00023,1,173859,174524,+,665
771,WOLB.0323.00093,1,208576,209241,+,665
771,WOLB.0323.00093,1,460470,461134,-,664
770,WOLB.0323.00023,1,69431,70051,+,620
770,WOLB.0323.00070,1,526975,527565,-,590
769,WOLB.0323.00023,1,46039,46591,+,552
769,WOLB.0323.00018,1,740804,741356,+,552
769,WOLB.0323.00128,1,816665,817232,-,567
768,WOLB.0323.00023,1,40458,42319,+,1861
768,WOLB.0323.00093,1,677635,679496,-,1861
768,WOLB.0323.00024,1,1382189,1384050,-,1861
767,WOLB.0323.00023,1,38108,40036,+,1928
767,WOLB.0323.00093,1,679917,681846,-,1929
767,WOLB.0323.00024,1,1384249,1386190,-,1941
766,WOLB.0323.00023,1,25845,26581,+,736
766,WOLB.0323.00064,1,1582552,1583294,+,742
766,WOLB.0323.00128,1,759999,760734,-,735
766,WOLB.0323.00014,1,522607,523348,-,741
765,WOLB.0323.00023,1,24136,25656,+,1520
765,WOLB.0323.00064,1,1580834,1582363,+,1529
765,WOLB.0323.00128,1,760924,762444,-,1520
765,WOLB.0323.00014,1,523538,525058,-,1520
764,WOLB.0323.00023,1,22065,23635,+,1570
764,WOLB.0323.00064,1,1578749,1580333,+,1584
764,WOLB.0323.00128,1,762945,764520,-,1575
764,WOLB.0323.00014,1,525568,527143,-,1575
763,WOLB.0323.00023,1,21049,21780,+,731
763,WOLB.0323.00023,1,144984,145715,+,731
763,WOLB.0323.00023,1,241523,242254,+,731
763,WOLB.0323.00023,1,326675,327406,-,731
763,WOLB.0323.00023,1,366244,366975,+,731
763,WOLB.0323.00023,1,449407,450138,-,731
763,WOLB.0323.00023,1,503759,504490,-,731
763,WOLB.0323.00023,1,700514,701245,-,731
763,WOLB.0323.00023,1,768949,769680,+,731
763,WOLB.0323.00023,1,893850,894581,-,731
763,WOLB.0323.00023,1,1111111,1111842,-,731
763,WOLB.0323.00023,1,1215632,1216363,-,731
763,WOLB.0323.00023,1,1357678,1358409,+,731
763,WOLB.0323.00023,1,1397215,1397946,+,731
763,WOLB.0323.00023,1,1591205,1591936,-,731
763,WOLB.0323.00023,1,1683851,1684582,+,731
763,WOLB.0323.00023,1,1700033,1700764,-,731
763,WOLB.0323.00023,1,1768056,1768787,+,731
763,WOLB.0323.00023,1,1827619,1828350,+,731
763,WOLB.0323.00093,1,14436,15167,+,731
763,WOLB.0323.00093,1,35253,35984,+,731
763,WOLB.0323.00093,1,487866,488597,+,731
763,WOLB.0323.00093,1,577564,578295,-,731
763,WOLB.0323.00093,1,651286,652017,-,731
763,WOLB.0323.00093,1,702599,703330,-,731
763,WOLB.0323.00093,1,736064,736795,+,731
763,WOLB.0323.00093,1,779868,780599,+,731
763,WOLB.0323.00093,1,884665,885396,+,731
763,WOLB.0323.00093,1,964886,965617,+,731
763,WOLB.0323.00093,1,987948,988679,+,731
763,WOLB.0323.00093,1,1067559,1068290,-,731
763,WOLB.0323.00093,1,1068976,1069707,+,731
763,WOLB.0323.00093,1,1090352,1091083,+,731
763,WOLB.0323.00093,1,1235116,1235847,+,731
763,WOLB.0323.00093,1,1259015,1259746,+,731
763,WOLB.0323.00093,1,1329929,1330648,+,719
763,WOLB.0323.00093,1,1330955,1331686,-,731
763,WOLB.0323.00093,1,1377379,1378110,-,731
763,WOLB.0323.00093,1,1393019,1393750,+,731
763,WOLB.0323.00093,1,1394057,1394788,-,731
763,WOLB.0323.00093,1,1431179,1431910,+,731
763,WOLB.0323.00093,1,1432217,1432948,-,731
763,WOLB.0323.00093,1,1452720,1453451,+,731
763,WOLB.0323.00093,1,1458832,1459563,-,731
763,WOLB.0323.00093,1,1544626,1545357,+,731
763,WOLB.0323.00024,1,546757,547488,+,731
763,WOLB.0323.00024,1,931696,932427,+,731
763,WOLB.0323.00018,1,66840,67572,+,732
763,WOLB.0323.00018,1,199159,199891,+,732
763,WOLB.0323.00018,1,466791,467523,-,732
763,WOLB.0323.00018,1,1182157,1182889,-,732
763,WOLB.0323.00018,1,1233533,1234265,+,732
763,WOLB.0323.00018,1,1286716,1287448,-,732
763,WOLB.0323.00018,1,1343547,1344279,+,732
763,WOLB.0323.00010,1,672493,673214,+,721
763,WOLB.0323.00010,1,1243833,1244597,+,764
763,WOLB.0323.00042,1,528519,529250,-,731
763,WOLB.0323.00042,1,762594,763325,-,731
763,WOLB.0323.00042,1,872242,872973,+,731
762,WOLB.0323.00023,1,17265,20151,+,2886
762,WOLB.0323.00064,1,1575536,1578422,+,2886
762,WOLB.0323.00128,1,764847,767733,-,2886
762,WOLB.0323.00014,1,527467,530353,-,2886
761,WOLB.0323.00023,1,15614,16287,+,673
761,WOLB.0323.00023,1,140225,140898,+,673
761,WOLB.0323.00023,1,160573,161247,-,674
761,WOLB.0323.00023,1,255196,255871,-,675
761,WOLB.0323.00023,1,291725,292398,+,673
761,WOLB.0323.00023,1,295238,295911,+,673
761,WOLB.0323.00023,1,350123,350796,+,673
761,WOLB.0323.00023,1,402287,402963,-,676
761,WOLB.0323.00023,1,406282,406956,-,674
761,WOLB.0323.00023,1,418156,418829,-,673
761,WOLB.0323.00023,1,431669,432342,+,673
761,WOLB.0323.00023,1,500379,501052,+,673
761,WOLB.0323.00023,1,506055,506729,-,674
761,WOLB.0323.00023,1,612484,613158,-,674
761,WOLB.0323.00023,1,653171,653845,-,674
761,WOLB.0323.00023,1,692892,693565,+,673
761,WOLB.0323.00023,1,745817,746490,+,673
761,WOLB.0323.00023,1,786921,787595,+,674
761,WOLB.0323.00023,1,817078,817752,-,674
761,WOLB.0323.00023,1,1050641,1051317,-,676
761,WOLB.0323.00023,1,1051653,1052326,+,673
761,WOLB.0323.00023,1,1143933,1144606,-,673
761,WOLB.0323.00023,1,1415810,1416484,-,674
761,WOLB.0323.00023,1,1417313,1417986,+,673
761,WOLB.0323.00023,1,1446804,1447479,+,675
761,WOLB.0323.00023,1,1478890,1479563,+,673
761,WOLB.0323.00023,1,1497800,1498472,+,672
761,WOLB.0323.00023,1,1545968,1546642,-,674
761,WOLB.0323.00023,1,1637591,1638265,-,674
761,WOLB.0323.00023,1,1693789,1694466,-,677
761,WOLB.0323.00023,1,1695941,1696603,+,662
761,WOLB.0323.00023,1,1706867,1707541,-,674
761,WOLB.0323.00023,1,1708357,1709031,-,674
761,WOLB.0323.00023,1,1709844,1710536,-,692
761,WOLB.0323.00023,1,1715333,1716006,+,673
761,WOLB.0323.00023,1,1745684,1746357,-,673
761,WOLB.0323.00023,1,1752208,1752885,+,677
761,WOLB.0323.00023,1,1808494,1809168,-,674
760,WOLB.0323.00142,1,575874,576784,+,910
760,WOLB.0323.00004,1,579183,580093,+,910
759,WOLB.0323.00056,1,1352632,1353430,+,798
759,WOLB.0323.00088,1,608951,609750,-,799
759,WOLB.0323.00020,1,542496,543295,-,799
759,WOLB.0323.00035,1,544066,544865,-,799
759,WOLB.0323.00012,1,613055,613854,-,799
759,WOLB.0323.00104,1,560728,561527,-,799
759,WOLB.0323.00100,1,867733,868532,-,799
758,WOLB.0323.00056,1,1347761,1348999,+,1238
758,WOLB.0323.00122,1,1397983,1399225,-,1242
758,WOLB.0323.00025,1,124769,125998,-,1229
757,WOLB.0323.00056,1,1193833,1195134,+,1301
757,WOLB.0323.00088,1,652598,653899,-,1301
757,WOLB.0323.00020,1,593509,594810,-,1301
757,WOLB.0323.00035,1,589738,591039,-,1301
757,WOLB.0323.00012,1,656700,658001,-,1301
757,WOLB.0323.00104,1,626156,627457,-,1301
757,WOLB.0323.00100,1,916509,917810,-,1301
756,WOLB.0323.00056,1,1184965,1185892,+,927
756,WOLB.0323.00021,1,619033,619960,+,927
755,WOLB.0323.00056,1,1182383,1184592,+,2209
755,WOLB.0323.00021,1,616451,618660,+,2209
754,WOLB.0323.00056,1,486667,487359,+,692
754,WOLB.0323.00024,1,1409897,1410592,-,695
754,WOLB.0323.00030,1,574059,574751,-,692
753,WOLB.0323.00056,1,485812,486368,+,556
753,WOLB.0323.00056,1,1346864,1347420,+,556
753,WOLB.0323.00030,1,575050,575606,-,556
753,WOLB.0323.00122,1,1399565,1400121,-,556
752,WOLB.0323.00041,1,1583029,1583815,+,786
752,WOLB.0323.00093,1,985319,986105,+,786
751,WOLB.0323.00041,1,1377330,1378969,+,1639
751,WOLB.0323.00093,1,656568,658204,+,1636
751,WOLB.0323.00008,1,721755,723391,+,1636
750,WOLB.0323.00041,1,1117794,1118314,+,520
750,WOLB.0323.00093,1,1390806,1391344,-,538
749,WOLB.0323.00039,1,384620,385152,+,532
749,WOLB.0323.00056,1,554233,554765,-,532
749,WOLB.0323.00093,1,693240,693772,+,532
749,WOLB.0323.00008,1,210582,211114,-,532
749,WOLB.0323.00064,1,388155,388687,+,532
749,WOLB.0323.00030,1,392873,393405,+,532
749,WOLB.0323.00030,1,402396,402928,-,532
749,WOLB.0323.00021,1,1205425,1205964,-,539
749,WOLB.0323.00122,1,1122804,1123336,-,532
749,WOLB.0323.00118,1,1087151,1087683,-,532
749,WOLB.0323.00007,1,916489,917021,-,532
748,WOLB.0323.00039,1,383990,384504,+,514
748,WOLB.0323.00056,1,554881,555395,-,514
748,WOLB.0323.00008,1,211230,211744,-,514
748,WOLB.0323.00122,1,1123452,1123966,-,514
748,WOLB.0323.00007,1,917137,917651,-,514
748,WOLB.0323.00070,1,801264,801805,+,541
748,WOLB.0323.00070,1,1228217,1228758,-,541
747,WOLB.0323.00039,1,43773,44875,+,1102
747,WOLB.0323.00133,1,329136,330226,-,1090
746,WOLB.0323.00039,1,31509,32349,+,840
746,WOLB.0323.00039,1,850260,851099,-,839
746,WOLB.0323.00039,1,1315165,1316004,-,839
746,WOLB.0323.00039,1,1319497,1320336,-,839
746,WOLB.0323.00039,1,1324633,1325473,+,840
746,WOLB.0323.00018,1,821715,822529,-,814
746,WOLB.0323.00018,1,965386,966201,+,815
746,WOLB.0323.00042,1,631023,631845,-,822
745,WOLB.0323.00074,1,1514428,1514936,+,508
745,WOLB.0323.00120,1,1491581,1492113,-,532
745,WOLB.0323.00120,1,1501405,1501913,+,508
745,WOLB.0323.00041,1,1641930,1642438,+,508
745,WOLB.0323.00096,1,1500679,1501187,+,508
744,WOLB.0323.00074,1,1513886,1514427,+,541
744,WOLB.0323.00120,1,1492115,1492655,-,540
744,WOLB.0323.00120,1,1500863,1501404,+,541
744,WOLB.0323.00041,1,1641388,1641929,+,541
744,WOLB.0323.00093,1,923107,923659,+,552
744,WOLB.0323.00008,1,242486,243038,-,552
744,WOLB.0323.00096,1,1500137,1500678,+,541
743,WOLB.0323.00074,1,1508375,1509324,+,949
743,WOLB.0323.00120,1,1488717,1489666,+,949
743,WOLB.0323.00041,1,1635877,1636826,+,949
743,WOLB.0323.00096,1,1494626,1495575,+,949
742,WOLB.0323.00074,1,1497169,1499319,+,2150
742,WOLB.0323.00120,1,1477511,1479661,+,2150
742,WOLB.0323.00041,1,1292046,1294196,+,2150
742,WOLB.0323.00041,1,1624671,1626821,+,2150
742,WOLB.0323.00096,1,1483420,1485570,+,2150
741,WOLB.0323.00074,1,1496013,1496808,+,795
741,WOLB.0323.00120,1,1476355,1477150,+,795
741,WOLB.0323.00041,1,1290890,1291685,+,795
741,WOLB.0323.00041,1,1623515,1624310,+,795
741,WOLB.0323.00096,1,1482264,1483059,+,795
740,WOLB.0323.00074,1,1366292,1366868,+,576
740,WOLB.0323.00120,1,1360050,1360626,+,576
740,WOLB.0323.00041,1,291324,291901,-,577
740,WOLB.0323.00096,1,303179,303756,-,577
739,WOLB.0323.00074,1,1207563,1208595,+,1032
739,WOLB.0323.00120,1,1199838,1200870,+,1032
739,WOLB.0323.00041,1,449597,450630,-,1033
739,WOLB.0323.00096,1,461452,462485,-,1033
738,WOLB.0323.00074,1,1158277,1159036,+,759
738,WOLB.0323.00120,1,1150552,1151311,+,759
738,WOLB.0323.00041,1,499156,499915,-,759
738,WOLB.0323.00096,1,521748,522507,-,759
737,WOLB.0323.00074,1,1115742,1116295,+,553
737,WOLB.0323.00120,1,1100378,1100931,+,553
737,WOLB.0323.00041,1,541898,542451,-,553
737,WOLB.0323.00093,1,1648732,1649278,+,546
737,WOLB.0323.00008,1,1383742,1384288,+,546
737,WOLB.0323.00096,1,580387,580940,-,553
736,WOLB.0323.00074,1,956934,957741,+,807
736,WOLB.0323.00120,1,942651,943458,+,807
736,WOLB.0323.00041,1,686139,686947,-,808
736,WOLB.0323.00093,1,82318,83127,-,809
736,WOLB.0323.00008,1,1280706,1281513,+,807
736,WOLB.0323.00096,1,724628,725436,-,808
735,WOLB.0323.00074,1,871321,871830,+,509
735,WOLB.0323.00120,1,857180,857689,+,509
735,WOLB.0323.00041,1,766675,767184,-,509
735,WOLB.0323.00093,1,250124,250624,-,500
735,WOLB.0323.00133,1,757580,758089,-,509
735,WOLB.0323.00096,1,804547,805056,-,509
734,WOLB.0323.00074,1,848943,849683,+,740
734,WOLB.0323.00120,1,834802,835542,+,740
734,WOLB.0323.00041,1,788821,789561,-,740
734,WOLB.0323.00096,1,826693,827433,-,740
733,WOLB.0323.00074,1,843873,844447,+,574
733,WOLB.0323.00120,1,829732,830306,+,574
733,WOLB.0323.00041,1,794058,794632,-,574
733,WOLB.0323.00096,1,831930,832504,-,574
732,WOLB.0323.00074,1,807714,809099,+,1385
732,WOLB.0323.00120,1,793675,795060,+,1385
732,WOLB.0323.00041,1,828434,829820,-,1386
732,WOLB.0323.00096,1,866306,867692,-,1386
731,WOLB.0323.00074,1,760436,761718,+,1282
731,WOLB.0323.00120,1,738114,739396,-,1282
731,WOLB.0323.00120,1,746397,747679,+,1282
731,WOLB.0323.00041,1,875815,877097,-,1282
731,WOLB.0323.00096,1,913687,914969,-,1282
730,WOLB.0323.00074,1,708265,709385,+,1120
730,WOLB.0323.00120,1,687792,688912,+,1120
730,WOLB.0323.00041,1,928120,929239,-,1119
730,WOLB.0323.00008,1,1024659,1025759,+,1100
730,WOLB.0323.00096,1,966023,967142,-,1119
729,WOLB.0323.00074,1,701101,701790,+,689
729,WOLB.0323.00120,1,680628,681317,+,689
729,WOLB.0323.00041,1,935714,936403,-,689
729,WOLB.0323.00096,1,973617,974306,-,689
728,WOLB.0323.00074,1,617482,618768,+,1286
728,WOLB.0323.00120,1,603653,604939,+,1286
728,WOLB.0323.00041,1,1012093,1013379,-,1286
728,WOLB.0323.00025,1,431983,433277,+,1294
728,WOLB.0323.00096,1,1049996,1051282,-,1286
727,WOLB.0323.00074,1,606700,607329,+,629
727,WOLB.0323.00120,1,592871,593500,+,629
727,WOLB.0323.00041,1,1023531,1024161,-,630
727,WOLB.0323.00096,1,1061434,1062064,-,630
726,WOLB.0323.00074,1,585448,586510,+,1062
726,WOLB.0323.00074,1,727731,728791,+,1060
726,WOLB.0323.00120,1,571619,572681,+,1062
726,WOLB.0323.00120,1,707258,708320,+,1062
726,WOLB.0323.00041,1,908742,909773,-,1031
726,WOLB.0323.00041,1,1044350,1045381,-,1031
726,WOLB.0323.00096,1,946614,947676,-,1062
726,WOLB.0323.00096,1,1082253,1083315,-,1062
725,WOLB.0323.00074,1,564695,565336,+,641
725,WOLB.0323.00120,1,550866,551507,+,641
725,WOLB.0323.00041,1,1065493,1066134,-,641
725,WOLB.0323.00096,1,1103427,1104068,-,641
724,WOLB.0323.00074,1,563710,564538,+,828
724,WOLB.0323.00120,1,549881,550709,+,828
724,WOLB.0323.00041,1,1066291,1067119,-,828
724,WOLB.0323.00096,1,1104225,1105053,-,828
723,WOLB.0323.00074,1,550456,551496,+,1040
723,WOLB.0323.00120,1,536627,537667,+,1040
723,WOLB.0323.00041,1,1079333,1080373,-,1040
723,WOLB.0323.00096,1,1117267,1118307,-,1040
722,WOLB.0323.00074,1,537571,538672,+,1101
722,WOLB.0323.00120,1,523742,524843,+,1101
722,WOLB.0323.00041,1,1092188,1093289,-,1101
722,WOLB.0323.00096,1,1130092,1131193,-,1101
721,WOLB.0323.00074,1,514953,515715,+,762
721,WOLB.0323.00120,1,501124,501886,+,762
721,WOLB.0323.00041,1,1115145,1115907,-,762
721,WOLB.0323.00041,1,1389566,1390328,-,762
721,WOLB.0323.00096,1,1153049,1153811,-,762
720,WOLB.0323.00074,1,503764,505993,+,2229
720,WOLB.0323.00120,1,489935,492164,+,2229
720,WOLB.0323.00041,1,1399287,1401516,-,2229
720,WOLB.0323.00096,1,1162770,1164999,-,2229
719,WOLB.0323.00074,1,502938,503659,+,721
719,WOLB.0323.00120,1,489109,489830,+,721
719,WOLB.0323.00041,1,1401621,1402342,-,721
719,WOLB.0323.00096,1,1165104,1165825,-,721
718,WOLB.0323.00074,1,502151,502688,+,537
718,WOLB.0323.00120,1,488322,488859,+,537
718,WOLB.0323.00039,1,235033,235562,-,529
718,WOLB.0323.00041,1,1402592,1403130,-,538
718,WOLB.0323.00096,1,1166075,1166613,-,538
717,WOLB.0323.00074,1,501429,502149,+,720
717,WOLB.0323.00120,1,487600,488320,+,720
717,WOLB.0323.00041,1,1403131,1403851,-,720
717,WOLB.0323.00096,1,1166614,1167334,-,720
716,WOLB.0323.00074,1,487118,488048,+,930
716,WOLB.0323.00120,1,473289,474219,+,930
716,WOLB.0323.00041,1,1417232,1418162,-,930
716,WOLB.0323.00096,1,1180715,1181645,-,930
715,WOLB.0323.00074,1,485658,487117,+,1459
715,WOLB.0323.00120,1,471829,473288,+,1459
715,WOLB.0323.00041,1,1418164,1419623,-,1459
715,WOLB.0323.00056,1,1192208,1193832,+,1624
715,WOLB.0323.00088,1,653901,655525,-,1624
715,WOLB.0323.00020,1,594812,596436,-,1624
715,WOLB.0323.00035,1,591041,592665,-,1624
715,WOLB.0323.00012,1,658003,659627,-,1624
715,WOLB.0323.00104,1,627459,629083,-,1624
715,WOLB.0323.00100,1,917812,919436,-,1624
715,WOLB.0323.00096,1,1181647,1183106,-,1459
714,WOLB.0323.00074,1,476329,477286,+,957
714,WOLB.0323.00120,1,462500,463457,+,957
714,WOLB.0323.00041,1,1427994,1428768,-,774
714,WOLB.0323.00096,1,1191477,1192251,-,774
713,WOLB.0323.00074,1,456119,456891,+,772
713,WOLB.0323.00120,1,442290,443062,+,772
713,WOLB.0323.00041,1,1448390,1449161,-,771
713,WOLB.0323.00096,1,1218770,1219541,-,771
712,WOLB.0323.00074,1,372663,373182,+,519
712,WOLB.0323.00074,1,484326,484845,+,519
712,WOLB.0323.00120,1,350992,351511,+,519
712,WOLB.0323.00120,1,470497,471016,+,519
712,WOLB.0323.00041,1,1117197,1117716,-,519
712,WOLB.0323.00041,1,1420436,1420955,-,519
712,WOLB.0323.00041,1,1533448,1533967,-,519
712,WOLB.0323.00093,1,684012,684531,-,519
712,WOLB.0323.00093,1,1391423,1391942,+,519
712,WOLB.0323.00096,1,1183919,1184438,-,519
712,WOLB.0323.00096,1,1302479,1302998,-,519
711,WOLB.0323.00074,1,371298,371875,+,577
711,WOLB.0323.00074,1,482961,483538,+,577
711,WOLB.0323.00120,1,349627,350204,+,577
711,WOLB.0323.00120,1,469132,469709,+,577
711,WOLB.0323.00041,1,1421742,1422319,-,577
711,WOLB.0323.00041,1,1534754,1535331,-,577
711,WOLB.0323.00096,1,1185225,1185802,-,577
711,WOLB.0323.00096,1,1303785,1304362,-,577
710,WOLB.0323.00074,1,370022,370738,+,716
710,WOLB.0323.00074,1,481685,482401,+,716
710,WOLB.0323.00120,1,348351,349067,+,716
710,WOLB.0323.00120,1,467856,468572,+,716
710,WOLB.0323.00041,1,1119661,1120378,-,717
710,WOLB.0323.00041,1,1422879,1423596,-,717
710,WOLB.0323.00041,1,1535891,1536608,-,717
710,WOLB.0323.00093,1,686508,687206,-,698
710,WOLB.0323.00096,1,1186362,1187079,-,717
710,WOLB.0323.00096,1,1304922,1305639,-,717
709,WOLB.0323.00074,1,367583,368233,+,650
709,WOLB.0323.00120,1,345912,346562,+,650
709,WOLB.0323.00041,1,1122167,1122816,-,649
709,WOLB.0323.00041,1,1538397,1539046,-,649
709,WOLB.0323.00096,1,1307428,1308077,-,649
708,WOLB.0323.00074,1,366789,367305,+,516
708,WOLB.0323.00120,1,345118,345634,+,516
708,WOLB.0323.00041,1,1123095,1123610,-,515
708,WOLB.0323.00041,1,1539325,1539840,-,515
708,WOLB.0323.00096,1,1308356,1308871,-,515
707,WOLB.0323.00074,1,362843,364106,+,1263
707,WOLB.0323.00120,1,341172,342435,+,1263
707,WOLB.0323.00041,1,1126296,1127559,-,1263
707,WOLB.0323.00041,1,1542523,1543780,-,1257
707,WOLB.0323.00096,1,1311554,1312817,-,1263
706,WOLB.0323.00074,1,361547,362204,+,657
706,WOLB.0323.00074,1,475130,475787,+,657
706,WOLB.0323.00120,1,339876,340533,+,657
706,WOLB.0323.00120,1,461301,461958,+,657
706,WOLB.0323.00041,1,1128199,1128855,-,656
706,WOLB.0323.00041,1,1429494,1430150,-,656
706,WOLB.0323.00041,1,1544419,1545075,-,656
706,WOLB.0323.00096,1,1192977,1193633,-,656
706,WOLB.0323.00096,1,1313457,1314113,-,656
705,WOLB.0323.00074,1,329980,331743,+,1763
705,WOLB.0323.00074,1,1494221,1495974,-,1753
705,WOLB.0323.00120,1,306997,308760,+,1763
705,WOLB.0323.00120,1,1474563,1476316,-,1753
705,WOLB.0323.00041,1,1158671,1160435,-,1764
705,WOLB.0323.00041,1,1289098,1290851,-,1753
705,WOLB.0323.00041,1,1574900,1576664,-,1764
705,WOLB.0323.00041,1,1621723,1623476,-,1753
705,WOLB.0323.00096,1,1343917,1345681,-,1764
705,WOLB.0323.00096,1,1480472,1482225,-,1753
704,WOLB.0323.00074,1,313258,314385,+,1127
704,WOLB.0323.00074,1,318764,319893,-,1129
704,WOLB.0323.00074,1,321009,322136,+,1127
704,WOLB.0323.00120,1,298026,299153,+,1127
704,WOLB.0323.00041,1,1168278,1169406,-,1128
704,WOLB.0323.00096,1,1353524,1354652,-,1128
703,WOLB.0323.00074,1,310539,311957,+,1418
703,WOLB.0323.00120,1,295307,296725,+,1418
703,WOLB.0323.00041,1,1170707,1172125,-,1418
703,WOLB.0323.00093,1,1422536,1423945,-,1409
703,WOLB.0323.00008,1,217122,218528,+,1406
703,WOLB.0323.00064,1,380913,382319,-,1406
703,WOLB.0323.00030,1,408764,410170,+,1406
703,WOLB.0323.00021,1,1211740,1213146,+,1406
703,WOLB.0323.00118,1,1093519,1094925,+,1406
703,WOLB.0323.00007,1,923034,924440,+,1406
703,WOLB.0323.00014,1,1226000,1227406,+,1406
703,WOLB.0323.00096,1,1355953,1357371,-,1418
702,WOLB.0323.00074,1,309038,309562,+,524
702,WOLB.0323.00120,1,293806,294330,+,524
702,WOLB.0323.00041,1,1173102,1173625,-,523
702,WOLB.0323.00024,1,1327402,1327925,-,523
702,WOLB.0323.00096,1,1358348,1358871,-,523
701,WOLB.0323.00074,1,306273,306854,+,581
701,WOLB.0323.00120,1,291041,291622,+,581
701,WOLB.0323.00041,1,1175810,1176390,-,580
701,WOLB.0323.00084,1,193774,194354,-,580
701,WOLB.0323.00043,1,655194,655775,+,581
701,WOLB.0323.00122,1,1461015,1461596,+,581
701,WOLB.0323.00032,1,74442,75023,+,581
701,WOLB.0323.00096,1,1361056,1361636,-,580
700,WOLB.0323.00074,1,304612,305186,+,574
700,WOLB.0323.00074,1,499387,499951,+,564
700,WOLB.0323.00120,1,289380,289954,+,574
700,WOLB.0323.00120,1,485558,486122,+,564
700,WOLB.0323.00041,1,1177478,1178051,-,573
700,WOLB.0323.00041,1,1405329,1405893,-,564
700,WOLB.0323.00064,1,389885,390462,-,577
700,WOLB.0323.00030,1,394603,395180,-,577
700,WOLB.0323.00030,1,400620,401198,+,578
700,WOLB.0323.00118,1,1085375,1085953,+,578
700,WOLB.0323.00096,1,1168812,1169376,-,564
700,WOLB.0323.00096,1,1362724,1363297,-,573
699,WOLB.0323.00074,1,246113,246687,+,574
699,WOLB.0323.00074,1,254496,255070,-,574
699,WOLB.0323.00074,1,325953,326527,+,574
699,WOLB.0323.00074,1,381992,382560,+,568
699,WOLB.0323.00074,1,461182,461756,+,574
699,WOLB.0323.00120,1,245343,245917,+,574
699,WOLB.0323.00120,1,302970,303544,+,574
699,WOLB.0323.00120,1,360321,360889,+,568
699,WOLB.0323.00120,1,447353,447927,+,574
699,WOLB.0323.00039,1,1327278,1327846,-,568
699,WOLB.0323.00041,1,1163888,1164462,-,574
699,WOLB.0323.00041,1,1216655,1217229,-,574
699,WOLB.0323.00041,1,1443525,1444099,-,574
699,WOLB.0323.00041,1,1524070,1524638,-,568
699,WOLB.0323.00041,1,1578768,1579342,-,574
699,WOLB.0323.00096,1,1207046,1207619,+,573
699,WOLB.0323.00096,1,1213905,1214479,-,574
699,WOLB.0323.00096,1,1293101,1293669,-,568
699,WOLB.0323.00096,1,1349134,1349708,-,574
699,WOLB.0323.00096,1,1406761,1407335,-,574
698,WOLB.0323.00074,1,245161,245812,+,651
698,WOLB.0323.00074,1,255372,256023,-,651
698,WOLB.0323.00074,1,315250,315901,-,651
698,WOLB.0323.00074,1,325001,325652,+,651
698,WOLB.0323.00074,1,379625,380276,+,651
698,WOLB.0323.00074,1,460230,460881,+,651
698,WOLB.0323.00074,1,1499321,1499964,-,643
698,WOLB.0323.00120,1,244391,245042,+,651
698,WOLB.0323.00120,1,302018,302669,+,651
698,WOLB.0323.00120,1,357954,358605,+,651
698,WOLB.0323.00120,1,446401,447052,+,651
698,WOLB.0323.00120,1,1479663,1480306,-,643
698,WOLB.0323.00039,1,1328147,1328797,-,650
698,WOLB.0323.00041,1,1164763,1165413,-,650
698,WOLB.0323.00041,1,1217530,1218180,-,650
698,WOLB.0323.00041,1,1294198,1294841,-,643
698,WOLB.0323.00041,1,1444400,1445050,-,650
698,WOLB.0323.00041,1,1526354,1527004,-,650
698,WOLB.0323.00041,1,1579643,1580293,-,650
698,WOLB.0323.00041,1,1626823,1627466,-,643
698,WOLB.0323.00096,1,1206101,1206744,+,643
698,WOLB.0323.00096,1,1214780,1215430,-,650
698,WOLB.0323.00096,1,1295385,1296035,-,650
698,WOLB.0323.00096,1,1350009,1350659,-,650
698,WOLB.0323.00096,1,1407636,1408286,-,650
698,WOLB.0323.00096,1,1485572,1486215,-,643
697,WOLB.0323.00074,1,244014,244549,+,535
697,WOLB.0323.00074,1,378478,379013,+,535
697,WOLB.0323.00074,1,1500577,1501112,-,535
697,WOLB.0323.00120,1,243244,243779,+,535
697,WOLB.0323.00120,1,356807,357342,+,535
697,WOLB.0323.00120,1,1480919,1481454,-,535
697,WOLB.0323.00039,1,1329415,1329953,-,538
697,WOLB.0323.00041,1,1218793,1219328,-,535
697,WOLB.0323.00041,1,1295454,1295989,-,535
697,WOLB.0323.00041,1,1527617,1528152,-,535
697,WOLB.0323.00041,1,1628079,1628614,-,535
697,WOLB.0323.00024,1,990655,991193,-,538
697,WOLB.0323.00096,1,1296648,1297183,-,535
697,WOLB.0323.00096,1,1408899,1409434,-,535
697,WOLB.0323.00096,1,1486828,1487363,-,535
696,WOLB.0323.00074,1,239233,240036,+,803
696,WOLB.0323.00074,1,375317,376120,+,803
696,WOLB.0323.00074,1,1505091,1505894,-,803
696,WOLB.0323.00120,1,238463,239266,+,803
696,WOLB.0323.00120,1,353646,354449,+,803
696,WOLB.0323.00120,1,1485433,1486236,-,803
696,WOLB.0323.00041,1,1223306,1224109,-,803
696,WOLB.0323.00041,1,1530510,1531313,-,803
696,WOLB.0323.00041,1,1632593,1633396,-,803
696,WOLB.0323.00023,1,1229751,1230562,+,811
696,WOLB.0323.00021,1,289618,290429,-,811
696,WOLB.0323.00070,1,336532,337343,+,811
696,WOLB.0323.00096,1,1299541,1300344,-,803
696,WOLB.0323.00096,1,1413412,1414215,-,803
696,WOLB.0323.00096,1,1491342,1492145,-,803
695,WOLB.0323.00074,1,232511,233056,+,545
695,WOLB.0323.00120,1,231741,232286,+,545
695,WOLB.0323.00041,1,1230285,1230841,-,556
695,WOLB.0323.00096,1,1420391,1420947,-,556
695,WOLB.0323.00096,1,1421642,1422215,-,573
694,WOLB.0323.00074,1,215855,216970,+,1115
694,WOLB.0323.00074,1,1451494,1452609,-,1115
694,WOLB.0323.00120,1,215085,216200,+,1115
694,WOLB.0323.00120,1,1431836,1432951,-,1115
694,WOLB.0323.00041,1,218999,220114,+,1115
694,WOLB.0323.00041,1,1246371,1247486,-,1115
694,WOLB.0323.00041,1,1606225,1607340,-,1115
694,WOLB.0323.00096,1,229870,230985,+,1115
694,WOLB.0323.00096,1,1437745,1438860,-,1115
693,WOLB.0323.00074,1,125518,126174,+,656
693,WOLB.0323.00120,1,124748,125404,+,656
693,WOLB.0323.00041,1,118764,119420,+,656
693,WOLB.0323.00096,1,132573,133229,+,656
692,WOLB.0323.00074,1,105629,106178,+,549
692,WOLB.0323.00120,1,104859,105408,+,549
692,WOLB.0323.00041,1,98875,99424,+,549
692,WOLB.0323.00093,1,1526704,1527262,+,558
692,WOLB.0323.00096,1,112684,113233,+,549
691,WOLB.0323.00074,1,35217,36579,+,1362
691,WOLB.0323.00120,1,35212,36574,+,1362
691,WOLB.0323.00041,1,35212,36574,+,1362
691,WOLB.0323.00096,1,41901,43263,+,1362
690,WOLB.0323.00074,1,33641,34892,+,1251
690,WOLB.0323.00074,1,59452,60703,-,1251
690,WOLB.0323.00074,1,61778,63029,+,1251
690,WOLB.0323.00074,1,388474,389725,+,1251
690,WOLB.0323.00074,1,489773,491024,-,1251
690,WOLB.0323.00074,1,763225,764476,+,1251
690,WOLB.0323.00074,1,918012,919263,+,1251
690,WOLB.0323.00074,1,1003154,1004405,-,1251
690,WOLB.0323.00074,1,1033110,1034361,-,1251
690,WOLB.0323.00074,1,1041848,1043098,+,1250
690,WOLB.0323.00074,1,1198039,1199290,-,1251
690,WOLB.0323.00074,1,1214205,1215456,+,1251
690,WOLB.0323.00120,1,33636,34887,+,1251
690,WOLB.0323.00120,1,59447,60698,-,1251
690,WOLB.0323.00120,1,61773,63024,+,1251
690,WOLB.0323.00120,1,366803,368054,+,1251
690,WOLB.0323.00120,1,475944,477195,-,1251
690,WOLB.0323.00120,1,749186,750437,+,1251
690,WOLB.0323.00120,1,903871,905122,+,1251
690,WOLB.0323.00120,1,994540,995791,-,1251
690,WOLB.0323.00120,1,1017833,1019084,-,1251
690,WOLB.0323.00120,1,1026635,1027884,+,1249
690,WOLB.0323.00120,1,1190314,1191565,-,1251
690,WOLB.0323.00120,1,1206480,1207731,+,1251
690,WOLB.0323.00041,1,33636,34887,+,1251
690,WOLB.0323.00041,1,59447,60698,-,1251
690,WOLB.0323.00041,1,61773,63024,+,1251
690,WOLB.0323.00041,1,442737,443988,-,1251
690,WOLB.0323.00041,1,458903,460154,+,1251
690,WOLB.0323.00041,1,617122,618373,+,1251
690,WOLB.0323.00041,1,640415,641666,+,1251
690,WOLB.0323.00041,1,717621,718872,-,1251
690,WOLB.0323.00041,1,873058,874309,-,1251
690,WOLB.0323.00041,1,1414257,1415508,+,1251
690,WOLB.0323.00041,1,1516905,1518156,-,1251
690,WOLB.0323.00024,1,27600,28850,-,1250
690,WOLB.0323.00024,1,310291,311541,+,1250
690,WOLB.0323.00024,1,391607,392857,+,1250
690,WOLB.0323.00024,1,780571,781821,+,1250
690,WOLB.0323.00024,1,1024972,1026222,+,1250
690,WOLB.0323.00024,1,1094738,1095988,-,1250
690,WOLB.0323.00024,1,1183477,1184727,+,1250
690,WOLB.0323.00024,1,1412467,1413717,+,1250
690,WOLB.0323.00024,1,1473501,1474751,-,1250
690,WOLB.0323.00024,1,1607091,1608341,+,1250
690,WOLB.0323.00024,1,1701082,1702332,-,1250
690,WOLB.0323.00024,1,1713881,1715104,+,1223
690,WOLB.0323.00024,1,1728009,1729259,-,1250
690,WOLB.0323.00096,1,40325,41576,+,1251
690,WOLB.0323.00096,1,66136,67387,-,1251
690,WOLB.0323.00096,1,68462,69713,+,1251
690,WOLB.0323.00096,1,70672,71925,-,1253
690,WOLB.0323.00096,1,72990,74233,+,1243
690,WOLB.0323.00096,1,75582,76833,+,1251
690,WOLB.0323.00096,1,454592,455843,-,1251
690,WOLB.0323.00096,1,470758,472009,+,1251
690,WOLB.0323.00096,1,655611,656862,+,1251
690,WOLB.0323.00096,1,678904,680155,+,1251
690,WOLB.0323.00096,1,756110,757361,-,1251
690,WOLB.0323.00096,1,910930,912181,-,1251
690,WOLB.0323.00096,1,1177740,1178991,+,1251
690,WOLB.0323.00096,1,1285936,1287187,-,1251
689,WOLB.0323.00074,1,9694,10237,+,543
689,WOLB.0323.00041,1,9682,10225,+,543
689,WOLB.0323.00096,1,5674,6218,-,544
688,WOLB.0323.00074,1,5441,7014,+,1573
688,WOLB.0323.00120,1,5441,7014,+,1573
688,WOLB.0323.00041,1,5429,7002,+,1573
688,WOLB.0323.00096,1,8897,10468,-,1571
688,WOLB.0323.00096,1,12130,13703,+,1573
687,WOLB.0323.00060,1,820931,821482,+,551
687,WOLB.0323.00056,1,868045,868596,+,551
687,WOLB.0323.00018,1,636705,637253,-,548
687,WOLB.0323.00007,1,413699,414250,-,551
686,WOLB.0323.00060,1,651162,652029,+,867
686,WOLB.0323.00084,1,1249952,1250817,+,865
686,WOLB.0323.00122,1,320864,321731,-,867
686,WOLB.0323.00010,1,674507,675374,+,867
686,WOLB.0323.00010,1,1245891,1246758,+,867
685,WOLB.0323.00060,1,632287,638646,+,6359
685,WOLB.0323.00084,1,1234083,1240462,+,6379
685,WOLB.0323.00122,1,331220,337591,-,6371
685,WOLB.0323.00032,1,302417,308795,-,6378
684,WOLB.0323.00060,1,630384,631241,+,857
684,WOLB.0323.00122,1,338635,339508,-,873
683,WOLB.0323.00060,1,629667,630233,+,566
683,WOLB.0323.00122,1,339658,340225,-,567
682,WOLB.0323.00060,1,627580,628621,+,1041
682,WOLB.0323.00060,1,631243,632286,-,1043
682,WOLB.0323.00084,1,1233043,1234082,-,1039
682,WOLB.0323.00122,1,337593,338634,+,1041
682,WOLB.0323.00122,1,341271,342312,-,1041
682,WOLB.0323.00032,1,308797,309836,+,1039
681,WOLB.0323.00060,1,403602,404691,+,1089
681,WOLB.0323.00024,1,1279101,1280197,-,1096
681,WOLB.0323.00030,1,536591,537688,-,1097
681,WOLB.0323.00030,1,606104,607197,-,1093
681,WOLB.0323.00043,1,513996,514993,-,997
681,WOLB.0323.00007,1,1105604,1106641,+,1037
680,WOLB.0323.00060,1,395640,396527,+,887
680,WOLB.0323.00032,1,27540,28427,+,887
679,WOLB.0323.00060,1,316971,317835,+,864
679,WOLB.0323.00084,1,190825,191689,+,864
679,WOLB.0323.00043,1,657859,658723,-,864
679,WOLB.0323.00122,1,1463680,1464544,-,864
679,WOLB.0323.00032,1,77107,77971,-,864
678,WOLB.0323.00060,1,281619,282840,+,1221
678,WOLB.0323.00093,1,1073246,1074470,-,1224
678,WOLB.0323.00010,1,882452,883675,-,1223
677,WOLB.0323.00060,1,121281,121858,+,577
677,WOLB.0323.00043,1,1010151,1010728,-,577
676,WOLB.0323.00060,1,119975,120887,+,912
676,WOLB.0323.00043,1,1011122,1011936,-,814
675,WOLB.0323.00060,1,113577,118395,+,4818
675,WOLB.0323.00043,1,1013411,1018314,-,4903
674,WOLB.0323.00060,1,109551,112286,+,2735
674,WOLB.0323.00043,1,1018316,1021066,-,2750
673,WOLB.0323.00060,1,106005,107079,+,1074
673,WOLB.0323.00007,1,998655,999728,-,1073
672,WOLB.0323.00060,1,98789,99360,+,571
672,WOLB.0323.00056,1,424507,425078,+,571
672,WOLB.0323.00088,1,487139,487710,+,571
672,WOLB.0323.00043,1,932638,933225,-,587
672,WOLB.0323.00020,1,456907,457478,+,571
672,WOLB.0323.00035,1,412630,413201,+,571
672,WOLB.0323.00012,1,488281,488852,+,571
672,WOLB.0323.00104,1,415972,416543,+,571
672,WOLB.0323.00007,1,1006373,1006944,-,571
672,WOLB.0323.00100,1,563874,564445,+,571
671,WOLB.0323.00060,1,21582,22210,+,628
671,WOLB.0323.00060,1,414773,415394,+,621
671,WOLB.0323.00060,1,415639,416260,+,621
671,WOLB.0323.00060,1,499344,499965,+,621
671,WOLB.0323.00060,1,976140,976761,-,621
671,WOLB.0323.00060,1,1007844,1008465,+,621
671,WOLB.0323.00060,1,1009621,1010248,-,627
671,WOLB.0323.00060,1,1558800,1559421,+,621
671,WOLB.0323.00056,1,677526,678147,+,621
671,WOLB.0323.00056,1,710306,710927,+,621
671,WOLB.0323.00007,1,442779,443400,+,621
671,WOLB.0323.00007,1,1071149,1071770,-,621
670,WOLB.0323.00019,1,1293700,1294416,+,716
670,WOLB.0323.00039,1,853133,853849,+,716
670,WOLB.0323.00119,1,1295188,1295904,+,716
669,WOLB.0323.00019,1,1283671,1284333,+,662
669,WOLB.0323.00119,1,1205778,1206440,-,662
668,WOLB.0323.00019,1,1282586,1283525,+,939
668,WOLB.0323.00030,1,451464,452405,+,941
668,WOLB.0323.00030,1,1118534,1119472,-,938
668,WOLB.0323.00100,1,677992,678933,+,941
668,WOLB.0323.00100,1,739226,740167,+,941
668,WOLB.0323.00070,1,494543,495471,+,928
668,WOLB.0323.00119,1,1206587,1207526,-,939
667,WOLB.0323.00019,1,1280481,1281965,+,1484
667,WOLB.0323.00064,1,1587463,1588949,-,1486
667,WOLB.0323.00030,1,383354,384838,+,1484
667,WOLB.0323.00030,1,636202,637687,+,1485
667,WOLB.0323.00030,1,723760,725244,+,1484
667,WOLB.0323.00043,1,1102951,1104436,-,1485
667,WOLB.0323.00128,1,652600,654085,-,1485
667,WOLB.0323.00119,1,1208146,1209631,-,1485
667,WOLB.0323.00014,1,1100638,1102123,-,1485
666,WOLB.0323.00019,1,1113792,1114797,+,1005
666,WOLB.0323.00039,1,670647,671652,+,1005
666,WOLB.0323.00119,1,1117887,1118892,+,1005
665,WOLB.0323.00019,1,1056773,1057299,+,526
665,WOLB.0323.00039,1,513492,514018,+,526
665,WOLB.0323.00119,1,1060868,1061394,+,526
664,WOLB.0323.00019,1,970197,970736,+,539
664,WOLB.0323.00039,1,615244,615783,-,539
664,WOLB.0323.00119,1,974292,974831,+,539
663,WOLB.0323.00019,1,960501,961102,+,601
663,WOLB.0323.00039,1,624880,625481,-,601
663,WOLB.0323.00024,1,1868635,1869226,-,591
663,WOLB.0323.00018,1,228122,228811,+,689
663,WOLB.0323.00119,1,963155,963756,+,601
662,WOLB.0323.00019,1,959402,959925,+,523
662,WOLB.0323.00039,1,626060,626579,-,519
662,WOLB.0323.00024,1,1869589,1870108,-,519
662,WOLB.0323.00018,1,227246,227762,+,516
662,WOLB.0323.00119,1,962056,962579,+,523
661,WOLB.0323.00019,1,903601,904133,+,532
661,WOLB.0323.00039,1,201529,202062,+,533
661,WOLB.0323.00064,1,1535915,1536475,+,560
661,WOLB.0323.00030,1,545984,546516,-,532
661,WOLB.0323.00030,1,615464,616024,-,560
661,WOLB.0323.00043,1,523285,523830,-,545
661,WOLB.0323.00032,1,25965,26524,+,559
661,WOLB.0323.00007,1,1095130,1095648,+,518
661,WOLB.0323.00119,1,906255,906787,+,532
660,WOLB.0323.00019,1,819367,820071,+,704
660,WOLB.0323.00074,1,384409,385113,+,704
660,WOLB.0323.00074,1,462612,463316,+,704
660,WOLB.0323.00120,1,362738,363442,+,704
660,WOLB.0323.00120,1,448783,449487,+,704
660,WOLB.0323.00039,1,1325718,1326422,-,704
660,WOLB.0323.00041,1,1441965,1442669,-,704
660,WOLB.0323.00041,1,1521517,1522221,-,704
660,WOLB.0323.00024,1,985262,985966,-,704
660,WOLB.0323.00119,1,822021,822725,+,704
660,WOLB.0323.00096,1,1208474,1209177,+,703
660,WOLB.0323.00096,1,1212345,1213049,-,704
660,WOLB.0323.00096,1,1290548,1291252,-,704
659,WOLB.0323.00019,1,817650,818188,+,538
659,WOLB.0323.00119,1,820304,820842,+,538
658,WOLB.0323.00019,1,816689,817245,+,556
658,WOLB.0323.00119,1,819343,819899,+,556
657,WOLB.0323.00019,1,813981,815255,+,1274
657,WOLB.0323.00119,1,816635,817909,+,1274
656,WOLB.0323.00019,1,672536,674908,+,2372
656,WOLB.0323.00119,1,503675,506047,-,2372
655,WOLB.0323.00019,1,669894,671098,+,1204
655,WOLB.0323.00119,1,507486,508689,-,1203
654,WOLB.0323.00019,1,572450,573630,+,1180
654,WOLB.0323.00039,1,1273937,1275104,-,1167
654,WOLB.0323.00093,1,1190108,1191294,+,1186
654,WOLB.0323.00119,1,604954,606134,-,1180
653,WOLB.0323.00019,1,533682,534894,+,1212
653,WOLB.0323.00039,1,192853,194065,+,1212
653,WOLB.0323.00119,1,645128,646340,-,1212
652,WOLB.0323.00019,1,531545,532098,+,553
652,WOLB.0323.00119,1,647925,648477,-,552
651,WOLB.0323.00019,1,384312,385185,+,873
651,WOLB.0323.00039,1,1165169,1166042,+,873
651,WOLB.0323.00093,1,937077,937949,-,872
651,WOLB.0323.00008,1,454249,455121,-,872
651,WOLB.0323.00118,1,806051,806915,-,864
651,WOLB.0323.00119,1,796277,797149,-,872
650,WOLB.0323.00019,1,60203,60713,+,510
650,WOLB.0323.00039,1,939540,940042,-,502
650,WOLB.0323.00119,1,60088,60598,+,510
649,WOLB.0323.00103,1,1398053,1399044,+,991
649,WOLB.0323.00107,1,1396479,1397470,+,991
649,WOLB.0323.00105,1,1398207,1399198,+,991
649,WOLB.0323.00001,1,1398207,1399198,+,991
648,WOLB.0323.00103,1,1381645,1384677,+,3032
648,WOLB.0323.00107,1,1380072,1383104,+,3032
648,WOLB.0323.00105,1,1381800,1384832,+,3032
648,WOLB.0323.00001,1,1381800,1384832,+,3032
647,WOLB.0323.00103,1,1379259,1381367,+,2108
647,WOLB.0323.00107,1,1377686,1379794,+,2108
647,WOLB.0323.00105,1,1379414,1381522,+,2108
647,WOLB.0323.00043,1,1095497,1097605,-,2108
647,WOLB.0323.00001,1,1379414,1381522,+,2108
646,WOLB.0323.00103,1,1378040,1379257,+,1217
646,WOLB.0323.00107,1,1376467,1377684,+,1217
646,WOLB.0323.00105,1,1378195,1379412,+,1217
646,WOLB.0323.00043,1,1098952,1100159,-,1207
646,WOLB.0323.00001,1,1378195,1379412,+,1217
645,WOLB.0323.00103,1,1376275,1378038,+,1763
645,WOLB.0323.00107,1,1374702,1376465,+,1763
645,WOLB.0323.00105,1,1376430,1378193,+,1763
645,WOLB.0323.00001,1,1376430,1378193,+,1763
644,WOLB.0323.00103,1,1375067,1375589,+,522
644,WOLB.0323.00107,1,1373494,1374016,+,522
644,WOLB.0323.00105,1,1375222,1375744,+,522
644,WOLB.0323.00001,1,1375222,1375744,+,522
643,WOLB.0323.00103,1,1350734,1351292,+,558
643,WOLB.0323.00107,1,1349161,1349719,+,558
643,WOLB.0323.00105,1,1350889,1351447,+,558
643,WOLB.0323.00001,1,1350889,1351447,+,558
642,WOLB.0323.00103,1,1234110,1234773,+,663
642,WOLB.0323.00107,1,1232373,1233036,+,663
642,WOLB.0323.00105,1,1234118,1234781,+,663
642,WOLB.0323.00133,1,396366,397013,-,647
642,WOLB.0323.00001,1,1234118,1234781,+,663
641,WOLB.0323.00103,1,1019706,1020992,+,1286
641,WOLB.0323.00107,1,1018273,1019559,+,1286
641,WOLB.0323.00105,1,1019714,1021000,+,1286
641,WOLB.0323.00001,1,1019714,1021000,+,1286
640,WOLB.0323.00103,1,917200,917744,+,544
640,WOLB.0323.00107,1,915774,916318,+,544
640,WOLB.0323.00105,1,917210,917754,+,544
640,WOLB.0323.00010,1,575703,576247,-,544
640,WOLB.0323.00001,1,917210,917754,+,544
639,WOLB.0323.00103,1,788588,789258,+,670
639,WOLB.0323.00107,1,787172,787842,+,670
639,WOLB.0323.00105,1,788599,789269,+,670
639,WOLB.0323.00001,1,788599,789269,+,670
638,WOLB.0323.00103,1,640412,642994,+,2582
638,WOLB.0323.00107,1,638996,641578,+,2582
638,WOLB.0323.00105,1,640423,643005,+,2582
638,WOLB.0323.00001,1,640423,643005,+,2582
637,WOLB.0323.00103,1,622623,623418,+,795
637,WOLB.0323.00107,1,621206,622001,+,795
637,WOLB.0323.00074,1,2288,3084,+,796
637,WOLB.0323.00120,1,2288,3084,+,796
637,WOLB.0323.00041,1,2288,3084,+,796
637,WOLB.0323.00093,1,1348625,1349419,+,794
637,WOLB.0323.00008,1,820162,820956,+,794
637,WOLB.0323.00105,1,622632,623427,+,795
637,WOLB.0323.00001,1,622632,623427,+,795
637,WOLB.0323.00096,1,2288,3084,+,796
636,WOLB.0323.00103,1,599752,600285,+,533
636,WOLB.0323.00107,1,599749,600282,+,533
636,WOLB.0323.00008,1,872074,872586,+,512
636,WOLB.0323.00105,1,599761,600294,+,533
636,WOLB.0323.00001,1,599761,600294,+,533
635,WOLB.0323.00103,1,369380,370476,+,1096
635,WOLB.0323.00107,1,369379,370475,+,1096
635,WOLB.0323.00105,1,369381,370477,+,1096
635,WOLB.0323.00001,1,369381,370477,+,1096
634,WOLB.0323.00103,1,251138,251789,+,651
634,WOLB.0323.00107,1,251136,251787,+,651
634,WOLB.0323.00105,1,251136,251787,+,651
634,WOLB.0323.00001,1,251136,251787,+,651
633,WOLB.0323.00103,1,219120,219942,+,822
633,WOLB.0323.00107,1,219118,219940,+,822
633,WOLB.0323.00019,1,1125230,1126052,-,822
633,WOLB.0323.00039,1,682070,682892,-,822
633,WOLB.0323.00023,1,856590,857381,+,791
633,WOLB.0323.00093,1,115270,116061,-,791
633,WOLB.0323.00008,1,1201465,1202271,-,806
633,WOLB.0323.00105,1,219119,219941,+,822
633,WOLB.0323.00133,1,705991,706797,-,806
633,WOLB.0323.00001,1,219119,219941,+,822
633,WOLB.0323.00119,1,1129325,1130147,-,822
632,WOLB.0323.00103,1,206103,207112,+,1009
632,WOLB.0323.00107,1,206101,207110,+,1009
632,WOLB.0323.00008,1,1210101,1211101,+,1000
632,WOLB.0323.00105,1,206102,207111,+,1009
632,WOLB.0323.00001,1,206102,207111,+,1009
632,WOLB.0323.00042,1,65682,66683,-,1001
631,WOLB.0323.00103,1,166589,167381,+,792
631,WOLB.0323.00107,1,166588,167380,+,792
631,WOLB.0323.00019,1,945171,945873,-,702
631,WOLB.0323.00074,1,792898,793698,+,800
631,WOLB.0323.00120,1,778859,779659,+,800
631,WOLB.0323.00039,1,639848,640550,+,702
631,WOLB.0323.00041,1,843836,844636,-,800
631,WOLB.0323.00093,1,317522,318323,-,801
631,WOLB.0323.00024,1,1883837,1884542,+,705
631,WOLB.0323.00064,1,1315980,1316684,-,704
631,WOLB.0323.00030,1,1591178,1591883,+,705
631,WOLB.0323.00105,1,166588,167380,+,792
631,WOLB.0323.00001,1,166588,167380,+,792
631,WOLB.0323.00042,1,186421,187153,-,732
631,WOLB.0323.00119,1,947825,948527,-,702
631,WOLB.0323.00096,1,881708,882508,-,800
630,WOLB.0323.00135,1,1328087,1332731,+,4644
630,WOLB.0323.00056,1,1361778,1366273,-,4495
630,WOLB.0323.00023,1,1549873,1554368,-,4495
630,WOLB.0323.00100,1,705019,709510,-,4491
630,WOLB.0323.00100,1,766253,770744,-,4491
630,WOLB.0323.00014,1,1304864,1309389,+,4525
629,WOLB.0323.00135,1,1325369,1326276,+,907
629,WOLB.0323.00074,1,1465679,1466586,-,907
629,WOLB.0323.00120,1,1446021,1446928,-,907
629,WOLB.0323.00041,1,1260556,1261463,-,907
629,WOLB.0323.00056,1,1368083,1368991,-,908
629,WOLB.0323.00023,1,1556177,1557085,-,908
629,WOLB.0323.00024,1,1178386,1179292,-,906
629,WOLB.0323.00100,1,711317,712225,-,908
629,WOLB.0323.00100,1,772551,773459,-,908
629,WOLB.0323.00014,1,1302146,1303053,+,907
629,WOLB.0323.00096,1,1451930,1452837,-,907
628,WOLB.0323.00135,1,1323178,1324318,+,1140
628,WOLB.0323.00074,1,1467630,1468771,-,1141
628,WOLB.0323.00120,1,1447972,1449113,-,1141
628,WOLB.0323.00041,1,1262507,1263648,-,1141
628,WOLB.0323.00024,1,1180342,1181483,-,1141
628,WOLB.0323.00014,1,1299955,1301095,+,1140
628,WOLB.0323.00096,1,1453881,1455022,-,1141
627,WOLB.0323.00135,1,1321085,1321869,+,784
627,WOLB.0323.00074,1,350104,350888,+,784
627,WOLB.0323.00074,1,1470043,1470826,-,783
627,WOLB.0323.00120,1,328433,329217,+,784
627,WOLB.0323.00120,1,1450385,1451168,-,783
627,WOLB.0323.00041,1,1139520,1140302,-,782
627,WOLB.0323.00041,1,1264920,1265703,-,783
627,WOLB.0323.00041,1,1555740,1556523,-,783
627,WOLB.0323.00023,1,1559996,1560762,-,766
627,WOLB.0323.00100,1,714786,715569,-,783
627,WOLB.0323.00100,1,776020,776803,-,783
627,WOLB.0323.00014,1,1297878,1298662,+,784
627,WOLB.0323.00096,1,1324773,1325556,-,783
627,WOLB.0323.00096,1,1456294,1457077,-,783
626,WOLB.0323.00135,1,1320419,1321084,+,665
626,WOLB.0323.00074,1,349431,350103,+,672
626,WOLB.0323.00074,1,1470828,1471500,-,672
626,WOLB.0323.00120,1,327760,328432,+,672
626,WOLB.0323.00120,1,1451170,1451842,-,672
626,WOLB.0323.00041,1,1140304,1140976,-,672
626,WOLB.0323.00041,1,1265705,1266377,-,672
626,WOLB.0323.00041,1,1556525,1557197,-,672
626,WOLB.0323.00023,1,1562412,1563148,-,736
626,WOLB.0323.00100,1,715571,716236,-,665
626,WOLB.0323.00100,1,776805,777470,-,665
626,WOLB.0323.00014,1,1297212,1297877,+,665
626,WOLB.0323.00096,1,1325558,1326230,-,672
626,WOLB.0323.00096,1,1457079,1457751,-,672
625,WOLB.0323.00135,1,1147306,1148911,+,1605
625,WOLB.0323.00122,1,932704,934312,-,1608
624,WOLB.0323.00135,1,1120217,1121022,+,805
624,WOLB.0323.00103,1,638938,639728,+,790
624,WOLB.0323.00107,1,637522,638312,+,790
624,WOLB.0323.00019,1,391196,392002,-,806
624,WOLB.0323.00039,1,1172170,1173009,-,839
624,WOLB.0323.00105,1,638949,639739,+,790
624,WOLB.0323.00001,1,638949,639739,+,790
624,WOLB.0323.00119,1,789460,790266,+,806
623,WOLB.0323.00135,1,1119084,1120215,+,1131
623,WOLB.0323.00019,1,392003,393126,-,1123
623,WOLB.0323.00039,1,1173010,1174133,-,1123
623,WOLB.0323.00119,1,788336,789458,+,1122
622,WOLB.0323.00135,1,1096060,1096610,+,550
622,WOLB.0323.00018,1,184480,185031,+,551
622,WOLB.0323.00018,1,915405,915956,-,551
621,WOLB.0323.00135,1,1093721,1094520,+,799
621,WOLB.0323.00018,1,843504,844304,+,800
621,WOLB.0323.00010,1,1584515,1585314,-,799
620,WOLB.0323.00135,1,812749,813320,+,571
620,WOLB.0323.00021,1,1196105,1196676,+,571
620,WOLB.0323.00043,1,1082281,1082852,-,571
620,WOLB.0323.00128,1,553402,553973,-,571
620,WOLB.0323.00070,1,1296770,1297341,+,571
620,WOLB.0323.00014,1,1155291,1155862,+,571
619,WOLB.0323.00135,1,798929,800314,+,1385
619,WOLB.0323.00060,1,835307,836692,-,1385
619,WOLB.0323.00056,1,882421,883806,-,1385
619,WOLB.0323.00088,1,923558,924943,-,1385
619,WOLB.0323.00020,1,864465,865850,-,1385
619,WOLB.0323.00035,1,861470,862855,-,1385
619,WOLB.0323.00012,1,927671,929056,-,1385
619,WOLB.0323.00104,1,901390,902775,-,1385
619,WOLB.0323.00007,1,398489,399874,+,1385
619,WOLB.0323.00100,1,1246119,1247504,-,1385
618,WOLB.0323.00135,1,14042,17156,+,3114
618,WOLB.0323.00135,1,1368900,1372013,+,3113
618,WOLB.0323.00060,1,238587,241662,-,3075
618,WOLB.0323.00060,1,1193059,1196164,+,3105
618,WOLB.0323.00093,1,1501774,1504852,+,3078
618,WOLB.0323.00024,1,887972,891059,-,3087
618,WOLB.0323.00024,1,1638382,1641430,+,3048
618,WOLB.0323.00024,1,2067058,2070151,-,3093
618,WOLB.0323.00024,1,2137731,2140824,-,3093
618,WOLB.0323.00133,1,271681,274754,+,3073
618,WOLB.0323.00043,1,742459,745537,+,3078
618,WOLB.0323.00025,1,928318,931320,+,3002
618,WOLB.0323.00010,1,546830,549907,+,3077
618,WOLB.0323.00007,1,1146953,1150031,+,3078
618,WOLB.0323.00042,1,987370,990448,+,3078
618,WOLB.0323.00042,1,1166401,1169479,-,3078
618,WOLB.0323.00042,1,1534696,1537774,-,3078
618,WOLB.0323.00042,1,1684437,1687515,-,3078
617,WOLB.0323.00135,1,12198,13272,+,1074
617,WOLB.0323.00135,1,1367056,1368130,+,1074
617,WOLB.0323.00060,1,242432,243507,-,1075
617,WOLB.0323.00060,1,1191221,1192295,+,1074
617,WOLB.0323.00093,1,1499917,1501004,+,1087
617,WOLB.0323.00024,1,1636528,1637612,+,1084
617,WOLB.0323.00024,1,2070921,2072005,-,1084
617,WOLB.0323.00024,1,2141594,2142678,-,1084
617,WOLB.0323.00133,1,269828,270912,+,1084
617,WOLB.0323.00043,1,740605,741689,+,1084
617,WOLB.0323.00025,1,926482,927560,+,1078
617,WOLB.0323.00010,1,544991,546065,+,1074
617,WOLB.0323.00007,1,1145109,1146183,+,1074
617,WOLB.0323.00042,1,985516,986600,+,1084
617,WOLB.0323.00042,1,1170249,1171333,-,1084
617,WOLB.0323.00042,1,1538544,1539628,-,1084
617,WOLB.0323.00042,1,1688285,1689369,-,1084
616,WOLB.0323.00135,1,8066,10442,+,2376
616,WOLB.0323.00135,1,1362924,1365300,+,2376
616,WOLB.0323.00060,1,245265,247587,-,2322
616,WOLB.0323.00060,1,1187119,1189489,+,2370
616,WOLB.0323.00093,1,1495849,1498228,+,2379
616,WOLB.0323.00024,1,1631338,1633714,+,2376
616,WOLB.0323.00024,1,2073607,2075986,-,2379
616,WOLB.0323.00024,1,2144280,2146659,-,2379
616,WOLB.0323.00133,1,265856,268226,+,2370
616,WOLB.0323.00043,1,736489,738865,+,2376
616,WOLB.0323.00025,1,922409,924754,+,2345
616,WOLB.0323.00010,1,540892,543267,+,2375
616,WOLB.0323.00007,1,1140980,1143356,+,2376
616,WOLB.0323.00042,1,981440,983809,+,2369
616,WOLB.0323.00042,1,1173040,1175409,-,2369
616,WOLB.0323.00042,1,1541335,1543704,-,2369
616,WOLB.0323.00042,1,1691076,1693445,-,2369
615,WOLB.0323.00135,1,7445,7958,+,513
615,WOLB.0323.00135,1,1362303,1362816,+,513
615,WOLB.0323.00060,1,249410,249923,-,513
615,WOLB.0323.00060,1,1186498,1187011,+,513
615,WOLB.0323.00093,1,1495228,1495741,+,513
615,WOLB.0323.00024,1,1630717,1631230,+,513
615,WOLB.0323.00024,1,2076094,2076607,-,513
615,WOLB.0323.00024,1,2146767,2147280,-,513
615,WOLB.0323.00133,1,265235,265748,+,513
615,WOLB.0323.00043,1,735868,736381,+,513
615,WOLB.0323.00025,1,921760,922273,+,513
615,WOLB.0323.00010,1,540277,540784,+,507
615,WOLB.0323.00007,1,1140359,1140872,+,513
615,WOLB.0323.00042,1,980812,981325,+,513
615,WOLB.0323.00042,1,1175524,1176037,-,513
615,WOLB.0323.00042,1,1543819,1544332,-,513
615,WOLB.0323.00042,1,1693560,1694073,-,513
614,WOLB.0323.00135,1,5493,7443,+,1950
614,WOLB.0323.00135,1,1360351,1362301,+,1950
614,WOLB.0323.00060,1,249924,251871,-,1947
614,WOLB.0323.00060,1,1184546,1186496,+,1950
614,WOLB.0323.00093,1,1493276,1495226,+,1950
614,WOLB.0323.00024,1,2076608,2078559,-,1951
614,WOLB.0323.00024,1,2147281,2149232,-,1951
614,WOLB.0323.00133,1,263294,265233,+,1939
614,WOLB.0323.00043,1,733916,735866,+,1950
614,WOLB.0323.00025,1,919808,921758,+,1950
614,WOLB.0323.00010,1,538327,540275,+,1948
614,WOLB.0323.00007,1,1138407,1140357,+,1950
614,WOLB.0323.00042,1,978860,980810,+,1950
614,WOLB.0323.00042,1,1176038,1177988,-,1950
614,WOLB.0323.00042,1,1544333,1546283,-,1950
614,WOLB.0323.00042,1,1694074,1696024,-,1950
613,WOLB.0323.00135,1,3147,4989,+,1842
613,WOLB.0323.00135,1,1358005,1359847,+,1842
613,WOLB.0323.00060,1,252361,254225,-,1864
613,WOLB.0323.00060,1,1182209,1184042,+,1833
613,WOLB.0323.00093,1,1490888,1492772,+,1884
613,WOLB.0323.00024,1,2079063,2080945,-,1882
613,WOLB.0323.00024,1,2149736,2151618,-,1882
613,WOLB.0323.00133,1,260976,262795,+,1819
613,WOLB.0323.00043,1,731579,733412,+,1833
613,WOLB.0323.00025,1,917480,919304,+,1824
613,WOLB.0323.00010,1,535990,537823,+,1833
613,WOLB.0323.00007,1,1136070,1137903,+,1833
613,WOLB.0323.00042,1,976442,978356,+,1914
613,WOLB.0323.00042,1,1178493,1180407,-,1914
613,WOLB.0323.00042,1,1546788,1548702,-,1914
613,WOLB.0323.00042,1,1696529,1698443,-,1914
612,WOLB.0323.00135,1,1886,2439,+,553
612,WOLB.0323.00135,1,1356742,1357295,+,553
612,WOLB.0323.00060,1,1180946,1181499,+,553
612,WOLB.0323.00024,1,2152330,2152883,-,553
612,WOLB.0323.00133,1,259721,260274,+,553
612,WOLB.0323.00025,1,916543,917090,+,547
611,WOLB.0323.00121,1,891126,892201,+,1075
611,WOLB.0323.00060,1,519109,520195,+,1086
611,WOLB.0323.00056,1,672048,673134,+,1086
611,WOLB.0323.00142,1,766283,767358,+,1075
611,WOLB.0323.00122,1,562498,563573,+,1075
611,WOLB.0323.00004,1,766284,767359,+,1075
611,WOLB.0323.00011,1,135343,136418,+,1075
611,WOLB.0323.00018,1,546207,547293,+,1086
611,WOLB.0323.00158,1,39134,40209,+,1075
611,WOLB.0323.00017,1,754991,756066,+,1075
611,WOLB.0323.00007,1,672010,673097,-,1087
611,WOLB.0323.00149,1,1076708,1077783,-,1075
610,WOLB.0323.00121,1,829354,829987,+,633
610,WOLB.0323.00100,1,993280,993913,+,633
609,WOLB.0323.00121,1,808044,809711,+,1667
609,WOLB.0323.00074,1,270688,272354,-,1666
609,WOLB.0323.00120,1,261781,263447,-,1666
609,WOLB.0323.00041,1,1199124,1200790,+,1666
609,WOLB.0323.00024,1,1290807,1292474,+,1667
609,WOLB.0323.00024,1,2112215,2113881,+,1666
609,WOLB.0323.00043,1,605550,607212,-,1662
609,WOLB.0323.00043,1,1127971,1129633,-,1662
609,WOLB.0323.00007,1,871944,873611,-,1667
609,WOLB.0323.00100,1,971970,973637,+,1667
609,WOLB.0323.00096,1,1389230,1390896,+,1666
608,WOLB.0323.00121,1,805825,808043,+,2218
608,WOLB.0323.00074,1,272356,274574,-,2218
608,WOLB.0323.00120,1,263449,265667,-,2218
608,WOLB.0323.00041,1,1196905,1199123,+,2218
608,WOLB.0323.00093,1,1553031,1555246,+,2215
608,WOLB.0323.00024,1,1288588,1290806,+,2218
608,WOLB.0323.00024,1,2109996,2112214,+,2218
608,WOLB.0323.00043,1,607214,609432,-,2218
608,WOLB.0323.00043,1,1129635,1131853,-,2218
608,WOLB.0323.00007,1,873613,875831,-,2218
608,WOLB.0323.00100,1,969751,971969,+,2218
608,WOLB.0323.00096,1,1387011,1389229,+,2218
607,WOLB.0323.00121,1,801815,802477,+,662
607,WOLB.0323.00074,1,277902,278577,-,675
607,WOLB.0323.00120,1,268995,269670,-,675
607,WOLB.0323.00041,1,1192901,1193577,+,676
607,WOLB.0323.00093,1,1548989,1549651,+,662
607,WOLB.0323.00024,1,840482,841144,+,662
607,WOLB.0323.00024,1,2105994,2106656,+,662
607,WOLB.0323.00043,1,612811,613473,-,662
607,WOLB.0323.00043,1,1135232,1135894,-,662
607,WOLB.0323.00018,1,760020,760682,-,662
607,WOLB.0323.00007,1,878986,879648,-,662
607,WOLB.0323.00100,1,965741,966403,+,662
607,WOLB.0323.00096,1,1383007,1383683,+,676
606,WOLB.0323.00121,1,800889,801457,+,568
606,WOLB.0323.00060,1,280503,281077,+,574
606,WOLB.0323.00093,1,1548063,1548631,+,568
606,WOLB.0323.00024,1,839547,840124,+,577
606,WOLB.0323.00024,1,2105059,2105636,+,577
606,WOLB.0323.00043,1,613831,614398,-,567
606,WOLB.0323.00043,1,1136252,1136819,-,567
606,WOLB.0323.00018,1,761040,761609,-,569
606,WOLB.0323.00010,1,884216,884791,-,575
606,WOLB.0323.00007,1,880006,880575,-,569
606,WOLB.0323.00100,1,964815,965383,+,568
605,WOLB.0323.00121,1,771399,772043,+,644
605,WOLB.0323.00023,1,444659,445316,+,657
605,WOLB.0323.00030,1,389081,389722,+,641
605,WOLB.0323.00030,1,513347,513991,+,644
605,WOLB.0323.00032,1,1525639,1526283,-,644
605,WOLB.0323.00100,1,939134,939778,+,644
604,WOLB.0323.00121,1,769685,770368,+,683
604,WOLB.0323.00023,1,442993,443676,+,683
604,WOLB.0323.00030,1,387405,388077,+,672
604,WOLB.0323.00030,1,511633,512316,+,683
604,WOLB.0323.00032,1,1527266,1527949,-,683
604,WOLB.0323.00100,1,937420,938103,+,683
604,WOLB.0323.00042,1,594391,595074,-,683
603,WOLB.0323.00121,1,767763,768669,+,906
603,WOLB.0323.00023,1,441071,441977,+,906
603,WOLB.0323.00030,1,385605,386405,+,800
603,WOLB.0323.00030,1,509711,510617,+,906
603,WOLB.0323.00032,1,1528998,1529891,-,893
603,WOLB.0323.00025,1,109616,110518,+,902
603,WOLB.0323.00100,1,935498,936404,+,906
603,WOLB.0323.00042,1,596090,596996,-,906
602,WOLB.0323.00121,1,750866,751539,+,673
602,WOLB.0323.00135,1,469214,469887,+,673
602,WOLB.0323.00135,1,493346,494019,+,673
602,WOLB.0323.00135,1,646606,647279,+,673
602,WOLB.0323.00135,1,1174673,1175346,+,673
602,WOLB.0323.00135,1,1274332,1275006,-,674
602,WOLB.0323.00142,1,541766,542439,+,673
602,WOLB.0323.00142,1,1308721,1309395,-,674
602,WOLB.0323.00064,1,21319,21993,-,674
602,WOLB.0323.00064,1,364947,365621,-,674
602,WOLB.0323.00064,1,396109,396783,-,674
602,WOLB.0323.00064,1,1484814,1485487,+,673
602,WOLB.0323.00030,1,1390334,1391007,+,673
602,WOLB.0323.00122,1,348084,348758,-,674
602,WOLB.0323.00122,1,611733,612407,-,674
602,WOLB.0323.00122,1,661080,661754,-,674
602,WOLB.0323.00122,1,765404,766077,+,673
602,WOLB.0323.00122,1,820668,821323,-,655
602,WOLB.0323.00122,1,1111721,1112394,+,673
602,WOLB.0323.00122,1,1259677,1260351,-,674
602,WOLB.0323.00122,1,1411348,1412022,-,674
602,WOLB.0323.00122,1,1417737,1418410,+,673
602,WOLB.0323.00122,1,1447493,1448167,-,674
602,WOLB.0323.00122,1,1472606,1473280,-,674
602,WOLB.0323.00122,1,1486064,1486737,+,673
602,WOLB.0323.00004,1,72263,72937,-,674
602,WOLB.0323.00004,1,539331,540004,+,673
602,WOLB.0323.00004,1,1304672,1305346,-,674
602,WOLB.0323.00010,1,294450,295124,-,674
602,WOLB.0323.00010,1,383125,383799,-,674
602,WOLB.0323.00010,1,682888,683561,+,673
602,WOLB.0323.00010,1,695402,696076,-,674
602,WOLB.0323.00010,1,706856,707529,+,673
602,WOLB.0323.00010,1,783435,784109,-,674
602,WOLB.0323.00010,1,785316,785989,+,673
602,WOLB.0323.00010,1,794025,794698,+,673
602,WOLB.0323.00010,1,909461,910135,-,674
602,WOLB.0323.00010,1,1254272,1254945,+,673
602,WOLB.0323.00158,1,605667,606341,-,674
602,WOLB.0323.00158,1,1193798,1194471,+,673
602,WOLB.0323.00017,1,541337,542010,+,673
602,WOLB.0323.00017,1,577130,577803,+,673
602,WOLB.0323.00017,1,1295356,1296030,-,674
602,WOLB.0323.00104,1,439664,440338,-,674
602,WOLB.0323.00104,1,743167,743841,-,674
602,WOLB.0323.00149,1,29725,30398,+,673
602,WOLB.0323.00149,1,1276671,1277344,+,673
601,WOLB.0323.00121,1,703691,704519,+,828
601,WOLB.0323.00135,1,1133845,1134673,+,828
601,WOLB.0323.00142,1,482679,483508,-,829
601,WOLB.0323.00004,1,479141,479970,-,829
601,WOLB.0323.00011,1,1217492,1218320,+,828
601,WOLB.0323.00010,1,362977,363805,+,828
601,WOLB.0323.00158,1,416189,417017,+,828
601,WOLB.0323.00017,1,556762,557591,-,829
601,WOLB.0323.00149,1,1285967,1286796,-,829
600,WOLB.0323.00121,1,702591,703494,+,903
600,WOLB.0323.00135,1,1132745,1133648,+,903
600,WOLB.0323.00060,1,318308,319174,+,866
600,WOLB.0323.00074,1,307600,308487,-,887
600,WOLB.0323.00074,1,478567,479473,-,906
600,WOLB.0323.00120,1,292368,293255,-,887
600,WOLB.0323.00120,1,464738,465644,-,906
600,WOLB.0323.00041,1,1174177,1175064,+,887
600,WOLB.0323.00041,1,1425808,1426714,+,906
600,WOLB.0323.00142,1,483705,484608,-,903
600,WOLB.0323.00024,1,1328474,1329364,+,890
600,WOLB.0323.00084,1,192162,193028,+,866
600,WOLB.0323.00043,1,656521,657387,-,866
600,WOLB.0323.00122,1,1462342,1463208,-,866
600,WOLB.0323.00004,1,480167,481070,-,903
600,WOLB.0323.00011,1,1216392,1217295,+,903
600,WOLB.0323.00032,1,75769,76635,-,866
600,WOLB.0323.00010,1,361877,362780,+,903
600,WOLB.0323.00158,1,415089,415992,+,903
600,WOLB.0323.00017,1,557788,558691,-,903
600,WOLB.0323.00042,1,1133038,1133904,-,866
600,WOLB.0323.00149,1,1286993,1287896,-,903
600,WOLB.0323.00096,1,1189291,1190197,+,906
600,WOLB.0323.00096,1,1359423,1360310,+,887
599,WOLB.0323.00121,1,701360,701978,+,618
599,WOLB.0323.00135,1,1131514,1132132,+,618
599,WOLB.0323.00074,1,480088,480702,-,614
599,WOLB.0323.00120,1,466259,466873,-,614
599,WOLB.0323.00041,1,1424579,1425193,+,614
599,WOLB.0323.00142,1,485221,485839,-,618
599,WOLB.0323.00004,1,481683,482301,-,618
599,WOLB.0323.00011,1,1215161,1215779,+,618
599,WOLB.0323.00010,1,360646,361264,+,618
599,WOLB.0323.00158,1,413858,414476,+,618
599,WOLB.0323.00017,1,559304,559922,-,618
599,WOLB.0323.00149,1,1290494,1291112,-,618
599,WOLB.0323.00096,1,1188062,1188676,+,614
598,WOLB.0323.00121,1,696561,700808,+,4247
598,WOLB.0323.00135,1,1126715,1130962,+,4247
598,WOLB.0323.00142,1,486390,490638,-,4248
598,WOLB.0323.00004,1,482852,487100,-,4248
598,WOLB.0323.00011,1,1210362,1214609,+,4247
598,WOLB.0323.00010,1,355847,360094,+,4247
598,WOLB.0323.00158,1,409059,413306,+,4247
598,WOLB.0323.00017,1,560473,564721,-,4248
598,WOLB.0323.00149,1,1291663,1295911,-,4248
597,WOLB.0323.00121,1,694519,695994,+,1475
597,WOLB.0323.00135,1,1124673,1126148,+,1475
597,WOLB.0323.00142,1,491205,492680,-,1475
597,WOLB.0323.00043,1,983075,984542,-,1467
597,WOLB.0323.00004,1,487667,489142,-,1475
597,WOLB.0323.00011,1,1208320,1209795,+,1475
597,WOLB.0323.00010,1,353804,355280,+,1476
597,WOLB.0323.00158,1,407017,408492,+,1475
597,WOLB.0323.00017,1,565288,566763,-,1475
597,WOLB.0323.00149,1,1296478,1297953,-,1475
596,WOLB.0323.00121,1,672983,676078,+,3095
596,WOLB.0323.00142,1,509609,512704,-,3095
596,WOLB.0323.00088,1,524432,527527,+,3095
596,WOLB.0323.00122,1,1073880,1076975,-,3095
596,WOLB.0323.00004,1,507174,510269,-,3095
596,WOLB.0323.00158,1,386992,390087,+,3095
596,WOLB.0323.00149,1,1244626,1247721,-,3095
595,WOLB.0323.00121,1,648668,649447,+,779
595,WOLB.0323.00060,1,266986,267765,+,779
595,WOLB.0323.00060,1,1168644,1169426,-,782
595,WOLB.0323.00039,1,49169,49948,+,779
595,WOLB.0323.00056,1,469754,470533,-,779
595,WOLB.0323.00056,1,536141,536920,-,779
595,WOLB.0323.00093,1,1479734,1480513,-,779
595,WOLB.0323.00008,1,403986,404765,-,779
595,WOLB.0323.00008,1,698048,698827,+,779
595,WOLB.0323.00008,1,734678,735457,+,779
595,WOLB.0323.00024,1,510115,510903,+,788
595,WOLB.0323.00024,1,1052909,1053697,+,788
595,WOLB.0323.00024,1,1344145,1344927,+,782
595,WOLB.0323.00064,1,477078,477857,+,779
595,WOLB.0323.00064,1,717456,718235,-,779
595,WOLB.0323.00064,1,1556224,1557003,-,779
595,WOLB.0323.00030,1,1137057,1137836,-,779
595,WOLB.0323.00084,1,210618,211397,+,779
595,WOLB.0323.00043,1,1151405,1152184,-,779
595,WOLB.0323.00010,1,377938,378717,+,779
595,WOLB.0323.00128,1,414123,414902,+,779
595,WOLB.0323.00007,1,969952,970734,-,782
595,WOLB.0323.00070,1,857880,858659,+,779
595,WOLB.0323.00014,1,817280,818059,-,779
594,WOLB.0323.00121,1,647026,647564,+,538
594,WOLB.0323.00060,1,265344,265882,+,538
594,WOLB.0323.00039,1,47527,48065,+,538
594,WOLB.0323.00056,1,538024,538561,-,537
594,WOLB.0323.00024,1,506159,506697,+,538
594,WOLB.0323.00064,1,1558107,1558644,-,537
594,WOLB.0323.00084,1,208976,209514,+,538
594,WOLB.0323.00043,1,1153288,1153825,-,537
593,WOLB.0323.00121,1,629180,630367,+,1187
593,WOLB.0323.00004,1,554464,555650,-,1186
593,WOLB.0323.00011,1,1265044,1266230,-,1186
593,WOLB.0323.00032,1,63436,64622,-,1186
593,WOLB.0323.00032,1,1513654,1514841,+,1187
593,WOLB.0323.00158,1,1208931,1210117,-,1186
593,WOLB.0323.00104,1,424018,425205,+,1187
593,WOLB.0323.00149,1,1335934,1337120,-,1186
592,WOLB.0323.00121,1,628345,629179,+,834
592,WOLB.0323.00019,1,913948,914784,+,836
592,WOLB.0323.00039,1,210695,211528,-,833
592,WOLB.0323.00142,1,552520,553354,-,834
592,WOLB.0323.00004,1,550085,550919,-,834
592,WOLB.0323.00004,1,555652,556486,-,834
592,WOLB.0323.00011,1,1266232,1267066,-,834
592,WOLB.0323.00032,1,59057,59891,-,834
592,WOLB.0323.00032,1,64624,65458,-,834
592,WOLB.0323.00032,1,1512819,1513653,+,834
592,WOLB.0323.00032,1,1518386,1519220,+,834
592,WOLB.0323.00158,1,1204552,1205386,-,834
592,WOLB.0323.00158,1,1210119,1210953,-,834
592,WOLB.0323.00104,1,423183,424017,+,834
592,WOLB.0323.00104,1,428750,429584,+,834
592,WOLB.0323.00119,1,916602,917438,+,836
592,WOLB.0323.00149,1,1331555,1332389,-,834
592,WOLB.0323.00149,1,1337122,1337956,-,834
591,WOLB.0323.00121,1,627372,628343,+,971
591,WOLB.0323.00019,1,912972,913946,+,974
591,WOLB.0323.00039,1,211529,212504,-,975
591,WOLB.0323.00142,1,553355,554327,-,972
591,WOLB.0323.00004,1,556487,557459,-,972
591,WOLB.0323.00011,1,1267067,1268039,-,972
591,WOLB.0323.00032,1,65459,66431,-,972
591,WOLB.0323.00032,1,1511846,1512817,+,971
591,WOLB.0323.00158,1,1210954,1211926,-,972
591,WOLB.0323.00104,1,422204,423181,+,977
591,WOLB.0323.00119,1,915626,916600,+,974
591,WOLB.0323.00149,1,1337957,1338929,-,972
590,WOLB.0323.00121,1,624307,624943,+,636
590,WOLB.0323.00039,1,214109,214745,-,636
590,WOLB.0323.00142,1,556756,557392,-,636
590,WOLB.0323.00004,1,559888,560524,-,636
590,WOLB.0323.00011,1,1270468,1271104,-,636
590,WOLB.0323.00032,1,1508751,1509387,+,636
590,WOLB.0323.00158,1,1214355,1214991,-,636
590,WOLB.0323.00104,1,419139,419775,+,636
590,WOLB.0323.00149,1,1328639,1329275,+,636
590,WOLB.0323.00149,1,1341374,1342010,-,636
589,WOLB.0323.00121,1,621917,623730,+,1813
589,WOLB.0323.00039,1,215307,217145,-,1838
589,WOLB.0323.00142,1,557968,559796,-,1828
589,WOLB.0323.00004,1,561100,562928,-,1828
589,WOLB.0323.00011,1,1271680,1273492,-,1812
589,WOLB.0323.00032,1,1506343,1508174,+,1831
589,WOLB.0323.00158,1,1215567,1217395,-,1828
589,WOLB.0323.00104,1,416749,418562,+,1813
589,WOLB.0323.00149,1,1326249,1328062,+,1813
589,WOLB.0323.00149,1,1342586,1344399,-,1813
588,WOLB.0323.00121,1,503317,505749,+,2432
588,WOLB.0323.00060,1,94114,96564,-,2450
588,WOLB.0323.00056,1,419832,422282,-,2450
588,WOLB.0323.00142,1,599854,602286,-,2432
588,WOLB.0323.00088,1,482464,484915,-,2451
588,WOLB.0323.00084,1,167718,170150,+,2432
588,WOLB.0323.00043,1,935451,937883,+,2432
588,WOLB.0323.00020,1,452232,454683,-,2451
588,WOLB.0323.00004,1,602060,604492,-,2432
588,WOLB.0323.00035,1,407955,410406,-,2451
588,WOLB.0323.00012,1,483606,486057,-,2451
588,WOLB.0323.00158,1,1232602,1235034,-,2432
588,WOLB.0323.00017,1,588572,591004,-,2432
588,WOLB.0323.00104,1,411297,413748,-,2451
588,WOLB.0323.00007,1,1009170,1011620,+,2450
588,WOLB.0323.00100,1,559199,561650,-,2451
588,WOLB.0323.00042,1,779997,782442,-,2445
588,WOLB.0323.00149,1,1310246,1312678,+,2432
587,WOLB.0323.00121,1,501024,503315,+,2291
587,WOLB.0323.00060,1,96565,98788,-,2223
587,WOLB.0323.00056,1,422283,424506,-,2223
587,WOLB.0323.00142,1,602287,604579,-,2292
587,WOLB.0323.00088,1,484916,487138,-,2222
587,WOLB.0323.00084,1,165493,167716,+,2223
587,WOLB.0323.00043,1,933227,935449,+,2222
587,WOLB.0323.00020,1,454684,456906,-,2222
587,WOLB.0323.00004,1,604493,606785,-,2292
587,WOLB.0323.00035,1,410407,412629,-,2222
587,WOLB.0323.00012,1,486058,488280,-,2222
587,WOLB.0323.00158,1,1235035,1237327,-,2292
587,WOLB.0323.00017,1,591005,593297,-,2292
587,WOLB.0323.00104,1,413749,415971,-,2222
587,WOLB.0323.00007,1,1006946,1009168,+,2222
587,WOLB.0323.00100,1,561651,563873,-,2222
587,WOLB.0323.00149,1,1307953,1310244,+,2291
586,WOLB.0323.00121,1,433520,434164,+,644
586,WOLB.0323.00142,1,358232,358876,+,644
586,WOLB.0323.00093,1,831076,831597,+,521
586,WOLB.0323.00088,1,434594,435130,+,536
586,WOLB.0323.00008,1,923707,924255,-,548
586,WOLB.0323.00133,1,394906,395406,-,500
586,WOLB.0323.00020,1,404372,404908,+,536
586,WOLB.0323.00004,1,356900,357544,+,644
586,WOLB.0323.00011,1,1108045,1108689,+,644
586,WOLB.0323.00035,1,360085,360621,+,536
586,WOLB.0323.00012,1,435746,436282,+,536
586,WOLB.0323.00010,1,1130458,1130973,-,515
586,WOLB.0323.00158,1,536152,536688,-,536
586,WOLB.0323.00017,1,432551,433195,+,644
586,WOLB.0323.00104,1,362485,363021,+,536
586,WOLB.0323.00100,1,511339,511875,+,536
586,WOLB.0323.00042,1,455361,455879,+,518
586,WOLB.0323.00149,1,107768,108304,-,536
585,WOLB.0323.00121,1,311396,311978,+,582
585,WOLB.0323.00060,1,674733,675315,+,582
585,WOLB.0323.00012,1,343964,344546,+,582
585,WOLB.0323.00018,1,733985,734567,+,582
585,WOLB.0323.00017,1,310393,310975,+,582
585,WOLB.0323.00007,1,467077,467659,+,582
585,WOLB.0323.00100,1,343976,344558,+,582
585,WOLB.0323.00100,1,419553,420135,+,582
585,WOLB.0323.00042,1,339206,339788,+,582
584,WOLB.0323.00121,1,304097,310612,+,6515
584,WOLB.0323.00023,1,1206995,1213510,+,6515
584,WOLB.0323.00088,1,336682,343197,+,6515
584,WOLB.0323.00064,1,506645,513160,+,6515
584,WOLB.0323.00030,1,1320683,1327198,+,6515
584,WOLB.0323.00021,1,306570,313085,-,6515
584,WOLB.0323.00032,1,1153675,1160190,-,6515
584,WOLB.0323.00012,1,336665,343180,+,6515
584,WOLB.0323.00018,1,726690,733201,+,6511
584,WOLB.0323.00017,1,303094,309609,+,6515
584,WOLB.0323.00100,1,336677,343192,+,6515
584,WOLB.0323.00100,1,412254,418769,+,6515
584,WOLB.0323.00070,1,313874,320389,+,6515
584,WOLB.0323.00042,1,331907,338422,+,6515
584,WOLB.0323.00014,1,298450,304965,+,6515
583,WOLB.0323.00121,1,302552,303605,+,1053
583,WOLB.0323.00023,1,1205450,1206503,+,1053
583,WOLB.0323.00088,1,335137,336190,+,1053
583,WOLB.0323.00064,1,505101,506154,+,1053
583,WOLB.0323.00064,1,1634759,1635810,+,1051
583,WOLB.0323.00030,1,1319139,1320192,+,1053
583,WOLB.0323.00021,1,313577,314630,-,1053
583,WOLB.0323.00032,1,1160682,1161735,-,1053
583,WOLB.0323.00012,1,335120,336173,+,1053
583,WOLB.0323.00017,1,301549,302602,+,1053
583,WOLB.0323.00100,1,335132,336185,+,1053
583,WOLB.0323.00100,1,410709,411762,+,1053
583,WOLB.0323.00070,1,312329,313382,+,1053
583,WOLB.0323.00042,1,330362,331415,+,1053
583,WOLB.0323.00014,1,296905,297958,+,1053
582,WOLB.0323.00121,1,298924,299500,+,576
582,WOLB.0323.00023,1,1201906,1202483,+,577
582,WOLB.0323.00088,1,331507,332083,+,576
582,WOLB.0323.00024,1,783695,784270,+,575
582,WOLB.0323.00024,1,1471052,1471626,-,574
582,WOLB.0323.00064,1,501476,502051,+,575
582,WOLB.0323.00064,1,1631134,1631709,+,575
582,WOLB.0323.00030,1,1315515,1316089,+,574
582,WOLB.0323.00133,1,470290,470878,-,588
582,WOLB.0323.00021,1,317683,318258,-,575
582,WOLB.0323.00012,1,331492,332068,+,576
582,WOLB.0323.00017,1,297921,298497,+,576
582,WOLB.0323.00100,1,331504,332080,+,576
582,WOLB.0323.00100,1,407081,407657,+,576
582,WOLB.0323.00070,1,308687,309276,+,589
582,WOLB.0323.00042,1,326734,327310,+,576
581,WOLB.0323.00143,1,914871,916619,+,1748
581,WOLB.0323.00106,1,914874,916622,+,1748
581,WOLB.0323.00031,1,1144217,1145966,-,1749
581,WOLB.0323.00006,1,194843,196591,+,1748
580,WOLB.0323.00143,1,905108,905726,+,618
580,WOLB.0323.00106,1,905111,905729,+,618
580,WOLB.0323.00074,1,583751,584369,+,618
580,WOLB.0323.00120,1,569922,570540,+,618
580,WOLB.0323.00041,1,1046461,1047078,-,617
580,WOLB.0323.00031,1,1155111,1155728,-,617
580,WOLB.0323.00093,1,842448,843062,-,614
580,WOLB.0323.00008,1,912233,912848,+,615
580,WOLB.0323.00006,1,185080,185698,+,618
580,WOLB.0323.00096,1,1084395,1085012,-,617
579,WOLB.0323.00143,1,874292,874846,+,554
579,WOLB.0323.00106,1,874295,874849,+,554
579,WOLB.0323.00031,1,1185990,1186545,-,555
579,WOLB.0323.00025,1,405518,406108,+,590
579,WOLB.0323.00010,1,1088295,1088832,+,537
579,WOLB.0323.00006,1,154372,154926,+,554
579,WOLB.0323.00042,1,498416,498958,-,542
578,WOLB.0323.00143,1,850761,851362,+,601
578,WOLB.0323.00106,1,850764,851365,+,601
578,WOLB.0323.00031,1,1209475,1210076,-,601
578,WOLB.0323.00006,1,1002125,1002726,-,601
577,WOLB.0323.00143,1,802040,808364,+,6324
577,WOLB.0323.00106,1,802042,808367,+,6325
577,WOLB.0323.00031,1,1252472,1258797,-,6325
577,WOLB.0323.00006,1,1280859,1287085,-,6226
576,WOLB.0323.00143,1,799492,800366,+,874
576,WOLB.0323.00106,1,799494,800368,+,874
576,WOLB.0323.00031,1,1260471,1261346,-,875
576,WOLB.0323.00006,1,1288759,1289634,-,875
575,WOLB.0323.00143,1,767448,768257,+,809
575,WOLB.0323.00106,1,767449,768258,+,809
575,WOLB.0323.00103,1,810307,811093,+,786
575,WOLB.0323.00107,1,808879,809665,+,786
575,WOLB.0323.00031,1,19046,19856,-,810
575,WOLB.0323.00105,1,810317,811103,+,786
575,WOLB.0323.00001,1,810317,811103,+,786
575,WOLB.0323.00006,1,19032,19842,-,810
574,WOLB.0323.00143,1,734857,737137,+,2280
574,WOLB.0323.00143,1,959576,961856,+,2280
574,WOLB.0323.00106,1,734858,737138,+,2280
574,WOLB.0323.00106,1,959579,961859,+,2280
574,WOLB.0323.00031,1,50167,52447,-,2280
574,WOLB.0323.00031,1,1098981,1101261,-,2280
574,WOLB.0323.00024,1,311916,314189,+,2273
574,WOLB.0323.00006,1,239535,241815,+,2280
573,WOLB.0323.00143,1,726802,727337,+,535
573,WOLB.0323.00106,1,726803,727338,+,535
573,WOLB.0323.00074,1,390491,391011,+,520
573,WOLB.0323.00120,1,368820,369340,+,520
573,WOLB.0323.00041,1,1515618,1516139,-,521
573,WOLB.0323.00031,1,59966,60487,-,521
573,WOLB.0323.00133,1,57852,58373,-,521
573,WOLB.0323.00025,1,227843,228364,-,521
573,WOLB.0323.00006,1,56760,57281,-,521
573,WOLB.0323.00096,1,1284649,1285170,-,521
572,WOLB.0323.00143,1,723187,723813,+,626
572,WOLB.0323.00106,1,723188,723814,+,626
572,WOLB.0323.00031,1,63491,64117,-,626
572,WOLB.0323.00093,1,664269,664914,-,645
572,WOLB.0323.00008,1,440222,440873,+,651
572,WOLB.0323.00006,1,60284,60910,-,626
571,WOLB.0323.00143,1,722494,723025,+,531
571,WOLB.0323.00106,1,722495,723026,+,531
571,WOLB.0323.00031,1,64278,64809,-,531
571,WOLB.0323.00006,1,61071,61602,-,531
570,WOLB.0323.00143,1,719425,720991,+,1566
570,WOLB.0323.00106,1,719426,720992,+,1566
570,WOLB.0323.00031,1,66313,67878,-,1565
570,WOLB.0323.00006,1,63106,64671,-,1565
569,WOLB.0323.00143,1,708891,709479,+,588
569,WOLB.0323.00106,1,708892,709480,+,588
569,WOLB.0323.00031,1,77824,78412,-,588
569,WOLB.0323.00008,1,380669,381265,+,596
569,WOLB.0323.00018,1,710636,711232,+,596
569,WOLB.0323.00025,1,259931,260526,-,595
569,WOLB.0323.00010,1,807385,807980,-,595
569,WOLB.0323.00006,1,74636,75224,-,588
568,WOLB.0323.00143,1,705923,708616,+,2693
568,WOLB.0323.00106,1,705922,708617,+,2695
568,WOLB.0323.00031,1,78688,81382,-,2694
567,WOLB.0323.00143,1,701826,705232,+,3406
567,WOLB.0323.00106,1,701826,705231,+,3405
567,WOLB.0323.00031,1,82073,85479,-,3406
567,WOLB.0323.00006,1,1187562,1190967,-,3405
566,WOLB.0323.00143,1,698057,701649,+,3592
566,WOLB.0323.00106,1,698058,701649,+,3591
566,WOLB.0323.00031,1,85657,89249,-,3592
566,WOLB.0323.00006,1,1191145,1194737,-,3592
565,WOLB.0323.00143,1,694248,694905,+,657
565,WOLB.0323.00106,1,694249,694906,+,657
565,WOLB.0323.00031,1,92400,93057,-,657
565,WOLB.0323.00006,1,111490,112147,+,657
564,WOLB.0323.00143,1,683834,684446,+,612
564,WOLB.0323.00106,1,683835,684447,+,612
564,WOLB.0323.00019,1,480655,481256,+,601
564,WOLB.0323.00039,1,325293,325905,-,612
564,WOLB.0323.00031,1,102860,103471,-,611
564,WOLB.0323.00093,1,870307,870920,-,613
564,WOLB.0323.00008,1,890555,891168,+,613
564,WOLB.0323.00133,1,243103,243704,-,601
564,WOLB.0323.00025,1,307366,307978,+,612
564,WOLB.0323.00006,1,101075,101687,+,612
564,WOLB.0323.00119,1,698767,699367,-,600
563,WOLB.0323.00143,1,650690,651365,+,675
563,WOLB.0323.00106,1,650691,651366,+,675
563,WOLB.0323.00031,1,135940,136616,-,676
563,WOLB.0323.00006,1,1182696,1183371,+,675
562,WOLB.0323.00143,1,601172,604259,+,3087
562,WOLB.0323.00106,1,601174,604259,+,3085
562,WOLB.0323.00031,1,183048,186135,-,3087
562,WOLB.0323.00006,1,1133423,1136271,+,2848
561,WOLB.0323.00143,1,529490,530358,+,868
561,WOLB.0323.00106,1,529493,530361,+,868
561,WOLB.0323.00031,1,256951,257819,-,868
561,WOLB.0323.00006,1,1061949,1062817,+,868
560,WOLB.0323.00143,1,470910,471598,+,688
560,WOLB.0323.00106,1,470913,471601,+,688
560,WOLB.0323.00031,1,315710,316399,-,689
560,WOLB.0323.00006,1,1239091,1239779,+,688
559,WOLB.0323.00143,1,425360,425955,+,595
559,WOLB.0323.00106,1,425363,425958,+,595
559,WOLB.0323.00031,1,361353,361948,-,595
559,WOLB.0323.00006,1,765439,766034,-,595
558,WOLB.0323.00143,1,406714,407644,+,930
558,WOLB.0323.00106,1,406717,407647,+,930
558,WOLB.0323.00031,1,379665,380595,-,930
558,WOLB.0323.00025,1,63718,64646,-,928
558,WOLB.0323.00006,1,782545,783403,-,858
557,WOLB.0323.00143,1,406109,406712,+,603
557,WOLB.0323.00106,1,406112,406715,+,603
557,WOLB.0323.00121,1,1487293,1487932,-,639
557,WOLB.0323.00031,1,380597,381200,-,603
557,WOLB.0323.00142,1,1365354,1365993,-,639
557,WOLB.0323.00118,1,1245455,1246094,-,639
557,WOLB.0323.00004,1,1361305,1361944,-,639
557,WOLB.0323.00011,1,730720,731359,-,639
557,WOLB.0323.00158,1,662300,662939,-,639
557,WOLB.0323.00017,1,1351989,1352628,-,639
557,WOLB.0323.00006,1,783405,784008,-,603
557,WOLB.0323.00149,1,484785,485424,+,639
556,WOLB.0323.00143,1,372272,372814,+,542
556,WOLB.0323.00106,1,372275,372817,+,542
556,WOLB.0323.00031,1,414496,415037,-,541
556,WOLB.0323.00006,1,976746,977288,+,542
555,WOLB.0323.00143,1,352310,353310,+,1000
555,WOLB.0323.00106,1,352313,353313,+,1000
555,WOLB.0323.00031,1,434000,434999,-,999
555,WOLB.0323.00064,1,244227,245274,+,1047
555,WOLB.0323.00030,1,813803,814850,+,1047
555,WOLB.0323.00006,1,956772,957772,+,1000
554,WOLB.0323.00143,1,345836,346698,+,862
554,WOLB.0323.00106,1,345839,346701,+,862
554,WOLB.0323.00074,1,1361636,1362498,+,862
554,WOLB.0323.00120,1,1355394,1356256,+,862
554,WOLB.0323.00041,1,295695,296556,-,861
554,WOLB.0323.00031,1,440612,441473,-,861
554,WOLB.0323.00006,1,950280,951142,+,862
554,WOLB.0323.00096,1,307550,308411,-,861
553,WOLB.0323.00143,1,300921,302165,+,1244
553,WOLB.0323.00106,1,300923,302167,+,1244
553,WOLB.0323.00031,1,485145,486390,-,1245
553,WOLB.0323.00006,1,905422,906666,+,1244
552,WOLB.0323.00143,1,248967,250321,+,1354
552,WOLB.0323.00106,1,248969,250323,+,1354
552,WOLB.0323.00031,1,536990,538344,-,1354
552,WOLB.0323.00093,1,539510,540839,+,1329
552,WOLB.0323.00008,1,1070294,1071618,+,1324
552,WOLB.0323.00118,1,905106,906461,-,1355
552,WOLB.0323.00006,1,853332,854686,+,1354
551,WOLB.0323.00143,1,241109,242369,+,1260
551,WOLB.0323.00106,1,241111,242371,+,1260
551,WOLB.0323.00031,1,544941,546201,-,1260
551,WOLB.0323.00006,1,747367,748626,+,1259
550,WOLB.0323.00143,1,136275,136880,+,605
550,WOLB.0323.00106,1,136277,136882,+,605
550,WOLB.0323.00031,1,650430,651036,-,606
550,WOLB.0323.00006,1,616871,617476,+,605
549,WOLB.0323.00143,1,130506,131751,+,1245
549,WOLB.0323.00106,1,130508,131753,+,1245
549,WOLB.0323.00031,1,655559,656805,-,1246
549,WOLB.0323.00133,1,875479,876696,+,1217
549,WOLB.0323.00025,1,863902,865285,+,1383
549,WOLB.0323.00006,1,611102,612347,+,1245
548,WOLB.0323.00143,1,74853,75687,+,834
548,WOLB.0323.00106,1,74854,75688,+,834
548,WOLB.0323.00019,1,51213,52050,-,837
548,WOLB.0323.00039,1,758967,759805,+,838
548,WOLB.0323.00031,1,837323,838157,+,834
548,WOLB.0323.00008,1,1250876,1251637,-,761
548,WOLB.0323.00006,1,501283,502117,-,834
548,WOLB.0323.00042,1,152578,153359,+,781
548,WOLB.0323.00119,1,51098,51935,-,837
547,WOLB.0323.00143,1,70443,71265,+,822
547,WOLB.0323.00106,1,70444,71266,+,822
547,WOLB.0323.00031,1,832913,833735,+,822
547,WOLB.0323.00006,1,505706,506527,-,821
546,WOLB.0323.00132,1,1174998,1175507,+,509
546,WOLB.0323.00023,1,1130307,1130815,-,508
546,WOLB.0323.00024,1,1922736,1923245,+,509
546,WOLB.0323.00064,1,1379954,1380462,-,508
546,WOLB.0323.00030,1,1527421,1527930,+,509
546,WOLB.0323.00010,1,248454,248959,-,505
546,WOLB.0323.00042,1,254114,254619,-,505
545,WOLB.0323.00132,1,927876,928850,+,974
545,WOLB.0323.00023,1,572237,573211,+,974
544,WOLB.0323.00132,1,846164,846814,+,650
544,WOLB.0323.00074,1,41970,42620,+,650
544,WOLB.0323.00120,1,41965,42615,+,650
544,WOLB.0323.00041,1,41965,42615,+,650
544,WOLB.0323.00093,1,976476,977126,-,650
544,WOLB.0323.00096,1,48654,49304,+,650
543,WOLB.0323.00132,1,839442,840025,+,583
543,WOLB.0323.00019,1,716419,717002,+,583
543,WOLB.0323.00074,1,11786,12362,-,576
543,WOLB.0323.00074,1,387754,388331,+,577
543,WOLB.0323.00120,1,11781,12357,-,576
543,WOLB.0323.00120,1,366083,366660,+,577
543,WOLB.0323.00039,1,122589,123171,-,582
543,WOLB.0323.00041,1,11782,12358,-,576
543,WOLB.0323.00041,1,1518299,1518875,-,576
543,WOLB.0323.00023,1,408981,409542,+,561
543,WOLB.0323.00093,1,983287,983869,-,582
543,WOLB.0323.00024,1,437997,438580,+,583
543,WOLB.0323.00064,1,748026,748609,+,583
543,WOLB.0323.00030,1,1169105,1169688,+,583
543,WOLB.0323.00119,1,461689,462271,-,582
543,WOLB.0323.00096,1,18470,19046,-,576
543,WOLB.0323.00096,1,1287330,1287906,-,576
542,WOLB.0323.00132,1,834900,835448,+,548
542,WOLB.0323.00010,1,1039369,1039917,+,548
542,WOLB.0323.00042,1,1587745,1588392,-,647
257,WOLB.0323.00090,1,749495,752923,+,3428
257,WOLB.0323.00002,1,518241,521661,-,3420
257,WOLB.0323.00138,1,1292702,1296130,-,3428
257,WOLB.0323.00132,1,461819,465238,-,3419
257,WOLB.0323.00143,1,539977,543407,-,3430
257,WOLB.0323.00106,1,539980,543410,-,3430
257,WOLB.0323.00121,1,1010112,1013540,+,3428
257,WOLB.0323.00135,1,913828,917256,+,3428
257,WOLB.0323.00103,1,712236,715663,+,3427
257,WOLB.0323.00107,1,710820,714247,+,3427
257,WOLB.0323.00019,1,543689,547108,+,3419
257,WOLB.0323.00060,1,587537,590965,-,3428
257,WOLB.0323.00074,1,111913,115332,+,3419
257,WOLB.0323.00120,1,111143,114562,+,3419
257,WOLB.0323.00039,1,1300383,1303800,-,3417
257,WOLB.0323.00041,1,105159,108578,+,3419
257,WOLB.0323.00031,1,243902,247332,+,3430
257,WOLB.0323.00056,1,795904,799332,+,3428
257,WOLB.0323.00142,1,884865,888293,+,3428
257,WOLB.0323.00023,1,1440967,1444386,-,3419
257,WOLB.0323.00153,1,821175,824603,+,3428
257,WOLB.0323.00093,1,939667,943086,+,3419
257,WOLB.0323.00088,1,841582,845010,+,3428
257,WOLB.0323.00008,1,456838,460265,+,3427
257,WOLB.0323.00024,1,42695,46113,+,3418
257,WOLB.0323.00064,1,196239,199658,-,3419
257,WOLB.0323.00030,1,998205,1001624,+,3419
257,WOLB.0323.00105,1,712247,715674,+,3427
257,WOLB.0323.00133,1,194211,197634,-,3423
257,WOLB.0323.00084,1,1192714,1196142,-,3428
257,WOLB.0323.00021,1,1046940,1050368,+,3428
257,WOLB.0323.00043,1,888495,891915,+,3420
257,WOLB.0323.00020,1,782478,785906,+,3428
257,WOLB.0323.00122,1,694337,697765,+,3428
257,WOLB.0323.00118,1,672796,676224,+,3428
257,WOLB.0323.00004,1,884866,888294,+,3428
257,WOLB.0323.00011,1,254331,257759,+,3428
257,WOLB.0323.00035,1,779483,782911,+,3428
257,WOLB.0323.00032,1,341843,345271,+,3428
257,WOLB.0323.00012,1,845684,849112,+,3428
257,WOLB.0323.00018,1,871924,875345,+,3421
257,WOLB.0323.00025,1,1085847,1089277,+,3430
257,WOLB.0323.00010,1,398317,401712,-,3395
257,WOLB.0323.00068,1,1016925,1020353,+,3428
257,WOLB.0323.00128,1,508716,512136,-,3420
257,WOLB.0323.00158,1,157716,161144,+,3428
257,WOLB.0323.00017,1,873573,877001,+,3428
257,WOLB.0323.00104,1,817103,820531,+,3428
257,WOLB.0323.00007,1,543139,546567,-,3428
257,WOLB.0323.00001,1,712247,715674,+,3427
257,WOLB.0323.00100,1,1164132,1167560,+,3428
257,WOLB.0323.00070,1,1338610,1342030,+,3420
257,WOLB.0323.00006,1,1072436,1075866,-,3430
257,WOLB.0323.00042,1,839702,843123,-,3421
257,WOLB.0323.00119,1,632915,636334,-,3419
257,WOLB.0323.00149,1,955368,958796,-,3428
257,WOLB.0323.00014,1,1200822,1204242,+,3420
257,WOLB.0323.00096,1,118968,122387,+,3419
256,WOLB.0323.00090,1,747988,749267,+,1279
256,WOLB.0323.00002,1,523034,524313,-,1279
256,WOLB.0323.00138,1,1296358,1297634,-,1276
256,WOLB.0323.00132,1,465466,466745,-,1279
256,WOLB.0323.00143,1,543651,544923,-,1272
256,WOLB.0323.00106,1,543654,544926,-,1272
256,WOLB.0323.00121,1,1008605,1009884,+,1279
256,WOLB.0323.00135,1,912342,913602,+,1260
256,WOLB.0323.00103,1,710738,712008,+,1270
256,WOLB.0323.00107,1,709322,710592,+,1270
256,WOLB.0323.00019,1,542175,543454,+,1279
256,WOLB.0323.00060,1,592726,593981,-,1255
256,WOLB.0323.00074,1,110404,111683,+,1279
256,WOLB.0323.00120,1,109634,110913,+,1279
256,WOLB.0323.00039,1,1304035,1305314,-,1279
256,WOLB.0323.00041,1,103650,104929,+,1279
256,WOLB.0323.00031,1,242386,243658,+,1272
256,WOLB.0323.00056,1,794397,795676,+,1279
256,WOLB.0323.00142,1,883358,884637,+,1279
256,WOLB.0323.00023,1,1444614,1445893,-,1279
256,WOLB.0323.00153,1,819668,820947,+,1279
256,WOLB.0323.00093,1,1533953,1535213,+,1260
256,WOLB.0323.00088,1,840075,841354,+,1279
256,WOLB.0323.00008,1,769395,770646,+,1251
256,WOLB.0323.00024,1,41204,42467,+,1263
256,WOLB.0323.00064,1,199886,201165,-,1279
256,WOLB.0323.00030,1,1045151,1046430,+,1279
256,WOLB.0323.00105,1,710749,712019,+,1270
256,WOLB.0323.00133,1,197885,199157,-,1272
256,WOLB.0323.00084,1,1196370,1197646,-,1276
256,WOLB.0323.00021,1,1045436,1046712,+,1276
256,WOLB.0323.00043,1,885843,887122,+,1279
256,WOLB.0323.00020,1,780971,782250,+,1279
256,WOLB.0323.00122,1,692851,694111,+,1260
256,WOLB.0323.00118,1,671289,672568,+,1279
256,WOLB.0323.00004,1,883359,884638,+,1279
256,WOLB.0323.00011,1,252824,254103,+,1279
256,WOLB.0323.00035,1,777976,779255,+,1279
256,WOLB.0323.00032,1,340339,341615,+,1276
256,WOLB.0323.00012,1,844177,845456,+,1279
256,WOLB.0323.00018,1,869272,870551,+,1279
256,WOLB.0323.00025,1,238832,240104,+,1272
256,WOLB.0323.00010,1,403085,404364,-,1279
256,WOLB.0323.00068,1,1015421,1016697,+,1276
256,WOLB.0323.00128,1,513509,514788,-,1279
256,WOLB.0323.00158,1,156209,157488,+,1279
256,WOLB.0323.00017,1,872066,873345,+,1279
256,WOLB.0323.00104,1,815596,816875,+,1279
256,WOLB.0323.00007,1,546795,548074,-,1279
256,WOLB.0323.00001,1,710749,712019,+,1270
256,WOLB.0323.00100,1,1162625,1163904,+,1279
256,WOLB.0323.00070,1,1335958,1337237,+,1279
256,WOLB.0323.00006,1,1076110,1077382,-,1272
256,WOLB.0323.00042,1,844496,845775,-,1279
256,WOLB.0323.00119,1,636569,637848,-,1279
256,WOLB.0323.00149,1,959024,960303,-,1279
256,WOLB.0323.00014,1,1198170,1199449,+,1279
256,WOLB.0323.00096,1,117459,118738,+,1279
255,WOLB.0323.00090,1,744963,745527,+,564
255,WOLB.0323.00002,1,567317,567881,+,564
255,WOLB.0323.00138,1,1301425,1301990,-,565
255,WOLB.0323.00132,1,469226,469791,-,565
255,WOLB.0323.00143,1,547429,547987,-,558
255,WOLB.0323.00106,1,547431,547989,-,558
255,WOLB.0323.00121,1,1005505,1006069,+,564
255,WOLB.0323.00135,1,909293,909857,+,564
255,WOLB.0323.00103,1,706610,707173,+,563
255,WOLB.0323.00107,1,705194,705757,+,563
255,WOLB.0323.00019,1,537684,538248,+,564
255,WOLB.0323.00060,1,596393,596958,-,565
255,WOLB.0323.00074,1,106902,107466,+,564
255,WOLB.0323.00120,1,106132,106696,+,564
255,WOLB.0323.00039,1,1307800,1308364,-,564
255,WOLB.0323.00041,1,100148,100712,+,564
255,WOLB.0323.00031,1,239322,239879,+,557
255,WOLB.0323.00056,1,791294,791858,+,564
255,WOLB.0323.00142,1,880258,880822,+,564
255,WOLB.0323.00023,1,1449893,1450458,-,565
255,WOLB.0323.00153,1,816643,817207,+,564
255,WOLB.0323.00093,1,1529462,1530033,+,571
255,WOLB.0323.00088,1,837000,837564,+,564
255,WOLB.0323.00008,1,766277,766841,+,564
255,WOLB.0323.00024,1,38254,38818,+,564
255,WOLB.0323.00064,1,205023,205588,-,565
255,WOLB.0323.00030,1,1042072,1042636,+,564
255,WOLB.0323.00105,1,706621,707184,+,563
255,WOLB.0323.00133,1,201637,202202,-,565
255,WOLB.0323.00084,1,1200069,1200634,-,565
255,WOLB.0323.00021,1,1041080,1041644,+,564
255,WOLB.0323.00043,1,882732,883296,+,564
255,WOLB.0323.00020,1,777896,778460,+,564
255,WOLB.0323.00122,1,689955,690519,+,564
255,WOLB.0323.00118,1,666916,667480,+,564
255,WOLB.0323.00004,1,880259,880823,+,564
255,WOLB.0323.00011,1,249724,250288,+,564
255,WOLB.0323.00035,1,774901,775465,+,564
255,WOLB.0323.00032,1,337351,337915,+,564
255,WOLB.0323.00012,1,841102,841666,+,564
255,WOLB.0323.00018,1,866415,866979,+,564
255,WOLB.0323.00010,1,406825,407390,-,565
255,WOLB.0323.00068,1,1087041,1087605,+,564
255,WOLB.0323.00128,1,517334,517899,-,565
255,WOLB.0323.00158,1,153109,153673,+,564
255,WOLB.0323.00017,1,868966,869530,+,564
255,WOLB.0323.00104,1,812521,813085,+,564
255,WOLB.0323.00007,1,550486,551051,-,565
255,WOLB.0323.00001,1,706621,707184,+,563
255,WOLB.0323.00100,1,1159550,1160114,+,564
255,WOLB.0323.00070,1,1332847,1333411,+,564
255,WOLB.0323.00006,1,1079888,1080445,-,557
255,WOLB.0323.00042,1,847688,848253,-,565
255,WOLB.0323.00119,1,641774,642339,-,565
255,WOLB.0323.00149,1,962838,963403,-,565
255,WOLB.0323.00014,1,1195059,1195623,+,564
255,WOLB.0323.00096,1,113957,114521,+,564
254,WOLB.0323.00090,1,740964,743121,+,2157
254,WOLB.0323.00002,1,745801,747955,+,2154
254,WOLB.0323.00138,1,1303799,1305956,-,2157
254,WOLB.0323.00132,1,521314,523471,-,2157
254,WOLB.0323.00143,1,548728,550882,-,2154
254,WOLB.0323.00106,1,548730,550884,-,2154
254,WOLB.0323.00121,1,1001536,1003693,+,2157
254,WOLB.0323.00135,1,905339,907496,+,2157
254,WOLB.0323.00103,1,699786,701943,+,2157
254,WOLB.0323.00107,1,698370,700527,+,2157
254,WOLB.0323.00019,1,520540,522705,+,2165
254,WOLB.0323.00060,1,598818,600975,-,2157
254,WOLB.0323.00074,1,102988,105141,+,2153
254,WOLB.0323.00120,1,102218,104371,+,2153
254,WOLB.0323.00039,1,1310202,1312367,-,2165
254,WOLB.0323.00041,1,96234,98387,+,2153
254,WOLB.0323.00031,1,236427,238581,+,2154
254,WOLB.0323.00056,1,787277,789434,+,2157
254,WOLB.0323.00142,1,876289,878446,+,2157
254,WOLB.0323.00023,1,1855257,1857422,-,2165
254,WOLB.0323.00153,1,812655,814812,+,2157
254,WOLB.0323.00093,1,1521558,1523715,+,2157
254,WOLB.0323.00088,1,833034,835191,+,2157
254,WOLB.0323.00008,1,761166,763323,+,2157
254,WOLB.0323.00024,1,1577409,1579566,+,2157
254,WOLB.0323.00064,1,645618,647775,+,2157
254,WOLB.0323.00030,1,858696,860853,-,2157
254,WOLB.0323.00105,1,699797,701954,+,2157
254,WOLB.0323.00133,1,204040,206182,-,2142
254,WOLB.0323.00084,1,1202443,1204600,-,2157
254,WOLB.0323.00021,1,1037114,1039271,+,2157
254,WOLB.0323.00043,1,1060945,1063099,-,2154
254,WOLB.0323.00020,1,773930,776087,+,2157
254,WOLB.0323.00122,1,685996,688153,+,2157
254,WOLB.0323.00118,1,662950,665107,+,2157
254,WOLB.0323.00004,1,876290,878447,+,2157
254,WOLB.0323.00011,1,245755,247912,+,2157
254,WOLB.0323.00035,1,770935,773092,+,2157
254,WOLB.0323.00032,1,333385,335542,+,2157
254,WOLB.0323.00012,1,837136,839293,+,2157
254,WOLB.0323.00018,1,803727,805884,+,2157
254,WOLB.0323.00025,1,1091268,1093433,-,2165
254,WOLB.0323.00010,1,618829,620983,+,2154
254,WOLB.0323.00068,1,1083075,1085232,+,2157
254,WOLB.0323.00128,1,671818,673972,+,2154
254,WOLB.0323.00158,1,149140,151297,+,2157
254,WOLB.0323.00017,1,864997,867154,+,2157
254,WOLB.0323.00104,1,808555,810712,+,2157
254,WOLB.0323.00007,1,552911,555068,-,2157
254,WOLB.0323.00001,1,699797,701954,+,2157
254,WOLB.0323.00100,1,1155584,1157741,+,2157
254,WOLB.0323.00070,1,766155,768312,-,2157
254,WOLB.0323.00006,1,1081186,1083340,-,2154
254,WOLB.0323.00042,1,849945,852080,-,2135
254,WOLB.0323.00119,1,657318,659483,-,2165
254,WOLB.0323.00149,1,965215,967372,-,2157
254,WOLB.0323.00014,1,1065040,1067194,-,2154
254,WOLB.0323.00096,1,110043,112196,+,2153
253,WOLB.0323.00090,1,738679,739237,+,558
253,WOLB.0323.00002,1,730593,731150,-,557
253,WOLB.0323.00138,1,1307941,1308498,-,557
253,WOLB.0323.00132,1,525206,525763,-,557
253,WOLB.0323.00121,1,999252,999810,+,558
253,WOLB.0323.00135,1,903049,903607,+,558
253,WOLB.0323.00103,1,631648,632205,-,557
253,WOLB.0323.00107,1,630232,630789,-,557
253,WOLB.0323.00019,1,518366,518923,+,557
253,WOLB.0323.00060,1,602709,603266,-,557
253,WOLB.0323.00074,1,100362,100920,+,558
253,WOLB.0323.00120,1,99592,100150,+,558
253,WOLB.0323.00039,1,289065,289621,-,556
253,WOLB.0323.00041,1,93608,94166,+,558
253,WOLB.0323.00056,1,784985,785543,+,558
253,WOLB.0323.00142,1,874005,874563,+,558
253,WOLB.0323.00023,1,1859156,1859713,-,557
253,WOLB.0323.00153,1,810370,810928,+,558
253,WOLB.0323.00093,1,1299098,1299656,+,558
253,WOLB.0323.00088,1,830263,830821,+,558
253,WOLB.0323.00008,1,245905,246462,-,557
253,WOLB.0323.00024,1,1574830,1575374,+,544
253,WOLB.0323.00064,1,642586,643130,+,544
253,WOLB.0323.00030,1,863344,863887,-,543
253,WOLB.0323.00105,1,631659,632216,-,557
253,WOLB.0323.00133,1,206544,207086,-,542
253,WOLB.0323.00084,1,1206585,1207142,-,557
253,WOLB.0323.00021,1,1034571,1035129,+,558
253,WOLB.0323.00043,1,1065491,1066048,-,557
253,WOLB.0323.00020,1,771159,771717,+,558
253,WOLB.0323.00122,1,683202,683760,+,558
253,WOLB.0323.00118,1,660289,660847,+,558
253,WOLB.0323.00004,1,874006,874564,+,558
253,WOLB.0323.00011,1,243471,244029,+,558
253,WOLB.0323.00035,1,768164,768722,+,558
253,WOLB.0323.00032,1,330842,331400,+,558
253,WOLB.0323.00012,1,834365,834923,+,558
253,WOLB.0323.00018,1,802829,803387,+,558
253,WOLB.0323.00025,1,346775,347337,-,562
253,WOLB.0323.00010,1,615984,616542,+,558
253,WOLB.0323.00068,1,1080532,1081090,+,558
253,WOLB.0323.00128,1,668868,669426,+,558
253,WOLB.0323.00158,1,146856,147414,+,558
253,WOLB.0323.00017,1,862713,863271,+,558
253,WOLB.0323.00104,1,805784,806342,+,558
253,WOLB.0323.00007,1,556802,557359,-,557
253,WOLB.0323.00001,1,631659,632216,-,557
253,WOLB.0323.00100,1,1152813,1153371,+,558
253,WOLB.0323.00070,1,770704,771261,-,557
253,WOLB.0323.00042,1,852401,852958,-,557
253,WOLB.0323.00119,1,661100,661656,-,556
253,WOLB.0323.00149,1,969098,969655,-,557
253,WOLB.0323.00096,1,107417,107975,+,558
252,WOLB.0323.00090,1,736223,737818,+,1595
252,WOLB.0323.00002,1,712077,713670,-,1593
252,WOLB.0323.00138,1,1309360,1310955,-,1595
252,WOLB.0323.00132,1,488680,490273,-,1593
252,WOLB.0323.00143,1,646967,648562,-,1595
252,WOLB.0323.00106,1,646968,648563,-,1595
252,WOLB.0323.00121,1,996796,998391,+,1595
252,WOLB.0323.00135,1,900593,902188,+,1595
252,WOLB.0323.00103,1,633067,634662,-,1595
252,WOLB.0323.00107,1,631651,633246,-,1595
252,WOLB.0323.00019,1,515910,517491,+,1581
252,WOLB.0323.00060,1,604128,605723,-,1595
252,WOLB.0323.00074,1,97906,99501,+,1595
252,WOLB.0323.00120,1,91152,92747,+,1595
252,WOLB.0323.00120,1,93624,95217,-,1593
252,WOLB.0323.00039,1,290497,292078,-,1581
252,WOLB.0323.00041,1,91152,92747,+,1595
252,WOLB.0323.00031,1,138744,140339,+,1595
252,WOLB.0323.00056,1,782529,784124,+,1595
252,WOLB.0323.00142,1,871549,873144,+,1595
252,WOLB.0323.00023,1,217214,218807,+,1593
252,WOLB.0323.00153,1,807914,809509,+,1595
252,WOLB.0323.00093,1,1296642,1298237,+,1595
252,WOLB.0323.00088,1,827807,829402,+,1595
252,WOLB.0323.00008,1,247324,248919,-,1595
252,WOLB.0323.00024,1,1686015,1687608,+,1593
252,WOLB.0323.00064,1,1466859,1468452,-,1593
252,WOLB.0323.00030,1,985855,987448,+,1593
252,WOLB.0323.00105,1,633078,634673,-,1595
252,WOLB.0323.00133,1,207962,209527,-,1565
252,WOLB.0323.00084,1,1208004,1209599,-,1595
252,WOLB.0323.00021,1,1032115,1033710,+,1595
252,WOLB.0323.00043,1,799958,801551,-,1593
252,WOLB.0323.00020,1,768703,770298,+,1595
252,WOLB.0323.00122,1,680746,682341,+,1595
252,WOLB.0323.00118,1,657833,659428,+,1595
252,WOLB.0323.00004,1,871550,873145,+,1595
252,WOLB.0323.00011,1,241015,242610,+,1595
252,WOLB.0323.00035,1,765708,767303,+,1595
252,WOLB.0323.00032,1,328386,329981,+,1595
252,WOLB.0323.00012,1,831909,833504,+,1595
252,WOLB.0323.00018,1,672717,674310,+,1593
252,WOLB.0323.00025,1,348195,349790,-,1595
252,WOLB.0323.00010,1,603040,604633,-,1593
252,WOLB.0323.00068,1,1078076,1079671,+,1595
252,WOLB.0323.00128,1,861824,863417,+,1593
252,WOLB.0323.00158,1,144400,145995,+,1595
252,WOLB.0323.00017,1,860257,861852,+,1595
252,WOLB.0323.00104,1,803328,804923,+,1595
252,WOLB.0323.00007,1,558221,559816,-,1595
252,WOLB.0323.00001,1,633078,634673,-,1595
252,WOLB.0323.00100,1,1150357,1151952,+,1595
252,WOLB.0323.00070,1,962874,964467,+,1593
252,WOLB.0323.00006,1,1178973,1180568,-,1595
252,WOLB.0323.00042,1,1428848,1430429,-,1581
252,WOLB.0323.00119,1,662532,664113,-,1581
252,WOLB.0323.00149,1,970517,972112,-,1595
252,WOLB.0323.00014,1,751143,752736,-,1593
252,WOLB.0323.00096,1,104961,106556,+,1595
251,WOLB.0323.00090,1,732715,734319,+,1604
251,WOLB.0323.00002,1,801610,803214,+,1604
251,WOLB.0323.00138,1,1314629,1316233,-,1604
251,WOLB.0323.00132,1,491984,493588,-,1604
251,WOLB.0323.00143,1,839803,841405,-,1602
251,WOLB.0323.00106,1,839806,841408,-,1602
251,WOLB.0323.00121,1,993270,994874,+,1604
251,WOLB.0323.00135,1,897066,898670,+,1604
251,WOLB.0323.00103,1,648767,650369,-,1602
251,WOLB.0323.00107,1,647351,648953,-,1602
251,WOLB.0323.00019,1,512566,514170,+,1604
251,WOLB.0323.00060,1,607645,609249,-,1604
251,WOLB.0323.00074,1,94380,95984,+,1604
251,WOLB.0323.00120,1,87626,89230,+,1604
251,WOLB.0323.00120,1,97137,98712,-,1575
251,WOLB.0323.00039,1,293818,295422,-,1604
251,WOLB.0323.00041,1,87626,89230,+,1604
251,WOLB.0323.00031,1,1219432,1221034,+,1602
251,WOLB.0323.00056,1,779003,780607,+,1604
251,WOLB.0323.00142,1,866920,868524,+,1604
251,WOLB.0323.00023,1,213898,215502,+,1604
251,WOLB.0323.00153,1,804406,806010,+,1604
251,WOLB.0323.00093,1,1293135,1294739,+,1604
251,WOLB.0323.00088,1,824281,825885,+,1604
251,WOLB.0323.00008,1,250649,252253,-,1604
251,WOLB.0323.00024,1,1680871,1682475,+,1604
251,WOLB.0323.00064,1,1470163,1471767,-,1604
251,WOLB.0323.00030,1,982540,984144,+,1604
251,WOLB.0323.00105,1,648778,650380,-,1602
251,WOLB.0323.00133,1,211415,213019,-,1604
251,WOLB.0323.00084,1,1211503,1213107,-,1604
251,WOLB.0323.00021,1,1026837,1028441,+,1604
251,WOLB.0323.00043,1,1055353,1056957,+,1604
251,WOLB.0323.00020,1,765177,766781,+,1604
251,WOLB.0323.00122,1,677238,678842,+,1604
251,WOLB.0323.00118,1,654333,655937,+,1604
251,WOLB.0323.00004,1,866921,868525,+,1604
251,WOLB.0323.00011,1,237489,239093,+,1604
251,WOLB.0323.00035,1,762182,763786,+,1604
251,WOLB.0323.00032,1,323226,324830,+,1604
251,WOLB.0323.00012,1,828383,829987,+,1604
251,WOLB.0323.00018,1,1022379,1023983,+,1604
251,WOLB.0323.00025,1,106312,107914,+,1602
251,WOLB.0323.00010,1,641165,642769,-,1604
251,WOLB.0323.00068,1,1072798,1074402,+,1604
251,WOLB.0323.00128,1,677959,679563,-,1604
251,WOLB.0323.00158,1,139771,141375,+,1604
251,WOLB.0323.00017,1,856731,858335,+,1604
251,WOLB.0323.00104,1,799802,801406,+,1604
251,WOLB.0323.00007,1,561738,563342,-,1604
251,WOLB.0323.00001,1,648778,650380,-,1602
251,WOLB.0323.00100,1,1146831,1148435,+,1604
251,WOLB.0323.00070,1,760563,762167,+,1604
251,WOLB.0323.00006,1,1012082,1013684,+,1602
251,WOLB.0323.00042,1,1432140,1433744,-,1604
251,WOLB.0323.00119,1,665853,667457,-,1604
251,WOLB.0323.00149,1,974034,975638,-,1604
251,WOLB.0323.00014,1,1059448,1061052,+,1604
251,WOLB.0323.00096,1,101435,103039,+,1604
250,WOLB.0323.00090,1,731323,732713,+,1390
250,WOLB.0323.00002,1,800218,801608,+,1390
250,WOLB.0323.00138,1,1316234,1317625,-,1391
250,WOLB.0323.00132,1,493589,494980,-,1391
250,WOLB.0323.00143,1,841406,842797,-,1391
250,WOLB.0323.00106,1,841409,842800,-,1391
250,WOLB.0323.00121,1,991878,993268,+,1390
250,WOLB.0323.00135,1,895674,897064,+,1390
250,WOLB.0323.00103,1,650370,651761,-,1391
250,WOLB.0323.00107,1,648954,650345,-,1391
250,WOLB.0323.00019,1,511174,512564,+,1390
250,WOLB.0323.00060,1,609250,610641,-,1391
250,WOLB.0323.00074,1,92988,94378,+,1390
250,WOLB.0323.00120,1,86234,87624,+,1390
250,WOLB.0323.00039,1,295423,296814,-,1391
250,WOLB.0323.00041,1,86234,87624,+,1390
250,WOLB.0323.00031,1,1218040,1219430,+,1390
250,WOLB.0323.00056,1,777611,779001,+,1390
250,WOLB.0323.00142,1,865528,866918,+,1390
250,WOLB.0323.00023,1,212506,213896,+,1390
250,WOLB.0323.00153,1,803014,804404,+,1390
250,WOLB.0323.00093,1,1291743,1293133,+,1390
250,WOLB.0323.00088,1,822889,824279,+,1390
250,WOLB.0323.00008,1,252254,253645,-,1391
250,WOLB.0323.00024,1,1679479,1680869,+,1390
250,WOLB.0323.00064,1,1471768,1473159,-,1391
250,WOLB.0323.00030,1,981148,982538,+,1390
250,WOLB.0323.00105,1,650381,651772,-,1391
250,WOLB.0323.00133,1,213020,214411,-,1391
250,WOLB.0323.00084,1,1213108,1214499,-,1391
250,WOLB.0323.00021,1,1025445,1026835,+,1390
250,WOLB.0323.00043,1,1053961,1055351,+,1390
250,WOLB.0323.00020,1,763785,765175,+,1390
250,WOLB.0323.00122,1,675846,677236,+,1390
250,WOLB.0323.00118,1,652941,654331,+,1390
250,WOLB.0323.00004,1,865529,866919,+,1390
250,WOLB.0323.00011,1,236097,237487,+,1390
250,WOLB.0323.00035,1,760790,762180,+,1390
250,WOLB.0323.00032,1,321834,323224,+,1390
250,WOLB.0323.00012,1,826991,828381,+,1390
250,WOLB.0323.00018,1,1020987,1022377,+,1390
250,WOLB.0323.00025,1,104920,106310,+,1390
250,WOLB.0323.00010,1,642770,644161,-,1391
250,WOLB.0323.00068,1,1071406,1072796,+,1390
250,WOLB.0323.00128,1,679564,680955,-,1391
250,WOLB.0323.00158,1,138379,139769,+,1390
250,WOLB.0323.00017,1,855339,856729,+,1390
250,WOLB.0323.00104,1,798410,799800,+,1390
250,WOLB.0323.00007,1,563343,564734,-,1391
250,WOLB.0323.00001,1,650381,651772,-,1391
250,WOLB.0323.00100,1,1145439,1146829,+,1390
250,WOLB.0323.00070,1,759171,760561,+,1390
250,WOLB.0323.00006,1,1010690,1012080,+,1390
250,WOLB.0323.00042,1,1433745,1435136,-,1391
250,WOLB.0323.00119,1,667458,668849,-,1391
250,WOLB.0323.00149,1,975639,977030,-,1391
250,WOLB.0323.00014,1,1058056,1059446,+,1390
250,WOLB.0323.00096,1,100043,101433,+,1390
249,WOLB.0323.00090,1,728537,729963,+,1426
249,WOLB.0323.00002,1,797418,798843,+,1425
249,WOLB.0323.00138,1,1318985,1320410,-,1425
249,WOLB.0323.00132,1,495525,496949,-,1424
249,WOLB.0323.00143,1,837378,838803,+,1425
249,WOLB.0323.00106,1,837381,838806,+,1425
249,WOLB.0323.00121,1,989092,990518,+,1426
249,WOLB.0323.00135,1,892888,894314,+,1426
249,WOLB.0323.00103,1,653121,654546,-,1425
249,WOLB.0323.00107,1,651705,653130,-,1425
249,WOLB.0323.00019,1,508133,509558,+,1425
249,WOLB.0323.00060,1,612001,613426,-,1425
249,WOLB.0323.00074,1,91121,92546,+,1425
249,WOLB.0323.00120,1,84367,85792,+,1425
249,WOLB.0323.00039,1,298430,299854,-,1424
249,WOLB.0323.00041,1,84367,85792,+,1425
249,WOLB.0323.00031,1,1222034,1223458,-,1424
249,WOLB.0323.00056,1,774825,776251,+,1426
249,WOLB.0323.00142,1,862742,864168,+,1426
249,WOLB.0323.00023,1,209707,211132,+,1425
249,WOLB.0323.00153,1,800228,801654,+,1426
249,WOLB.0323.00093,1,1288956,1290382,+,1426
249,WOLB.0323.00088,1,820103,821529,+,1426
249,WOLB.0323.00008,1,255006,256431,-,1425
249,WOLB.0323.00024,1,1675962,1677387,+,1425
249,WOLB.0323.00064,1,1473704,1475128,-,1424
249,WOLB.0323.00030,1,979178,980603,+,1425
249,WOLB.0323.00105,1,653132,654557,-,1425
249,WOLB.0323.00133,1,215744,217168,-,1424
249,WOLB.0323.00084,1,1215859,1217284,-,1425
249,WOLB.0323.00021,1,1022659,1024085,+,1426
249,WOLB.0323.00043,1,1051161,1052586,+,1425
249,WOLB.0323.00020,1,760999,762425,+,1426
249,WOLB.0323.00122,1,673876,675301,+,1425
249,WOLB.0323.00118,1,650971,652396,+,1425
249,WOLB.0323.00004,1,862743,864169,+,1426
249,WOLB.0323.00011,1,233311,234737,+,1426
249,WOLB.0323.00035,1,758004,759430,+,1426
249,WOLB.0323.00032,1,319048,320474,+,1426
249,WOLB.0323.00012,1,824205,825631,+,1426
249,WOLB.0323.00018,1,1018188,1019613,+,1425
249,WOLB.0323.00025,1,323405,324829,-,1424
249,WOLB.0323.00010,1,645536,646960,-,1424
249,WOLB.0323.00068,1,1068620,1070046,+,1426
249,WOLB.0323.00128,1,682330,683754,-,1424
249,WOLB.0323.00158,1,135593,137019,+,1426
249,WOLB.0323.00017,1,852553,853979,+,1426
249,WOLB.0323.00104,1,795624,797050,+,1426
249,WOLB.0323.00007,1,566094,567519,-,1425
249,WOLB.0323.00001,1,653132,654557,-,1425
249,WOLB.0323.00100,1,1142653,1144079,+,1426
249,WOLB.0323.00070,1,756371,757796,+,1425
249,WOLB.0323.00006,1,1014684,1016108,-,1424
249,WOLB.0323.00042,1,1435681,1437105,-,1424
249,WOLB.0323.00119,1,670465,671889,-,1424
249,WOLB.0323.00149,1,978390,979815,-,1425
249,WOLB.0323.00014,1,1055256,1056681,+,1425
249,WOLB.0323.00096,1,98176,99601,+,1425
248,WOLB.0323.00090,1,722741,728157,+,5416
248,WOLB.0323.00002,1,791604,797038,+,5434
248,WOLB.0323.00138,1,1320791,1326206,-,5415
248,WOLB.0323.00132,1,497330,502754,-,5424
248,WOLB.0323.00143,1,831553,836998,+,5445
248,WOLB.0323.00106,1,831556,837001,+,5445
248,WOLB.0323.00121,1,983296,988712,+,5416
248,WOLB.0323.00135,1,887092,892508,+,5416
248,WOLB.0323.00103,1,654927,660377,-,5450
248,WOLB.0323.00107,1,653511,658961,-,5450
248,WOLB.0323.00019,1,502328,507753,+,5425
248,WOLB.0323.00060,1,613807,619222,-,5415
248,WOLB.0323.00074,1,78578,83992,+,5414
248,WOLB.0323.00074,1,84413,89833,-,5420
248,WOLB.0323.00120,1,78573,83987,+,5414
248,WOLB.0323.00039,1,300235,305659,-,5424
248,WOLB.0323.00041,1,78573,83987,+,5414
248,WOLB.0323.00031,1,1223839,1229283,-,5444
248,WOLB.0323.00056,1,769029,774445,+,5416
248,WOLB.0323.00142,1,856946,862362,+,5416
248,WOLB.0323.00023,1,203893,209327,+,5434
248,WOLB.0323.00153,1,794432,799848,+,5416
248,WOLB.0323.00093,1,1283124,1288576,+,5452
248,WOLB.0323.00088,1,814307,819723,+,5416
248,WOLB.0323.00008,1,256812,262263,-,5451
248,WOLB.0323.00024,1,1670157,1675582,+,5425
248,WOLB.0323.00064,1,1475509,1480942,-,5433
248,WOLB.0323.00030,1,973364,978798,+,5434
248,WOLB.0323.00105,1,654938,660388,-,5450
248,WOLB.0323.00133,1,217549,223002,-,5453
248,WOLB.0323.00084,1,1217665,1223080,-,5415
248,WOLB.0323.00021,1,1016863,1022279,+,5416
248,WOLB.0323.00043,1,1045347,1050781,+,5434
248,WOLB.0323.00020,1,755203,760619,+,5416
248,WOLB.0323.00122,1,668080,673496,+,5416
248,WOLB.0323.00118,1,645175,650591,+,5416
248,WOLB.0323.00004,1,856947,862363,+,5416
248,WOLB.0323.00011,1,227515,232931,+,5416
248,WOLB.0323.00035,1,752208,757624,+,5416
248,WOLB.0323.00032,1,313252,318668,+,5416
248,WOLB.0323.00012,1,818409,823825,+,5416
248,WOLB.0323.00018,1,1012374,1017808,+,5434
248,WOLB.0323.00025,1,325210,330653,-,5443
248,WOLB.0323.00010,1,647341,652774,-,5433
248,WOLB.0323.00068,1,1062824,1068240,+,5416
248,WOLB.0323.00128,1,684135,689568,-,5433
248,WOLB.0323.00158,1,129797,135213,+,5416
248,WOLB.0323.00017,1,846757,852173,+,5416
248,WOLB.0323.00104,1,789828,795244,+,5416
248,WOLB.0323.00007,1,567900,573315,-,5415
248,WOLB.0323.00001,1,654938,660388,-,5450
248,WOLB.0323.00100,1,1136857,1142273,+,5416
248,WOLB.0323.00070,1,750557,755991,+,5434
248,WOLB.0323.00006,1,1016489,1021933,-,5444
248,WOLB.0323.00042,1,1437486,1442919,-,5433
248,WOLB.0323.00119,1,672270,677694,-,5424
248,WOLB.0323.00149,1,980196,985611,-,5415
248,WOLB.0323.00014,1,1049442,1054876,+,5434
248,WOLB.0323.00096,1,92382,97796,+,5414
247,WOLB.0323.00090,1,720950,722419,+,1469
247,WOLB.0323.00002,1,789813,791282,+,1469
247,WOLB.0323.00138,1,1326529,1327998,-,1469
247,WOLB.0323.00132,1,503077,504546,-,1469
247,WOLB.0323.00143,1,829768,831231,+,1463
247,WOLB.0323.00106,1,829771,831234,+,1463
247,WOLB.0323.00121,1,981505,982974,+,1469
247,WOLB.0323.00135,1,885301,886770,+,1469
247,WOLB.0323.00103,1,660700,662169,-,1469
247,WOLB.0323.00107,1,659284,660753,-,1469
247,WOLB.0323.00019,1,500537,502006,+,1469
247,WOLB.0323.00060,1,619545,621014,-,1469
247,WOLB.0323.00039,1,305982,307451,-,1469
247,WOLB.0323.00041,1,1386053,1387497,+,1444
247,WOLB.0323.00031,1,1229606,1231069,-,1463
247,WOLB.0323.00056,1,767238,768707,+,1469
247,WOLB.0323.00142,1,855155,856624,+,1469
247,WOLB.0323.00023,1,202102,203571,+,1469
247,WOLB.0323.00153,1,792641,794110,+,1469
247,WOLB.0323.00093,1,1281333,1282802,+,1469
247,WOLB.0323.00088,1,812516,813985,+,1469
247,WOLB.0323.00008,1,262585,264054,-,1469
247,WOLB.0323.00024,1,1668373,1669835,+,1462
247,WOLB.0323.00064,1,1481265,1482734,-,1469
247,WOLB.0323.00030,1,971573,973042,+,1469
247,WOLB.0323.00105,1,660711,662180,-,1469
247,WOLB.0323.00133,1,223325,224794,-,1469
247,WOLB.0323.00084,1,1223403,1224872,-,1469
247,WOLB.0323.00021,1,1015072,1016541,+,1469
247,WOLB.0323.00043,1,1043556,1045025,+,1469
247,WOLB.0323.00020,1,753412,754881,+,1469
247,WOLB.0323.00122,1,666289,667758,+,1469
247,WOLB.0323.00118,1,643384,644853,+,1469
247,WOLB.0323.00004,1,855156,856625,+,1469
247,WOLB.0323.00011,1,225724,227193,+,1469
247,WOLB.0323.00035,1,750417,751886,+,1469
247,WOLB.0323.00032,1,311461,312930,+,1469
247,WOLB.0323.00012,1,816618,818087,+,1469
247,WOLB.0323.00018,1,1010583,1012052,+,1469
247,WOLB.0323.00025,1,330976,332437,-,1461
247,WOLB.0323.00010,1,653097,654566,-,1469
247,WOLB.0323.00068,1,1061033,1062502,+,1469
247,WOLB.0323.00128,1,689891,691360,-,1469
247,WOLB.0323.00158,1,128006,129475,+,1469
247,WOLB.0323.00017,1,844966,846435,+,1469
247,WOLB.0323.00104,1,788037,789506,+,1469
247,WOLB.0323.00007,1,573638,575107,-,1469
247,WOLB.0323.00001,1,660711,662180,-,1469
247,WOLB.0323.00100,1,1135066,1136535,+,1469
247,WOLB.0323.00070,1,748766,750235,+,1469
247,WOLB.0323.00006,1,1022256,1023719,-,1463
247,WOLB.0323.00042,1,1443242,1444711,-,1469
247,WOLB.0323.00119,1,678017,679486,-,1469
247,WOLB.0323.00149,1,985934,987403,-,1469
247,WOLB.0323.00014,1,1047651,1049120,+,1469
246,WOLB.0323.00090,1,716250,720891,+,4641
246,WOLB.0323.00002,1,760844,765510,+,4666
246,WOLB.0323.00138,1,1341410,1346050,-,4640
246,WOLB.0323.00132,1,504613,509278,-,4665
246,WOLB.0323.00143,1,825054,829695,+,4641
246,WOLB.0323.00106,1,825057,829698,+,4641
246,WOLB.0323.00121,1,976805,981446,+,4641
246,WOLB.0323.00135,1,880601,885242,+,4641
246,WOLB.0323.00103,1,662228,666869,-,4641
246,WOLB.0323.00107,1,660812,665453,-,4641
246,WOLB.0323.00019,1,495805,500470,+,4665
246,WOLB.0323.00060,1,775534,780175,+,4641
246,WOLB.0323.00039,1,307518,312182,-,4664
246,WOLB.0323.00041,1,1381360,1385994,+,4634
246,WOLB.0323.00031,1,1231142,1235782,-,4640
246,WOLB.0323.00056,1,762538,767179,+,4641
246,WOLB.0323.00142,1,850455,855096,+,4641
246,WOLB.0323.00023,1,1837248,1841904,-,4656
246,WOLB.0323.00153,1,787941,792582,+,4641
246,WOLB.0323.00093,1,1011728,1016371,+,4643
246,WOLB.0323.00088,1,807816,812457,+,4641
246,WOLB.0323.00008,1,270258,274877,+,4619
246,WOLB.0323.00024,1,1592641,1597307,+,4666
246,WOLB.0323.00064,1,658465,663131,+,4666
246,WOLB.0323.00030,1,843340,848005,-,4665
246,WOLB.0323.00105,1,662239,666880,-,4641
246,WOLB.0323.00133,1,224861,229501,-,4640
246,WOLB.0323.00084,1,1293460,1298100,-,4640
246,WOLB.0323.00021,1,997019,1001660,+,4641
246,WOLB.0323.00043,1,1038824,1043490,+,4666
246,WOLB.0323.00020,1,748712,753353,+,4641
246,WOLB.0323.00122,1,652024,656665,+,4641
246,WOLB.0323.00118,1,638676,643317,+,4641
246,WOLB.0323.00004,1,850456,855097,+,4641
246,WOLB.0323.00011,1,221024,225665,+,4641
246,WOLB.0323.00035,1,745717,750358,+,4641
246,WOLB.0323.00032,1,279948,284589,+,4641
246,WOLB.0323.00012,1,811918,816559,+,4641
246,WOLB.0323.00018,1,1005867,1010524,+,4657
246,WOLB.0323.00025,1,332527,337161,-,4634
246,WOLB.0323.00010,1,330179,334844,-,4665
246,WOLB.0323.00068,1,1056333,1060974,+,4641
246,WOLB.0323.00128,1,691426,696091,-,4665
246,WOLB.0323.00158,1,123306,127947,+,4641
246,WOLB.0323.00017,1,840266,844907,+,4641
246,WOLB.0323.00104,1,783337,787978,+,4641
246,WOLB.0323.00007,1,575166,579806,-,4640
246,WOLB.0323.00001,1,662239,666880,-,4641
246,WOLB.0323.00100,1,1130366,1135007,+,4641
246,WOLB.0323.00070,1,682525,687191,+,4666
246,WOLB.0323.00006,1,1023792,1028432,-,4640
246,WOLB.0323.00042,1,1444778,1449443,-,4665
246,WOLB.0323.00119,1,679553,684217,-,4664
246,WOLB.0323.00149,1,987462,992102,-,4640
246,WOLB.0323.00014,1,924107,928773,+,4666
245,WOLB.0323.00090,1,713236,715437,+,2201
245,WOLB.0323.00002,1,758385,760582,+,2197
245,WOLB.0323.00138,1,1346861,1349061,-,2200
245,WOLB.0323.00132,1,509541,511738,-,2197
245,WOLB.0323.00143,1,822593,824792,+,2199
245,WOLB.0323.00106,1,822596,824795,+,2199
245,WOLB.0323.00121,1,974343,976543,+,2200
245,WOLB.0323.00135,1,878139,880339,+,2200
245,WOLB.0323.00103,1,667126,669320,-,2194
245,WOLB.0323.00107,1,665710,667904,-,2194
245,WOLB.0323.00019,1,493342,495543,+,2201
245,WOLB.0323.00060,1,773072,775272,+,2200
245,WOLB.0323.00074,1,575688,577882,+,2194
245,WOLB.0323.00120,1,561859,564053,+,2194
245,WOLB.0323.00039,1,312445,314646,-,2201
245,WOLB.0323.00041,1,1052948,1055142,-,2194
245,WOLB.0323.00031,1,1236045,1238244,-,2199
245,WOLB.0323.00056,1,760076,762276,+,2200
245,WOLB.0323.00142,1,847993,850193,+,2200
245,WOLB.0323.00023,1,1842168,1844365,-,2197
245,WOLB.0323.00153,1,784927,787128,+,2201
245,WOLB.0323.00093,1,857323,859523,-,2200
245,WOLB.0323.00088,1,805354,807554,+,2200
245,WOLB.0323.00008,1,902128,904328,+,2200
245,WOLB.0323.00024,1,1589196,1591393,+,2197
245,WOLB.0323.00064,1,656006,658203,+,2197
245,WOLB.0323.00030,1,848268,850465,-,2197
245,WOLB.0323.00105,1,667137,669331,-,2194
245,WOLB.0323.00133,1,229760,231961,-,2201
245,WOLB.0323.00084,1,1298911,1301111,-,2200
245,WOLB.0323.00021,1,994009,996209,+,2200
245,WOLB.0323.00043,1,1036365,1038562,+,2197
245,WOLB.0323.00020,1,746250,748450,+,2200
245,WOLB.0323.00122,1,649562,651762,+,2200
245,WOLB.0323.00118,1,635665,637863,+,2198
245,WOLB.0323.00004,1,847994,850194,+,2200
245,WOLB.0323.00011,1,218562,220762,+,2200
245,WOLB.0323.00035,1,743255,745455,+,2200
245,WOLB.0323.00032,1,276938,279138,+,2200
245,WOLB.0323.00012,1,809456,811656,+,2200
245,WOLB.0323.00018,1,1003407,1005604,+,2197
245,WOLB.0323.00025,1,337424,339582,-,2158
245,WOLB.0323.00010,1,335107,337304,-,2197
245,WOLB.0323.00068,1,1053323,1055523,+,2200
245,WOLB.0323.00128,1,696354,698551,-,2197
245,WOLB.0323.00158,1,120844,123044,+,2200
245,WOLB.0323.00017,1,837804,840004,+,2200
245,WOLB.0323.00104,1,780875,783075,+,2200
245,WOLB.0323.00007,1,580069,582269,-,2200
245,WOLB.0323.00001,1,667137,669331,-,2194
245,WOLB.0323.00100,1,1127904,1130104,+,2200
245,WOLB.0323.00070,1,680066,682263,+,2197
245,WOLB.0323.00006,1,1028695,1030893,-,2198
245,WOLB.0323.00042,1,1449706,1451903,-,2197
245,WOLB.0323.00119,1,684480,686681,-,2201
245,WOLB.0323.00149,1,992365,994565,-,2200
245,WOLB.0323.00014,1,921648,923845,+,2197
245,WOLB.0323.00096,1,1090882,1093076,-,2194
244,WOLB.0323.00090,1,712078,712736,+,658
244,WOLB.0323.00138,1,1349561,1350217,-,656
244,WOLB.0323.00143,1,819914,820570,+,656
244,WOLB.0323.00106,1,819917,820573,+,656
244,WOLB.0323.00121,1,973187,973843,+,656
244,WOLB.0323.00135,1,876983,877639,+,656
244,WOLB.0323.00019,1,492266,492921,+,655
244,WOLB.0323.00060,1,771916,772572,+,656
244,WOLB.0323.00074,1,574417,575073,+,656
244,WOLB.0323.00120,1,560588,561244,+,656
244,WOLB.0323.00039,1,315067,315723,-,656
244,WOLB.0323.00041,1,1055757,1056413,-,656
244,WOLB.0323.00031,1,1240267,1240923,-,656
244,WOLB.0323.00056,1,758920,759576,+,656
244,WOLB.0323.00142,1,846837,847493,+,656
244,WOLB.0323.00153,1,783769,784427,+,658
244,WOLB.0323.00093,1,860023,860679,-,656
244,WOLB.0323.00088,1,804198,804854,+,656
244,WOLB.0323.00008,1,900972,901628,+,656
244,WOLB.0323.00133,1,232448,233087,-,639
244,WOLB.0323.00084,1,1301611,1302267,-,656
244,WOLB.0323.00021,1,992853,993509,+,656
244,WOLB.0323.00020,1,745094,745750,+,656
244,WOLB.0323.00122,1,648406,649062,+,656
244,WOLB.0323.00118,1,634322,634962,+,640
244,WOLB.0323.00004,1,846838,847494,+,656
244,WOLB.0323.00011,1,217406,218062,+,656
244,WOLB.0323.00035,1,742099,742755,+,656
244,WOLB.0323.00032,1,274684,275340,+,656
244,WOLB.0323.00012,1,808300,808956,+,656
244,WOLB.0323.00025,1,340130,340786,-,656
244,WOLB.0323.00068,1,1052167,1052823,+,656
244,WOLB.0323.00158,1,119688,120344,+,656
244,WOLB.0323.00017,1,836648,837304,+,656
244,WOLB.0323.00104,1,779719,780375,+,656
244,WOLB.0323.00007,1,582769,583425,-,656
244,WOLB.0323.00100,1,1126748,1127404,+,656
244,WOLB.0323.00006,1,1268655,1269311,-,656
244,WOLB.0323.00119,1,687102,687757,-,655
244,WOLB.0323.00149,1,995065,995721,-,656
244,WOLB.0323.00096,1,1093691,1094347,-,656
243,WOLB.0323.00090,1,707940,710609,+,2669
243,WOLB.0323.00002,1,715204,717863,-,2659
243,WOLB.0323.00138,1,1351686,1354355,-,2669
243,WOLB.0323.00132,1,477359,480037,-,2678
243,WOLB.0323.00143,1,815855,818507,+,2652
243,WOLB.0323.00106,1,815858,818510,+,2652
243,WOLB.0323.00121,1,969059,971718,+,2659
243,WOLB.0323.00135,1,872855,875514,+,2659
243,WOLB.0323.00103,1,671225,673888,-,2663
243,WOLB.0323.00107,1,669809,672472,-,2663
243,WOLB.0323.00019,1,488100,490763,+,2663
243,WOLB.0323.00060,1,766413,769044,+,2631
243,WOLB.0323.00074,1,570384,573053,+,2669
243,WOLB.0323.00120,1,556555,559224,+,2669
243,WOLB.0323.00039,1,317226,319889,-,2663
243,WOLB.0323.00041,1,1057777,1060446,-,2669
243,WOLB.0323.00031,1,1242330,1244982,-,2652
243,WOLB.0323.00056,1,754792,757451,+,2659
243,WOLB.0323.00142,1,842709,845368,+,2659
243,WOLB.0323.00023,1,1756441,1759100,+,2659
243,WOLB.0323.00153,1,779631,782300,+,2669
243,WOLB.0323.00093,1,862148,864807,-,2659
243,WOLB.0323.00088,1,800070,802729,+,2659
243,WOLB.0323.00008,1,896834,899503,+,2669
243,WOLB.0323.00024,1,29138,31797,+,2659
243,WOLB.0323.00064,1,211181,213840,-,2659
243,WOLB.0323.00030,1,1031843,1034502,+,2659
243,WOLB.0323.00105,1,671236,673899,-,2663
243,WOLB.0323.00133,1,234702,237432,-,2730
243,WOLB.0323.00084,1,1303736,1306405,-,2669
243,WOLB.0323.00021,1,988715,991384,+,2669
243,WOLB.0323.00043,1,803084,805743,-,2659
243,WOLB.0323.00020,1,740966,743625,+,2659
243,WOLB.0323.00122,1,644278,646937,+,2659
243,WOLB.0323.00118,1,629960,632682,+,2722
243,WOLB.0323.00004,1,842710,845369,+,2659
243,WOLB.0323.00011,1,213278,215937,+,2659
243,WOLB.0323.00035,1,737971,740630,+,2659
243,WOLB.0323.00032,1,270546,273215,+,2669
243,WOLB.0323.00012,1,804172,806831,+,2659
243,WOLB.0323.00018,1,668514,671161,+,2647
243,WOLB.0323.00025,1,1106935,1109586,-,2651
243,WOLB.0323.00010,1,606167,608827,-,2660
243,WOLB.0323.00068,1,1048033,1050702,+,2669
243,WOLB.0323.00128,1,857631,860290,+,2659
243,WOLB.0323.00158,1,115560,118219,+,2659
243,WOLB.0323.00017,1,832520,835179,+,2659
243,WOLB.0323.00104,1,775591,778250,+,2659
243,WOLB.0323.00007,1,584894,587553,-,2659
243,WOLB.0323.00001,1,671236,673899,-,2663
243,WOLB.0323.00100,1,1122620,1125279,+,2659
243,WOLB.0323.00070,1,958681,961340,+,2659
243,WOLB.0323.00006,1,1270718,1273370,-,2652
243,WOLB.0323.00042,1,797210,799869,-,2659
243,WOLB.0323.00119,1,689260,691923,-,2663
243,WOLB.0323.00149,1,997190,999849,-,2659
243,WOLB.0323.00014,1,754269,756928,-,2659
243,WOLB.0323.00096,1,1095711,1098380,-,2669
242,WOLB.0323.00090,1,705658,707249,+,1591
242,WOLB.0323.00002,1,718552,720142,-,1590
242,WOLB.0323.00138,1,1355045,1356637,-,1592
242,WOLB.0323.00132,1,481014,482604,-,1590
242,WOLB.0323.00143,1,813285,814876,+,1591
242,WOLB.0323.00106,1,813288,814879,+,1591
242,WOLB.0323.00121,1,966777,968368,+,1591
242,WOLB.0323.00135,1,870575,872164,+,1589
242,WOLB.0323.00103,1,690676,692268,+,1592
242,WOLB.0323.00107,1,689260,690852,+,1592
242,WOLB.0323.00019,1,485820,487410,+,1590
242,WOLB.0323.00060,1,764131,765722,+,1591
242,WOLB.0323.00074,1,568102,569693,+,1591
242,WOLB.0323.00120,1,554273,555864,+,1591
242,WOLB.0323.00039,1,320579,322169,-,1590
242,WOLB.0323.00041,1,1061137,1062728,-,1591
242,WOLB.0323.00031,1,1245961,1247552,-,1591
242,WOLB.0323.00056,1,752511,754101,+,1590
242,WOLB.0323.00142,1,840427,842018,+,1591
242,WOLB.0323.00023,1,1754162,1755752,+,1590
242,WOLB.0323.00153,1,777349,778940,+,1591
242,WOLB.0323.00093,1,865497,867088,-,1591
242,WOLB.0323.00088,1,797790,799379,+,1589
242,WOLB.0323.00008,1,894552,896144,+,1592
242,WOLB.0323.00024,1,25007,26597,+,1590
242,WOLB.0323.00064,1,214819,216408,-,1589
242,WOLB.0323.00030,1,1029275,1030864,+,1589
242,WOLB.0323.00105,1,690687,692279,+,1592
242,WOLB.0323.00133,1,238122,239705,-,1583
242,WOLB.0323.00084,1,1307095,1308687,-,1592
242,WOLB.0323.00021,1,986433,988025,+,1592
242,WOLB.0323.00043,1,806432,808022,-,1590
242,WOLB.0323.00020,1,738686,740275,+,1589
242,WOLB.0323.00122,1,641996,643587,+,1591
242,WOLB.0323.00118,1,627678,629270,+,1592
242,WOLB.0323.00004,1,840428,842019,+,1591
242,WOLB.0323.00011,1,210996,212587,+,1591
242,WOLB.0323.00035,1,735691,737280,+,1589
242,WOLB.0323.00032,1,268264,269856,+,1592
242,WOLB.0323.00012,1,801892,803481,+,1589
242,WOLB.0323.00018,1,666235,667825,+,1590
242,WOLB.0323.00025,1,1110275,1111867,-,1592
242,WOLB.0323.00010,1,609516,611106,-,1590
242,WOLB.0323.00068,1,1045751,1047343,+,1592
242,WOLB.0323.00128,1,855352,856942,+,1590
242,WOLB.0323.00158,1,113278,114869,+,1591
242,WOLB.0323.00017,1,830238,831829,+,1591
242,WOLB.0323.00104,1,773311,774900,+,1589
242,WOLB.0323.00007,1,588244,589835,-,1591
242,WOLB.0323.00001,1,690687,692279,+,1592
242,WOLB.0323.00100,1,1120340,1121929,+,1589
242,WOLB.0323.00070,1,956402,957992,+,1590
242,WOLB.0323.00006,1,1274349,1275940,-,1591
242,WOLB.0323.00042,1,800558,802148,-,1590
242,WOLB.0323.00119,1,692613,694203,-,1590
242,WOLB.0323.00149,1,1000540,1002131,-,1591
242,WOLB.0323.00014,1,757617,759207,-,1590
242,WOLB.0323.00096,1,1099071,1100662,-,1591
241,WOLB.0323.00090,1,703140,704071,+,931
241,WOLB.0323.00002,1,843893,844825,-,932
241,WOLB.0323.00138,1,1358204,1359136,-,932
241,WOLB.0323.00132,1,484447,485379,-,932
241,WOLB.0323.00143,1,810428,811359,+,931
241,WOLB.0323.00106,1,810431,811362,+,931
241,WOLB.0323.00121,1,964260,965191,+,931
241,WOLB.0323.00135,1,868058,868989,+,931
241,WOLB.0323.00103,1,687415,688346,+,931
241,WOLB.0323.00107,1,685999,686930,+,931
241,WOLB.0323.00019,1,483312,484243,+,931
241,WOLB.0323.00060,1,761614,762545,+,931
241,WOLB.0323.00074,1,565338,566269,+,931
241,WOLB.0323.00120,1,551509,552440,+,931
241,WOLB.0323.00039,1,323745,324677,-,932
241,WOLB.0323.00041,1,1064560,1065492,-,932
241,WOLB.0323.00031,1,1249477,1250409,-,932
241,WOLB.0323.00056,1,749994,750925,+,931
241,WOLB.0323.00142,1,837910,838841,+,931
241,WOLB.0323.00023,1,1749907,1750838,+,931
241,WOLB.0323.00153,1,774831,775762,+,931
241,WOLB.0323.00093,1,868680,869612,-,932
241,WOLB.0323.00088,1,795273,796204,+,931
241,WOLB.0323.00008,1,891784,892715,+,931
241,WOLB.0323.00024,1,22236,23167,+,931
241,WOLB.0323.00064,1,218236,219168,-,932
241,WOLB.0323.00030,1,1026515,1027446,+,931
241,WOLB.0323.00105,1,687426,688357,+,931
241,WOLB.0323.00133,1,241554,242482,-,928
241,WOLB.0323.00084,1,1310254,1311186,-,932
241,WOLB.0323.00021,1,983934,984865,+,931
241,WOLB.0323.00043,1,690719,691651,-,932
241,WOLB.0323.00020,1,736169,737100,+,931
241,WOLB.0323.00122,1,639479,640410,+,931
241,WOLB.0323.00118,1,625179,626110,+,931
241,WOLB.0323.00004,1,837911,838842,+,931
241,WOLB.0323.00011,1,208479,209410,+,931
241,WOLB.0323.00035,1,733174,734105,+,931
241,WOLB.0323.00032,1,265768,266699,+,931
241,WOLB.0323.00012,1,799375,800306,+,931
241,WOLB.0323.00018,1,663471,664402,+,931
241,WOLB.0323.00025,1,1113431,1114363,-,932
241,WOLB.0323.00010,1,623585,624516,+,931
241,WOLB.0323.00068,1,1043252,1044183,+,931
241,WOLB.0323.00128,1,951964,952895,+,931
241,WOLB.0323.00158,1,110761,111692,+,931
241,WOLB.0323.00017,1,827721,828652,+,931
241,WOLB.0323.00104,1,770794,771725,+,931
241,WOLB.0323.00007,1,591420,592352,-,932
241,WOLB.0323.00001,1,687426,688357,+,931
241,WOLB.0323.00100,1,1117823,1118754,+,931
241,WOLB.0323.00070,1,1155179,1156111,-,932
241,WOLB.0323.00006,1,1277865,1278797,-,932
241,WOLB.0323.00042,1,803728,804660,-,932
241,WOLB.0323.00119,1,695779,696711,-,932
241,WOLB.0323.00149,1,1003716,1004648,-,932
241,WOLB.0323.00014,1,594811,595743,-,932
241,WOLB.0323.00096,1,1102494,1103426,-,932
240,WOLB.0323.00090,1,699169,700660,+,1491
240,WOLB.0323.00002,1,925327,926814,-,1487
240,WOLB.0323.00138,1,1364184,1365674,-,1490
240,WOLB.0323.00132,1,538075,539562,-,1487
240,WOLB.0323.00143,1,671487,672978,+,1491
240,WOLB.0323.00106,1,671488,672979,+,1491
240,WOLB.0323.00121,1,960192,961683,+,1491
240,WOLB.0323.00135,1,864079,865570,+,1491
240,WOLB.0323.00103,1,685288,686777,+,1489
240,WOLB.0323.00107,1,683872,685361,+,1489
240,WOLB.0323.00019,1,478239,479726,+,1487
240,WOLB.0323.00060,1,755343,756834,+,1491
240,WOLB.0323.00074,1,551498,552949,+,1451
240,WOLB.0323.00120,1,537669,539120,+,1451
240,WOLB.0323.00039,1,326819,328306,-,1487
240,WOLB.0323.00041,1,1077881,1079332,-,1451
240,WOLB.0323.00031,1,114328,115818,-,1490
240,WOLB.0323.00056,1,746016,747507,+,1491
240,WOLB.0323.00142,1,833842,835333,+,1491
240,WOLB.0323.00023,1,1872024,1873511,-,1487
240,WOLB.0323.00153,1,770860,772351,+,1491
240,WOLB.0323.00093,1,881766,883225,-,1459
240,WOLB.0323.00088,1,791294,792785,+,1491
240,WOLB.0323.00008,1,878253,879713,+,1460
240,WOLB.0323.00024,1,1559901,1561388,+,1487
240,WOLB.0323.00064,1,628774,630261,+,1487
240,WOLB.0323.00030,1,877566,879053,-,1487
240,WOLB.0323.00105,1,685299,686788,+,1489
240,WOLB.0323.00133,1,160189,161677,+,1488
240,WOLB.0323.00084,1,1316233,1317723,-,1490
240,WOLB.0323.00021,1,977395,978886,+,1491
240,WOLB.0323.00043,1,833358,834845,-,1487
240,WOLB.0323.00020,1,732190,733681,+,1491
240,WOLB.0323.00122,1,635508,636999,+,1491
240,WOLB.0323.00118,1,617052,618543,+,1491
240,WOLB.0323.00004,1,833843,835334,+,1491
240,WOLB.0323.00011,1,204411,205902,+,1491
240,WOLB.0323.00035,1,729196,730687,+,1491
240,WOLB.0323.00032,1,259229,260720,+,1491
240,WOLB.0323.00012,1,795396,796887,+,1491
240,WOLB.0323.00018,1,695313,696800,-,1487
240,WOLB.0323.00025,1,295012,296508,+,1496
240,WOLB.0323.00010,1,820760,822247,+,1487
240,WOLB.0323.00068,1,656265,657756,+,1491
240,WOLB.0323.00128,1,828520,830007,+,1487
240,WOLB.0323.00158,1,106693,108184,+,1491
240,WOLB.0323.00017,1,823653,825144,+,1491
240,WOLB.0323.00104,1,766815,768306,+,1491
240,WOLB.0323.00007,1,597139,598629,-,1490
240,WOLB.0323.00001,1,685299,686788,+,1489
240,WOLB.0323.00100,1,1113844,1115335,+,1491
240,WOLB.0323.00070,1,929578,931065,+,1487
240,WOLB.0323.00006,1,88728,90219,+,1491
240,WOLB.0323.00042,1,865269,866756,-,1487
240,WOLB.0323.00119,1,700297,701784,-,1487
240,WOLB.0323.00149,1,1007225,1008715,-,1490
240,WOLB.0323.00014,1,785904,787391,-,1487
240,WOLB.0323.00096,1,1115815,1117266,-,1451
239,WOLB.0323.00090,1,694815,697817,+,3002
239,WOLB.0323.00002,1,930383,933365,-,2982
239,WOLB.0323.00138,1,1368092,1371074,-,2982
239,WOLB.0323.00132,1,542175,545160,-,2985
239,WOLB.0323.00143,1,665247,668251,+,3004
239,WOLB.0323.00106,1,665248,668252,+,3004
239,WOLB.0323.00121,1,954792,957795,+,3003
239,WOLB.0323.00135,1,858602,861586,+,2984
239,WOLB.0323.00103,1,937574,940567,-,2993
239,WOLB.0323.00107,1,936147,939140,-,2993
239,WOLB.0323.00019,1,474054,477057,+,3003
239,WOLB.0323.00060,1,749969,752951,+,2982
239,WOLB.0323.00074,1,27256,30240,+,2984
239,WOLB.0323.00120,1,27251,30235,+,2984
239,WOLB.0323.00039,1,329488,332491,-,3003
239,WOLB.0323.00041,1,27252,30236,+,2984
239,WOLB.0323.00031,1,119055,122059,-,3004
239,WOLB.0323.00056,1,740620,743602,+,2982
239,WOLB.0323.00142,1,828442,831445,+,3003
239,WOLB.0323.00023,1,1799056,1802038,+,2982
239,WOLB.0323.00153,1,766506,769508,+,3002
239,WOLB.0323.00093,1,994715,997702,-,2987
239,WOLB.0323.00088,1,785806,788790,+,2984
239,WOLB.0323.00008,1,369237,372215,-,2978
239,WOLB.0323.00024,1,1553321,1556303,+,2982
239,WOLB.0323.00064,1,623126,626165,+,3039
239,WOLB.0323.00030,1,881662,884701,-,3039
239,WOLB.0323.00105,1,937583,940576,-,2993
239,WOLB.0323.00133,1,155828,158831,+,3003
239,WOLB.0323.00084,1,1320141,1323123,-,2982
239,WOLB.0323.00021,1,971996,974978,+,2982
239,WOLB.0323.00043,1,837055,840037,-,2982
239,WOLB.0323.00020,1,726702,729686,+,2984
239,WOLB.0323.00122,1,630109,633112,+,3003
239,WOLB.0323.00118,1,612697,615700,+,3003
239,WOLB.0323.00004,1,828443,831446,+,3003
239,WOLB.0323.00011,1,199011,202014,+,3003
239,WOLB.0323.00035,1,723708,726692,+,2984
239,WOLB.0323.00032,1,253830,256812,+,2982
239,WOLB.0323.00012,1,789908,792892,+,2984
239,WOLB.0323.00018,1,699092,702095,-,3003
239,WOLB.0323.00025,1,289563,292555,+,2992
239,WOLB.0323.00010,1,816526,819528,+,3002
239,WOLB.0323.00068,1,650866,653848,+,2982
239,WOLB.0323.00128,1,737451,740433,+,2982
239,WOLB.0323.00158,1,101293,104296,+,3003
239,WOLB.0323.00017,1,818253,821256,+,3003
239,WOLB.0323.00104,1,761327,764311,+,2984
239,WOLB.0323.00007,1,601045,604027,-,2982
239,WOLB.0323.00001,1,937583,940576,-,2993
239,WOLB.0323.00100,1,1108356,1111340,+,2984
239,WOLB.0323.00070,1,923024,926006,+,2982
239,WOLB.0323.00006,1,82488,85492,+,3004
239,WOLB.0323.00042,1,826944,829947,+,3003
239,WOLB.0323.00119,1,702966,705969,-,3003
239,WOLB.0323.00149,1,1011113,1014116,-,3003
239,WOLB.0323.00014,1,790985,793967,-,2982
239,WOLB.0323.00096,1,33940,36924,+,2984
238,WOLB.0323.00090,1,690989,692414,+,1425
238,WOLB.0323.00002,1,937252,938674,-,1422
238,WOLB.0323.00138,1,1376724,1378149,-,1425
238,WOLB.0323.00132,1,545601,547026,-,1425
238,WOLB.0323.00143,1,662835,664260,+,1425
238,WOLB.0323.00106,1,662836,664261,+,1425
238,WOLB.0323.00121,1,949487,950912,+,1425
238,WOLB.0323.00135,1,854776,856201,+,1425
238,WOLB.0323.00103,1,836567,837992,-,1425
238,WOLB.0323.00107,1,835141,836566,-,1425
238,WOLB.0323.00019,1,471777,473198,+,1421
238,WOLB.0323.00060,1,743012,744437,+,1425
238,WOLB.0323.00074,1,25040,26453,+,1413
238,WOLB.0323.00120,1,25035,26448,+,1413
238,WOLB.0323.00039,1,333330,334751,-,1421
238,WOLB.0323.00041,1,25036,26449,+,1413
238,WOLB.0323.00031,1,123046,124471,-,1425
238,WOLB.0323.00056,1,733663,735088,+,1425
238,WOLB.0323.00142,1,823137,824562,+,1425
238,WOLB.0323.00023,1,1795178,1796603,+,1425
238,WOLB.0323.00153,1,761028,762453,+,1425
238,WOLB.0323.00093,1,998542,999963,-,1421
238,WOLB.0323.00088,1,781980,783405,+,1425
238,WOLB.0323.00008,1,374534,375954,-,1420
238,WOLB.0323.00024,1,1547897,1549322,+,1425
238,WOLB.0323.00064,1,619248,620673,+,1425
238,WOLB.0323.00030,1,887154,888579,-,1425
238,WOLB.0323.00105,1,836577,838002,-,1425
238,WOLB.0323.00133,1,153607,155013,+,1406
238,WOLB.0323.00084,1,1327003,1328428,-,1425
238,WOLB.0323.00021,1,966691,968116,+,1425
238,WOLB.0323.00043,1,842369,843791,-,1422
238,WOLB.0323.00020,1,722876,724301,+,1425
238,WOLB.0323.00122,1,624804,626229,+,1425
238,WOLB.0323.00118,1,609301,610726,+,1425
238,WOLB.0323.00004,1,823138,824563,+,1425
238,WOLB.0323.00011,1,193706,195131,+,1425
238,WOLB.0323.00035,1,719882,721307,+,1425
238,WOLB.0323.00032,1,248525,249950,+,1425
238,WOLB.0323.00012,1,786082,787507,+,1425
238,WOLB.0323.00018,1,704552,705977,-,1425
238,WOLB.0323.00025,1,285506,286920,+,1414
238,WOLB.0323.00010,1,812649,814074,+,1425
238,WOLB.0323.00068,1,643792,645217,+,1425
238,WOLB.0323.00128,1,733697,735119,+,1422
238,WOLB.0323.00158,1,95988,97413,+,1425
238,WOLB.0323.00017,1,812948,814373,+,1425
238,WOLB.0323.00104,1,757501,758926,+,1425
238,WOLB.0323.00007,1,607907,609332,-,1425
238,WOLB.0323.00001,1,836577,838002,-,1425
238,WOLB.0323.00100,1,1104530,1105955,+,1425
238,WOLB.0323.00070,1,919270,920692,+,1422
238,WOLB.0323.00006,1,80076,81501,+,1425
238,WOLB.0323.00042,1,822120,823545,+,1425
238,WOLB.0323.00119,1,706825,708246,-,1421
238,WOLB.0323.00149,1,1017996,1019421,-,1425
238,WOLB.0323.00014,1,796299,797721,-,1422
238,WOLB.0323.00096,1,31724,33137,+,1413
237,WOLB.0323.00090,1,690276,690801,+,525
237,WOLB.0323.00002,1,938852,939387,-,535
237,WOLB.0323.00138,1,1379425,1379960,-,535
237,WOLB.0323.00132,1,547214,547739,-,525
237,WOLB.0323.00143,1,662122,662657,+,535
237,WOLB.0323.00106,1,662123,662658,+,535
237,WOLB.0323.00121,1,947692,948227,+,535
237,WOLB.0323.00135,1,1162283,1162808,-,525
237,WOLB.0323.00103,1,838180,838705,-,525
237,WOLB.0323.00107,1,836754,837279,-,525
237,WOLB.0323.00019,1,471064,471589,+,525
237,WOLB.0323.00060,1,741209,741734,+,525
237,WOLB.0323.00074,1,24516,25038,+,522
237,WOLB.0323.00120,1,24511,25033,+,522
237,WOLB.0323.00039,1,334939,335464,-,525
237,WOLB.0323.00041,1,24512,25034,+,522
237,WOLB.0323.00031,1,124649,125184,-,535
237,WOLB.0323.00056,1,731860,732385,+,525
237,WOLB.0323.00142,1,821342,821877,+,535
237,WOLB.0323.00023,1,1794465,1794985,+,520
237,WOLB.0323.00153,1,760315,760840,+,525
237,WOLB.0323.00093,1,1000153,1000678,-,525
237,WOLB.0323.00088,1,780185,780710,+,525
237,WOLB.0323.00008,1,376142,376667,-,525
237,WOLB.0323.00024,1,1547184,1547709,+,525
237,WOLB.0323.00064,1,618535,619060,+,525
237,WOLB.0323.00030,1,888767,889292,-,525
237,WOLB.0323.00105,1,838190,838715,-,525
237,WOLB.0323.00133,1,152895,153419,+,524
237,WOLB.0323.00084,1,1329704,1330239,-,535
237,WOLB.0323.00021,1,964880,965415,+,535
237,WOLB.0323.00043,1,843969,844504,-,535
237,WOLB.0323.00020,1,721081,721606,+,525
237,WOLB.0323.00122,1,624091,624616,+,525
237,WOLB.0323.00118,1,607490,608015,+,525
237,WOLB.0323.00004,1,821343,821878,+,535
237,WOLB.0323.00011,1,191911,192446,+,535
237,WOLB.0323.00035,1,718087,718612,+,525
237,WOLB.0323.00032,1,246714,247249,+,535
237,WOLB.0323.00012,1,784287,784812,+,525
237,WOLB.0323.00018,1,706165,706690,-,525
237,WOLB.0323.00025,1,269732,270240,-,508
237,WOLB.0323.00010,1,811936,812461,+,525
237,WOLB.0323.00068,1,641981,642516,+,535
237,WOLB.0323.00128,1,732984,733519,+,535
237,WOLB.0323.00158,1,94193,94728,+,535
237,WOLB.0323.00017,1,811167,811688,+,521
237,WOLB.0323.00104,1,755706,756231,+,525
237,WOLB.0323.00007,1,610610,611135,-,525
237,WOLB.0323.00001,1,838190,838715,-,525
237,WOLB.0323.00100,1,1102735,1103260,+,525
237,WOLB.0323.00070,1,918557,919092,+,535
237,WOLB.0323.00006,1,79363,79898,+,535
237,WOLB.0323.00042,1,821407,821932,+,525
237,WOLB.0323.00119,1,708434,708959,-,525
237,WOLB.0323.00149,1,1020681,1021216,-,535
237,WOLB.0323.00014,1,797899,798434,-,535
237,WOLB.0323.00096,1,31200,31722,+,522
236,WOLB.0323.00090,1,688524,690274,+,1750
236,WOLB.0323.00002,1,939388,941160,-,1772
236,WOLB.0323.00138,1,1379961,1381712,-,1751
236,WOLB.0323.00132,1,547740,549536,-,1796
236,WOLB.0323.00143,1,660364,662120,+,1756
236,WOLB.0323.00106,1,660365,662121,+,1756
236,WOLB.0323.00121,1,945940,947690,+,1750
236,WOLB.0323.00135,1,1162809,1164560,-,1751
236,WOLB.0323.00103,1,838706,840469,-,1763
236,WOLB.0323.00107,1,837280,839043,-,1763
236,WOLB.0323.00019,1,469285,471062,+,1777
236,WOLB.0323.00060,1,739457,741207,+,1750
236,WOLB.0323.00074,1,22755,24514,+,1759
236,WOLB.0323.00120,1,22750,24509,+,1759
236,WOLB.0323.00039,1,335465,337243,-,1778
236,WOLB.0323.00041,1,22751,24510,+,1759
236,WOLB.0323.00031,1,125185,126942,-,1757
236,WOLB.0323.00056,1,730108,731858,+,1750
236,WOLB.0323.00142,1,819590,821340,+,1750
236,WOLB.0323.00023,1,1792659,1794463,+,1804
236,WOLB.0323.00153,1,758563,760313,+,1750
236,WOLB.0323.00093,1,1000679,1002484,-,1805
236,WOLB.0323.00088,1,778433,780183,+,1750
236,WOLB.0323.00008,1,376668,378452,-,1784
236,WOLB.0323.00024,1,1545378,1547182,+,1804
236,WOLB.0323.00064,1,616729,618533,+,1804
236,WOLB.0323.00030,1,889293,891098,-,1805
236,WOLB.0323.00105,1,838716,840479,-,1763
236,WOLB.0323.00133,1,151099,152893,+,1794
236,WOLB.0323.00084,1,1330240,1331991,-,1751
236,WOLB.0323.00021,1,963128,964878,+,1750
236,WOLB.0323.00043,1,844505,846277,-,1772
236,WOLB.0323.00020,1,719329,721079,+,1750
236,WOLB.0323.00122,1,622339,624089,+,1750
236,WOLB.0323.00118,1,605738,607488,+,1750
236,WOLB.0323.00004,1,819591,821341,+,1750
236,WOLB.0323.00011,1,190159,191909,+,1750
236,WOLB.0323.00035,1,716335,718085,+,1750
236,WOLB.0323.00032,1,244962,246712,+,1750
236,WOLB.0323.00012,1,782535,784285,+,1750
236,WOLB.0323.00018,1,706691,708448,-,1757
236,WOLB.0323.00025,1,270241,271998,-,1757
236,WOLB.0323.00010,1,810169,811934,+,1765
236,WOLB.0323.00068,1,640229,641979,+,1750
236,WOLB.0323.00128,1,731211,732982,+,1771
236,WOLB.0323.00158,1,92441,94191,+,1750
236,WOLB.0323.00017,1,808298,810061,+,1763
236,WOLB.0323.00104,1,753954,755704,+,1750
236,WOLB.0323.00007,1,611136,612887,-,1751
236,WOLB.0323.00001,1,838716,840479,-,1763
236,WOLB.0323.00100,1,1100983,1102733,+,1750
236,WOLB.0323.00070,1,916784,918555,+,1771
236,WOLB.0323.00006,1,77605,79361,+,1756
236,WOLB.0323.00042,1,819868,821405,+,1537
236,WOLB.0323.00119,1,708960,710738,-,1778
236,WOLB.0323.00149,1,1021217,1022968,-,1751
236,WOLB.0323.00014,1,798435,800207,-,1772
236,WOLB.0323.00096,1,29439,31198,+,1759
235,WOLB.0323.00090,1,687597,688444,+,847
235,WOLB.0323.00002,1,941240,942095,-,855
235,WOLB.0323.00138,1,1381792,1382647,-,855
235,WOLB.0323.00132,1,549616,550471,-,855
235,WOLB.0323.00143,1,659432,660273,+,841
235,WOLB.0323.00106,1,659433,660274,+,841
235,WOLB.0323.00121,1,945005,945860,+,855
235,WOLB.0323.00135,1,1164640,1165487,-,847
235,WOLB.0323.00103,1,841752,842599,-,847
235,WOLB.0323.00107,1,840326,841173,-,847
235,WOLB.0323.00019,1,468358,469205,+,847
235,WOLB.0323.00060,1,738522,739377,+,855
235,WOLB.0323.00074,1,21828,22675,+,847
235,WOLB.0323.00120,1,21823,22670,+,847
235,WOLB.0323.00039,1,337323,338170,-,847
235,WOLB.0323.00041,1,21824,22671,+,847
235,WOLB.0323.00031,1,127033,127874,-,841
235,WOLB.0323.00056,1,729173,730028,+,855
235,WOLB.0323.00142,1,818655,819510,+,855
235,WOLB.0323.00023,1,1791724,1792579,+,855
235,WOLB.0323.00153,1,757636,758483,+,847
235,WOLB.0323.00093,1,1002564,1003411,-,847
235,WOLB.0323.00088,1,777506,778353,+,847
235,WOLB.0323.00008,1,378532,379379,-,847
235,WOLB.0323.00024,1,1544443,1545298,+,855
235,WOLB.0323.00064,1,615794,616649,+,855
235,WOLB.0323.00030,1,891178,892033,-,855
235,WOLB.0323.00105,1,841762,842609,-,847
235,WOLB.0323.00133,1,150162,151009,+,847
235,WOLB.0323.00084,1,1332071,1332926,-,855
235,WOLB.0323.00021,1,962193,963048,+,855
235,WOLB.0323.00043,1,846357,847212,-,855
235,WOLB.0323.00020,1,718402,719249,+,847
235,WOLB.0323.00122,1,621404,622259,+,855
235,WOLB.0323.00118,1,604811,605658,+,847
235,WOLB.0323.00004,1,818656,819511,+,855
235,WOLB.0323.00011,1,189224,190079,+,855
235,WOLB.0323.00035,1,715408,716255,+,847
235,WOLB.0323.00032,1,244027,244882,+,855
235,WOLB.0323.00012,1,781608,782455,+,847
235,WOLB.0323.00018,1,708528,709383,-,855
235,WOLB.0323.00025,1,272089,272930,-,841
235,WOLB.0323.00010,1,809234,810089,+,855
235,WOLB.0323.00068,1,639294,640149,+,855
235,WOLB.0323.00128,1,730276,731131,+,855
235,WOLB.0323.00158,1,91506,92361,+,855
235,WOLB.0323.00017,1,807363,808218,+,855
235,WOLB.0323.00104,1,753027,753874,+,847
235,WOLB.0323.00007,1,612967,613822,-,855
235,WOLB.0323.00001,1,841762,842609,-,847
235,WOLB.0323.00100,1,1100056,1100903,+,847
235,WOLB.0323.00070,1,915849,916704,+,855
235,WOLB.0323.00006,1,76673,77514,+,841
235,WOLB.0323.00042,1,818933,819788,+,855
235,WOLB.0323.00119,1,710818,711665,-,847
235,WOLB.0323.00149,1,1023048,1023903,-,855
235,WOLB.0323.00014,1,800287,801142,-,855
235,WOLB.0323.00096,1,28512,29359,+,847
234,WOLB.0323.00090,1,685455,686156,+,701
234,WOLB.0323.00002,1,945621,946322,-,701
234,WOLB.0323.00138,1,1383900,1384601,-,701
234,WOLB.0323.00132,1,551922,552623,-,701
234,WOLB.0323.00121,1,943050,943751,+,701
234,WOLB.0323.00135,1,1166938,1167639,-,701
234,WOLB.0323.00103,1,843889,844590,-,701
234,WOLB.0323.00107,1,842463,843164,-,701
234,WOLB.0323.00019,1,466198,466900,+,702
234,WOLB.0323.00060,1,735058,735759,+,701
234,WOLB.0323.00074,1,19836,20537,+,701
234,WOLB.0323.00120,1,19831,20532,+,701
234,WOLB.0323.00039,1,339621,340321,-,700
234,WOLB.0323.00041,1,19832,20533,+,701
234,WOLB.0323.00056,1,727218,727919,+,701
234,WOLB.0323.00142,1,816700,817401,+,701
234,WOLB.0323.00023,1,1789571,1790272,+,701
234,WOLB.0323.00153,1,755494,756195,+,701
234,WOLB.0323.00093,1,1006115,1006816,-,701
234,WOLB.0323.00088,1,775353,776054,+,701
234,WOLB.0323.00024,1,1542303,1543004,+,701
234,WOLB.0323.00064,1,613641,614342,+,701
234,WOLB.0323.00030,1,893484,894185,-,701
234,WOLB.0323.00105,1,843899,844600,-,701
234,WOLB.0323.00133,1,148009,148710,+,701
234,WOLB.0323.00084,1,1334179,1334880,-,701
234,WOLB.0323.00021,1,960238,960939,+,701
234,WOLB.0323.00043,1,848663,849364,-,701
234,WOLB.0323.00020,1,716249,716950,+,701
234,WOLB.0323.00122,1,619449,620150,+,701
234,WOLB.0323.00118,1,602669,603370,+,701
234,WOLB.0323.00004,1,816701,817402,+,701
234,WOLB.0323.00011,1,187269,187970,+,701
234,WOLB.0323.00035,1,713255,713956,+,701
234,WOLB.0323.00032,1,242072,242773,+,701
234,WOLB.0323.00012,1,779455,780156,+,701
234,WOLB.0323.00068,1,637339,638040,+,701
234,WOLB.0323.00128,1,728123,728824,+,701
234,WOLB.0323.00158,1,89551,90252,+,701
234,WOLB.0323.00017,1,805408,806109,+,701
234,WOLB.0323.00104,1,750874,751575,+,701
234,WOLB.0323.00007,1,616584,617285,-,701
234,WOLB.0323.00001,1,843899,844600,-,701
234,WOLB.0323.00100,1,1097903,1098604,+,701
234,WOLB.0323.00070,1,913696,914397,+,701
234,WOLB.0323.00042,1,816780,817481,+,701
234,WOLB.0323.00119,1,713122,713824,-,702
234,WOLB.0323.00149,1,1025156,1025857,-,701
234,WOLB.0323.00014,1,802593,803294,-,701
234,WOLB.0323.00096,1,26520,27221,+,701
233,WOLB.0323.00090,1,683933,685454,+,1521
233,WOLB.0323.00002,1,946324,947845,-,1521
233,WOLB.0323.00138,1,1384603,1386124,-,1521
233,WOLB.0323.00132,1,552625,554146,-,1521
233,WOLB.0323.00143,1,710938,712457,-,1519
233,WOLB.0323.00106,1,710939,712458,-,1519
233,WOLB.0323.00121,1,941528,943049,+,1521
233,WOLB.0323.00135,1,1167641,1169162,-,1521
233,WOLB.0323.00103,1,844592,846113,-,1521
233,WOLB.0323.00107,1,843166,844687,-,1521
233,WOLB.0323.00019,1,464676,466197,+,1521
233,WOLB.0323.00060,1,733536,735057,+,1521
233,WOLB.0323.00074,1,18314,19835,+,1521
233,WOLB.0323.00120,1,18309,19830,+,1521
233,WOLB.0323.00039,1,340323,341844,-,1521
233,WOLB.0323.00041,1,18310,19831,+,1521
233,WOLB.0323.00031,1,74847,76366,+,1519
233,WOLB.0323.00056,1,725696,727217,+,1521
233,WOLB.0323.00142,1,815178,816699,+,1521
233,WOLB.0323.00023,1,1788049,1789570,+,1521
233,WOLB.0323.00153,1,753972,755493,+,1521
233,WOLB.0323.00093,1,1006818,1008339,-,1521
233,WOLB.0323.00088,1,773831,775352,+,1521
233,WOLB.0323.00008,1,381417,382938,-,1521
233,WOLB.0323.00024,1,1540781,1542302,+,1521
233,WOLB.0323.00064,1,612119,613640,+,1521
233,WOLB.0323.00030,1,894187,895708,-,1521
233,WOLB.0323.00105,1,844602,846123,-,1521
233,WOLB.0323.00133,1,146487,148008,+,1521
233,WOLB.0323.00084,1,1334882,1336403,-,1521
233,WOLB.0323.00021,1,958716,960237,+,1521
233,WOLB.0323.00043,1,849366,850887,-,1521
233,WOLB.0323.00020,1,714727,716248,+,1521
233,WOLB.0323.00122,1,617927,619448,+,1521
233,WOLB.0323.00118,1,601147,602668,+,1521
233,WOLB.0323.00004,1,815179,816700,+,1521
233,WOLB.0323.00011,1,185747,187268,+,1521
233,WOLB.0323.00035,1,711733,713254,+,1521
233,WOLB.0323.00032,1,240550,242071,+,1521
233,WOLB.0323.00012,1,777933,779454,+,1521
233,WOLB.0323.00018,1,711384,712905,-,1521
233,WOLB.0323.00025,1,258260,259779,+,1519
233,WOLB.0323.00010,1,805712,807233,+,1521
233,WOLB.0323.00068,1,635817,637338,+,1521
233,WOLB.0323.00128,1,726601,728122,+,1521
233,WOLB.0323.00158,1,88029,89550,+,1521
233,WOLB.0323.00017,1,803886,805407,+,1521
233,WOLB.0323.00104,1,749352,750873,+,1521
233,WOLB.0323.00007,1,617287,618808,-,1521
233,WOLB.0323.00001,1,844602,846123,-,1521
233,WOLB.0323.00100,1,1096381,1097902,+,1521
233,WOLB.0323.00070,1,912174,913695,+,1521
233,WOLB.0323.00006,1,71640,73159,+,1519
233,WOLB.0323.00042,1,815258,816779,+,1521
233,WOLB.0323.00119,1,713826,715347,-,1521
233,WOLB.0323.00149,1,1025859,1027380,-,1521
233,WOLB.0323.00014,1,803296,804817,-,1521
233,WOLB.0323.00096,1,24998,26519,+,1521
232,WOLB.0323.00090,1,682304,682880,+,576
232,WOLB.0323.00002,1,948899,949475,-,576
232,WOLB.0323.00138,1,1387177,1387753,-,576
232,WOLB.0323.00132,1,555199,555775,-,576
232,WOLB.0323.00143,1,713524,714100,-,576
232,WOLB.0323.00106,1,713525,714101,-,576
232,WOLB.0323.00121,1,939899,940475,+,576
232,WOLB.0323.00135,1,1170215,1170782,-,567
232,WOLB.0323.00103,1,847167,847721,-,554
232,WOLB.0323.00107,1,845741,846295,-,554
232,WOLB.0323.00019,1,463046,463622,+,576
232,WOLB.0323.00019,1,905190,905832,+,642
232,WOLB.0323.00060,1,396535,397097,+,562
232,WOLB.0323.00060,1,731907,732483,+,576
232,WOLB.0323.00074,1,16619,17261,+,642
232,WOLB.0323.00120,1,16614,17256,+,642
232,WOLB.0323.00039,1,203112,203702,+,590
232,WOLB.0323.00039,1,342898,343465,-,567
232,WOLB.0323.00041,1,16615,17257,+,642
232,WOLB.0323.00031,1,73204,73780,+,576
232,WOLB.0323.00056,1,724067,724643,+,576
232,WOLB.0323.00142,1,813549,814125,+,576
232,WOLB.0323.00023,1,1786420,1786996,+,576
232,WOLB.0323.00153,1,752343,752919,+,576
232,WOLB.0323.00093,1,1009399,1009957,-,558
232,WOLB.0323.00088,1,772211,772778,+,567
232,WOLB.0323.00008,1,383991,384549,-,558
232,WOLB.0323.00024,1,1539161,1539733,+,572
232,WOLB.0323.00064,1,610490,611066,+,576
232,WOLB.0323.00064,1,1537533,1538175,+,642
232,WOLB.0323.00030,1,544285,544927,-,642
232,WOLB.0323.00030,1,613761,614403,-,642
232,WOLB.0323.00030,1,896761,897337,-,576
232,WOLB.0323.00105,1,847177,847731,-,554
232,WOLB.0323.00133,1,144867,145434,+,567
232,WOLB.0323.00084,1,1337456,1338032,-,576
232,WOLB.0323.00021,1,957087,957663,+,576
232,WOLB.0323.00043,1,521567,522209,-,642
232,WOLB.0323.00043,1,855273,855849,-,576
232,WOLB.0323.00020,1,713107,713674,+,567
232,WOLB.0323.00122,1,616298,616874,+,576
232,WOLB.0323.00118,1,599527,600094,+,567
232,WOLB.0323.00004,1,813550,814126,+,576
232,WOLB.0323.00011,1,184118,184694,+,576
232,WOLB.0323.00035,1,710113,710680,+,567
232,WOLB.0323.00032,1,28435,28988,+,553
232,WOLB.0323.00032,1,238921,239497,+,576
232,WOLB.0323.00012,1,776313,776880,+,567
232,WOLB.0323.00018,1,713958,714519,-,561
232,WOLB.0323.00010,1,804082,804658,+,576
232,WOLB.0323.00068,1,634197,634764,+,567
232,WOLB.0323.00128,1,724971,725547,+,576
232,WOLB.0323.00158,1,86400,86976,+,576
232,WOLB.0323.00017,1,802257,802833,+,576
232,WOLB.0323.00104,1,747732,748299,+,567
232,WOLB.0323.00007,1,619861,620437,-,576
232,WOLB.0323.00001,1,847177,847731,-,554
232,WOLB.0323.00100,1,1094761,1095328,+,567
232,WOLB.0323.00070,1,910544,911120,+,576
232,WOLB.0323.00006,1,69997,70573,+,576
232,WOLB.0323.00042,1,813629,814205,+,576
232,WOLB.0323.00119,1,716401,716977,-,576
232,WOLB.0323.00119,1,907844,908486,+,642
232,WOLB.0323.00149,1,1028433,1029009,-,576
232,WOLB.0323.00014,1,805871,806447,-,576
232,WOLB.0323.00096,1,23303,23945,+,642
231,WOLB.0323.00090,1,679149,681903,+,2754
231,WOLB.0323.00002,1,949875,952629,-,2754
231,WOLB.0323.00138,1,1388153,1390907,-,2754
231,WOLB.0323.00132,1,556176,558930,-,2754
231,WOLB.0323.00143,1,846676,849430,-,2754
231,WOLB.0323.00106,1,846679,849433,-,2754
231,WOLB.0323.00121,1,936743,939497,+,2754
231,WOLB.0323.00135,1,1171185,1173939,-,2754
231,WOLB.0323.00103,1,849295,852049,-,2754
231,WOLB.0323.00107,1,847869,850623,-,2754
231,WOLB.0323.00019,1,459891,462645,+,2754
231,WOLB.0323.00060,1,728750,731504,+,2754
231,WOLB.0323.00039,1,343864,346618,-,2754
231,WOLB.0323.00041,1,1326763,1329517,+,2754
231,WOLB.0323.00031,1,1211407,1214161,+,2754
231,WOLB.0323.00056,1,720910,723664,+,2754
231,WOLB.0323.00142,1,810392,813146,+,2754
231,WOLB.0323.00023,1,1783263,1786017,+,2754
231,WOLB.0323.00153,1,749188,751942,+,2754
231,WOLB.0323.00093,1,644266,647004,-,2738
231,WOLB.0323.00088,1,769054,771808,+,2754
231,WOLB.0323.00008,1,711037,713774,-,2737
231,WOLB.0323.00024,1,1536007,1538761,+,2754
231,WOLB.0323.00064,1,607335,610089,+,2754
231,WOLB.0323.00030,1,897693,900447,-,2754
231,WOLB.0323.00105,1,849305,852059,-,2754
231,WOLB.0323.00133,1,141736,144490,+,2754
231,WOLB.0323.00084,1,1338433,1341187,-,2754
231,WOLB.0323.00021,1,953932,956686,+,2754
231,WOLB.0323.00043,1,856249,859003,-,2754
231,WOLB.0323.00020,1,709950,712704,+,2754
231,WOLB.0323.00122,1,613141,615895,+,2754
231,WOLB.0323.00118,1,596372,599126,+,2754
231,WOLB.0323.00004,1,810393,813147,+,2754
231,WOLB.0323.00011,1,180961,183715,+,2754
231,WOLB.0323.00035,1,706956,709710,+,2754
231,WOLB.0323.00032,1,235766,238520,+,2754
231,WOLB.0323.00012,1,773156,775910,+,2754
231,WOLB.0323.00018,1,714921,717675,-,2754
231,WOLB.0323.00025,1,1060168,1062922,+,2754
231,WOLB.0323.00010,1,800928,803682,+,2754
231,WOLB.0323.00068,1,631042,633796,+,2754
231,WOLB.0323.00128,1,721817,724571,+,2754
231,WOLB.0323.00158,1,83243,85997,+,2754
231,WOLB.0323.00017,1,799100,801854,+,2754
231,WOLB.0323.00104,1,744575,747329,+,2754
231,WOLB.0323.00007,1,620840,623594,-,2754
231,WOLB.0323.00001,1,849305,852059,-,2754
231,WOLB.0323.00100,1,1091604,1094358,+,2754
231,WOLB.0323.00070,1,907390,910144,+,2754
231,WOLB.0323.00006,1,1004057,1006811,+,2754
231,WOLB.0323.00042,1,810474,813228,+,2754
231,WOLB.0323.00119,1,717378,720132,-,2754
231,WOLB.0323.00149,1,1029412,1032166,-,2754
231,WOLB.0323.00014,1,806847,809601,-,2754
230,WOLB.0323.00090,1,677270,678386,+,1116
230,WOLB.0323.00002,1,977724,978839,-,1115
230,WOLB.0323.00138,1,1391670,1392786,-,1116
230,WOLB.0323.00132,1,559692,560806,-,1114
230,WOLB.0323.00143,1,843659,844774,-,1115
230,WOLB.0323.00106,1,843662,844777,-,1115
230,WOLB.0323.00121,1,934864,935980,+,1116
230,WOLB.0323.00135,1,1176666,1177782,-,1116
230,WOLB.0323.00103,1,854253,855368,-,1115
230,WOLB.0323.00107,1,852827,853942,-,1115
230,WOLB.0323.00019,1,458012,459127,+,1115
230,WOLB.0323.00060,1,726871,727987,+,1116
230,WOLB.0323.00039,1,347382,348497,-,1115
230,WOLB.0323.00041,1,1324885,1325985,+,1100
230,WOLB.0323.00031,1,1216063,1217178,+,1115
230,WOLB.0323.00056,1,719031,720147,+,1116
230,WOLB.0323.00142,1,808513,809629,+,1116
230,WOLB.0323.00023,1,1781387,1782501,+,1114
230,WOLB.0323.00153,1,747309,748425,+,1116
230,WOLB.0323.00093,1,647589,648705,-,1116
230,WOLB.0323.00088,1,767175,768291,+,1116
230,WOLB.0323.00008,1,714519,715524,-,1005
230,WOLB.0323.00024,1,1534130,1535244,+,1114
230,WOLB.0323.00064,1,605459,606573,+,1114
230,WOLB.0323.00030,1,901209,902323,-,1114
230,WOLB.0323.00105,1,854263,855378,-,1115
230,WOLB.0323.00133,1,139858,140973,+,1115
230,WOLB.0323.00084,1,1341950,1343066,-,1116
230,WOLB.0323.00021,1,952053,953169,+,1116
230,WOLB.0323.00043,1,453777,454892,+,1115
230,WOLB.0323.00020,1,708071,709187,+,1116
230,WOLB.0323.00122,1,609298,610414,+,1116
230,WOLB.0323.00118,1,594493,595609,+,1116
230,WOLB.0323.00004,1,808514,809630,+,1116
230,WOLB.0323.00011,1,179082,180198,+,1116
230,WOLB.0323.00035,1,705077,706193,+,1116
230,WOLB.0323.00032,1,233887,235003,+,1116
230,WOLB.0323.00012,1,771277,772393,+,1116
230,WOLB.0323.00018,1,577518,578633,+,1115
230,WOLB.0323.00025,1,232419,233552,+,1133
230,WOLB.0323.00010,1,958993,960108,-,1115
230,WOLB.0323.00068,1,629163,630279,+,1116
230,WOLB.0323.00128,1,468625,469740,+,1115
230,WOLB.0323.00158,1,81364,82480,+,1116
230,WOLB.0323.00017,1,797221,798337,+,1116
230,WOLB.0323.00104,1,740732,741848,+,1116
230,WOLB.0323.00007,1,624357,625473,-,1116
230,WOLB.0323.00001,1,854263,855378,-,1115
230,WOLB.0323.00100,1,1089725,1090841,+,1116
230,WOLB.0323.00070,1,1382493,1383608,-,1115
230,WOLB.0323.00006,1,1008713,1009828,+,1115
230,WOLB.0323.00042,1,808597,809711,+,1114
230,WOLB.0323.00119,1,720896,722011,-,1115
230,WOLB.0323.00149,1,1032929,1034045,-,1116
230,WOLB.0323.00014,1,1394468,1395583,-,1115
229,WOLB.0323.00090,1,675789,676380,+,591
229,WOLB.0323.00002,1,979731,980322,-,591
229,WOLB.0323.00138,1,1393678,1394269,-,591
229,WOLB.0323.00132,1,561699,562290,-,591
229,WOLB.0323.00143,1,716174,716765,-,591
229,WOLB.0323.00106,1,716175,716766,-,591
229,WOLB.0323.00121,1,933381,933972,+,591
229,WOLB.0323.00135,1,1189924,1190515,-,591
229,WOLB.0323.00103,1,857451,858042,-,591
229,WOLB.0323.00107,1,856025,856616,-,591
229,WOLB.0323.00019,1,456529,457120,+,591
229,WOLB.0323.00060,1,725388,725979,+,591
229,WOLB.0323.00039,1,349389,349980,-,591
229,WOLB.0323.00041,1,1323404,1323995,+,591
229,WOLB.0323.00031,1,70539,71130,+,591
229,WOLB.0323.00056,1,717548,718139,+,591
229,WOLB.0323.00142,1,807030,807621,+,591
229,WOLB.0323.00023,1,1779903,1780494,+,591
229,WOLB.0323.00153,1,745828,746419,+,591
229,WOLB.0323.00093,1,649597,650188,-,591
229,WOLB.0323.00088,1,765692,766283,+,591
229,WOLB.0323.00008,1,716370,716961,-,591
229,WOLB.0323.00024,1,1532647,1533238,+,591
229,WOLB.0323.00064,1,603975,604566,+,591
229,WOLB.0323.00030,1,903223,903808,-,585
229,WOLB.0323.00105,1,857461,858052,-,591
229,WOLB.0323.00133,1,138377,138967,+,590
229,WOLB.0323.00084,1,1343958,1344549,-,591
229,WOLB.0323.00021,1,950570,951161,+,591
229,WOLB.0323.00043,1,452294,452885,+,591
229,WOLB.0323.00020,1,706588,707179,+,591
229,WOLB.0323.00122,1,607817,608408,+,591
229,WOLB.0323.00118,1,593012,593602,+,590
229,WOLB.0323.00004,1,807031,807622,+,591
229,WOLB.0323.00011,1,177599,178190,+,591
229,WOLB.0323.00035,1,703594,704185,+,591
229,WOLB.0323.00032,1,232404,232995,+,591
229,WOLB.0323.00012,1,769794,770385,+,591
229,WOLB.0323.00018,1,576034,576625,+,591
229,WOLB.0323.00025,1,235676,236267,+,591
229,WOLB.0323.00010,1,961000,961591,-,591
229,WOLB.0323.00068,1,627680,628271,+,591
229,WOLB.0323.00128,1,467142,467733,+,591
229,WOLB.0323.00158,1,79881,80472,+,591
229,WOLB.0323.00017,1,795738,796329,+,591
229,WOLB.0323.00104,1,739249,739840,+,591
229,WOLB.0323.00007,1,626365,626956,-,591
229,WOLB.0323.00001,1,857461,858052,-,591
229,WOLB.0323.00100,1,1088242,1088833,+,591
229,WOLB.0323.00070,1,1384500,1385091,-,591
229,WOLB.0323.00006,1,67332,67923,+,591
229,WOLB.0323.00042,1,807114,807705,+,591
229,WOLB.0323.00119,1,722903,723494,-,591
229,WOLB.0323.00149,1,1034937,1035528,-,591
229,WOLB.0323.00014,1,1396475,1397066,-,591
228,WOLB.0323.00090,1,674180,674930,+,750
228,WOLB.0323.00002,1,981192,981950,-,758
228,WOLB.0323.00138,1,1395129,1395878,-,749
228,WOLB.0323.00132,1,563150,563908,-,758
228,WOLB.0323.00143,1,717625,718374,-,749
228,WOLB.0323.00106,1,717626,718375,-,749
228,WOLB.0323.00121,1,931772,932522,+,750
228,WOLB.0323.00135,1,1191374,1192123,-,749
228,WOLB.0323.00103,1,748051,748800,-,749
228,WOLB.0323.00107,1,746635,747384,-,749
228,WOLB.0323.00019,1,454920,455670,+,750
228,WOLB.0323.00060,1,722382,723132,+,750
228,WOLB.0323.00039,1,350839,351588,-,749
228,WOLB.0323.00041,1,1321576,1322326,+,750
228,WOLB.0323.00031,1,68929,69679,+,750
228,WOLB.0323.00056,1,714430,715180,+,750
228,WOLB.0323.00142,1,805421,806171,+,750
228,WOLB.0323.00023,1,1778283,1779042,+,759
228,WOLB.0323.00153,1,744219,744969,+,750
228,WOLB.0323.00093,1,652632,653381,-,749
228,WOLB.0323.00088,1,764083,764833,+,750
228,WOLB.0323.00008,1,717819,718568,-,749
228,WOLB.0323.00024,1,1531021,1531780,+,759
228,WOLB.0323.00064,1,602356,603115,+,759
228,WOLB.0323.00030,1,904668,905426,-,758
228,WOLB.0323.00105,1,748062,748811,-,749
228,WOLB.0323.00133,1,136490,137240,+,750
228,WOLB.0323.00084,1,1345408,1346157,-,749
228,WOLB.0323.00021,1,948960,949710,+,750
228,WOLB.0323.00043,1,450665,451424,+,759
228,WOLB.0323.00020,1,704979,705729,+,750
228,WOLB.0323.00122,1,604699,605449,+,750
228,WOLB.0323.00118,1,591403,592153,+,750
228,WOLB.0323.00004,1,805422,806172,+,750
228,WOLB.0323.00011,1,174481,175231,+,750
228,WOLB.0323.00035,1,701985,702735,+,750
228,WOLB.0323.00032,1,230795,231545,+,750
228,WOLB.0323.00012,1,768185,768935,+,750
228,WOLB.0323.00018,1,574415,575174,+,759
228,WOLB.0323.00025,1,231428,232178,+,750
228,WOLB.0323.00010,1,962461,963219,-,758
228,WOLB.0323.00068,1,626070,626820,+,750
228,WOLB.0323.00128,1,465513,466272,+,759
228,WOLB.0323.00158,1,78272,79022,+,750
228,WOLB.0323.00017,1,794129,794879,+,750
228,WOLB.0323.00104,1,737640,738390,+,750
228,WOLB.0323.00007,1,629324,630073,-,749
228,WOLB.0323.00001,1,748062,748811,-,749
228,WOLB.0323.00100,1,1086633,1087383,+,750
228,WOLB.0323.00070,1,1385961,1386719,-,758
228,WOLB.0323.00006,1,65715,66472,+,757
228,WOLB.0323.00042,1,805495,806254,+,759
228,WOLB.0323.00119,1,724353,725102,-,749
228,WOLB.0323.00149,1,1036387,1037136,-,749
228,WOLB.0323.00014,1,1397936,1398694,-,758
227,WOLB.0323.00090,1,673269,674179,+,910
227,WOLB.0323.00002,1,855593,856501,-,908
227,WOLB.0323.00138,1,1395880,1396790,-,910
227,WOLB.0323.00132,1,629739,630647,-,908
227,WOLB.0323.00143,1,718376,719286,-,910
227,WOLB.0323.00106,1,718377,719287,-,910
227,WOLB.0323.00121,1,930861,931771,+,910
227,WOLB.0323.00135,1,1192125,1193035,-,910
227,WOLB.0323.00103,1,748802,749712,-,910
227,WOLB.0323.00107,1,747386,748296,-,910
227,WOLB.0323.00019,1,454009,454919,+,910
227,WOLB.0323.00060,1,721471,722381,+,910
227,WOLB.0323.00039,1,351590,352500,-,910
227,WOLB.0323.00041,1,1320664,1321575,+,911
227,WOLB.0323.00031,1,68018,68928,+,910
227,WOLB.0323.00056,1,713519,714429,+,910
227,WOLB.0323.00142,1,804510,805420,+,910
227,WOLB.0323.00023,1,1457226,1458134,-,908
227,WOLB.0323.00153,1,743308,744218,+,910
227,WOLB.0323.00093,1,653383,654293,-,910
227,WOLB.0323.00088,1,763172,764082,+,910
227,WOLB.0323.00008,1,718570,719480,-,910
227,WOLB.0323.00024,1,1438085,1438993,+,908
227,WOLB.0323.00064,1,326170,327078,+,908
227,WOLB.0323.00030,1,906181,907089,-,908
227,WOLB.0323.00105,1,748813,749723,-,910
227,WOLB.0323.00133,1,135579,136489,+,910
227,WOLB.0323.00084,1,1346159,1347069,-,910
227,WOLB.0323.00021,1,948049,948959,+,910
227,WOLB.0323.00043,1,702418,703326,-,908
227,WOLB.0323.00020,1,704068,704978,+,910
227,WOLB.0323.00122,1,603788,604698,+,910
227,WOLB.0323.00118,1,590492,591402,+,910
227,WOLB.0323.00004,1,804511,805421,+,910
227,WOLB.0323.00011,1,173570,174480,+,910
227,WOLB.0323.00035,1,701074,701984,+,910
227,WOLB.0323.00032,1,229884,230794,+,910
227,WOLB.0323.00012,1,767274,768184,+,910
227,WOLB.0323.00018,1,1032405,1033313,-,908
227,WOLB.0323.00025,1,230599,231427,+,828
227,WOLB.0323.00010,1,636081,636988,-,907
227,WOLB.0323.00068,1,625159,626069,+,910
227,WOLB.0323.00128,1,940288,941196,+,908
227,WOLB.0323.00158,1,77361,78271,+,910
227,WOLB.0323.00017,1,793218,794128,+,910
227,WOLB.0323.00104,1,736729,737639,+,910
227,WOLB.0323.00007,1,630075,630985,-,910
227,WOLB.0323.00001,1,748813,749723,-,910
227,WOLB.0323.00100,1,1085722,1086632,+,910
227,WOLB.0323.00070,1,1166879,1167787,-,908
227,WOLB.0323.00006,1,64811,65713,+,902
227,WOLB.0323.00042,1,1669405,1670313,-,908
227,WOLB.0323.00119,1,725104,726014,-,910
227,WOLB.0323.00149,1,1037138,1038048,-,910
227,WOLB.0323.00014,1,606510,607418,-,908
226,WOLB.0323.00090,1,668494,669839,+,1345
226,WOLB.0323.00002,1,907414,908764,-,1350
226,WOLB.0323.00138,1,1404912,1406257,+,1345
226,WOLB.0323.00132,1,741216,742568,+,1352
226,WOLB.0323.00143,1,686361,687704,-,1343
226,WOLB.0323.00106,1,686362,687705,-,1343
226,WOLB.0323.00121,1,921383,922727,-,1344
226,WOLB.0323.00135,1,1226756,1228101,+,1345
226,WOLB.0323.00103,1,757148,758501,+,1353
226,WOLB.0323.00107,1,755732,757085,+,1353
226,WOLB.0323.00019,1,625188,626540,+,1352
226,WOLB.0323.00060,1,550869,552220,-,1351
226,WOLB.0323.00039,1,361405,362757,+,1352
226,WOLB.0323.00041,1,1312330,1313650,-,1320
226,WOLB.0323.00031,1,99601,100945,+,1344
226,WOLB.0323.00056,1,703171,704522,-,1351
226,WOLB.0323.00142,1,795032,796376,-,1344
226,WOLB.0323.00023,1,227328,228679,+,1351
226,WOLB.0323.00153,1,738533,739878,+,1345
226,WOLB.0323.00093,1,658587,659952,+,1365
226,WOLB.0323.00088,1,753704,755048,-,1344
226,WOLB.0323.00008,1,723774,725139,+,1365
226,WOLB.0323.00024,1,1697380,1698747,+,1367
226,WOLB.0323.00064,1,1457663,1459014,-,1351
226,WOLB.0323.00030,1,995301,996653,+,1352
226,WOLB.0323.00105,1,757159,758512,+,1353
226,WOLB.0323.00133,1,61697,63065,-,1368
226,WOLB.0323.00084,1,1355191,1356536,+,1345
226,WOLB.0323.00021,1,938593,939937,-,1344
226,WOLB.0323.00043,1,815445,816795,-,1350
226,WOLB.0323.00020,1,694600,695944,-,1344
226,WOLB.0323.00122,1,594336,595680,-,1344
226,WOLB.0323.00118,1,581009,582353,-,1344
226,WOLB.0323.00004,1,795033,796377,-,1344
226,WOLB.0323.00011,1,164092,165436,-,1344
226,WOLB.0323.00035,1,691606,692950,-,1344
226,WOLB.0323.00032,1,220417,221761,-,1344
226,WOLB.0323.00012,1,757806,759150,-,1344
226,WOLB.0323.00018,1,815988,817339,+,1351
226,WOLB.0323.00025,1,374096,375439,-,1343
226,WOLB.0323.00010,1,838817,840168,+,1351
226,WOLB.0323.00068,1,615692,617036,-,1344
226,WOLB.0323.00128,1,846578,847929,+,1351
226,WOLB.0323.00158,1,67883,69227,-,1344
226,WOLB.0323.00017,1,783740,785084,-,1344
226,WOLB.0323.00104,1,727261,728605,-,1344
226,WOLB.0323.00007,1,639116,640468,+,1352
226,WOLB.0323.00001,1,757159,758512,+,1353
226,WOLB.0323.00100,1,1076254,1077598,-,1344
226,WOLB.0323.00070,1,947627,948978,+,1351
226,WOLB.0323.00006,1,103602,104945,-,1343
226,WOLB.0323.00042,1,629272,630610,+,1338
226,WOLB.0323.00119,1,552044,553395,-,1351
226,WOLB.0323.00149,1,1046181,1047526,+,1345
226,WOLB.0323.00014,1,767982,769332,-,1350
225,WOLB.0323.00090,1,663724,667052,+,3328
225,WOLB.0323.00002,1,910886,914241,-,3355
225,WOLB.0323.00138,1,1400142,1403470,+,3328
225,WOLB.0323.00132,1,736067,739395,+,3328
225,WOLB.0323.00143,1,689166,692512,-,3346
225,WOLB.0323.00106,1,689167,692513,-,3346
225,WOLB.0323.00121,1,924170,927508,-,3338
225,WOLB.0323.00135,1,1196388,1199716,+,3328
225,WOLB.0323.00103,1,751982,755291,+,3309
225,WOLB.0323.00107,1,750566,753875,+,3309
225,WOLB.0323.00019,1,619636,622963,+,3327
225,WOLB.0323.00060,1,553663,556991,-,3328
225,WOLB.0323.00039,1,355854,359181,+,3327
225,WOLB.0323.00041,1,1314994,1318321,-,3327
225,WOLB.0323.00031,1,94794,98140,+,3346
225,WOLB.0323.00056,1,705965,709293,-,3328
225,WOLB.0323.00142,1,797819,801157,-,3338
225,WOLB.0323.00023,1,221486,224841,+,3355
225,WOLB.0323.00153,1,733763,737091,+,3328
225,WOLB.0323.00093,1,637402,640710,+,3308
225,WOLB.0323.00088,1,756491,759819,-,3328
225,WOLB.0323.00008,1,362401,365709,+,3308
225,WOLB.0323.00024,1,1692003,1695331,+,3328
225,WOLB.0323.00064,1,1460836,1464154,-,3318
225,WOLB.0323.00030,1,990162,993480,+,3318
225,WOLB.0323.00105,1,751993,755302,+,3309
225,WOLB.0323.00133,1,129983,133310,-,3327
225,WOLB.0323.00084,1,1350421,1353749,+,3328
225,WOLB.0323.00021,1,941380,944708,-,3328
225,WOLB.0323.00043,1,818917,822272,-,3355
225,WOLB.0323.00020,1,697387,700715,-,3328
225,WOLB.0323.00122,1,597123,600451,-,3328
225,WOLB.0323.00118,1,583796,587124,-,3328
225,WOLB.0323.00004,1,797820,801158,-,3338
225,WOLB.0323.00011,1,166879,170217,-,3338
225,WOLB.0323.00035,1,694393,697721,-,3328
225,WOLB.0323.00032,1,223204,226532,-,3328
225,WOLB.0323.00012,1,760593,763921,-,3328
225,WOLB.0323.00018,1,809401,812718,+,3317
225,WOLB.0323.00025,1,387270,390616,-,3346
225,WOLB.0323.00010,1,833332,836696,+,3364
225,WOLB.0323.00068,1,618479,621807,-,3328
225,WOLB.0323.00128,1,841093,844410,+,3317
225,WOLB.0323.00158,1,70670,74008,-,3338
225,WOLB.0323.00017,1,786527,789865,-,3338
225,WOLB.0323.00104,1,730048,733376,-,3328
225,WOLB.0323.00007,1,634346,637674,+,3328
225,WOLB.0323.00001,1,751993,755302,+,3309
225,WOLB.0323.00100,1,1079041,1082369,-,3328
225,WOLB.0323.00070,1,942151,945506,+,3355
225,WOLB.0323.00006,1,106407,109753,-,3346
225,WOLB.0323.00042,1,624095,627423,+,3328
225,WOLB.0323.00119,1,555621,558948,-,3327
225,WOLB.0323.00149,1,1041401,1044739,+,3338
225,WOLB.0323.00014,1,771454,774818,-,3364
224,WOLB.0323.00090,1,661153,661758,+,605
224,WOLB.0323.00138,1,1213597,1214202,+,605
224,WOLB.0323.00121,1,919825,920430,+,605
224,WOLB.0323.00135,1,1229053,1229659,-,606
224,WOLB.0323.00019,1,627071,627678,-,607
224,WOLB.0323.00060,1,549302,549907,+,605
224,WOLB.0323.00039,1,1314517,1315062,-,545
224,WOLB.0323.00056,1,701604,702209,+,605
224,WOLB.0323.00142,1,793474,794079,+,605
224,WOLB.0323.00153,1,729777,730382,+,605
224,WOLB.0323.00088,1,752146,752751,+,605
224,WOLB.0323.00133,1,60680,61285,+,605
224,WOLB.0323.00084,1,1357497,1358103,-,606
224,WOLB.0323.00021,1,935928,936533,+,605
224,WOLB.0323.00020,1,693042,693647,+,605
224,WOLB.0323.00122,1,592778,593383,+,605
224,WOLB.0323.00118,1,576496,577101,+,605
224,WOLB.0323.00004,1,793475,794080,+,605
224,WOLB.0323.00011,1,162534,163139,+,605
224,WOLB.0323.00035,1,690048,690653,+,605
224,WOLB.0323.00032,1,217752,218357,+,605
224,WOLB.0323.00012,1,756248,756853,+,605
224,WOLB.0323.00068,1,613027,613632,+,605
224,WOLB.0323.00158,1,66325,66930,+,605
224,WOLB.0323.00017,1,782182,782787,+,605
224,WOLB.0323.00104,1,725703,726308,+,605
224,WOLB.0323.00007,1,641429,642035,-,606
224,WOLB.0323.00100,1,1074696,1075301,+,605
224,WOLB.0323.00119,1,550906,551513,+,607
224,WOLB.0323.00149,1,1048478,1049084,-,606
223,WOLB.0323.00090,1,659657,660508,+,851
223,WOLB.0323.00002,1,982701,983560,-,859
223,WOLB.0323.00138,1,1212101,1212952,+,851
223,WOLB.0323.00132,1,573124,573983,-,859
223,WOLB.0323.00143,1,724686,725532,-,846
223,WOLB.0323.00106,1,724687,725533,-,846
223,WOLB.0323.00121,1,916820,917692,+,872
223,WOLB.0323.00135,1,1230303,1231155,-,852
223,WOLB.0323.00103,1,762828,763689,-,861
223,WOLB.0323.00107,1,761412,762273,-,861
223,WOLB.0323.00019,1,631636,632488,-,852
223,WOLB.0323.00060,1,546297,547169,+,872
223,WOLB.0323.00074,1,32428,33279,-,851
223,WOLB.0323.00120,1,32423,33274,-,851
223,WOLB.0323.00039,1,1316702,1317554,-,852
223,WOLB.0323.00041,1,32423,33274,-,851
223,WOLB.0323.00031,1,61772,62618,+,846
223,WOLB.0323.00056,1,698599,699471,+,872
223,WOLB.0323.00142,1,791978,792829,+,851
223,WOLB.0323.00023,1,1404418,1405277,+,859
223,WOLB.0323.00153,1,728281,729132,+,851
223,WOLB.0323.00093,1,1442110,1442961,-,851
223,WOLB.0323.00088,1,750650,751501,+,851
223,WOLB.0323.00008,1,635330,636181,-,851
223,WOLB.0323.00024,1,1521146,1522005,+,859
223,WOLB.0323.00064,1,591705,592564,+,859
223,WOLB.0323.00030,1,711283,712142,+,859
223,WOLB.0323.00105,1,762839,763700,-,861
223,WOLB.0323.00133,1,59185,60036,+,851
223,WOLB.0323.00084,1,1358747,1359599,-,852
223,WOLB.0323.00021,1,932780,933631,+,851
223,WOLB.0323.00043,1,449055,449914,+,859
223,WOLB.0323.00020,1,691546,692397,+,851
223,WOLB.0323.00122,1,589773,590645,+,872
223,WOLB.0323.00118,1,575000,575851,+,851
223,WOLB.0323.00004,1,791979,792830,+,851
223,WOLB.0323.00011,1,161038,161889,+,851
223,WOLB.0323.00035,1,688552,689403,+,851
223,WOLB.0323.00032,1,214747,215619,+,872
223,WOLB.0323.00012,1,754752,755603,+,851
223,WOLB.0323.00018,1,572816,573675,+,859
223,WOLB.0323.00025,1,229403,230249,+,846
223,WOLB.0323.00010,1,963970,964829,-,859
223,WOLB.0323.00068,1,611531,612382,+,851
223,WOLB.0323.00128,1,463904,464763,+,859
223,WOLB.0323.00158,1,64829,65680,+,851
223,WOLB.0323.00017,1,780686,781537,+,851
223,WOLB.0323.00104,1,724207,725058,+,851
223,WOLB.0323.00007,1,644168,645040,-,872
223,WOLB.0323.00007,1,896618,897490,+,872
223,WOLB.0323.00001,1,762839,763700,-,861
223,WOLB.0323.00100,1,1073200,1074051,+,851
223,WOLB.0323.00070,1,1387470,1388329,-,859
223,WOLB.0323.00006,1,58565,59411,+,846
223,WOLB.0323.00042,1,1665412,1666271,+,859
223,WOLB.0323.00119,1,546096,546947,+,851
223,WOLB.0323.00149,1,1051217,1052089,-,872
223,WOLB.0323.00014,1,1399445,1400304,-,859
223,WOLB.0323.00096,1,39112,39963,-,851
222,WOLB.0323.00090,1,656884,657967,+,1083
222,WOLB.0323.00002,1,985249,986333,-,1084
222,WOLB.0323.00138,1,1209328,1210411,+,1083
222,WOLB.0323.00132,1,577560,578644,-,1084
222,WOLB.0323.00143,1,727676,728760,-,1084
222,WOLB.0323.00106,1,727677,728761,-,1084
222,WOLB.0323.00121,1,914047,915130,+,1083
222,WOLB.0323.00135,1,1232845,1233929,-,1084
222,WOLB.0323.00103,1,766360,767444,-,1084
222,WOLB.0323.00107,1,764944,766028,-,1084
222,WOLB.0323.00019,1,532598,533681,+,1083
222,WOLB.0323.00060,1,543523,544607,+,1084
222,WOLB.0323.00074,1,391317,392401,-,1084
222,WOLB.0323.00120,1,369646,370730,-,1084
222,WOLB.0323.00039,1,191769,192852,+,1083
222,WOLB.0323.00041,1,1514229,1515313,+,1084
222,WOLB.0323.00031,1,58544,59628,+,1084
222,WOLB.0323.00056,1,695825,696909,+,1084
222,WOLB.0323.00142,1,789205,790288,+,1083
222,WOLB.0323.00023,1,1401644,1402728,+,1084
222,WOLB.0323.00153,1,725508,726591,+,1083
222,WOLB.0323.00093,1,748577,749661,-,1084
222,WOLB.0323.00088,1,747876,748960,+,1084
222,WOLB.0323.00008,1,600634,601678,-,1044
222,WOLB.0323.00024,1,1127311,1128394,+,1083
222,WOLB.0323.00064,1,588931,590015,+,1084
222,WOLB.0323.00030,1,708509,709593,+,1084
222,WOLB.0323.00105,1,766371,767455,-,1084
222,WOLB.0323.00133,1,56420,57504,+,1084
222,WOLB.0323.00084,1,1361289,1362372,-,1083
222,WOLB.0323.00021,1,930007,931090,+,1083
222,WOLB.0323.00043,1,446282,447366,+,1084
222,WOLB.0323.00020,1,688772,689856,+,1084
222,WOLB.0323.00122,1,587000,588083,+,1083
222,WOLB.0323.00118,1,572226,573310,+,1084
222,WOLB.0323.00004,1,789206,790289,+,1083
222,WOLB.0323.00011,1,158265,159348,+,1083
222,WOLB.0323.00035,1,685778,686862,+,1084
222,WOLB.0323.00032,1,211974,213057,+,1083
222,WOLB.0323.00012,1,751977,753061,+,1084
222,WOLB.0323.00018,1,569123,570207,+,1084
222,WOLB.0323.00025,1,226412,227496,+,1084
222,WOLB.0323.00010,1,966515,967599,-,1084
222,WOLB.0323.00068,1,608758,609841,+,1083
222,WOLB.0323.00128,1,461131,462215,+,1084
222,WOLB.0323.00158,1,62056,63139,+,1083
222,WOLB.0323.00017,1,777913,778996,+,1083
222,WOLB.0323.00104,1,721433,722517,+,1084
222,WOLB.0323.00007,1,646730,647814,-,1084
222,WOLB.0323.00007,1,893844,894928,+,1084
222,WOLB.0323.00001,1,766371,767455,-,1084
222,WOLB.0323.00100,1,1070426,1071510,+,1084
222,WOLB.0323.00070,1,1390018,1391102,-,1084
222,WOLB.0323.00006,1,55338,56422,+,1084
222,WOLB.0323.00042,1,1662638,1663722,+,1084
222,WOLB.0323.00119,1,646342,647425,-,1083
222,WOLB.0323.00149,1,1053779,1054862,-,1083
222,WOLB.0323.00014,1,1401993,1403077,-,1084
222,WOLB.0323.00096,1,1283260,1284344,+,1084
221,WOLB.0323.00090,1,655665,656336,+,671
221,WOLB.0323.00138,1,1208136,1208779,+,643
221,WOLB.0323.00132,1,579175,579846,-,671
221,WOLB.0323.00121,1,912828,913499,+,671
221,WOLB.0323.00135,1,936658,937328,-,670
221,WOLB.0323.00103,1,767976,768646,-,670
221,WOLB.0323.00107,1,766560,767230,-,670
221,WOLB.0323.00019,1,669164,669835,+,671
221,WOLB.0323.00060,1,540814,541485,+,671
221,WOLB.0323.00074,1,392933,393604,-,671
221,WOLB.0323.00120,1,371262,371933,-,671
221,WOLB.0323.00039,1,190549,191220,+,671
221,WOLB.0323.00041,1,1513026,1513697,+,671
221,WOLB.0323.00056,1,694625,695296,+,671
221,WOLB.0323.00142,1,787986,788657,+,671
221,WOLB.0323.00023,1,1400461,1401115,+,654
221,WOLB.0323.00153,1,724288,724959,+,671
221,WOLB.0323.00088,1,746676,747347,+,671
221,WOLB.0323.00024,1,1124973,1125642,+,669
221,WOLB.0323.00064,1,587731,588391,+,660
221,WOLB.0323.00030,1,707316,707987,+,671
221,WOLB.0323.00105,1,767987,768657,-,670
221,WOLB.0323.00084,1,1362921,1363438,-,517
221,WOLB.0323.00021,1,928815,929458,+,643
221,WOLB.0323.00020,1,687572,688243,+,671
221,WOLB.0323.00122,1,585780,586451,+,671
221,WOLB.0323.00118,1,571024,571695,+,671
221,WOLB.0323.00004,1,787987,788658,+,671
221,WOLB.0323.00011,1,157046,157717,+,671
221,WOLB.0323.00035,1,684578,685249,+,671
221,WOLB.0323.00032,1,210782,211425,+,643
221,WOLB.0323.00012,1,750778,751449,+,671
221,WOLB.0323.00018,1,567923,568594,+,671
221,WOLB.0323.00068,1,607566,608209,+,643
221,WOLB.0323.00158,1,60837,61508,+,671
221,WOLB.0323.00017,1,776694,777365,+,671
221,WOLB.0323.00104,1,720233,720904,+,671
221,WOLB.0323.00007,1,649852,650523,-,671
221,WOLB.0323.00001,1,767987,768657,-,670
221,WOLB.0323.00100,1,1069226,1069897,+,671
221,WOLB.0323.00042,1,1661439,1662109,+,670
221,WOLB.0323.00119,1,508749,509420,-,671
221,WOLB.0323.00149,1,1055410,1056081,-,671
221,WOLB.0323.00096,1,1282057,1282728,+,671
220,WOLB.0323.00090,1,654301,655372,+,1071
220,WOLB.0323.00002,1,987813,988883,-,1070
220,WOLB.0323.00138,1,1206744,1207815,+,1071
220,WOLB.0323.00132,1,580139,581207,-,1068
220,WOLB.0323.00143,1,730330,731399,-,1069
220,WOLB.0323.00106,1,730331,731400,-,1069
220,WOLB.0323.00121,1,911464,912535,+,1071
220,WOLB.0323.00135,1,937621,938692,-,1071
220,WOLB.0323.00103,1,768934,770002,-,1068
220,WOLB.0323.00107,1,767518,768586,-,1068
220,WOLB.0323.00019,1,667800,668871,+,1071
220,WOLB.0323.00060,1,539453,540521,+,1068
220,WOLB.0323.00074,1,393903,394969,-,1066
220,WOLB.0323.00120,1,372232,373298,-,1066
220,WOLB.0323.00039,1,189186,190257,+,1071
220,WOLB.0323.00041,1,1511661,1512727,+,1066
220,WOLB.0323.00031,1,55905,56974,+,1069
220,WOLB.0323.00056,1,693264,694332,+,1068
220,WOLB.0323.00142,1,786622,787693,+,1071
220,WOLB.0323.00023,1,1399098,1400168,+,1070
220,WOLB.0323.00153,1,722924,723995,+,1071
220,WOLB.0323.00093,1,751145,752216,-,1071
220,WOLB.0323.00088,1,745312,746383,+,1071
220,WOLB.0323.00008,1,603160,604230,-,1070
220,WOLB.0323.00024,1,1123609,1124680,+,1071
220,WOLB.0323.00064,1,586367,587438,+,1071
220,WOLB.0323.00030,1,705952,707023,+,1071
220,WOLB.0323.00105,1,768945,770013,-,1068
220,WOLB.0323.00133,1,53847,54917,+,1070
220,WOLB.0323.00084,1,1363759,1364830,-,1071
220,WOLB.0323.00021,1,927423,928494,+,1071
220,WOLB.0323.00043,1,443728,444798,+,1070
220,WOLB.0323.00020,1,686208,687279,+,1071
220,WOLB.0323.00122,1,584416,585487,+,1071
220,WOLB.0323.00118,1,569654,570722,+,1068
220,WOLB.0323.00004,1,786623,787694,+,1071
220,WOLB.0323.00011,1,155682,156753,+,1071
220,WOLB.0323.00035,1,683214,684285,+,1071
220,WOLB.0323.00032,1,209390,210461,+,1071
220,WOLB.0323.00012,1,749414,750485,+,1071
220,WOLB.0323.00018,1,566559,567630,+,1071
220,WOLB.0323.00025,1,223791,224860,+,1069
220,WOLB.0323.00010,1,969083,970153,-,1070
220,WOLB.0323.00068,1,606174,607245,+,1071
220,WOLB.0323.00128,1,458577,459647,+,1070
220,WOLB.0323.00158,1,59473,60544,+,1071
220,WOLB.0323.00017,1,775330,776401,+,1071
220,WOLB.0323.00104,1,718869,719940,+,1071
220,WOLB.0323.00007,1,650816,651884,-,1068
220,WOLB.0323.00001,1,768945,770013,-,1068
220,WOLB.0323.00100,1,1067862,1068933,+,1071
220,WOLB.0323.00070,1,1392586,1393656,-,1070
220,WOLB.0323.00006,1,52699,53768,+,1069
220,WOLB.0323.00042,1,1660065,1661130,+,1065
220,WOLB.0323.00119,1,509713,510784,-,1071
220,WOLB.0323.00149,1,1056374,1057445,-,1071
220,WOLB.0323.00014,1,1404561,1405632,-,1071
220,WOLB.0323.00096,1,1280692,1281758,+,1066
219,WOLB.0323.00090,1,653240,654043,+,803
219,WOLB.0323.00138,1,1205697,1206516,+,819
219,WOLB.0323.00143,1,731646,732449,-,803
219,WOLB.0323.00106,1,731647,732450,-,803
219,WOLB.0323.00121,1,910417,911236,+,819
219,WOLB.0323.00135,1,938920,939735,-,815
219,WOLB.0323.00060,1,538406,539225,+,819
219,WOLB.0323.00031,1,54854,55658,+,804
219,WOLB.0323.00056,1,692217,693036,+,819
219,WOLB.0323.00142,1,785575,786394,+,819
219,WOLB.0323.00153,1,721863,722666,+,803
219,WOLB.0323.00088,1,744268,745084,+,816
219,WOLB.0323.00008,1,604475,605278,-,803
219,WOLB.0323.00084,1,1365058,1365876,-,818
219,WOLB.0323.00021,1,926376,927195,+,819
219,WOLB.0323.00020,1,685164,685980,+,816
219,WOLB.0323.00118,1,568607,569426,+,819
219,WOLB.0323.00004,1,785576,786395,+,819
219,WOLB.0323.00011,1,154635,155454,+,819
219,WOLB.0323.00035,1,682170,682986,+,816
219,WOLB.0323.00032,1,208343,209162,+,819
219,WOLB.0323.00012,1,748370,749186,+,816
219,WOLB.0323.00018,1,565512,566331,+,819
219,WOLB.0323.00068,1,605127,605946,+,819
219,WOLB.0323.00158,1,58426,59245,+,819
219,WOLB.0323.00017,1,774283,775102,+,819
219,WOLB.0323.00104,1,717825,718641,+,816
219,WOLB.0323.00007,1,652112,652930,-,818
219,WOLB.0323.00100,1,1066818,1067634,+,816
219,WOLB.0323.00006,1,51648,52452,+,804
219,WOLB.0323.00042,1,1659004,1659807,+,803
219,WOLB.0323.00149,1,1057673,1058491,-,818
218,WOLB.0323.00090,1,651383,653183,+,1800
218,WOLB.0323.00002,1,990463,992271,-,1808
218,WOLB.0323.00138,1,1203840,1205640,+,1800
218,WOLB.0323.00132,1,582808,584607,-,1799
218,WOLB.0323.00143,1,732507,734278,-,1771
218,WOLB.0323.00106,1,732508,734279,-,1771
218,WOLB.0323.00121,1,908555,910360,+,1805
218,WOLB.0323.00135,1,939793,941597,-,1804
218,WOLB.0323.00103,1,771580,773344,-,1764
218,WOLB.0323.00107,1,770164,771928,-,1764
218,WOLB.0323.00019,1,664441,666246,+,1805
218,WOLB.0323.00060,1,536544,538349,+,1805
218,WOLB.0323.00074,1,396549,398340,-,1791
218,WOLB.0323.00120,1,374878,376669,-,1791
218,WOLB.0323.00039,1,185795,187600,+,1805
218,WOLB.0323.00041,1,1508289,1510081,+,1792
218,WOLB.0323.00031,1,53025,54797,+,1772
218,WOLB.0323.00056,1,690355,692160,+,1805
218,WOLB.0323.00142,1,783713,785518,+,1805
218,WOLB.0323.00023,1,328681,330480,-,1799
218,WOLB.0323.00153,1,720006,721806,+,1800
218,WOLB.0323.00093,1,756257,758065,-,1808
218,WOLB.0323.00088,1,742406,744211,+,1805
218,WOLB.0323.00008,1,605336,607142,-,1806
218,WOLB.0323.00024,1,1119095,1120903,+,1808
218,WOLB.0323.00064,1,582966,584766,+,1800
218,WOLB.0323.00030,1,702551,704351,+,1800
218,WOLB.0323.00105,1,771591,773355,-,1764
218,WOLB.0323.00133,1,50485,52263,+,1778
218,WOLB.0323.00084,1,1365934,1367733,-,1799
218,WOLB.0323.00021,1,924519,926319,+,1800
218,WOLB.0323.00043,1,440340,442148,+,1808
218,WOLB.0323.00020,1,683302,685107,+,1805
218,WOLB.0323.00122,1,579928,581733,+,1805
218,WOLB.0323.00118,1,566745,568550,+,1805
218,WOLB.0323.00004,1,783714,785519,+,1805
218,WOLB.0323.00011,1,152773,154578,+,1805
218,WOLB.0323.00035,1,680308,682113,+,1805
218,WOLB.0323.00032,1,206486,208286,+,1800
218,WOLB.0323.00012,1,746508,748313,+,1805
218,WOLB.0323.00018,1,563642,565455,+,1813
218,WOLB.0323.00025,1,220393,222201,+,1808
218,WOLB.0323.00010,1,971732,973540,-,1808
218,WOLB.0323.00068,1,603270,605070,+,1800
218,WOLB.0323.00128,1,455189,456997,+,1808
218,WOLB.0323.00158,1,56564,58369,+,1805
218,WOLB.0323.00017,1,772421,774226,+,1805
218,WOLB.0323.00104,1,715963,717768,+,1805
218,WOLB.0323.00007,1,652988,654792,-,1804
218,WOLB.0323.00001,1,771591,773355,-,1764
218,WOLB.0323.00100,1,1064956,1066761,+,1805
218,WOLB.0323.00070,1,1395236,1397044,-,1808
218,WOLB.0323.00006,1,49819,51591,+,1772
218,WOLB.0323.00042,1,1657147,1658947,+,1800
218,WOLB.0323.00119,1,512338,514142,-,1804
218,WOLB.0323.00149,1,1058549,1060353,-,1804
218,WOLB.0323.00014,1,1407212,1409020,-,1808
218,WOLB.0323.00096,1,1277320,1279112,+,1792
217,WOLB.0323.00090,1,648122,650135,+,2013
217,WOLB.0323.00002,1,993510,995523,-,2013
217,WOLB.0323.00138,1,1200579,1202592,+,2013
217,WOLB.0323.00132,1,585855,587868,-,2013
217,WOLB.0323.00143,1,737950,739963,-,2013
217,WOLB.0323.00106,1,737951,739964,-,2013
217,WOLB.0323.00121,1,905294,907307,+,2013
217,WOLB.0323.00135,1,942845,944858,-,2013
217,WOLB.0323.00103,1,774576,776589,-,2013
217,WOLB.0323.00107,1,773160,775173,-,2013
217,WOLB.0323.00019,1,661183,663200,+,2017
217,WOLB.0323.00060,1,533283,535296,+,2013
217,WOLB.0323.00074,1,400793,402806,-,2013
217,WOLB.0323.00120,1,379122,381135,-,2013
217,WOLB.0323.00039,1,182541,184554,+,2013
217,WOLB.0323.00041,1,1503823,1505836,+,2013
217,WOLB.0323.00031,1,47340,49353,+,2013
217,WOLB.0323.00056,1,687094,689107,+,2013
217,WOLB.0323.00142,1,780452,782465,+,2013
217,WOLB.0323.00023,1,331728,333741,-,2013
217,WOLB.0323.00153,1,716745,718758,+,2013
217,WOLB.0323.00093,1,759304,761317,-,2013
217,WOLB.0323.00088,1,739145,741158,+,2013
217,WOLB.0323.00008,1,608374,610387,-,2013
217,WOLB.0323.00024,1,1113576,1115589,+,2013
217,WOLB.0323.00064,1,579705,581718,+,2013
217,WOLB.0323.00030,1,699290,701303,+,2013
217,WOLB.0323.00105,1,774587,776600,-,2013
217,WOLB.0323.00133,1,47960,49983,+,2023
217,WOLB.0323.00084,1,1368981,1370994,-,2013
217,WOLB.0323.00021,1,921258,923271,+,2013
217,WOLB.0323.00043,1,437087,439100,+,2013
217,WOLB.0323.00020,1,680041,682054,+,2013
217,WOLB.0323.00122,1,576667,578680,+,2013
217,WOLB.0323.00118,1,563484,565497,+,2013
217,WOLB.0323.00004,1,780453,782466,+,2013
217,WOLB.0323.00011,1,149512,151525,+,2013
217,WOLB.0323.00035,1,676279,678292,+,2013
217,WOLB.0323.00032,1,203225,205238,+,2013
217,WOLB.0323.00012,1,743247,745260,+,2013
217,WOLB.0323.00018,1,560390,562402,+,2012
217,WOLB.0323.00025,1,217900,219913,+,2013
217,WOLB.0323.00010,1,974779,976791,-,2012
217,WOLB.0323.00068,1,600009,602022,+,2013
217,WOLB.0323.00128,1,451936,453949,+,2013
217,WOLB.0323.00158,1,53303,55316,+,2013
217,WOLB.0323.00017,1,769160,771173,+,2013
217,WOLB.0323.00104,1,712702,714715,+,2013
217,WOLB.0323.00007,1,656040,658053,-,2013
217,WOLB.0323.00001,1,774587,776600,-,2013
217,WOLB.0323.00100,1,1061695,1063708,+,2013
217,WOLB.0323.00070,1,1398283,1400296,-,2013
217,WOLB.0323.00006,1,47326,49339,+,2013
217,WOLB.0323.00042,1,1653892,1655905,+,2013
217,WOLB.0323.00119,1,515383,517401,-,2018
217,WOLB.0323.00149,1,1061601,1063614,-,2013
217,WOLB.0323.00014,1,1410259,1412272,-,2013
217,WOLB.0323.00096,1,1272854,1274867,+,2013
216,WOLB.0323.00090,1,646907,648121,+,1214
216,WOLB.0323.00002,1,995525,996739,-,1214
216,WOLB.0323.00138,1,1199364,1200578,+,1214
216,WOLB.0323.00132,1,587870,589084,-,1214
216,WOLB.0323.00143,1,739965,741179,-,1214
216,WOLB.0323.00106,1,739966,741180,-,1214
216,WOLB.0323.00121,1,904079,905293,+,1214
216,WOLB.0323.00135,1,944860,946074,-,1214
216,WOLB.0323.00103,1,776591,777805,-,1214
216,WOLB.0323.00107,1,775175,776389,-,1214
216,WOLB.0323.00019,1,659972,661181,+,1209
216,WOLB.0323.00060,1,532068,533282,+,1214
216,WOLB.0323.00074,1,402808,404011,-,1203
216,WOLB.0323.00120,1,381137,382340,-,1203
216,WOLB.0323.00120,1,382465,383668,-,1203
216,WOLB.0323.00039,1,181326,182540,+,1214
216,WOLB.0323.00041,1,1502619,1503822,+,1203
216,WOLB.0323.00031,1,46125,47339,+,1214
216,WOLB.0323.00056,1,685879,687093,+,1214
216,WOLB.0323.00142,1,779237,780451,+,1214
216,WOLB.0323.00023,1,333743,334949,-,1206
216,WOLB.0323.00153,1,715530,716744,+,1214
216,WOLB.0323.00093,1,761319,762533,-,1214
216,WOLB.0323.00088,1,737930,739144,+,1214
216,WOLB.0323.00008,1,610389,611603,-,1214
216,WOLB.0323.00024,1,1112361,1113575,+,1214
216,WOLB.0323.00064,1,578490,579704,+,1214
216,WOLB.0323.00030,1,698075,699289,+,1214
216,WOLB.0323.00105,1,776602,777816,-,1214
216,WOLB.0323.00133,1,46755,47958,+,1203
216,WOLB.0323.00084,1,1370996,1372210,-,1214
216,WOLB.0323.00021,1,920043,921257,+,1214
216,WOLB.0323.00043,1,435872,437086,+,1214
216,WOLB.0323.00020,1,678826,680040,+,1214
216,WOLB.0323.00122,1,575452,576666,+,1214
216,WOLB.0323.00118,1,562269,563483,+,1214
216,WOLB.0323.00004,1,779238,780452,+,1214
216,WOLB.0323.00011,1,148297,149511,+,1214
216,WOLB.0323.00035,1,675064,676278,+,1214
216,WOLB.0323.00032,1,202010,203224,+,1214
216,WOLB.0323.00012,1,742032,743246,+,1214
216,WOLB.0323.00018,1,559175,560389,+,1214
216,WOLB.0323.00025,1,216685,217899,+,1214
216,WOLB.0323.00010,1,976793,978003,-,1210
216,WOLB.0323.00068,1,598794,600008,+,1214
216,WOLB.0323.00128,1,450721,451935,+,1214
216,WOLB.0323.00158,1,52088,53302,+,1214
216,WOLB.0323.00017,1,767945,769159,+,1214
216,WOLB.0323.00104,1,711487,712701,+,1214
216,WOLB.0323.00007,1,658055,659269,-,1214
216,WOLB.0323.00001,1,776602,777816,-,1214
216,WOLB.0323.00100,1,1060480,1061694,+,1214
216,WOLB.0323.00070,1,1400298,1401512,-,1214
216,WOLB.0323.00006,1,46111,47325,+,1214
216,WOLB.0323.00042,1,1652677,1653891,+,1214
216,WOLB.0323.00119,1,517403,518612,-,1209
216,WOLB.0323.00149,1,1063616,1064830,-,1214
216,WOLB.0323.00014,1,1412274,1413488,-,1214
216,WOLB.0323.00096,1,1271650,1272853,+,1203
215,WOLB.0323.00090,1,640878,646760,+,5882
215,WOLB.0323.00002,1,996886,1002787,-,5901
215,WOLB.0323.00138,1,1193335,1199217,+,5882
215,WOLB.0323.00132,1,589231,595132,-,5901
215,WOLB.0323.00143,1,741326,747218,-,5892
215,WOLB.0323.00106,1,741327,747219,-,5892
215,WOLB.0323.00121,1,898050,903932,+,5882
215,WOLB.0323.00135,1,946221,952102,-,5881
215,WOLB.0323.00103,1,777952,783847,-,5895
215,WOLB.0323.00107,1,776536,782431,-,5895
215,WOLB.0323.00019,1,653930,659825,+,5895
215,WOLB.0323.00060,1,526045,531921,+,5876
215,WOLB.0323.00074,1,404175,410027,-,5852
215,WOLB.0323.00120,1,383832,389684,-,5852
215,WOLB.0323.00039,1,175284,181179,+,5895
215,WOLB.0323.00041,1,1496603,1502455,+,5852
215,WOLB.0323.00031,1,40086,45978,+,5892
215,WOLB.0323.00056,1,679850,685732,+,5882
215,WOLB.0323.00142,1,773208,779090,+,5882
215,WOLB.0323.00023,1,335104,341005,-,5901
215,WOLB.0323.00153,1,709501,715383,+,5882
215,WOLB.0323.00093,1,762680,768581,-,5901
215,WOLB.0323.00088,1,731901,737783,+,5882
215,WOLB.0323.00008,1,611750,617651,-,5901
215,WOLB.0323.00024,1,1106313,1112214,+,5901
215,WOLB.0323.00064,1,572442,578343,+,5901
215,WOLB.0323.00030,1,692027,697928,+,5901
215,WOLB.0323.00105,1,777963,783858,-,5895
215,WOLB.0323.00133,1,40762,46608,+,5846
215,WOLB.0323.00084,1,1372357,1378239,-,5882
215,WOLB.0323.00021,1,914014,919896,+,5882
215,WOLB.0323.00043,1,429824,435725,+,5901
215,WOLB.0323.00020,1,672797,678679,+,5882
215,WOLB.0323.00122,1,569423,575305,+,5882
215,WOLB.0323.00118,1,556240,562122,+,5882
215,WOLB.0323.00004,1,773209,779091,+,5882
215,WOLB.0323.00011,1,142268,148150,+,5882
215,WOLB.0323.00035,1,669035,674917,+,5882
215,WOLB.0323.00032,1,195981,201863,+,5882
215,WOLB.0323.00012,1,736003,741885,+,5882
215,WOLB.0323.00018,1,553127,559028,+,5901
215,WOLB.0323.00025,1,210670,216538,+,5868
215,WOLB.0323.00010,1,978154,984055,-,5901
215,WOLB.0323.00068,1,592765,598647,+,5882
215,WOLB.0323.00128,1,444673,450574,+,5901
215,WOLB.0323.00158,1,46059,51941,+,5882
215,WOLB.0323.00017,1,761916,767798,+,5882
215,WOLB.0323.00104,1,705458,711340,+,5882
215,WOLB.0323.00007,1,659416,665298,-,5882
215,WOLB.0323.00001,1,777963,783858,-,5895
215,WOLB.0323.00100,1,1054451,1060333,+,5882
215,WOLB.0323.00070,1,1401659,1407560,-,5901
215,WOLB.0323.00006,1,40072,45964,+,5892
215,WOLB.0323.00042,1,1646654,1652530,+,5876
215,WOLB.0323.00119,1,518759,524654,-,5895
215,WOLB.0323.00149,1,1064977,1070859,-,5882
215,WOLB.0323.00014,1,1413635,1419513,-,5878
215,WOLB.0323.00096,1,1265634,1271486,+,5852
214,WOLB.0323.00090,1,639298,640866,+,1568
214,WOLB.0323.00002,1,1002788,1004351,-,1563
214,WOLB.0323.00138,1,1191755,1193323,+,1568
214,WOLB.0323.00132,1,595133,596696,-,1563
214,WOLB.0323.00143,1,747220,748788,-,1568
214,WOLB.0323.00106,1,747221,748789,-,1568
214,WOLB.0323.00121,1,896470,898038,+,1568
214,WOLB.0323.00135,1,952114,953682,-,1568
214,WOLB.0323.00103,1,783849,785417,-,1568
214,WOLB.0323.00107,1,782433,784001,-,1568
214,WOLB.0323.00019,1,652360,653928,+,1568
214,WOLB.0323.00060,1,524465,526033,+,1568
214,WOLB.0323.00074,1,410029,411597,-,1568
214,WOLB.0323.00120,1,389686,391254,-,1568
214,WOLB.0323.00039,1,173714,175282,+,1568
214,WOLB.0323.00041,1,1495033,1496601,+,1568
214,WOLB.0323.00031,1,38516,40084,+,1568
214,WOLB.0323.00056,1,678270,679838,+,1568
214,WOLB.0323.00142,1,771628,773196,+,1568
214,WOLB.0323.00023,1,341006,342569,-,1563
214,WOLB.0323.00153,1,707921,709489,+,1568
214,WOLB.0323.00093,1,768582,770145,-,1563
214,WOLB.0323.00088,1,730321,731889,+,1568
214,WOLB.0323.00008,1,617652,619215,-,1563
214,WOLB.0323.00024,1,1104749,1106311,+,1562
214,WOLB.0323.00064,1,570878,572440,+,1562
214,WOLB.0323.00030,1,690463,692025,+,1562
214,WOLB.0323.00105,1,783860,785428,-,1568
214,WOLB.0323.00133,1,39192,40760,+,1568
214,WOLB.0323.00084,1,1378251,1379819,-,1568
214,WOLB.0323.00021,1,912434,914002,+,1568
214,WOLB.0323.00043,1,428260,429822,+,1562
214,WOLB.0323.00020,1,671217,672785,+,1568
214,WOLB.0323.00122,1,567843,569411,+,1568
214,WOLB.0323.00118,1,554660,556228,+,1568
214,WOLB.0323.00004,1,771629,773197,+,1568
214,WOLB.0323.00011,1,140688,142256,+,1568
214,WOLB.0323.00035,1,667455,669023,+,1568
214,WOLB.0323.00032,1,194401,195969,+,1568
214,WOLB.0323.00012,1,734423,735991,+,1568
214,WOLB.0323.00018,1,551563,553125,+,1562
214,WOLB.0323.00025,1,209101,210668,+,1567
214,WOLB.0323.00010,1,984056,985619,-,1563
214,WOLB.0323.00068,1,591185,592753,+,1568
214,WOLB.0323.00128,1,443109,444671,+,1562
214,WOLB.0323.00158,1,44479,46047,+,1568
214,WOLB.0323.00017,1,760336,761904,+,1568
214,WOLB.0323.00104,1,703878,705446,+,1568
214,WOLB.0323.00007,1,665310,666878,-,1568
214,WOLB.0323.00001,1,783860,785428,-,1568
214,WOLB.0323.00100,1,1052871,1054439,+,1568
214,WOLB.0323.00070,1,1407561,1409124,-,1563
214,WOLB.0323.00006,1,38502,40070,+,1568
214,WOLB.0323.00042,1,1644152,1645720,+,1568
214,WOLB.0323.00119,1,524656,526224,-,1568
214,WOLB.0323.00149,1,1070871,1072439,-,1568
214,WOLB.0323.00014,1,1419514,1421077,-,1563
214,WOLB.0323.00096,1,1264064,1265632,+,1568
213,WOLB.0323.00090,1,636123,639256,+,3133
213,WOLB.0323.00002,1,1004385,1007527,-,3142
213,WOLB.0323.00138,1,1188580,1191721,+,3141
213,WOLB.0323.00132,1,596730,599872,-,3142
213,WOLB.0323.00143,1,748822,751964,-,3142
213,WOLB.0323.00106,1,748823,751965,-,3142
213,WOLB.0323.00121,1,893298,896436,+,3138
213,WOLB.0323.00135,1,953716,956858,-,3142
213,WOLB.0323.00103,1,785451,788587,-,3136
213,WOLB.0323.00107,1,784035,787171,-,3136
213,WOLB.0323.00019,1,649184,652326,+,3142
213,WOLB.0323.00060,1,521293,524431,+,3138
213,WOLB.0323.00074,1,411631,414773,-,3142
213,WOLB.0323.00120,1,391288,394430,-,3142
213,WOLB.0323.00039,1,170538,173680,+,3142
213,WOLB.0323.00041,1,1491857,1494999,+,3142
213,WOLB.0323.00031,1,35340,38482,+,3142
213,WOLB.0323.00056,1,674232,677370,+,3138
213,WOLB.0323.00142,1,768456,771594,+,3138
213,WOLB.0323.00023,1,342603,345735,-,3132
213,WOLB.0323.00153,1,704746,707879,+,3133
213,WOLB.0323.00093,1,770187,773321,-,3134
213,WOLB.0323.00088,1,727146,730287,+,3141
213,WOLB.0323.00008,1,619257,622391,-,3134
213,WOLB.0323.00024,1,1101573,1104707,+,3134
213,WOLB.0323.00064,1,567702,570844,+,3142
213,WOLB.0323.00030,1,687287,690429,+,3142
213,WOLB.0323.00105,1,785462,788598,-,3136
213,WOLB.0323.00133,1,36028,39158,+,3130
213,WOLB.0323.00084,1,1379853,1382994,-,3141
213,WOLB.0323.00021,1,909259,912400,+,3141
213,WOLB.0323.00043,1,425084,428226,+,3142
213,WOLB.0323.00020,1,668042,671183,+,3141
213,WOLB.0323.00122,1,564671,567809,+,3138
213,WOLB.0323.00118,1,551485,554626,+,3141
213,WOLB.0323.00004,1,768457,771595,+,3138
213,WOLB.0323.00011,1,137516,140654,+,3138
213,WOLB.0323.00035,1,664280,667421,+,3141
213,WOLB.0323.00032,1,191226,194367,+,3141
213,WOLB.0323.00012,1,731248,734389,+,3141
213,WOLB.0323.00018,1,548391,551529,+,3138
213,WOLB.0323.00025,1,205925,209067,+,3142
213,WOLB.0323.00010,1,985653,988795,-,3142
213,WOLB.0323.00068,1,588010,591151,+,3141
213,WOLB.0323.00128,1,439933,443075,+,3142
213,WOLB.0323.00158,1,41307,44445,+,3138
213,WOLB.0323.00017,1,757164,760302,+,3138
213,WOLB.0323.00104,1,700703,703844,+,3141
213,WOLB.0323.00007,1,667775,670913,-,3138
213,WOLB.0323.00001,1,785462,788598,-,3136
213,WOLB.0323.00100,1,1049696,1052837,+,3141
213,WOLB.0323.00070,1,1409158,1412300,-,3142
213,WOLB.0323.00006,1,35326,38468,+,3142
213,WOLB.0323.00042,1,1640986,1644118,+,3132
213,WOLB.0323.00119,1,526258,529400,-,3142
213,WOLB.0323.00149,1,1072473,1075611,-,3138
213,WOLB.0323.00014,1,1421111,1424253,-,3142
213,WOLB.0323.00096,1,1260888,1264030,+,3142
212,WOLB.0323.00090,1,635030,636013,+,983
212,WOLB.0323.00121,1,892203,893185,+,982
212,WOLB.0323.00060,1,520197,521180,+,983
212,WOLB.0323.00056,1,673136,674119,+,983
212,WOLB.0323.00142,1,767360,768343,+,983
212,WOLB.0323.00153,1,703653,704636,+,983
212,WOLB.0323.00122,1,563575,564558,+,983
212,WOLB.0323.00004,1,767361,768344,+,983
212,WOLB.0323.00011,1,136420,137403,+,983
212,WOLB.0323.00018,1,547295,548278,+,983
212,WOLB.0323.00158,1,40211,41194,+,983
212,WOLB.0323.00017,1,756068,757051,+,983
212,WOLB.0323.00007,1,671025,672009,-,984
212,WOLB.0323.00149,1,1075723,1076707,-,984
211,WOLB.0323.00090,1,633201,633924,+,723
211,WOLB.0323.00060,1,518389,519107,+,718
211,WOLB.0323.00056,1,671328,672046,+,718
211,WOLB.0323.00153,1,701824,702547,+,723
211,WOLB.0323.00118,1,547235,547958,+,723
211,WOLB.0323.00018,1,545487,546205,+,718
211,WOLB.0323.00007,1,673098,673816,-,718
210,WOLB.0323.00090,1,631398,632026,+,628
210,WOLB.0323.00142,1,86040,86671,-,631
210,WOLB.0323.00142,1,171447,172073,+,626
210,WOLB.0323.00142,1,184865,185491,+,626
210,WOLB.0323.00142,1,370363,370989,-,626
210,WOLB.0323.00142,1,428297,428926,+,629
210,WOLB.0323.00142,1,436738,437364,+,626
210,WOLB.0323.00142,1,448357,448983,+,626
210,WOLB.0323.00142,1,579970,580596,+,626
210,WOLB.0323.00142,1,637865,638491,+,626
210,WOLB.0323.00142,1,680301,680927,-,626
210,WOLB.0323.00142,1,736122,736748,+,626
210,WOLB.0323.00142,1,869545,870171,-,626
210,WOLB.0323.00142,1,950060,950688,-,628
210,WOLB.0323.00142,1,1044156,1044782,+,626
210,WOLB.0323.00142,1,1181810,1182436,+,626
210,WOLB.0323.00153,1,700020,700648,+,628
210,WOLB.0323.00064,1,329920,330507,-,587
210,WOLB.0323.00122,1,8870,9496,-,626
210,WOLB.0323.00122,1,31409,32035,+,626
210,WOLB.0323.00122,1,54756,55382,+,626
210,WOLB.0323.00122,1,118785,119411,+,626
210,WOLB.0323.00122,1,144588,145214,-,626
210,WOLB.0323.00122,1,284019,284648,-,629
210,WOLB.0323.00122,1,301414,302040,+,626
210,WOLB.0323.00122,1,305612,306238,-,626
210,WOLB.0323.00122,1,309353,309979,+,626
210,WOLB.0323.00122,1,315121,315747,-,626
210,WOLB.0323.00122,1,319166,319792,+,626
210,WOLB.0323.00122,1,389686,390312,-,626
210,WOLB.0323.00122,1,391614,392240,-,626
210,WOLB.0323.00122,1,393528,394154,+,626
210,WOLB.0323.00122,1,432852,433492,+,640
210,WOLB.0323.00122,1,443174,443800,+,626
210,WOLB.0323.00122,1,448750,449376,-,626
210,WOLB.0323.00122,1,473849,474475,-,626
210,WOLB.0323.00122,1,484754,485380,+,626
210,WOLB.0323.00122,1,583244,583870,+,626
210,WOLB.0323.00122,1,663263,663889,+,626
210,WOLB.0323.00122,1,758716,759342,-,626
210,WOLB.0323.00122,1,797205,797833,-,628
210,WOLB.0323.00122,1,862147,862773,-,626
210,WOLB.0323.00122,1,905936,906562,-,626
210,WOLB.0323.00122,1,923258,923884,+,626
210,WOLB.0323.00122,1,979166,979794,+,628
210,WOLB.0323.00122,1,983976,984602,+,626
210,WOLB.0323.00122,1,991320,991946,+,626
210,WOLB.0323.00122,1,998592,999220,-,628
210,WOLB.0323.00122,1,1025363,1025989,+,626
210,WOLB.0323.00122,1,1037423,1038049,-,626
210,WOLB.0323.00122,1,1039363,1039989,+,626
210,WOLB.0323.00122,1,1084229,1084855,-,626
210,WOLB.0323.00122,1,1089914,1090540,+,626
210,WOLB.0323.00122,1,1115920,1116546,+,626
210,WOLB.0323.00122,1,1219673,1220299,-,626
210,WOLB.0323.00122,1,1239637,1240263,-,626
210,WOLB.0323.00122,1,1251698,1252324,+,626
210,WOLB.0323.00122,1,1258376,1259002,+,626
210,WOLB.0323.00122,1,1261469,1262095,-,626
210,WOLB.0323.00122,1,1285330,1285956,-,626
210,WOLB.0323.00122,1,1289720,1290346,+,626
210,WOLB.0323.00122,1,1364246,1364872,+,626
210,WOLB.0323.00122,1,1385898,1386524,+,626
210,WOLB.0323.00122,1,1433609,1434235,-,626
210,WOLB.0323.00122,1,1453327,1453953,-,626
210,WOLB.0323.00122,1,1537896,1538522,+,626
210,WOLB.0323.00004,1,433200,433826,+,626
210,WOLB.0323.00004,1,444819,445445,+,626
210,WOLB.0323.00004,1,503715,504341,+,626
210,WOLB.0323.00004,1,700126,700752,-,626
210,WOLB.0323.00004,1,869546,870172,-,626
210,WOLB.0323.00004,1,948076,948704,-,628
210,WOLB.0323.00128,1,331992,332618,+,626
210,WOLB.0323.00128,1,779134,779762,+,628
210,WOLB.0323.00128,1,882007,882633,-,626
210,WOLB.0323.00128,1,1082572,1083198,-,626
210,WOLB.0323.00158,1,31344,31970,+,626
210,WOLB.0323.00158,1,142396,143022,-,626
210,WOLB.0323.00158,1,220925,221553,-,628
210,WOLB.0323.00158,1,249059,249685,-,626
210,WOLB.0323.00158,1,347821,348449,-,628
210,WOLB.0323.00158,1,375012,375638,-,626
210,WOLB.0323.00158,1,380347,380973,-,626
210,WOLB.0323.00158,1,448657,449283,-,626
210,WOLB.0323.00158,1,458660,459286,-,626
210,WOLB.0323.00158,1,467098,467727,-,629
210,WOLB.0323.00158,1,712841,713467,+,626
210,WOLB.0323.00158,1,1013780,1014406,-,626
210,WOLB.0323.00158,1,1148234,1148860,+,626
210,WOLB.0323.00158,1,1172368,1172994,+,626
210,WOLB.0323.00158,1,1291865,1292491,+,626
210,WOLB.0323.00158,1,1305916,1306542,-,626
210,WOLB.0323.00017,1,487720,488346,-,626
210,WOLB.0323.00017,1,509954,510580,+,626
210,WOLB.0323.00017,1,605302,605928,+,626
210,WOLB.0323.00017,1,643922,644548,+,626
210,WOLB.0323.00017,1,737807,738438,+,631
210,WOLB.0323.00017,1,810538,811166,-,628
210,WOLB.0323.00017,1,977621,978247,-,626
209,WOLB.0323.00090,1,629312,631396,+,2084
209,WOLB.0323.00002,1,1007658,1009744,-,2086
209,WOLB.0323.00138,1,1181399,1183485,+,2086
209,WOLB.0323.00132,1,600003,602089,-,2086
209,WOLB.0323.00143,1,752095,754181,-,2086
209,WOLB.0323.00106,1,752096,754182,-,2086
209,WOLB.0323.00121,1,887258,889344,+,2086
209,WOLB.0323.00135,1,960784,962870,-,2086
209,WOLB.0323.00103,1,790236,792318,-,2082
209,WOLB.0323.00107,1,788820,790902,-,2082
209,WOLB.0323.00019,1,646958,649053,+,2095
209,WOLB.0323.00060,1,515600,517686,+,2086
209,WOLB.0323.00074,1,414904,416990,-,2086
209,WOLB.0323.00120,1,394561,396647,-,2086
209,WOLB.0323.00039,1,168312,170407,+,2095
209,WOLB.0323.00041,1,1489640,1491726,+,2086
209,WOLB.0323.00031,1,33123,35209,+,2086
209,WOLB.0323.00056,1,668539,670625,+,2086
209,WOLB.0323.00142,1,762415,764501,+,2086
209,WOLB.0323.00023,1,352228,354312,-,2084
209,WOLB.0323.00153,1,697934,700018,+,2084
209,WOLB.0323.00093,1,773447,775540,-,2093
209,WOLB.0323.00088,1,721144,723230,+,2086
209,WOLB.0323.00008,1,622517,624610,-,2093
209,WOLB.0323.00024,1,1099356,1101442,+,2086
209,WOLB.0323.00064,1,565485,567571,+,2086
209,WOLB.0323.00030,1,685070,687156,+,2086
209,WOLB.0323.00105,1,790247,792329,-,2082
209,WOLB.0323.00133,1,33802,35897,+,2095
209,WOLB.0323.00084,1,1388089,1390175,-,2086
209,WOLB.0323.00021,1,902078,904164,+,2086
209,WOLB.0323.00043,1,422867,424953,+,2086
209,WOLB.0323.00020,1,662040,664126,+,2086
209,WOLB.0323.00122,1,558630,560716,+,2086
209,WOLB.0323.00118,1,543348,545434,+,2086
209,WOLB.0323.00004,1,762416,764502,+,2086
209,WOLB.0323.00011,1,131475,133561,+,2086
209,WOLB.0323.00035,1,658278,660364,+,2086
209,WOLB.0323.00032,1,184045,186131,+,2086
209,WOLB.0323.00012,1,725246,727332,+,2086
209,WOLB.0323.00018,1,542700,544784,+,2084
209,WOLB.0323.00025,1,203411,205497,+,2086
209,WOLB.0323.00010,1,988926,990980,-,2054
209,WOLB.0323.00068,1,580829,582915,+,2086
209,WOLB.0323.00128,1,437716,439802,+,2086
209,WOLB.0323.00158,1,35266,37352,+,2086
209,WOLB.0323.00017,1,751128,753214,+,2086
209,WOLB.0323.00104,1,694701,696787,+,2086
209,WOLB.0323.00007,1,674520,676606,-,2086
209,WOLB.0323.00001,1,790247,792329,-,2082
209,WOLB.0323.00100,1,1043694,1045780,+,2086
209,WOLB.0323.00070,1,1412431,1414517,-,2086
209,WOLB.0323.00006,1,33109,35195,+,2086
209,WOLB.0323.00042,1,1635035,1637121,+,2086
209,WOLB.0323.00119,1,529531,531626,-,2095
209,WOLB.0323.00149,1,1079566,1081652,-,2086
209,WOLB.0323.00014,1,1424384,1426470,-,2086
209,WOLB.0323.00096,1,1258671,1260757,+,2086
208,WOLB.0323.00090,1,627009,628912,+,1903
208,WOLB.0323.00002,1,1010143,1012055,-,1912
208,WOLB.0323.00138,1,1179096,1180999,+,1903
208,WOLB.0323.00132,1,602488,604406,-,1918
208,WOLB.0323.00143,1,754580,756492,-,1912
208,WOLB.0323.00106,1,754581,756493,-,1912
208,WOLB.0323.00121,1,884955,886858,+,1903
208,WOLB.0323.00135,1,963269,965173,-,1904
208,WOLB.0323.00103,1,792717,794629,-,1912
208,WOLB.0323.00107,1,791301,793213,-,1912
208,WOLB.0323.00019,1,644647,646558,+,1911
208,WOLB.0323.00060,1,513289,515200,+,1911
208,WOLB.0323.00074,1,417389,419301,-,1912
208,WOLB.0323.00120,1,397046,398958,-,1912
208,WOLB.0323.00120,1,405971,407881,+,1910
208,WOLB.0323.00039,1,166001,167912,+,1911
208,WOLB.0323.00041,1,1487329,1489240,+,1911
208,WOLB.0323.00031,1,30812,32723,+,1911
208,WOLB.0323.00056,1,666228,668139,+,1911
208,WOLB.0323.00142,1,760112,762015,+,1903
208,WOLB.0323.00023,1,354711,356623,-,1912
208,WOLB.0323.00153,1,695631,697534,+,1903
208,WOLB.0323.00093,1,775939,777851,-,1912
208,WOLB.0323.00088,1,718841,720744,+,1903
208,WOLB.0323.00008,1,625009,626921,-,1912
208,WOLB.0323.00024,1,1097044,1098956,+,1912
208,WOLB.0323.00064,1,563174,565085,+,1911
208,WOLB.0323.00030,1,682759,684670,+,1911
208,WOLB.0323.00105,1,792728,794640,-,1912
208,WOLB.0323.00133,1,31491,33402,+,1911
208,WOLB.0323.00084,1,1390574,1392478,-,1904
208,WOLB.0323.00021,1,899775,901678,+,1903
208,WOLB.0323.00043,1,420588,422467,+,1879
208,WOLB.0323.00020,1,659737,661640,+,1903
208,WOLB.0323.00122,1,556327,558230,+,1903
208,WOLB.0323.00118,1,541045,542948,+,1903
208,WOLB.0323.00004,1,760113,762016,+,1903
208,WOLB.0323.00011,1,129172,131075,+,1903
208,WOLB.0323.00035,1,655975,657878,+,1903
208,WOLB.0323.00032,1,181742,183645,+,1903
208,WOLB.0323.00012,1,722943,724846,+,1903
208,WOLB.0323.00018,1,540390,542300,+,1910
208,WOLB.0323.00025,1,7796,9723,-,1927
208,WOLB.0323.00010,1,991404,993316,-,1912
208,WOLB.0323.00068,1,578526,580429,+,1903
208,WOLB.0323.00128,1,435405,437316,+,1911
208,WOLB.0323.00158,1,32963,34866,+,1903
208,WOLB.0323.00017,1,748825,750728,+,1903
208,WOLB.0323.00104,1,692398,694301,+,1903
208,WOLB.0323.00007,1,677005,678917,-,1912
208,WOLB.0323.00001,1,792728,794640,-,1912
208,WOLB.0323.00100,1,1041391,1043294,+,1903
208,WOLB.0323.00070,1,1414916,1416828,-,1912
208,WOLB.0323.00006,1,30798,32709,+,1911
208,WOLB.0323.00042,1,1632732,1634635,+,1903
208,WOLB.0323.00119,1,532025,533937,-,1912
208,WOLB.0323.00149,1,1082051,1083955,-,1904
208,WOLB.0323.00014,1,1426869,1428781,-,1912
208,WOLB.0323.00096,1,1256360,1258271,+,1911
207,WOLB.0323.00090,1,624731,625493,+,762
207,WOLB.0323.00002,1,1014229,1014993,-,764
207,WOLB.0323.00138,1,1176818,1177580,+,762
207,WOLB.0323.00132,1,606572,607336,-,764
207,WOLB.0323.00143,1,758161,758921,-,760
207,WOLB.0323.00106,1,758162,758922,-,760
207,WOLB.0323.00121,1,882677,883439,+,762
207,WOLB.0323.00135,1,966689,967451,-,762
207,WOLB.0323.00103,1,796276,797040,-,764
207,WOLB.0323.00107,1,794860,795624,-,764
207,WOLB.0323.00019,1,642374,643138,+,764
207,WOLB.0323.00060,1,511011,511773,+,762
207,WOLB.0323.00074,1,420953,421715,-,762
207,WOLB.0323.00120,1,400610,401372,-,762
207,WOLB.0323.00120,1,403561,404323,+,762
207,WOLB.0323.00039,1,163728,164492,+,764
207,WOLB.0323.00041,1,1484915,1485677,+,762
207,WOLB.0323.00031,1,28383,29143,+,760
207,WOLB.0323.00056,1,663950,664712,+,762
207,WOLB.0323.00142,1,757834,758596,+,762
207,WOLB.0323.00023,1,358275,359037,-,762
207,WOLB.0323.00153,1,693353,694115,+,762
207,WOLB.0323.00093,1,781087,781849,-,762
207,WOLB.0323.00088,1,716563,717325,+,762
207,WOLB.0323.00008,1,628574,629338,-,764
207,WOLB.0323.00024,1,1092526,1093290,+,764
207,WOLB.0323.00064,1,560745,561509,+,764
207,WOLB.0323.00030,1,680330,681094,+,764
207,WOLB.0323.00105,1,796287,797051,-,764
207,WOLB.0323.00133,1,29217,29981,+,764
207,WOLB.0323.00084,1,1393994,1394756,-,762
207,WOLB.0323.00021,1,897497,898259,+,762
207,WOLB.0323.00043,1,416655,417419,+,764
207,WOLB.0323.00020,1,657459,658221,+,762
207,WOLB.0323.00122,1,554049,554811,+,762
207,WOLB.0323.00118,1,538767,539529,+,762
207,WOLB.0323.00004,1,757835,758597,+,762
207,WOLB.0323.00011,1,126894,127656,+,762
207,WOLB.0323.00035,1,653697,654459,+,762
207,WOLB.0323.00032,1,179464,180226,+,762
207,WOLB.0323.00012,1,720665,721427,+,762
207,WOLB.0323.00018,1,537451,538215,+,764
207,WOLB.0323.00025,1,188557,189317,+,760
207,WOLB.0323.00010,1,995494,996258,-,764
207,WOLB.0323.00068,1,576248,577010,+,762
207,WOLB.0323.00128,1,432467,433231,+,764
207,WOLB.0323.00158,1,29582,30344,+,762
207,WOLB.0323.00017,1,746547,747309,+,762
207,WOLB.0323.00104,1,690120,690882,+,762
207,WOLB.0323.00007,1,680433,681195,-,762
207,WOLB.0323.00001,1,796287,797051,-,764
207,WOLB.0323.00100,1,1039113,1039875,+,762
207,WOLB.0323.00070,1,1419002,1419766,-,764
207,WOLB.0323.00006,1,28369,29129,+,760
207,WOLB.0323.00042,1,1630234,1630998,+,764
207,WOLB.0323.00119,1,535446,536210,-,764
207,WOLB.0323.00149,1,1085471,1086233,-,762
207,WOLB.0323.00014,1,1430955,1431719,-,764
207,WOLB.0323.00096,1,1253946,1254708,+,762
206,WOLB.0323.00090,1,623393,623938,+,545
206,WOLB.0323.00002,1,1015776,1016322,-,546
206,WOLB.0323.00138,1,1175480,1176025,+,545
206,WOLB.0323.00132,1,608119,608665,-,546
206,WOLB.0323.00143,1,759612,760158,-,546
206,WOLB.0323.00106,1,759613,760159,-,546
206,WOLB.0323.00121,1,881339,881884,+,545
206,WOLB.0323.00135,1,968243,968789,-,546
206,WOLB.0323.00103,1,797832,798378,-,546
206,WOLB.0323.00107,1,796416,796962,-,546
206,WOLB.0323.00019,1,641036,641581,+,545
206,WOLB.0323.00060,1,509673,510218,+,545
206,WOLB.0323.00074,1,422498,423044,-,546
206,WOLB.0323.00120,1,402155,402701,-,546
206,WOLB.0323.00120,1,408669,409215,-,546
206,WOLB.0323.00039,1,162390,162935,+,545
206,WOLB.0323.00041,1,1483586,1484131,+,545
206,WOLB.0323.00031,1,27146,27691,+,545
206,WOLB.0323.00056,1,662612,663157,+,545
206,WOLB.0323.00142,1,756496,757041,+,545
206,WOLB.0323.00023,1,359820,360366,-,546
206,WOLB.0323.00153,1,692015,692560,+,545
206,WOLB.0323.00093,1,782632,783178,-,546
206,WOLB.0323.00088,1,715225,715770,+,545
206,WOLB.0323.00008,1,630130,630676,-,546
206,WOLB.0323.00024,1,1091197,1091742,+,545
206,WOLB.0323.00064,1,559416,559961,+,545
206,WOLB.0323.00030,1,679001,679546,+,545
206,WOLB.0323.00105,1,797843,798389,-,546
206,WOLB.0323.00133,1,27918,28463,+,545
206,WOLB.0323.00084,1,1395548,1396094,-,546
206,WOLB.0323.00021,1,896159,896704,+,545
206,WOLB.0323.00043,1,415326,415871,+,545
206,WOLB.0323.00020,1,656121,656666,+,545
206,WOLB.0323.00122,1,552711,553256,+,545
206,WOLB.0323.00118,1,537429,537974,+,545
206,WOLB.0323.00004,1,756497,757042,+,545
206,WOLB.0323.00011,1,125556,126101,+,545
206,WOLB.0323.00035,1,652359,652904,+,545
206,WOLB.0323.00032,1,178126,178671,+,545
206,WOLB.0323.00012,1,719327,719872,+,545
206,WOLB.0323.00018,1,536122,536667,+,545
206,WOLB.0323.00025,1,187320,187865,+,545
206,WOLB.0323.00010,1,997041,997587,-,546
206,WOLB.0323.00068,1,574910,575455,+,545
206,WOLB.0323.00128,1,431138,431683,+,545
206,WOLB.0323.00158,1,28244,28789,+,545
206,WOLB.0323.00017,1,745209,745754,+,545
206,WOLB.0323.00104,1,688782,689327,+,545
206,WOLB.0323.00007,1,681987,682533,-,546
206,WOLB.0323.00001,1,797843,798389,-,546
206,WOLB.0323.00100,1,1037775,1038320,+,545
206,WOLB.0323.00070,1,1420549,1421095,-,546
206,WOLB.0323.00006,1,27132,27677,+,545
206,WOLB.0323.00042,1,1628905,1629450,+,545
206,WOLB.0323.00119,1,537002,537548,-,546
206,WOLB.0323.00149,1,1087025,1087571,-,546
206,WOLB.0323.00014,1,1432502,1433048,-,546
206,WOLB.0323.00096,1,1252617,1253162,+,545
205,WOLB.0323.00090,1,622571,623391,+,820
205,WOLB.0323.00002,1,1016323,1017147,-,824
205,WOLB.0323.00138,1,1174658,1175478,+,820
205,WOLB.0323.00132,1,608666,609486,-,820
205,WOLB.0323.00143,1,760159,760979,-,820
205,WOLB.0323.00106,1,760160,760980,-,820
205,WOLB.0323.00121,1,880517,881337,+,820
205,WOLB.0323.00135,1,968790,969610,-,820
205,WOLB.0323.00103,1,798379,799199,-,820
205,WOLB.0323.00107,1,796963,797783,-,820
205,WOLB.0323.00019,1,640227,641034,+,807
205,WOLB.0323.00060,1,508851,509671,+,820
205,WOLB.0323.00074,1,423045,423865,-,820
205,WOLB.0323.00120,1,409216,410036,-,820
205,WOLB.0323.00039,1,161568,162388,+,820
205,WOLB.0323.00041,1,1482765,1483584,+,819
205,WOLB.0323.00031,1,26324,27144,+,820
205,WOLB.0323.00056,1,661790,662610,+,820
205,WOLB.0323.00142,1,755674,756494,+,820
205,WOLB.0323.00023,1,360367,361187,-,820
205,WOLB.0323.00153,1,691193,692013,+,820
205,WOLB.0323.00093,1,783179,783999,-,820
205,WOLB.0323.00088,1,714403,715223,+,820
205,WOLB.0323.00008,1,630677,631496,-,819
205,WOLB.0323.00024,1,1090375,1091195,+,820
205,WOLB.0323.00064,1,558594,559414,+,820
205,WOLB.0323.00030,1,678179,678999,+,820
205,WOLB.0323.00105,1,798390,799210,-,820
205,WOLB.0323.00133,1,27096,27916,+,820
205,WOLB.0323.00084,1,1396095,1396915,-,820
205,WOLB.0323.00021,1,895337,896157,+,820
205,WOLB.0323.00043,1,414504,415324,+,820
205,WOLB.0323.00020,1,655299,656119,+,820
205,WOLB.0323.00122,1,551889,552709,+,820
205,WOLB.0323.00118,1,536607,537427,+,820
205,WOLB.0323.00004,1,755675,756495,+,820
205,WOLB.0323.00011,1,124734,125554,+,820
205,WOLB.0323.00035,1,651537,652357,+,820
205,WOLB.0323.00032,1,177304,178124,+,820
205,WOLB.0323.00012,1,718505,719325,+,820
205,WOLB.0323.00018,1,535300,536120,+,820
205,WOLB.0323.00025,1,186498,187318,+,820
205,WOLB.0323.00010,1,997588,998405,-,817
205,WOLB.0323.00068,1,574088,574908,+,820
205,WOLB.0323.00128,1,430316,431136,+,820
205,WOLB.0323.00158,1,27422,28242,+,820
205,WOLB.0323.00017,1,744387,745207,+,820
205,WOLB.0323.00104,1,687960,688780,+,820
205,WOLB.0323.00007,1,682534,683354,-,820
205,WOLB.0323.00001,1,798390,799210,-,820
205,WOLB.0323.00100,1,1036953,1037773,+,820
205,WOLB.0323.00070,1,1421096,1421916,-,820
205,WOLB.0323.00006,1,26310,27130,+,820
205,WOLB.0323.00042,1,1628083,1628903,+,820
205,WOLB.0323.00119,1,537549,538357,-,808
205,WOLB.0323.00149,1,1087572,1088392,-,820
205,WOLB.0323.00014,1,1433049,1433869,-,820
205,WOLB.0323.00096,1,1251796,1252615,+,819
204,WOLB.0323.00090,1,621737,622424,+,687
204,WOLB.0323.00002,1,642977,643667,+,690
204,WOLB.0323.00138,1,1173821,1174511,+,690
204,WOLB.0323.00132,1,609634,610342,-,708
204,WOLB.0323.00143,1,761127,761817,-,690
204,WOLB.0323.00106,1,761128,761818,-,690
204,WOLB.0323.00121,1,879683,880370,+,687
204,WOLB.0323.00135,1,969758,970436,-,678
204,WOLB.0323.00103,1,799347,800034,-,687
204,WOLB.0323.00107,1,797931,798618,-,687
204,WOLB.0323.00019,1,528786,529494,+,708
204,WOLB.0323.00060,1,508017,508704,+,687
204,WOLB.0323.00074,1,425428,426136,-,708
204,WOLB.0323.00120,1,411599,412307,-,708
204,WOLB.0323.00039,1,160713,161421,+,708
204,WOLB.0323.00041,1,1480494,1481202,+,708
204,WOLB.0323.00031,1,25487,26177,+,690
204,WOLB.0323.00056,1,660956,661643,+,687
204,WOLB.0323.00142,1,754840,755527,+,687
204,WOLB.0323.00023,1,361335,362025,-,690
204,WOLB.0323.00153,1,690359,691046,+,687
204,WOLB.0323.00093,1,784147,784855,-,708
204,WOLB.0323.00088,1,713566,714256,+,690
204,WOLB.0323.00008,1,631644,632352,-,708
204,WOLB.0323.00024,1,1089520,1090228,+,708
204,WOLB.0323.00064,1,557739,558447,+,708
204,WOLB.0323.00030,1,677324,678032,+,708
204,WOLB.0323.00105,1,799357,800044,-,687
204,WOLB.0323.00133,1,26241,26949,+,708
204,WOLB.0323.00084,1,1397063,1397753,-,690
204,WOLB.0323.00021,1,894500,895190,+,690
204,WOLB.0323.00043,1,413667,414357,+,690
204,WOLB.0323.00020,1,654462,655152,+,690
204,WOLB.0323.00122,1,551055,551742,+,687
204,WOLB.0323.00118,1,535752,536460,+,708
204,WOLB.0323.00004,1,754841,755528,+,687
204,WOLB.0323.00011,1,123900,124587,+,687
204,WOLB.0323.00035,1,650700,651390,+,690
204,WOLB.0323.00032,1,176467,177157,+,690
204,WOLB.0323.00012,1,717668,718358,+,690
204,WOLB.0323.00018,1,534463,535153,+,690
204,WOLB.0323.00025,1,185664,186351,+,687
204,WOLB.0323.00010,1,998555,999242,-,687
204,WOLB.0323.00068,1,572925,573600,+,675
204,WOLB.0323.00128,1,429479,430169,+,690
204,WOLB.0323.00158,1,26588,27275,+,687
204,WOLB.0323.00017,1,743553,744240,+,687
204,WOLB.0323.00104,1,687123,687813,+,690
204,WOLB.0323.00007,1,683502,684189,-,687
204,WOLB.0323.00001,1,799357,800044,-,687
204,WOLB.0323.00100,1,1036116,1036806,+,690
204,WOLB.0323.00070,1,1422064,1422754,-,690
204,WOLB.0323.00006,1,25473,26163,+,690
204,WOLB.0323.00042,1,1627229,1627937,+,708
204,WOLB.0323.00119,1,650529,651237,-,708
204,WOLB.0323.00149,1,1088540,1089227,-,687
204,WOLB.0323.00014,1,1434017,1434707,-,690
204,WOLB.0323.00096,1,1249525,1250233,+,708
203,WOLB.0323.00090,1,619664,620334,+,670
203,WOLB.0323.00002,1,639539,640209,+,670
203,WOLB.0323.00138,1,1171730,1172400,+,670
203,WOLB.0323.00132,1,611718,612388,-,670
203,WOLB.0323.00143,1,763207,763877,-,670
203,WOLB.0323.00106,1,763208,763878,-,670
203,WOLB.0323.00121,1,877610,878280,+,670
203,WOLB.0323.00135,1,971842,972512,-,670
203,WOLB.0323.00103,1,801422,802092,-,670
203,WOLB.0323.00107,1,800006,800676,-,670
203,WOLB.0323.00019,1,526728,527398,+,670
203,WOLB.0323.00060,1,505944,506614,+,670
203,WOLB.0323.00074,1,428742,429412,-,670
203,WOLB.0323.00120,1,414913,415583,-,670
203,WOLB.0323.00039,1,158655,159325,+,670
203,WOLB.0323.00041,1,1477218,1477888,+,670
203,WOLB.0323.00031,1,23427,24097,+,670
203,WOLB.0323.00056,1,658884,659554,+,670
203,WOLB.0323.00142,1,752774,753444,+,670
203,WOLB.0323.00023,1,363419,364089,-,670
203,WOLB.0323.00153,1,688286,688956,+,670
203,WOLB.0323.00093,1,744668,745338,+,670
203,WOLB.0323.00088,1,711475,712145,+,670
203,WOLB.0323.00008,1,746938,747596,-,658
203,WOLB.0323.00024,1,1085479,1086149,+,670
203,WOLB.0323.00064,1,555681,556351,+,670
203,WOLB.0323.00030,1,675266,675936,+,670
203,WOLB.0323.00105,1,801432,802102,-,670
203,WOLB.0323.00133,1,24225,24853,+,628
203,WOLB.0323.00084,1,1399174,1399844,-,670
203,WOLB.0323.00021,1,892409,893079,+,670
203,WOLB.0323.00043,1,411574,412244,+,670
203,WOLB.0323.00020,1,652386,653056,+,670
203,WOLB.0323.00122,1,886154,886824,-,670
203,WOLB.0323.00118,1,533679,534349,+,670
203,WOLB.0323.00004,1,752768,753438,+,670
203,WOLB.0323.00011,1,121827,122497,+,670
203,WOLB.0323.00035,1,648611,649281,+,670
203,WOLB.0323.00032,1,174392,175061,+,669
203,WOLB.0323.00012,1,715577,716247,+,670
203,WOLB.0323.00018,1,532198,532868,+,670
203,WOLB.0323.00025,1,183711,184341,+,630
203,WOLB.0323.00010,1,1000645,1001315,-,670
203,WOLB.0323.00068,1,570834,571504,+,670
203,WOLB.0323.00128,1,427394,428064,+,670
203,WOLB.0323.00158,1,24515,25185,+,670
203,WOLB.0323.00017,1,741480,742150,+,670
203,WOLB.0323.00104,1,685032,685702,+,670
203,WOLB.0323.00007,1,685577,686247,-,670
203,WOLB.0323.00001,1,801432,802102,-,670
203,WOLB.0323.00100,1,1034025,1034695,+,670
203,WOLB.0323.00070,1,1424177,1424847,-,670
203,WOLB.0323.00006,1,23413,24083,+,670
203,WOLB.0323.00042,1,1625156,1625826,+,670
203,WOLB.0323.00119,1,652625,653295,-,670
203,WOLB.0323.00149,1,1090630,1091300,-,670
203,WOLB.0323.00014,1,1436130,1436800,-,670
203,WOLB.0323.00096,1,1246249,1246919,+,670
202,WOLB.0323.00090,1,618682,619459,+,777
202,WOLB.0323.00002,1,638557,639334,+,777
202,WOLB.0323.00138,1,1170748,1171525,+,777
202,WOLB.0323.00132,1,612580,613368,-,788
202,WOLB.0323.00143,1,764082,764851,-,769
202,WOLB.0323.00106,1,764083,764852,-,769
202,WOLB.0323.00121,1,876628,877405,+,777
202,WOLB.0323.00135,1,972717,973494,-,777
202,WOLB.0323.00103,1,802297,803074,-,777
202,WOLB.0323.00107,1,800881,801658,-,777
202,WOLB.0323.00019,1,525746,526523,+,777
202,WOLB.0323.00060,1,504962,505739,+,777
202,WOLB.0323.00074,1,429617,430405,-,788
202,WOLB.0323.00120,1,415788,416576,-,788
202,WOLB.0323.00039,1,157673,158450,+,777
202,WOLB.0323.00041,1,1476225,1477013,+,788
202,WOLB.0323.00031,1,22453,23222,+,769
202,WOLB.0323.00056,1,657902,658679,+,777
202,WOLB.0323.00142,1,751792,752569,+,777
202,WOLB.0323.00023,1,364294,365082,-,788
202,WOLB.0323.00153,1,687304,688081,+,777
202,WOLB.0323.00093,1,743686,744463,+,777
202,WOLB.0323.00088,1,710501,711270,+,769
202,WOLB.0323.00008,1,747801,748578,-,777
202,WOLB.0323.00024,1,1083366,1084154,+,788
202,WOLB.0323.00064,1,554688,555476,+,788
202,WOLB.0323.00030,1,674273,675061,+,788
202,WOLB.0323.00105,1,802307,803084,-,777
202,WOLB.0323.00133,1,23226,24004,+,778
202,WOLB.0323.00084,1,1400049,1400826,-,777
202,WOLB.0323.00021,1,891427,892204,+,777
202,WOLB.0323.00043,1,409312,410089,+,777
202,WOLB.0323.00020,1,651412,652181,+,769
202,WOLB.0323.00122,1,887029,887806,-,777
202,WOLB.0323.00118,1,532686,533474,+,788
202,WOLB.0323.00004,1,751786,752563,+,777
202,WOLB.0323.00011,1,120845,121622,+,777
202,WOLB.0323.00035,1,647637,648406,+,769
202,WOLB.0323.00032,1,173409,174186,+,777
202,WOLB.0323.00012,1,714603,715372,+,769
202,WOLB.0323.00018,1,531228,532006,+,778
202,WOLB.0323.00025,1,182581,183345,+,764
202,WOLB.0323.00010,1,1001520,1002297,-,777
202,WOLB.0323.00068,1,569852,570629,+,777
202,WOLB.0323.00128,1,426412,427189,+,777
202,WOLB.0323.00158,1,23533,24310,+,777
202,WOLB.0323.00017,1,740498,741275,+,777
202,WOLB.0323.00104,1,684058,684827,+,769
202,WOLB.0323.00007,1,686452,687229,-,777
202,WOLB.0323.00001,1,802307,803084,-,777
202,WOLB.0323.00100,1,1033051,1033820,+,769
202,WOLB.0323.00070,1,1425052,1425829,-,777
202,WOLB.0323.00006,1,22439,23208,+,769
202,WOLB.0323.00042,1,1624182,1624951,+,769
202,WOLB.0323.00119,1,653500,654277,-,777
202,WOLB.0323.00149,1,1091505,1092282,-,777
202,WOLB.0323.00014,1,1437005,1437782,-,777
202,WOLB.0323.00096,1,1245256,1246044,+,788
201,WOLB.0323.00090,1,613828,615659,+,1831
201,WOLB.0323.00002,1,632207,634042,+,1835
201,WOLB.0323.00138,1,1161271,1163103,+,1832
201,WOLB.0323.00132,1,618896,620733,-,1837
201,WOLB.0323.00143,1,768259,770078,-,1819
201,WOLB.0323.00106,1,768260,770079,-,1819
201,WOLB.0323.00121,1,869835,871667,+,1832
201,WOLB.0323.00135,1,975887,977717,-,1830
201,WOLB.0323.00103,1,811095,812914,-,1819
201,WOLB.0323.00107,1,809667,811486,-,1819
201,WOLB.0323.00019,1,681784,683630,-,1846
201,WOLB.0323.00060,1,495982,497814,+,1832
201,WOLB.0323.00074,1,437310,439143,-,1833
201,WOLB.0323.00120,1,423481,425314,-,1833
201,WOLB.0323.00039,1,153113,154959,+,1846
201,WOLB.0323.00041,1,1466138,1467971,+,1833
201,WOLB.0323.00031,1,17226,19045,+,1819
201,WOLB.0323.00056,1,649788,651620,+,1832
201,WOLB.0323.00142,1,744999,746831,+,1832
201,WOLB.0323.00023,1,371094,372924,-,1830
201,WOLB.0323.00153,1,682450,684281,+,1831
201,WOLB.0323.00093,1,737427,739266,+,1839
201,WOLB.0323.00088,1,703303,705134,+,1831
201,WOLB.0323.00008,1,750993,752838,-,1845
201,WOLB.0323.00024,1,542546,544382,+,1836
201,WOLB.0323.00064,1,547332,549168,+,1836
201,WOLB.0323.00030,1,666917,668753,+,1836
201,WOLB.0323.00105,1,811105,812924,-,1819
201,WOLB.0323.00133,1,18684,20519,+,1835
201,WOLB.0323.00084,1,1407102,1408934,-,1832
201,WOLB.0323.00021,1,883319,885151,+,1832
201,WOLB.0323.00043,1,402962,404797,+,1835
201,WOLB.0323.00020,1,644214,646045,+,1831
201,WOLB.0323.00122,1,893136,894968,-,1832
201,WOLB.0323.00118,1,526258,528090,+,1832
201,WOLB.0323.00004,1,744993,746825,+,1832
201,WOLB.0323.00011,1,114052,115884,+,1832
201,WOLB.0323.00035,1,640439,642270,+,1831
201,WOLB.0323.00032,1,165301,167133,+,1832
201,WOLB.0323.00012,1,707405,709236,+,1831
201,WOLB.0323.00018,1,526382,528213,+,1831
201,WOLB.0323.00025,1,175962,177794,+,1832
201,WOLB.0323.00010,1,1006475,1008312,-,1837
201,WOLB.0323.00068,1,1120687,1122519,+,1832
201,WOLB.0323.00128,1,420062,421897,+,1835
201,WOLB.0323.00158,1,16740,18572,+,1832
201,WOLB.0323.00017,1,732602,734434,+,1832
201,WOLB.0323.00104,1,676860,678691,+,1831
201,WOLB.0323.00007,1,693511,695343,-,1832
201,WOLB.0323.00001,1,811105,812924,-,1819
201,WOLB.0323.00100,1,1025853,1027684,+,1831
201,WOLB.0323.00070,1,1430344,1432179,-,1835
201,WOLB.0323.00006,1,17212,19031,+,1819
201,WOLB.0323.00042,1,1617984,1619819,+,1835
201,WOLB.0323.00119,1,495061,496907,+,1846
201,WOLB.0323.00149,1,1097243,1099075,-,1832
201,WOLB.0323.00014,1,1442297,1444132,-,1835
201,WOLB.0323.00096,1,1236518,1238351,+,1833
200,WOLB.0323.00090,1,611449,612768,+,1319
200,WOLB.0323.00002,1,629827,631146,+,1319
200,WOLB.0323.00138,1,1157788,1159107,+,1319
200,WOLB.0323.00132,1,621788,623107,-,1319
200,WOLB.0323.00143,1,771210,772529,-,1319
200,WOLB.0323.00106,1,771212,772531,-,1319
200,WOLB.0323.00121,1,867450,868769,+,1319
200,WOLB.0323.00135,1,978783,980102,-,1319
200,WOLB.0323.00103,1,815286,816605,-,1319
200,WOLB.0323.00107,1,813858,815177,-,1319
200,WOLB.0323.00019,1,684701,686020,-,1319
200,WOLB.0323.00060,1,493597,494916,+,1319
200,WOLB.0323.00074,1,440273,441595,-,1322
200,WOLB.0323.00120,1,426444,427766,-,1322
200,WOLB.0323.00039,1,150723,152042,+,1319
200,WOLB.0323.00041,1,1463686,1465008,+,1322
200,WOLB.0323.00031,1,14774,16093,+,1319
200,WOLB.0323.00056,1,647403,648722,+,1319
200,WOLB.0323.00142,1,742614,743933,+,1319
200,WOLB.0323.00023,1,374092,375415,-,1323
200,WOLB.0323.00153,1,680071,681390,+,1319
200,WOLB.0323.00093,1,1515731,1517054,-,1323
200,WOLB.0323.00088,1,699836,701155,+,1319
200,WOLB.0323.00008,1,754100,755380,-,1280
200,WOLB.0323.00024,1,540111,541430,+,1319
200,WOLB.0323.00064,1,544841,546164,+,1323
200,WOLB.0323.00030,1,664426,665749,+,1323
200,WOLB.0323.00105,1,815296,816615,-,1319
200,WOLB.0323.00133,1,16292,17614,+,1322
200,WOLB.0323.00084,1,1411098,1412417,-,1319
200,WOLB.0323.00021,1,879836,881155,+,1319
200,WOLB.0323.00043,1,400583,401902,+,1319
200,WOLB.0323.00020,1,640747,642066,+,1319
200,WOLB.0323.00122,1,896026,897345,-,1319
200,WOLB.0323.00118,1,522839,524158,+,1319
200,WOLB.0323.00004,1,742608,743927,+,1319
200,WOLB.0323.00011,1,111667,112986,+,1319
200,WOLB.0323.00035,1,636972,638291,+,1319
200,WOLB.0323.00032,1,161818,163137,+,1319
200,WOLB.0323.00012,1,703938,705257,+,1319
200,WOLB.0323.00018,1,524003,525322,+,1319
200,WOLB.0323.00025,1,134266,135599,-,1333
200,WOLB.0323.00010,1,1009372,1010691,-,1319
200,WOLB.0323.00068,1,1117204,1118523,+,1319
200,WOLB.0323.00128,1,1101338,1102657,-,1319
200,WOLB.0323.00158,1,14355,15674,+,1319
200,WOLB.0323.00017,1,730229,731536,+,1307
200,WOLB.0323.00104,1,673393,674712,+,1319
200,WOLB.0323.00007,1,696409,697728,-,1319
200,WOLB.0323.00001,1,815296,816615,-,1319
200,WOLB.0323.00100,1,1022386,1023705,+,1319
200,WOLB.0323.00070,1,1433239,1434558,-,1319
200,WOLB.0323.00006,1,14760,16079,+,1319
200,WOLB.0323.00042,1,1615551,1616846,+,1295
200,WOLB.0323.00119,1,492671,493990,+,1319
200,WOLB.0323.00149,1,1100141,1101460,-,1319
200,WOLB.0323.00014,1,1445191,1446510,-,1319
200,WOLB.0323.00096,1,1234066,1235388,+,1322
199,WOLB.0323.00090,1,609233,610858,+,1625
199,WOLB.0323.00002,1,625719,627344,+,1625
199,WOLB.0323.00138,1,1153757,1155382,+,1625
199,WOLB.0323.00132,1,625692,627317,-,1625
199,WOLB.0323.00143,1,775018,776643,-,1625
199,WOLB.0323.00106,1,775020,776645,-,1625
199,WOLB.0323.00121,1,863618,865243,+,1625
199,WOLB.0323.00135,1,984983,986608,-,1625
199,WOLB.0323.00103,1,824255,825880,-,1625
199,WOLB.0323.00107,1,822829,824454,-,1625
199,WOLB.0323.00019,1,688517,690142,-,1625
199,WOLB.0323.00060,1,489549,491174,+,1625
199,WOLB.0323.00074,1,443902,445523,-,1621
199,WOLB.0323.00120,1,430073,431694,-,1621
199,WOLB.0323.00039,1,146611,148236,+,1625
199,WOLB.0323.00041,1,1459758,1461379,+,1621
199,WOLB.0323.00031,1,10660,12285,+,1625
199,WOLB.0323.00056,1,643355,644980,+,1625
199,WOLB.0323.00142,1,738776,740401,+,1625
199,WOLB.0323.00023,1,378133,379758,-,1625
199,WOLB.0323.00153,1,677855,679480,+,1625
199,WOLB.0323.00093,1,482753,484376,-,1623
199,WOLB.0323.00093,1,1358980,1360602,+,1622
199,WOLB.0323.00088,1,695898,697523,+,1625
199,WOLB.0323.00008,1,639969,641594,-,1625
199,WOLB.0323.00024,1,535939,537564,+,1625
199,WOLB.0323.00064,1,538637,540259,+,1622
199,WOLB.0323.00030,1,660528,662150,+,1622
199,WOLB.0323.00105,1,824265,825890,-,1625
199,WOLB.0323.00133,1,13273,14907,+,1634
199,WOLB.0323.00084,1,1414823,1416448,-,1625
199,WOLB.0323.00021,1,875805,877430,+,1625
199,WOLB.0323.00043,1,396533,398158,+,1625
199,WOLB.0323.00020,1,636809,638434,+,1625
199,WOLB.0323.00122,1,899690,901315,-,1625
199,WOLB.0323.00118,1,518754,520379,+,1625
199,WOLB.0323.00004,1,738776,740401,+,1625
199,WOLB.0323.00011,1,107829,109454,+,1625
199,WOLB.0323.00035,1,633038,634663,+,1625
199,WOLB.0323.00032,1,157787,159412,+,1625
199,WOLB.0323.00012,1,700000,701625,+,1625
199,WOLB.0323.00018,1,520176,521801,+,1625
199,WOLB.0323.00025,1,113625,115250,-,1625
199,WOLB.0323.00010,1,1012991,1014616,-,1625
199,WOLB.0323.00068,1,1113173,1114798,+,1625
199,WOLB.0323.00128,1,1105140,1106765,-,1625
199,WOLB.0323.00158,1,10517,12142,+,1625
199,WOLB.0323.00017,1,726391,728016,+,1625
199,WOLB.0323.00104,1,669455,671080,+,1625
199,WOLB.0323.00007,1,700151,701776,-,1625
199,WOLB.0323.00001,1,824265,825890,-,1625
199,WOLB.0323.00100,1,1018448,1020073,+,1625
199,WOLB.0323.00070,1,1437041,1438666,-,1625
199,WOLB.0323.00006,1,10646,12271,+,1625
199,WOLB.0323.00042,1,1613311,1614936,+,1625
199,WOLB.0323.00119,1,488549,490174,+,1625
199,WOLB.0323.00149,1,1103673,1105298,-,1625
199,WOLB.0323.00014,1,1448993,1450618,-,1625
199,WOLB.0323.00096,1,1230138,1231759,+,1621
198,WOLB.0323.00090,1,607657,608368,+,711
198,WOLB.0323.00002,1,622941,623652,+,711
198,WOLB.0323.00138,1,1152181,1152892,+,711
198,WOLB.0323.00132,1,628183,628894,-,711
198,WOLB.0323.00143,1,777516,778227,-,711
198,WOLB.0323.00106,1,777518,778229,-,711
198,WOLB.0323.00121,1,862042,862753,+,711
198,WOLB.0323.00135,1,987473,988184,-,711
198,WOLB.0323.00103,1,826760,827463,-,703
198,WOLB.0323.00107,1,825334,826037,-,703
198,WOLB.0323.00019,1,691007,691718,-,711
198,WOLB.0323.00060,1,487973,488684,+,711
198,WOLB.0323.00074,1,447408,448119,-,711
198,WOLB.0323.00120,1,433579,434290,-,711
198,WOLB.0323.00039,1,145035,145746,+,711
198,WOLB.0323.00041,1,1457162,1457873,+,711
198,WOLB.0323.00031,1,9076,9787,+,711
198,WOLB.0323.00056,1,641779,642490,+,711
198,WOLB.0323.00142,1,737224,737911,+,687
198,WOLB.0323.00023,1,380623,381334,-,711
198,WOLB.0323.00153,1,676279,676990,+,711
198,WOLB.0323.00093,1,485241,485948,-,707
198,WOLB.0323.00093,1,1357408,1358115,+,707
198,WOLB.0323.00088,1,694322,695033,+,711
198,WOLB.0323.00024,1,534363,535074,+,711
198,WOLB.0323.00064,1,537061,537772,+,711
198,WOLB.0323.00030,1,658952,659663,+,711
198,WOLB.0323.00105,1,826770,827473,-,703
198,WOLB.0323.00133,1,11689,12400,+,711
198,WOLB.0323.00084,1,1417313,1418024,-,711
198,WOLB.0323.00021,1,874229,874940,+,711
198,WOLB.0323.00043,1,393755,394466,+,711
198,WOLB.0323.00020,1,635233,635944,+,711
198,WOLB.0323.00122,1,902180,902891,-,711
198,WOLB.0323.00118,1,517177,517888,+,711
198,WOLB.0323.00004,1,737200,737911,+,711
198,WOLB.0323.00011,1,106253,106964,+,711
198,WOLB.0323.00035,1,631462,632173,+,711
198,WOLB.0323.00032,1,156211,156922,+,711
198,WOLB.0323.00012,1,698424,699135,+,711
198,WOLB.0323.00018,1,517431,518142,+,711
198,WOLB.0323.00010,1,1016684,1017395,-,711
198,WOLB.0323.00068,1,1111597,1112308,+,711
198,WOLB.0323.00128,1,1108832,1109543,-,711
198,WOLB.0323.00158,1,8941,9652,+,711
198,WOLB.0323.00017,1,724815,725526,+,711
198,WOLB.0323.00104,1,667879,668590,+,711
198,WOLB.0323.00007,1,702641,703352,-,711
198,WOLB.0323.00001,1,826770,827473,-,703
198,WOLB.0323.00100,1,1016872,1017583,+,711
198,WOLB.0323.00070,1,1440733,1441444,-,711
198,WOLB.0323.00006,1,9076,9787,+,711
198,WOLB.0323.00042,1,1609608,1610315,+,707
198,WOLB.0323.00119,1,486973,487684,+,711
198,WOLB.0323.00149,1,1106163,1106874,-,711
198,WOLB.0323.00014,1,1452686,1453397,-,711
198,WOLB.0323.00096,1,1227542,1228253,+,711
197,WOLB.0323.00090,1,601351,604012,+,2661
197,WOLB.0323.00002,1,821678,824331,-,2653
197,WOLB.0323.00138,1,1145890,1148551,+,2661
197,WOLB.0323.00132,1,816768,819430,-,2662
197,WOLB.0323.00143,1,781825,784487,-,2662
197,WOLB.0323.00106,1,781827,784489,-,2662
197,WOLB.0323.00121,1,855765,858426,+,2661
197,WOLB.0323.00135,1,991766,994428,-,2662
197,WOLB.0323.00103,1,623786,626447,+,2661
197,WOLB.0323.00107,1,622369,625030,+,2661
197,WOLB.0323.00019,1,697059,699721,-,2662
197,WOLB.0323.00060,1,481681,484342,+,2661
197,WOLB.0323.00074,1,451850,454503,-,2653
197,WOLB.0323.00120,1,438021,440674,-,2653
197,WOLB.0323.00039,1,138472,141133,+,2661
197,WOLB.0323.00041,1,1450778,1453430,+,2652
197,WOLB.0323.00031,1,2816,5477,+,2661
197,WOLB.0323.00056,1,635487,638148,+,2661
197,WOLB.0323.00142,1,729820,732481,+,2661
197,WOLB.0323.00023,1,384881,387543,-,2662
197,WOLB.0323.00153,1,669973,672634,+,2661
197,WOLB.0323.00093,1,1349783,1352441,+,2658
197,WOLB.0323.00088,1,688078,690739,+,2661
197,WOLB.0323.00008,1,834628,837260,+,2632
197,WOLB.0323.00024,1,529911,532572,+,2661
197,WOLB.0323.00064,1,1491734,1494396,-,2662
197,WOLB.0323.00030,1,652296,654957,+,2661
197,WOLB.0323.00105,1,623795,626456,+,2661
197,WOLB.0323.00133,1,5475,8127,+,2652
197,WOLB.0323.00084,1,1422752,1425414,-,2662
197,WOLB.0323.00021,1,866840,869501,+,2661
197,WOLB.0323.00043,1,387489,390141,+,2652
197,WOLB.0323.00020,1,628989,631650,+,2661
197,WOLB.0323.00122,1,907625,910287,-,2662
197,WOLB.0323.00118,1,508751,511412,+,2661
197,WOLB.0323.00004,1,730923,733584,+,2661
197,WOLB.0323.00011,1,99976,102637,+,2661
197,WOLB.0323.00035,1,625218,627879,+,2661
197,WOLB.0323.00032,1,149920,152581,+,2661
197,WOLB.0323.00012,1,692180,694841,+,2661
197,WOLB.0323.00018,1,510983,513635,+,2652
197,WOLB.0323.00025,1,20052,22867,-,2815
197,WOLB.0323.00010,1,1021028,1023689,-,2661
197,WOLB.0323.00068,1,1105306,1107967,+,2661
197,WOLB.0323.00128,1,1114533,1117186,-,2653
197,WOLB.0323.00158,1,2664,5325,+,2661
197,WOLB.0323.00017,1,718538,721199,+,2661
197,WOLB.0323.00104,1,661635,664296,+,2661
197,WOLB.0323.00007,1,706982,709644,-,2662
197,WOLB.0323.00001,1,623795,626456,+,2661
197,WOLB.0323.00100,1,1010628,1013289,+,2661
197,WOLB.0323.00070,1,1446434,1449087,-,2653
197,WOLB.0323.00006,1,2816,5477,+,2661
197,WOLB.0323.00042,1,1604001,1606662,+,2661
197,WOLB.0323.00119,1,478970,481631,+,2661
197,WOLB.0323.00149,1,1110489,1113151,-,2662
197,WOLB.0323.00014,1,1477456,1480108,+,2652
197,WOLB.0323.00096,1,1221158,1223810,+,2652
196,WOLB.0323.00090,1,598691,600865,+,2174
196,WOLB.0323.00002,1,824825,826990,-,2165
196,WOLB.0323.00138,1,1143230,1145404,+,2174
196,WOLB.0323.00132,1,819924,822089,-,2165
196,WOLB.0323.00143,1,784981,787147,-,2166
196,WOLB.0323.00106,1,784983,787149,-,2166
196,WOLB.0323.00121,1,853105,855279,+,2174
196,WOLB.0323.00135,1,994914,997087,-,2173
196,WOLB.0323.00103,1,620339,622505,+,2166
196,WOLB.0323.00107,1,618922,621088,+,2166
196,WOLB.0323.00019,1,700215,702380,-,2165
196,WOLB.0323.00060,1,479021,481195,+,2174
196,WOLB.0323.00074,1,1,2170,+,2169
196,WOLB.0323.00120,1,1,2170,+,2169
196,WOLB.0323.00039,1,135812,137978,+,2166
196,WOLB.0323.00041,1,1,2170,+,2169
196,WOLB.0323.00031,1,155,2322,+,2167
196,WOLB.0323.00056,1,632827,635001,+,2174
196,WOLB.0323.00142,1,727160,729334,+,2174
196,WOLB.0323.00023,1,388037,390202,-,2165
196,WOLB.0323.00153,1,667313,669487,+,2174
196,WOLB.0323.00093,1,1346324,1348507,+,2183
196,WOLB.0323.00088,1,685418,687592,+,2174
196,WOLB.0323.00008,1,817861,820044,+,2183
196,WOLB.0323.00024,1,527251,529417,+,2166
196,WOLB.0323.00064,1,1494890,1497055,-,2165
196,WOLB.0323.00030,1,649636,651802,+,2166
196,WOLB.0323.00105,1,620348,622514,+,2166
196,WOLB.0323.00133,1,2815,4981,+,2166
196,WOLB.0323.00084,1,1425900,1428073,-,2173
196,WOLB.0323.00021,1,864180,866354,+,2174
196,WOLB.0323.00043,1,384829,386995,+,2166
196,WOLB.0323.00020,1,626329,628503,+,2174
196,WOLB.0323.00122,1,910773,912946,-,2173
196,WOLB.0323.00118,1,506091,508265,+,2174
196,WOLB.0323.00004,1,728263,730437,+,2174
196,WOLB.0323.00011,1,97316,99490,+,2174
196,WOLB.0323.00035,1,622558,624732,+,2174
196,WOLB.0323.00032,1,147260,149434,+,2174
196,WOLB.0323.00012,1,689520,691694,+,2174
196,WOLB.0323.00018,1,508323,510489,+,2166
196,WOLB.0323.00025,1,4147,6313,+,2166
196,WOLB.0323.00010,1,1024183,1026348,-,2165
196,WOLB.0323.00068,1,1102646,1104820,+,2174
196,WOLB.0323.00128,1,1117680,1119845,-,2165
196,WOLB.0323.00158,1,1,2178,+,2177
196,WOLB.0323.00017,1,715878,718052,+,2174
196,WOLB.0323.00104,1,658975,661149,+,2174
196,WOLB.0323.00007,1,710130,712303,-,2173
196,WOLB.0323.00001,1,620348,622514,+,2166
196,WOLB.0323.00100,1,1007968,1010142,+,2174
196,WOLB.0323.00070,1,1449581,1451746,-,2165
196,WOLB.0323.00006,1,155,2322,+,2167
196,WOLB.0323.00042,1,1601341,1603507,+,2166
196,WOLB.0323.00119,1,476310,478476,+,2166
196,WOLB.0323.00149,1,1113637,1115810,-,2173
196,WOLB.0323.00014,1,1474796,1476962,+,2166
196,WOLB.0323.00096,1,1,2170,+,2169
195,WOLB.0323.00090,1,597630,598519,+,889
195,WOLB.0323.00002,1,827162,828052,-,890
195,WOLB.0323.00138,1,1142170,1143059,+,889
195,WOLB.0323.00132,1,822261,823151,-,890
195,WOLB.0323.00143,1,787319,788210,-,891
195,WOLB.0323.00106,1,787321,788212,-,891
195,WOLB.0323.00121,1,852044,852933,+,889
195,WOLB.0323.00135,1,997259,998149,-,890
195,WOLB.0323.00103,1,619278,620167,+,889
195,WOLB.0323.00107,1,617861,618750,+,889
195,WOLB.0323.00019,1,702552,703443,-,891
195,WOLB.0323.00060,1,477961,478850,+,889
195,WOLB.0323.00074,1,1527730,1528619,+,889
195,WOLB.0323.00120,1,1514707,1515596,+,889
195,WOLB.0323.00039,1,134750,135640,+,890
195,WOLB.0323.00041,1,1655232,1656121,+,889
195,WOLB.0323.00031,1,1272628,1273534,+,906
195,WOLB.0323.00056,1,631767,632656,+,889
195,WOLB.0323.00142,1,726099,726988,+,889
195,WOLB.0323.00023,1,390374,391264,-,890
195,WOLB.0323.00153,1,666252,667141,+,889
195,WOLB.0323.00093,1,1345263,1346152,+,889
195,WOLB.0323.00088,1,684364,685246,+,882
195,WOLB.0323.00008,1,816800,817689,+,889
195,WOLB.0323.00024,1,526191,527080,+,889
195,WOLB.0323.00064,1,1497227,1498117,-,890
195,WOLB.0323.00030,1,648575,649464,+,889
195,WOLB.0323.00105,1,619287,620176,+,889
195,WOLB.0323.00133,1,1753,2643,+,890
195,WOLB.0323.00084,1,1428244,1429134,-,890
195,WOLB.0323.00021,1,863120,864009,+,889
195,WOLB.0323.00043,1,383768,384657,+,889
195,WOLB.0323.00020,1,625275,626157,+,882
195,WOLB.0323.00122,1,913118,914008,-,890
195,WOLB.0323.00118,1,505031,505920,+,889
195,WOLB.0323.00004,1,727202,728091,+,889
195,WOLB.0323.00011,1,96255,97144,+,889
195,WOLB.0323.00035,1,621504,622386,+,882
195,WOLB.0323.00032,1,146200,147089,+,889
195,WOLB.0323.00012,1,688466,689348,+,882
195,WOLB.0323.00018,1,507262,508151,+,889
195,WOLB.0323.00025,1,3109,3975,+,866
195,WOLB.0323.00010,1,1026520,1027410,-,890
195,WOLB.0323.00068,1,1101586,1102475,+,889
195,WOLB.0323.00128,1,1120017,1120907,-,890
195,WOLB.0323.00158,1,1358847,1359736,+,889
195,WOLB.0323.00017,1,714817,715706,+,889
195,WOLB.0323.00104,1,657921,658803,+,882
195,WOLB.0323.00007,1,712474,713364,-,890
195,WOLB.0323.00001,1,619287,620176,+,889
195,WOLB.0323.00100,1,1006914,1007796,+,882
195,WOLB.0323.00070,1,1451918,1452808,-,890
195,WOLB.0323.00006,1,1300916,1301822,+,906
195,WOLB.0323.00042,1,1600280,1601169,+,889
195,WOLB.0323.00119,1,475248,476138,+,890
195,WOLB.0323.00149,1,1115982,1116872,-,890
195,WOLB.0323.00014,1,1473735,1474624,+,889
195,WOLB.0323.00096,1,1513981,1514870,+,889
194,WOLB.0323.00090,1,594878,595938,+,1060
194,WOLB.0323.00002,1,829669,830728,-,1059
194,WOLB.0323.00138,1,1139418,1140478,+,1060
194,WOLB.0323.00132,1,824843,825902,-,1059
194,WOLB.0323.00143,1,790004,791063,-,1059
194,WOLB.0323.00106,1,790006,791065,-,1059
194,WOLB.0323.00121,1,849292,850352,+,1060
194,WOLB.0323.00135,1,999841,1000900,-,1059
194,WOLB.0323.00103,1,615269,616329,+,1060
194,WOLB.0323.00107,1,613852,614912,+,1060
194,WOLB.0323.00019,1,705135,706194,-,1059
194,WOLB.0323.00060,1,475210,476270,+,1060
194,WOLB.0323.00074,1,1524743,1525803,+,1060
194,WOLB.0323.00120,1,1511720,1512780,+,1060
194,WOLB.0323.00039,1,131998,133058,+,1060
194,WOLB.0323.00041,1,1652245,1653305,+,1060
194,WOLB.0323.00031,1,1269774,1270834,+,1060
194,WOLB.0323.00056,1,629016,630076,+,1060
194,WOLB.0323.00142,1,723347,724407,+,1060
194,WOLB.0323.00023,1,392956,394015,-,1059
194,WOLB.0323.00153,1,663500,664560,+,1060
194,WOLB.0323.00093,1,1342415,1343475,+,1060
194,WOLB.0323.00088,1,681605,682665,+,1060
194,WOLB.0323.00008,1,813757,814796,+,1039
194,WOLB.0323.00024,1,523439,524499,+,1060
194,WOLB.0323.00064,1,1499808,1500867,-,1059
194,WOLB.0323.00030,1,645823,646883,+,1060
194,WOLB.0323.00105,1,615278,616338,+,1060
194,WOLB.0323.00133,1,1128209,1129264,+,1055
194,WOLB.0323.00084,1,1430826,1431885,-,1059
194,WOLB.0323.00021,1,860368,861428,+,1060
194,WOLB.0323.00043,1,381091,382151,+,1060
194,WOLB.0323.00020,1,622516,623576,+,1060
194,WOLB.0323.00122,1,915700,916759,-,1059
194,WOLB.0323.00118,1,502279,503339,+,1060
194,WOLB.0323.00004,1,724450,725510,+,1060
194,WOLB.0323.00011,1,93503,94563,+,1060
194,WOLB.0323.00035,1,618745,619805,+,1060
194,WOLB.0323.00032,1,143448,144508,+,1060
194,WOLB.0323.00012,1,685707,686767,+,1060
194,WOLB.0323.00018,1,504510,505570,+,1060
194,WOLB.0323.00025,1,357,1435,+,1078
194,WOLB.0323.00010,1,1029102,1030161,-,1059
194,WOLB.0323.00068,1,1098834,1099894,+,1060
194,WOLB.0323.00128,1,1122524,1123583,-,1059
194,WOLB.0323.00158,1,1356095,1357155,+,1060
194,WOLB.0323.00017,1,712065,713125,+,1060
194,WOLB.0323.00104,1,655162,656222,+,1060
194,WOLB.0323.00007,1,715055,716114,-,1059
194,WOLB.0323.00001,1,615278,616338,+,1060
194,WOLB.0323.00100,1,1004155,1005215,+,1060
194,WOLB.0323.00070,1,1454425,1455484,-,1059
194,WOLB.0323.00006,1,1298062,1299122,+,1060
194,WOLB.0323.00042,1,1597588,1598648,+,1060
194,WOLB.0323.00119,1,472496,473556,+,1060
194,WOLB.0323.00149,1,1118564,1119623,-,1059
194,WOLB.0323.00014,1,1471058,1472118,+,1060
194,WOLB.0323.00096,1,1510994,1512054,+,1060
193,WOLB.0323.00090,1,588475,594877,+,6402
193,WOLB.0323.00002,1,830730,837118,-,6388
193,WOLB.0323.00138,1,1133015,1139417,+,6402
193,WOLB.0323.00132,1,825904,832292,-,6388
193,WOLB.0323.00143,1,791065,797423,-,6358
193,WOLB.0323.00106,1,791067,797425,-,6358
193,WOLB.0323.00121,1,842889,849291,+,6402
193,WOLB.0323.00135,1,1000902,1007304,-,6402
193,WOLB.0323.00103,1,608874,615268,+,6394
193,WOLB.0323.00107,1,607457,613851,+,6394
193,WOLB.0323.00019,1,706196,712597,-,6401
193,WOLB.0323.00060,1,468807,475209,+,6402
193,WOLB.0323.00074,1,1518346,1524742,+,6396
193,WOLB.0323.00120,1,1505323,1511719,+,6396
193,WOLB.0323.00039,1,125595,131997,+,6402
193,WOLB.0323.00041,1,1645848,1652244,+,6396
193,WOLB.0323.00031,1,1263415,1269773,+,6358
193,WOLB.0323.00056,1,622613,629015,+,6402
193,WOLB.0323.00142,1,716944,723346,+,6402
193,WOLB.0323.00023,1,394017,400405,-,6388
193,WOLB.0323.00153,1,657097,663499,+,6402
193,WOLB.0323.00093,1,1336012,1342414,+,6402
193,WOLB.0323.00088,1,675202,681604,+,6402
193,WOLB.0323.00008,1,807368,813756,+,6388
193,WOLB.0323.00024,1,517050,523438,+,6388
193,WOLB.0323.00064,1,1500869,1507271,-,6402
193,WOLB.0323.00030,1,639476,645822,+,6346
193,WOLB.0323.00105,1,608883,615277,+,6394
193,WOLB.0323.00133,1,1121805,1128208,+,6403
193,WOLB.0323.00084,1,1431887,1438289,-,6402
193,WOLB.0323.00021,1,853965,860367,+,6402
193,WOLB.0323.00043,1,374702,381090,+,6388
193,WOLB.0323.00020,1,616113,622515,+,6402
193,WOLB.0323.00122,1,916761,923163,-,6402
193,WOLB.0323.00118,1,495877,502278,+,6401
193,WOLB.0323.00004,1,718047,724449,+,6402
193,WOLB.0323.00011,1,87100,93502,+,6402
193,WOLB.0323.00035,1,612342,618744,+,6402
193,WOLB.0323.00032,1,137045,143447,+,6402
193,WOLB.0323.00012,1,679304,685706,+,6402
193,WOLB.0323.00018,1,498121,504509,+,6388
193,WOLB.0323.00025,1,1114764,1121094,+,6330
193,WOLB.0323.00010,1,1030163,1036551,-,6388
193,WOLB.0323.00068,1,1092431,1098833,+,6402
193,WOLB.0323.00128,1,1123585,1129973,-,6388
193,WOLB.0323.00158,1,1349692,1356094,+,6402
193,WOLB.0323.00017,1,705662,712064,+,6402
193,WOLB.0323.00104,1,648759,655161,+,6402
193,WOLB.0323.00007,1,716116,722518,-,6402
193,WOLB.0323.00001,1,608883,615277,+,6394
193,WOLB.0323.00100,1,997752,1004154,+,6402
193,WOLB.0323.00070,1,1455486,1461874,-,6388
193,WOLB.0323.00006,1,1291703,1298061,+,6358
193,WOLB.0323.00042,1,1591199,1597587,+,6388
193,WOLB.0323.00119,1,466094,472495,+,6401
193,WOLB.0323.00149,1,1119625,1126027,-,6402
193,WOLB.0323.00014,1,1464669,1471057,+,6388
193,WOLB.0323.00096,1,1504597,1510993,+,6396
192,WOLB.0323.00090,1,582964,584403,+,1439
192,WOLB.0323.00138,1,1426236,1427674,-,1438
192,WOLB.0323.00143,1,858063,859594,-,1531
192,WOLB.0323.00106,1,858066,859597,-,1531
192,WOLB.0323.00121,1,620170,621609,+,1439
192,WOLB.0323.00135,1,1012377,1013785,-,1408
192,WOLB.0323.00060,1,461787,463226,+,1439
192,WOLB.0323.00031,1,1201242,1202774,+,1532
192,WOLB.0323.00056,1,615593,617032,+,1439
192,WOLB.0323.00142,1,711433,712872,+,1439
192,WOLB.0323.00153,1,651586,653025,+,1439
192,WOLB.0323.00088,1,669691,671130,+,1439
192,WOLB.0323.00084,1,1442455,1443893,-,1438
192,WOLB.0323.00021,1,354523,355962,+,1439
192,WOLB.0323.00020,1,610602,612041,+,1439
192,WOLB.0323.00122,1,935321,936759,-,1438
192,WOLB.0323.00118,1,490372,491811,+,1439
192,WOLB.0323.00004,1,712536,713975,+,1439
192,WOLB.0323.00011,1,81589,83028,+,1439
192,WOLB.0323.00035,1,606831,608270,+,1439
192,WOLB.0323.00032,1,127871,129310,+,1439
192,WOLB.0323.00012,1,673793,675232,+,1439
192,WOLB.0323.00018,1,492599,494137,+,1538
192,WOLB.0323.00010,1,1040734,1042271,-,1537
192,WOLB.0323.00068,1,1126989,1128427,-,1438
192,WOLB.0323.00128,1,1135003,1136540,-,1537
192,WOLB.0323.00158,1,1344181,1345620,+,1439
192,WOLB.0323.00017,1,700151,701590,+,1439
192,WOLB.0323.00104,1,643248,644687,+,1439
192,WOLB.0323.00007,1,730400,731838,-,1438
192,WOLB.0323.00100,1,933602,935041,+,1439
192,WOLB.0323.00070,1,1466904,1468441,-,1537
192,WOLB.0323.00006,1,993893,995425,+,1532
192,WOLB.0323.00042,1,679916,681355,+,1439
192,WOLB.0323.00149,1,1130099,1131537,-,1438
192,WOLB.0323.00014,1,1458398,1459936,+,1538
191,WOLB.0323.00090,1,577815,580581,+,2766
191,WOLB.0323.00002,1,815196,817961,+,2765
191,WOLB.0323.00138,1,1430058,1432824,-,2766
191,WOLB.0323.00132,1,841870,844638,-,2768
191,WOLB.0323.00143,1,565224,567990,+,2766
191,WOLB.0323.00106,1,565226,567992,+,2766
191,WOLB.0323.00121,1,615021,617787,+,2766
191,WOLB.0323.00135,1,1016169,1018935,-,2766
191,WOLB.0323.00103,1,1337535,1340301,-,2766
191,WOLB.0323.00103,1,1363958,1366724,+,2766
191,WOLB.0323.00107,1,1335962,1338728,-,2766
191,WOLB.0323.00107,1,1362385,1365151,+,2766
191,WOLB.0323.00019,1,718859,721627,-,2768
191,WOLB.0323.00060,1,456638,459404,+,2766
191,WOLB.0323.00074,1,37668,40434,-,2766
191,WOLB.0323.00120,1,37663,40429,-,2766
191,WOLB.0323.00039,1,117964,120732,+,2768
191,WOLB.0323.00041,1,37663,40429,-,2766
191,WOLB.0323.00031,1,219319,222085,-,2766
191,WOLB.0323.00056,1,610444,613210,+,2766
191,WOLB.0323.00142,1,706284,709050,+,2766
191,WOLB.0323.00023,1,411389,414157,-,2768
191,WOLB.0323.00153,1,646437,649203,+,2766
191,WOLB.0323.00093,1,978661,981427,+,2766
191,WOLB.0323.00088,1,664542,667308,+,2766
191,WOLB.0323.00008,1,794955,797723,+,2768
191,WOLB.0323.00024,1,440434,443202,-,2768
191,WOLB.0323.00064,1,750493,753261,-,2768
191,WOLB.0323.00030,1,1171572,1174340,-,2768
191,WOLB.0323.00105,1,1337690,1340456,-,2766
191,WOLB.0323.00105,1,1364113,1366879,+,2766
191,WOLB.0323.00133,1,1196905,1199672,+,2767
191,WOLB.0323.00084,1,1446277,1449043,-,2766
191,WOLB.0323.00021,1,468017,470783,-,2766
191,WOLB.0323.00043,1,365663,368428,+,2765
191,WOLB.0323.00020,1,605453,608219,+,2766
191,WOLB.0323.00122,1,939143,941909,-,2766
191,WOLB.0323.00118,1,485223,487989,+,2766
191,WOLB.0323.00004,1,707387,710153,+,2766
191,WOLB.0323.00011,1,76440,79206,+,2766
191,WOLB.0323.00035,1,601682,604448,+,2766
191,WOLB.0323.00032,1,122722,125488,+,2766
191,WOLB.0323.00012,1,668644,671410,+,2766
191,WOLB.0323.00018,1,487467,490235,+,2768
191,WOLB.0323.00025,1,170778,173540,+,2762
191,WOLB.0323.00010,1,1044625,1047391,-,2766
191,WOLB.0323.00068,1,1130811,1133577,-,2766
191,WOLB.0323.00128,1,1138893,1141658,-,2765
191,WOLB.0323.00158,1,1339032,1341798,+,2766
191,WOLB.0323.00017,1,695002,697768,+,2766
191,WOLB.0323.00104,1,638099,640865,+,2766
191,WOLB.0323.00007,1,734222,736988,-,2766
191,WOLB.0323.00001,1,1337690,1340456,-,2766
191,WOLB.0323.00001,1,1364113,1366879,+,2766
191,WOLB.0323.00100,1,928453,931219,+,2766
191,WOLB.0323.00070,1,1470794,1473559,-,2765
191,WOLB.0323.00006,1,1097553,1100319,+,2766
191,WOLB.0323.00042,1,674796,677564,+,2768
191,WOLB.0323.00119,1,457064,459832,+,2768
191,WOLB.0323.00149,1,1133921,1136687,-,2766
191,WOLB.0323.00014,1,1483826,1486591,-,2765
191,WOLB.0323.00096,1,44352,47118,-,2766
190,WOLB.0323.00090,1,576914,577739,+,825
190,WOLB.0323.00002,1,814295,815120,+,825
190,WOLB.0323.00138,1,1432900,1433725,-,825
190,WOLB.0323.00132,1,844714,845539,-,825
190,WOLB.0323.00143,1,564323,565145,+,822
190,WOLB.0323.00106,1,564325,565147,+,822
190,WOLB.0323.00121,1,614120,614945,+,825
190,WOLB.0323.00135,1,1027531,1028368,-,837
190,WOLB.0323.00103,1,1340377,1341202,-,825
190,WOLB.0323.00103,1,1363057,1363882,+,825
190,WOLB.0323.00107,1,1338804,1339629,-,825
190,WOLB.0323.00107,1,1361484,1362309,+,825
190,WOLB.0323.00019,1,721703,722528,-,825
190,WOLB.0323.00060,1,447178,448014,+,836
190,WOLB.0323.00074,1,40510,41335,-,825
190,WOLB.0323.00120,1,40505,41330,-,825
190,WOLB.0323.00039,1,117063,117888,+,825
190,WOLB.0323.00041,1,40505,41330,-,825
190,WOLB.0323.00031,1,222164,222986,-,822
190,WOLB.0323.00056,1,600985,601821,+,836
190,WOLB.0323.00142,1,705383,706208,+,825
190,WOLB.0323.00023,1,414245,415058,-,813
190,WOLB.0323.00153,1,645536,646361,+,825
190,WOLB.0323.00093,1,977760,978585,+,825
190,WOLB.0323.00088,1,604209,605045,+,836
190,WOLB.0323.00008,1,794054,794879,+,825
190,WOLB.0323.00024,1,447158,447983,-,825
190,WOLB.0323.00064,1,753337,754162,-,825
190,WOLB.0323.00030,1,1174416,1175241,-,825
190,WOLB.0323.00105,1,1340532,1341357,-,825
190,WOLB.0323.00105,1,1363212,1364037,+,825
190,WOLB.0323.00133,1,1196004,1196829,+,825
190,WOLB.0323.00084,1,1449119,1449944,-,825
190,WOLB.0323.00021,1,470859,471684,-,825
190,WOLB.0323.00043,1,364762,365587,+,825
190,WOLB.0323.00020,1,537754,538590,+,836
190,WOLB.0323.00122,1,941985,942810,-,825
190,WOLB.0323.00118,1,484322,485156,+,834
190,WOLB.0323.00004,1,706486,707311,+,825
190,WOLB.0323.00011,1,75539,76364,+,825
190,WOLB.0323.00035,1,539324,540160,+,836
190,WOLB.0323.00032,1,121821,122646,+,825
190,WOLB.0323.00012,1,608313,609149,+,836
190,WOLB.0323.00018,1,486567,487392,+,825
190,WOLB.0323.00025,1,169873,170698,+,825
190,WOLB.0323.00010,1,1047467,1048292,-,825
190,WOLB.0323.00068,1,1133653,1134478,-,825
190,WOLB.0323.00128,1,1141734,1142559,-,825
190,WOLB.0323.00158,1,1338131,1338956,+,825
190,WOLB.0323.00017,1,694101,694926,+,825
190,WOLB.0323.00104,1,555986,556822,+,836
190,WOLB.0323.00007,1,745611,746448,-,837
190,WOLB.0323.00001,1,1340532,1341357,-,825
190,WOLB.0323.00001,1,1363212,1364037,+,825
190,WOLB.0323.00100,1,862991,863827,+,836
190,WOLB.0323.00070,1,1473635,1474460,-,825
190,WOLB.0323.00006,1,1096652,1097474,+,822
190,WOLB.0323.00042,1,673895,674729,+,834
190,WOLB.0323.00119,1,456163,456988,+,825
190,WOLB.0323.00149,1,1136763,1137588,-,825
190,WOLB.0323.00014,1,1486667,1487490,-,823
190,WOLB.0323.00096,1,47194,48019,-,825
189,WOLB.0323.00090,1,576246,576861,+,615
189,WOLB.0323.00002,1,813627,814242,+,615
189,WOLB.0323.00138,1,1433778,1434393,-,615
189,WOLB.0323.00132,1,845592,846154,-,562
189,WOLB.0323.00143,1,563655,564270,+,615
189,WOLB.0323.00106,1,563657,564272,+,615
189,WOLB.0323.00121,1,613452,614067,+,615
189,WOLB.0323.00135,1,1028421,1029036,-,615
189,WOLB.0323.00103,1,1341255,1341820,-,565
189,WOLB.0323.00103,1,1362439,1363004,+,565
189,WOLB.0323.00107,1,1339682,1340247,-,565
189,WOLB.0323.00107,1,1360866,1361431,+,565
189,WOLB.0323.00019,1,722581,723195,-,614
189,WOLB.0323.00060,1,445001,445585,+,584
189,WOLB.0323.00074,1,41388,41965,-,577
189,WOLB.0323.00120,1,41383,41960,-,577
189,WOLB.0323.00039,1,116395,117010,+,615
189,WOLB.0323.00041,1,41383,41960,-,577
189,WOLB.0323.00031,1,223039,223654,-,615
189,WOLB.0323.00056,1,600317,600932,+,615
189,WOLB.0323.00142,1,704715,705330,+,615
189,WOLB.0323.00023,1,415111,415726,-,615
189,WOLB.0323.00153,1,644868,645483,+,615
189,WOLB.0323.00093,1,977131,977707,+,576
189,WOLB.0323.00088,1,603541,604156,+,615
189,WOLB.0323.00008,1,793283,794001,+,718
189,WOLB.0323.00024,1,448036,448651,-,615
189,WOLB.0323.00064,1,754215,754830,-,615
189,WOLB.0323.00030,1,1175294,1175909,-,615
189,WOLB.0323.00105,1,1341410,1341975,-,565
189,WOLB.0323.00105,1,1362594,1363159,+,565
189,WOLB.0323.00133,1,1195344,1195951,+,607
189,WOLB.0323.00084,1,1449997,1450612,-,615
189,WOLB.0323.00021,1,471737,472352,-,615
189,WOLB.0323.00043,1,364094,364709,+,615
189,WOLB.0323.00020,1,537086,537701,+,615
189,WOLB.0323.00122,1,942863,943478,-,615
189,WOLB.0323.00118,1,483654,484269,+,615
189,WOLB.0323.00004,1,705818,706433,+,615
189,WOLB.0323.00011,1,74871,75486,+,615
189,WOLB.0323.00035,1,538656,539271,+,615
189,WOLB.0323.00032,1,121153,121768,+,615
189,WOLB.0323.00012,1,607645,608260,+,615
189,WOLB.0323.00018,1,485899,486514,+,615
189,WOLB.0323.00025,1,169205,169820,+,615
189,WOLB.0323.00010,1,1048345,1048960,-,615
189,WOLB.0323.00068,1,1134531,1135146,-,615
189,WOLB.0323.00128,1,1142612,1143227,-,615
189,WOLB.0323.00158,1,1337463,1338078,+,615
189,WOLB.0323.00017,1,693433,694048,+,615
189,WOLB.0323.00104,1,555318,555933,+,615
189,WOLB.0323.00007,1,746501,747116,-,615
189,WOLB.0323.00001,1,1341410,1341975,-,565
189,WOLB.0323.00001,1,1362594,1363159,+,565
189,WOLB.0323.00100,1,862323,862938,+,615
189,WOLB.0323.00070,1,1474513,1475128,-,615
189,WOLB.0323.00006,1,1095984,1096599,+,615
189,WOLB.0323.00042,1,673227,673842,+,615
189,WOLB.0323.00119,1,455496,456110,+,614
189,WOLB.0323.00149,1,1137641,1138256,-,615
189,WOLB.0323.00014,1,1487543,1488158,-,615
189,WOLB.0323.00096,1,48072,48649,-,577
188,WOLB.0323.00090,1,568865,569986,+,1121
188,WOLB.0323.00002,1,1161334,1162436,+,1102
188,WOLB.0323.00138,1,1440653,1441774,-,1121
188,WOLB.0323.00132,1,851590,852711,-,1121
188,WOLB.0323.00143,1,557134,558255,+,1121
188,WOLB.0323.00106,1,557136,558257,+,1121
188,WOLB.0323.00121,1,606071,607192,+,1121
188,WOLB.0323.00135,1,1034423,1035544,-,1121
188,WOLB.0323.00103,1,1352007,1353128,-,1121
188,WOLB.0323.00107,1,1350434,1351555,-,1121
188,WOLB.0323.00019,1,729452,730573,-,1121
188,WOLB.0323.00060,1,437620,438741,+,1121
188,WOLB.0323.00074,1,47408,48529,-,1121
188,WOLB.0323.00120,1,47403,48524,-,1121
188,WOLB.0323.00039,1,109021,110142,+,1121
188,WOLB.0323.00041,1,47403,48524,-,1121
188,WOLB.0323.00031,1,229054,230175,-,1121
188,WOLB.0323.00056,1,592936,594057,+,1121
188,WOLB.0323.00142,1,697334,698455,+,1121
188,WOLB.0323.00023,1,422593,423714,-,1121
188,WOLB.0323.00153,1,637486,638607,+,1121
188,WOLB.0323.00093,1,970596,971717,+,1121
188,WOLB.0323.00088,1,596160,597281,+,1121
188,WOLB.0323.00008,1,785745,786866,+,1121
188,WOLB.0323.00024,1,454030,455151,-,1121
188,WOLB.0323.00064,1,760236,761338,-,1102
188,WOLB.0323.00030,1,1181315,1182417,-,1102
188,WOLB.0323.00105,1,1352162,1353283,-,1121
188,WOLB.0323.00133,1,1187958,1189079,+,1121
188,WOLB.0323.00084,1,1456872,1457993,-,1121
188,WOLB.0323.00021,1,478614,479735,-,1121
188,WOLB.0323.00043,1,357565,358667,+,1102
188,WOLB.0323.00020,1,529705,530826,+,1121
188,WOLB.0323.00122,1,951083,952204,-,1121
188,WOLB.0323.00118,1,477146,478267,+,1121
188,WOLB.0323.00004,1,697334,698455,+,1121
188,WOLB.0323.00011,1,67490,68611,+,1121
188,WOLB.0323.00035,1,531275,532396,+,1121
188,WOLB.0323.00032,1,113772,114893,+,1121
188,WOLB.0323.00012,1,600264,601385,+,1121
188,WOLB.0323.00018,1,479370,480491,+,1121
188,WOLB.0323.00025,1,162677,163798,+,1121
188,WOLB.0323.00010,1,1054368,1055489,-,1121
188,WOLB.0323.00068,1,1141406,1142527,-,1121
188,WOLB.0323.00128,1,1148654,1149756,-,1102
188,WOLB.0323.00158,1,1330082,1331203,+,1121
188,WOLB.0323.00017,1,686052,687173,+,1121
188,WOLB.0323.00104,1,547937,549058,+,1121
188,WOLB.0323.00007,1,755515,756636,-,1121
188,WOLB.0323.00001,1,1352162,1353283,-,1121
188,WOLB.0323.00100,1,854942,856063,+,1121
188,WOLB.0323.00070,1,1480555,1481657,-,1102
188,WOLB.0323.00006,1,1089455,1090576,+,1121
188,WOLB.0323.00042,1,666698,667819,+,1121
188,WOLB.0323.00119,1,448118,449239,+,1121
188,WOLB.0323.00149,1,1144516,1145637,-,1121
188,WOLB.0323.00014,1,1493585,1494687,-,1102
188,WOLB.0323.00096,1,54092,55213,-,1121
187,WOLB.0323.00090,1,567969,568698,+,729
187,WOLB.0323.00002,1,1160438,1161167,+,729
187,WOLB.0323.00138,1,1441941,1442670,-,729
187,WOLB.0323.00132,1,852896,853609,-,713
187,WOLB.0323.00143,1,556270,556964,+,694
187,WOLB.0323.00106,1,556272,556966,+,694
187,WOLB.0323.00121,1,605175,605904,+,729
187,WOLB.0323.00135,1,1035712,1036441,-,729
187,WOLB.0323.00019,1,730743,731471,-,728
187,WOLB.0323.00060,1,436723,437452,+,729
187,WOLB.0323.00074,1,48696,49425,-,729
187,WOLB.0323.00120,1,48691,49420,-,729
187,WOLB.0323.00039,1,108123,108851,+,728
187,WOLB.0323.00041,1,48691,49420,-,729
187,WOLB.0323.00031,1,230345,231039,-,694
187,WOLB.0323.00056,1,592039,592768,+,729
187,WOLB.0323.00142,1,696438,697167,+,729
187,WOLB.0323.00023,1,423899,424612,-,713
187,WOLB.0323.00153,1,636590,637319,+,729
187,WOLB.0323.00093,1,969700,970429,+,729
187,WOLB.0323.00088,1,595264,595993,+,729
187,WOLB.0323.00008,1,784849,785578,+,729
187,WOLB.0323.00024,1,455320,456066,-,746
187,WOLB.0323.00064,1,761523,762236,-,713
187,WOLB.0323.00030,1,1182602,1183315,-,713
187,WOLB.0323.00133,1,1187060,1187789,+,729
187,WOLB.0323.00084,1,1458160,1458889,-,729
187,WOLB.0323.00021,1,479902,480631,-,729
187,WOLB.0323.00043,1,356669,357398,+,729
187,WOLB.0323.00020,1,528809,529538,+,729
187,WOLB.0323.00122,1,952371,953100,-,729
187,WOLB.0323.00118,1,476250,476979,+,729
187,WOLB.0323.00004,1,696438,697167,+,729
187,WOLB.0323.00011,1,66594,67323,+,729
187,WOLB.0323.00035,1,530379,531108,+,729
187,WOLB.0323.00032,1,112876,113605,+,729
187,WOLB.0323.00012,1,599368,600097,+,729
187,WOLB.0323.00018,1,478472,479201,+,729
187,WOLB.0323.00025,1,161813,162507,+,694
187,WOLB.0323.00010,1,1055674,1056387,-,713
187,WOLB.0323.00068,1,1142694,1143423,-,729
187,WOLB.0323.00128,1,1149923,1150652,-,729
187,WOLB.0323.00158,1,1329186,1329915,+,729
187,WOLB.0323.00017,1,685156,685885,+,729
187,WOLB.0323.00104,1,547041,547770,+,729
187,WOLB.0323.00007,1,756804,757533,-,729
187,WOLB.0323.00100,1,854046,854775,+,729
187,WOLB.0323.00070,1,1481824,1482553,-,729
187,WOLB.0323.00006,1,1088591,1089285,+,694
187,WOLB.0323.00042,1,665800,666513,+,713
187,WOLB.0323.00119,1,447220,447948,+,728
187,WOLB.0323.00149,1,1145804,1146533,-,729
187,WOLB.0323.00014,1,1494854,1495583,-,729
187,WOLB.0323.00096,1,55380,56109,-,729
186,WOLB.0323.00090,1,564508,567402,+,2894
186,WOLB.0323.00002,1,1156967,1159871,+,2904
186,WOLB.0323.00138,1,1443237,1446131,-,2894
186,WOLB.0323.00132,1,854176,857081,-,2905
186,WOLB.0323.00143,1,552640,555544,+,2904
186,WOLB.0323.00106,1,552642,555546,+,2904
186,WOLB.0323.00121,1,601714,604608,+,2894
186,WOLB.0323.00135,1,1037008,1039902,-,2894
186,WOLB.0323.00103,1,1328618,1331495,+,2877
186,WOLB.0323.00107,1,1327045,1329922,+,2877
186,WOLB.0323.00019,1,732038,734933,-,2895
186,WOLB.0323.00060,1,433262,436156,+,2894
186,WOLB.0323.00074,1,49992,52886,-,2894
186,WOLB.0323.00120,1,49987,52881,-,2894
186,WOLB.0323.00039,1,104661,107556,+,2895
186,WOLB.0323.00041,1,49987,52881,-,2894
186,WOLB.0323.00031,1,231628,234669,-,3041
186,WOLB.0323.00056,1,588578,591472,+,2894
186,WOLB.0323.00142,1,692977,695871,+,2894
186,WOLB.0323.00023,1,425179,428084,-,2905
186,WOLB.0323.00153,1,633129,636023,+,2894
186,WOLB.0323.00093,1,966228,969133,+,2905
186,WOLB.0323.00088,1,591803,594697,+,2894
186,WOLB.0323.00008,1,781378,784282,+,2904
186,WOLB.0323.00024,1,412533,415429,-,2896
186,WOLB.0323.00064,1,762803,765707,-,2904
186,WOLB.0323.00030,1,1185730,1188635,-,2905
186,WOLB.0323.00105,1,1328773,1331650,+,2877
186,WOLB.0323.00133,1,1183589,1186493,+,2904
186,WOLB.0323.00084,1,1459456,1462351,-,2895
186,WOLB.0323.00021,1,481198,484092,-,2894
186,WOLB.0323.00043,1,353198,356102,+,2904
186,WOLB.0323.00020,1,525348,528242,+,2894
186,WOLB.0323.00122,1,953667,956561,-,2894
186,WOLB.0323.00118,1,472782,475683,+,2901
186,WOLB.0323.00004,1,692977,695871,+,2894
186,WOLB.0323.00011,1,63133,66027,+,2894
186,WOLB.0323.00035,1,526918,529812,+,2894
186,WOLB.0323.00032,1,109415,112309,+,2894
186,WOLB.0323.00012,1,595907,598801,+,2894
186,WOLB.0323.00018,1,475001,477905,+,2904
186,WOLB.0323.00025,1,158320,161224,+,2904
186,WOLB.0323.00010,1,1056942,1059847,-,2905
186,WOLB.0323.00068,1,1143990,1146884,-,2894
186,WOLB.0323.00128,1,1151219,1154124,-,2905
186,WOLB.0323.00158,1,1325725,1328619,+,2894
186,WOLB.0323.00017,1,681695,684589,+,2894
186,WOLB.0323.00104,1,543580,546474,+,2894
186,WOLB.0323.00007,1,758100,760994,-,2894
186,WOLB.0323.00001,1,1328773,1331650,+,2877
186,WOLB.0323.00100,1,850585,853479,+,2894
186,WOLB.0323.00070,1,1483120,1486025,-,2905
186,WOLB.0323.00006,1,1085098,1088002,+,2904
186,WOLB.0323.00042,1,662329,665233,+,2904
186,WOLB.0323.00119,1,443758,446653,+,2895
186,WOLB.0323.00149,1,1147100,1149994,-,2894
186,WOLB.0323.00014,1,1496150,1499055,-,2905
186,WOLB.0323.00096,1,56676,59570,-,2894
185,WOLB.0323.00090,1,562570,563143,+,573
185,WOLB.0323.00002,1,1167694,1168267,-,573
185,WOLB.0323.00138,1,1447496,1448069,-,573
185,WOLB.0323.00132,1,858649,859222,-,573
185,WOLB.0323.00143,1,645515,646088,+,573
185,WOLB.0323.00106,1,645516,646089,+,573
185,WOLB.0323.00121,1,599776,600349,+,573
185,WOLB.0323.00135,1,1041267,1041840,-,573
185,WOLB.0323.00103,1,1326680,1327253,+,573
185,WOLB.0323.00107,1,1325107,1325680,+,573
185,WOLB.0323.00019,1,736300,736873,-,573
185,WOLB.0323.00060,1,431324,431897,+,573
185,WOLB.0323.00074,1,54437,55010,-,573
185,WOLB.0323.00120,1,54432,55005,-,573
185,WOLB.0323.00039,1,102723,103296,+,573
185,WOLB.0323.00041,1,54432,55005,-,573
185,WOLB.0323.00031,1,141218,141791,-,573
185,WOLB.0323.00056,1,586640,587213,+,573
185,WOLB.0323.00142,1,691039,691612,+,573
185,WOLB.0323.00023,1,429652,430225,-,573
185,WOLB.0323.00153,1,631191,631764,+,573
185,WOLB.0323.00093,1,961421,961994,+,573
185,WOLB.0323.00088,1,589865,590438,+,573
185,WOLB.0323.00008,1,779339,779909,+,570
185,WOLB.0323.00024,1,1260458,1261031,+,573
185,WOLB.0323.00064,1,767276,767849,-,573
185,WOLB.0323.00030,1,1190203,1190776,-,573
185,WOLB.0323.00105,1,1326835,1327408,+,573
185,WOLB.0323.00133,1,1182097,1182658,+,561
185,WOLB.0323.00021,1,485457,486030,-,573
185,WOLB.0323.00043,1,349711,350284,+,573
185,WOLB.0323.00020,1,523410,523983,+,573
185,WOLB.0323.00122,1,957926,958499,-,573
185,WOLB.0323.00118,1,469473,470046,+,573
185,WOLB.0323.00004,1,691039,691612,+,573
185,WOLB.0323.00011,1,61195,61768,+,573
185,WOLB.0323.00035,1,524980,525553,+,573
185,WOLB.0323.00032,1,107576,108149,+,573
185,WOLB.0323.00012,1,593969,594542,+,573
185,WOLB.0323.00018,1,472859,473432,+,573
185,WOLB.0323.00010,1,1061415,1061988,-,573
185,WOLB.0323.00068,1,1148249,1148822,-,573
185,WOLB.0323.00128,1,1155692,1156265,-,573
185,WOLB.0323.00158,1,1323787,1324360,+,573
185,WOLB.0323.00017,1,679757,680330,+,573
185,WOLB.0323.00104,1,541642,542215,+,573
185,WOLB.0323.00007,1,762359,762932,-,573
185,WOLB.0323.00001,1,1326835,1327408,+,573
185,WOLB.0323.00100,1,848647,849220,+,573
185,WOLB.0323.00070,1,1487593,1488166,-,573
185,WOLB.0323.00006,1,1177521,1178094,+,573
185,WOLB.0323.00042,1,660187,660760,+,573
185,WOLB.0323.00119,1,441818,442391,+,573
185,WOLB.0323.00149,1,1151359,1151932,-,573
185,WOLB.0323.00014,1,1500623,1501196,-,573
185,WOLB.0323.00096,1,61121,61694,-,573
184,WOLB.0323.00090,1,560688,562466,+,1778
184,WOLB.0323.00002,1,1168371,1170152,-,1781
184,WOLB.0323.00138,1,1448173,1449950,-,1777
184,WOLB.0323.00132,1,859326,861053,-,1727
184,WOLB.0323.00143,1,643638,645402,+,1764
184,WOLB.0323.00106,1,643639,645403,+,1764
184,WOLB.0323.00121,1,597890,599672,+,1782
184,WOLB.0323.00135,1,1041944,1043721,-,1777
184,WOLB.0323.00103,1,1324788,1326570,+,1782
184,WOLB.0323.00107,1,1323215,1324997,+,1782
184,WOLB.0323.00019,1,736977,738755,-,1778
184,WOLB.0323.00060,1,429438,431220,+,1782
184,WOLB.0323.00074,1,55123,56903,-,1780
184,WOLB.0323.00120,1,55118,56898,-,1780
184,WOLB.0323.00039,1,100840,102619,+,1779
184,WOLB.0323.00041,1,55118,56898,-,1780
184,WOLB.0323.00031,1,141904,143668,-,1764
184,WOLB.0323.00056,1,584754,586536,+,1782
184,WOLB.0323.00142,1,689153,690935,+,1782
184,WOLB.0323.00023,1,497331,499044,-,1713
184,WOLB.0323.00153,1,629309,631087,+,1778
184,WOLB.0323.00093,1,959538,961317,+,1779
184,WOLB.0323.00088,1,587979,589761,+,1782
184,WOLB.0323.00008,1,776155,777927,+,1772
184,WOLB.0323.00024,1,1258576,1260354,+,1778
184,WOLB.0323.00064,1,767953,769750,-,1797
184,WOLB.0323.00030,1,1190880,1192677,-,1797
184,WOLB.0323.00105,1,1324943,1326725,+,1782
184,WOLB.0323.00133,1,1180193,1181972,+,1779
184,WOLB.0323.00021,1,486134,487911,-,1777
184,WOLB.0323.00043,1,347825,349607,+,1782
184,WOLB.0323.00020,1,521524,523306,+,1782
184,WOLB.0323.00122,1,958603,960380,-,1777
184,WOLB.0323.00118,1,467591,469369,+,1778
184,WOLB.0323.00004,1,689153,690935,+,1782
184,WOLB.0323.00011,1,59309,61091,+,1782
184,WOLB.0323.00035,1,523094,524876,+,1782
184,WOLB.0323.00032,1,105694,107472,+,1778
184,WOLB.0323.00012,1,592083,593865,+,1782
184,WOLB.0323.00018,1,470934,472755,+,1821
184,WOLB.0323.00025,1,777265,779034,+,1769
184,WOLB.0323.00010,1,1062092,1063873,-,1781
184,WOLB.0323.00068,1,1148926,1150703,-,1777
184,WOLB.0323.00128,1,1156369,1158150,-,1781
184,WOLB.0323.00158,1,1321901,1323683,+,1782
184,WOLB.0323.00017,1,677871,679653,+,1782
184,WOLB.0323.00104,1,539756,541538,+,1782
184,WOLB.0323.00007,1,763036,764817,-,1781
184,WOLB.0323.00001,1,1324943,1326725,+,1782
184,WOLB.0323.00100,1,846761,848543,+,1782
184,WOLB.0323.00070,1,1488270,1490051,-,1781
184,WOLB.0323.00006,1,1175635,1177408,+,1773
184,WOLB.0323.00042,1,658301,660083,+,1782
184,WOLB.0323.00119,1,439935,441714,+,1779
184,WOLB.0323.00149,1,1152036,1153817,-,1781
184,WOLB.0323.00014,1,1501300,1503081,-,1781
184,WOLB.0323.00096,1,61807,63587,-,1780
183,WOLB.0323.00090,1,559961,560587,+,626
183,WOLB.0323.00002,1,1170240,1170867,-,627
183,WOLB.0323.00138,1,1450051,1450678,-,627
183,WOLB.0323.00132,1,861145,861772,-,627
183,WOLB.0323.00143,1,642906,643532,+,626
183,WOLB.0323.00106,1,642907,643533,+,626
183,WOLB.0323.00121,1,597167,597793,+,626
183,WOLB.0323.00135,1,1043822,1044449,-,627
183,WOLB.0323.00103,1,1324065,1324691,+,626
183,WOLB.0323.00107,1,1322492,1323118,+,626
183,WOLB.0323.00019,1,738840,739482,-,642
183,WOLB.0323.00060,1,428715,429341,+,626
183,WOLB.0323.00074,1,56991,57645,-,654
183,WOLB.0323.00120,1,56986,57640,-,654
183,WOLB.0323.00039,1,100114,100756,+,642
183,WOLB.0323.00041,1,56986,57640,-,654
183,WOLB.0323.00031,1,143773,144400,-,627
183,WOLB.0323.00056,1,584031,584657,+,626
183,WOLB.0323.00142,1,688430,689056,+,626
183,WOLB.0323.00023,1,499145,499772,-,627
183,WOLB.0323.00153,1,628582,629208,+,626
183,WOLB.0323.00093,1,733448,734074,+,626
183,WOLB.0323.00088,1,587256,587882,+,626
183,WOLB.0323.00008,1,676574,677201,-,627
183,WOLB.0323.00024,1,1257849,1258475,+,626
183,WOLB.0323.00064,1,769809,770449,-,640
183,WOLB.0323.00030,1,1192736,1193376,-,640
183,WOLB.0323.00105,1,1324220,1324846,+,626
183,WOLB.0323.00133,1,1179470,1180109,+,639
183,WOLB.0323.00021,1,488012,488639,-,627
183,WOLB.0323.00043,1,347111,347737,+,626
183,WOLB.0323.00020,1,520801,521427,+,626
183,WOLB.0323.00122,1,960481,961108,-,627
183,WOLB.0323.00118,1,466920,467490,+,570
183,WOLB.0323.00004,1,688430,689056,+,626
183,WOLB.0323.00011,1,58586,59212,+,626
183,WOLB.0323.00035,1,522371,522997,+,626
183,WOLB.0323.00032,1,104967,105593,+,626
183,WOLB.0323.00012,1,591360,591986,+,626
183,WOLB.0323.00018,1,470208,470850,+,642
183,WOLB.0323.00025,1,776538,777164,+,626
183,WOLB.0323.00010,1,1063961,1064588,-,627
183,WOLB.0323.00068,1,1150804,1151404,-,600
183,WOLB.0323.00128,1,1158238,1158865,-,627
183,WOLB.0323.00158,1,1321178,1321804,+,626
183,WOLB.0323.00017,1,677148,677774,+,626
183,WOLB.0323.00104,1,539033,539659,+,626
183,WOLB.0323.00007,1,764914,765541,-,627
183,WOLB.0323.00001,1,1324220,1324846,+,626
183,WOLB.0323.00100,1,846038,846664,+,626
183,WOLB.0323.00070,1,1490139,1490766,-,627
183,WOLB.0323.00006,1,1174912,1175538,+,626
183,WOLB.0323.00042,1,657587,658213,+,626
183,WOLB.0323.00119,1,439209,439851,+,642
183,WOLB.0323.00149,1,1153914,1154541,-,627
183,WOLB.0323.00014,1,1503169,1503796,-,627
183,WOLB.0323.00096,1,63675,64329,-,654
182,WOLB.0323.00090,1,553339,556937,+,3598
182,WOLB.0323.00002,1,1173770,1177369,-,3599
182,WOLB.0323.00138,1,1453723,1457322,-,3599
182,WOLB.0323.00132,1,864858,868447,-,3589
182,WOLB.0323.00143,1,636127,639707,+,3580
182,WOLB.0323.00106,1,636128,639708,+,3580
182,WOLB.0323.00121,1,590546,594144,+,3598
182,WOLB.0323.00135,1,1047494,1051093,-,3599
182,WOLB.0323.00103,1,1316504,1320092,+,3588
182,WOLB.0323.00107,1,1314932,1318520,+,3588
182,WOLB.0323.00019,1,742512,746101,-,3589
182,WOLB.0323.00060,1,422050,425648,+,3598
182,WOLB.0323.00074,1,63825,67440,-,3615
182,WOLB.0323.00120,1,63820,67435,-,3615
182,WOLB.0323.00039,1,93495,97083,+,3588
182,WOLB.0323.00041,1,63820,67435,-,3615
182,WOLB.0323.00031,1,147598,151179,-,3581
182,WOLB.0323.00056,1,577344,580942,+,3598
182,WOLB.0323.00142,1,681809,685407,+,3598
182,WOLB.0323.00023,1,507432,511021,-,3589
182,WOLB.0323.00153,1,621960,625558,+,3598
182,WOLB.0323.00093,1,726862,730440,+,3578
182,WOLB.0323.00088,1,580634,584232,+,3598
182,WOLB.0323.00008,1,680199,683782,-,3583
182,WOLB.0323.00024,1,1249723,1253311,+,3588
182,WOLB.0323.00064,1,773548,777137,-,3589
182,WOLB.0323.00030,1,1196475,1200064,-,3589
182,WOLB.0323.00105,1,1316659,1320247,+,3588
182,WOLB.0323.00133,1,500837,504425,+,3588
182,WOLB.0323.00021,1,493642,497241,-,3599
182,WOLB.0323.00043,1,340609,344207,+,3598
182,WOLB.0323.00020,1,514179,517777,+,3598
182,WOLB.0323.00122,1,964131,967730,-,3599
182,WOLB.0323.00118,1,460232,463830,+,3598
182,WOLB.0323.00004,1,681809,685407,+,3598
182,WOLB.0323.00011,1,51965,55563,+,3598
182,WOLB.0323.00035,1,515749,519347,+,3598
182,WOLB.0323.00032,1,98301,101899,+,3598
182,WOLB.0323.00012,1,584738,588336,+,3598
182,WOLB.0323.00018,1,462112,465710,+,3598
182,WOLB.0323.00025,1,398204,401784,+,3580
182,WOLB.0323.00010,1,1067491,1071090,-,3599
182,WOLB.0323.00068,1,1157898,1161497,-,3599
182,WOLB.0323.00128,1,1161768,1165367,-,3599
182,WOLB.0323.00158,1,1314557,1318155,+,3598
182,WOLB.0323.00017,1,670527,674125,+,3598
182,WOLB.0323.00104,1,532411,536009,+,3598
182,WOLB.0323.00007,1,768585,772184,-,3599
182,WOLB.0323.00001,1,1316659,1320247,+,3588
182,WOLB.0323.00100,1,839416,843014,+,3598
182,WOLB.0323.00070,1,1493669,1497268,-,3599
182,WOLB.0323.00006,1,1168133,1171713,+,3580
182,WOLB.0323.00042,1,523760,527358,+,3598
182,WOLB.0323.00119,1,432590,436178,+,3588
182,WOLB.0323.00149,1,1157563,1161162,-,3599
182,WOLB.0323.00014,1,1506699,1510298,-,3599
182,WOLB.0323.00096,1,77629,81244,-,3615
181,WOLB.0323.00090,1,552652,553337,+,685
181,WOLB.0323.00002,1,1177370,1178061,-,691
181,WOLB.0323.00138,1,1457323,1458009,-,686
181,WOLB.0323.00132,1,868448,869139,-,691
181,WOLB.0323.00143,1,635440,636125,+,685
181,WOLB.0323.00106,1,635441,636126,+,685
181,WOLB.0323.00121,1,589859,590544,+,685
181,WOLB.0323.00135,1,1051094,1051780,-,686
181,WOLB.0323.00103,1,1315812,1316502,+,690
181,WOLB.0323.00107,1,1314240,1314930,+,690
181,WOLB.0323.00019,1,746102,746793,-,691
181,WOLB.0323.00060,1,421363,422048,+,685
181,WOLB.0323.00074,1,67441,68127,-,686
181,WOLB.0323.00120,1,67436,68122,-,686
181,WOLB.0323.00039,1,92803,93493,+,690
181,WOLB.0323.00041,1,67436,68122,-,686
181,WOLB.0323.00031,1,151180,151866,-,686
181,WOLB.0323.00056,1,576657,577342,+,685
181,WOLB.0323.00142,1,681122,681807,+,685
181,WOLB.0323.00023,1,511022,511713,-,691
181,WOLB.0323.00153,1,621273,621958,+,685
181,WOLB.0323.00093,1,726168,726860,+,692
181,WOLB.0323.00088,1,579947,580632,+,685
181,WOLB.0323.00024,1,1249031,1249721,+,690
181,WOLB.0323.00064,1,777138,777830,-,692
181,WOLB.0323.00030,1,1200065,1200757,-,692
181,WOLB.0323.00105,1,1315967,1316657,+,690
181,WOLB.0323.00133,1,500153,500835,+,682
181,WOLB.0323.00021,1,497242,497928,-,686
181,WOLB.0323.00043,1,339917,340607,+,690
181,WOLB.0323.00020,1,513492,514177,+,685
181,WOLB.0323.00122,1,967731,968417,-,686
181,WOLB.0323.00118,1,459545,460230,+,685
181,WOLB.0323.00004,1,681122,681807,+,685
181,WOLB.0323.00011,1,51278,51963,+,685
181,WOLB.0323.00035,1,515062,515747,+,685
181,WOLB.0323.00032,1,97614,98299,+,685
181,WOLB.0323.00012,1,584051,584736,+,685
181,WOLB.0323.00018,1,461420,462110,+,690
181,WOLB.0323.00025,1,397594,398202,+,608
181,WOLB.0323.00010,1,1071091,1071782,-,691
181,WOLB.0323.00068,1,1161498,1162184,-,686
181,WOLB.0323.00128,1,1165368,1166059,-,691
181,WOLB.0323.00158,1,1313870,1314555,+,685
181,WOLB.0323.00017,1,669840,670525,+,685
181,WOLB.0323.00104,1,531724,532409,+,685
181,WOLB.0323.00007,1,772185,772871,-,686
181,WOLB.0323.00001,1,1315967,1316657,+,690
181,WOLB.0323.00100,1,838729,839414,+,685
181,WOLB.0323.00070,1,1497269,1497960,-,691
181,WOLB.0323.00006,1,1167446,1168131,+,685
181,WOLB.0323.00042,1,523084,523758,+,674
181,WOLB.0323.00119,1,431898,432588,+,690
181,WOLB.0323.00149,1,1161163,1161849,-,686
181,WOLB.0323.00014,1,1510299,1510990,-,691
181,WOLB.0323.00096,1,81245,81931,-,686
180,WOLB.0323.00090,1,551484,552252,+,768
180,WOLB.0323.00002,1,1178459,1179194,-,735
180,WOLB.0323.00138,1,1458408,1459178,-,770
180,WOLB.0323.00132,1,869537,870271,-,734
180,WOLB.0323.00143,1,634302,635041,+,739
180,WOLB.0323.00106,1,634303,635042,+,739
180,WOLB.0323.00121,1,588690,589459,+,769
180,WOLB.0323.00103,1,1314656,1315419,+,763
180,WOLB.0323.00107,1,1313084,1313847,+,763
180,WOLB.0323.00031,1,152264,153004,-,740
180,WOLB.0323.00142,1,678850,679619,+,769
180,WOLB.0323.00023,1,512111,512845,-,734
180,WOLB.0323.00153,1,620105,620873,+,768
180,WOLB.0323.00093,1,723728,724492,+,764
180,WOLB.0323.00024,1,1247899,1248633,+,734
180,WOLB.0323.00064,1,778228,778962,-,734
180,WOLB.0323.00030,1,1201155,1201889,-,734
180,WOLB.0323.00105,1,1314811,1315574,+,763
180,WOLB.0323.00133,1,499013,499745,+,732
180,WOLB.0323.00021,1,498327,499097,-,770
180,WOLB.0323.00043,1,338784,339519,+,735
180,WOLB.0323.00122,1,968816,969586,-,770
180,WOLB.0323.00118,1,458377,459145,+,768
180,WOLB.0323.00004,1,679953,680722,+,769
180,WOLB.0323.00011,1,50109,50878,+,769
180,WOLB.0323.00032,1,96445,97214,+,769
180,WOLB.0323.00018,1,460287,461022,+,735
180,WOLB.0323.00025,1,1103498,1104268,+,770
180,WOLB.0323.00010,1,1072180,1072915,-,735
180,WOLB.0323.00068,1,1162583,1163353,-,770
180,WOLB.0323.00128,1,1166457,1167192,-,735
180,WOLB.0323.00158,1,1312701,1313470,+,769
180,WOLB.0323.00017,1,668671,669440,+,769
180,WOLB.0323.00001,1,1314811,1315574,+,763
180,WOLB.0323.00070,1,1498358,1499093,-,735
180,WOLB.0323.00006,1,1166308,1167047,+,739
180,WOLB.0323.00042,1,521952,522686,+,734
180,WOLB.0323.00149,1,1162248,1163018,-,770
180,WOLB.0323.00014,1,1511388,1512123,-,735
179,WOLB.0323.00090,1,547849,548370,+,521
179,WOLB.0323.00002,1,1106829,1107351,+,522
179,WOLB.0323.00138,1,186276,186797,+,521
179,WOLB.0323.00132,1,810831,811353,+,522
179,WOLB.0323.00121,1,484531,485052,-,521
179,WOLB.0323.00039,1,39477,39998,+,521
179,WOLB.0323.00041,1,1336190,1336712,+,522
179,WOLB.0323.00142,1,410346,410867,-,521
179,WOLB.0323.00023,1,1761713,1762235,-,522
179,WOLB.0323.00153,1,616470,616991,+,521
179,WOLB.0323.00088,1,615504,616025,+,521
179,WOLB.0323.00024,1,1441293,1441815,-,522
179,WOLB.0323.00064,1,329381,329903,-,522
179,WOLB.0323.00030,1,747541,748063,+,522
179,WOLB.0323.00084,1,282752,283273,+,521
179,WOLB.0323.00043,1,573799,574321,-,522
179,WOLB.0323.00122,1,1051216,1051809,-,593
179,WOLB.0323.00118,1,454742,455263,+,521
179,WOLB.0323.00004,1,407911,408432,-,521
179,WOLB.0323.00035,1,550619,551140,+,521
179,WOLB.0323.00012,1,619608,620129,+,521
179,WOLB.0323.00018,1,969393,969915,-,522
179,WOLB.0323.00010,1,1289019,1289539,+,520
179,WOLB.0323.00068,1,417121,417642,+,521
179,WOLB.0323.00128,1,985064,985586,-,522
179,WOLB.0323.00158,1,485157,485678,+,521
179,WOLB.0323.00017,1,483562,484083,-,521
179,WOLB.0323.00104,1,567281,567802,+,521
179,WOLB.0323.00100,1,874286,874807,+,521
179,WOLB.0323.00070,1,1122783,1123305,+,522
179,WOLB.0323.00042,1,607462,607984,-,522
179,WOLB.0323.00149,1,56772,57293,+,521
178,WOLB.0323.00090,1,546137,547817,+,1680
178,WOLB.0323.00002,1,1105120,1106798,+,1678
178,WOLB.0323.00138,1,184564,186244,+,1680
178,WOLB.0323.00132,1,809122,810800,+,1678
178,WOLB.0323.00143,1,800368,802039,-,1671
178,WOLB.0323.00106,1,800370,802041,-,1671
178,WOLB.0323.00121,1,485084,486764,-,1680
178,WOLB.0323.00039,1,37768,39446,+,1678
178,WOLB.0323.00041,1,1334478,1336158,+,1680
178,WOLB.0323.00031,1,1258799,1260470,+,1671
178,WOLB.0323.00142,1,410899,412579,-,1680
178,WOLB.0323.00023,1,1762266,1763944,-,1678
178,WOLB.0323.00153,1,614758,616438,+,1680
178,WOLB.0323.00088,1,613792,615472,+,1680
178,WOLB.0323.00024,1,1441846,1443524,-,1678
178,WOLB.0323.00030,1,745832,747510,+,1678
178,WOLB.0323.00084,1,281040,282720,+,1680
178,WOLB.0323.00043,1,574352,576030,-,1678
178,WOLB.0323.00122,1,1051841,1053521,-,1680
178,WOLB.0323.00118,1,453030,454710,+,1680
178,WOLB.0323.00004,1,408464,410144,-,1680
178,WOLB.0323.00035,1,548907,550587,+,1680
178,WOLB.0323.00012,1,617896,619576,+,1680
178,WOLB.0323.00018,1,969946,971624,-,1678
178,WOLB.0323.00010,1,1287311,1288988,+,1677
178,WOLB.0323.00068,1,415409,417089,+,1680
178,WOLB.0323.00128,1,985617,987295,-,1678
178,WOLB.0323.00158,1,483445,485125,+,1680
178,WOLB.0323.00017,1,484115,485795,-,1680
178,WOLB.0323.00104,1,565569,567249,+,1680
178,WOLB.0323.00100,1,872574,874254,+,1680
178,WOLB.0323.00070,1,1121074,1122752,+,1678
178,WOLB.0323.00006,1,1287087,1288758,+,1671
178,WOLB.0323.00042,1,608015,609693,-,1678
178,WOLB.0323.00149,1,55060,56740,+,1680
177,WOLB.0323.00090,1,544672,546135,+,1463
177,WOLB.0323.00002,1,1103646,1105118,+,1472
177,WOLB.0323.00138,1,183099,184562,+,1463
177,WOLB.0323.00132,1,807649,809120,+,1471
177,WOLB.0323.00121,1,486765,488229,-,1464
177,WOLB.0323.00039,1,36303,37766,+,1463
177,WOLB.0323.00041,1,1333016,1334476,+,1460
177,WOLB.0323.00142,1,412580,414044,-,1464
177,WOLB.0323.00023,1,1763945,1765418,-,1473
177,WOLB.0323.00153,1,613293,614756,+,1463
177,WOLB.0323.00088,1,612327,613790,+,1463
177,WOLB.0323.00024,1,1443525,1444998,-,1473
177,WOLB.0323.00030,1,744358,745830,+,1472
177,WOLB.0323.00084,1,279575,281038,+,1463
177,WOLB.0323.00043,1,576031,577504,-,1473
177,WOLB.0323.00122,1,1053522,1054986,-,1464
177,WOLB.0323.00118,1,451565,453028,+,1463
177,WOLB.0323.00004,1,410145,411609,-,1464
177,WOLB.0323.00035,1,547442,548905,+,1463
177,WOLB.0323.00012,1,616431,617894,+,1463
177,WOLB.0323.00018,1,971625,973098,-,1473
177,WOLB.0323.00010,1,1285837,1287309,+,1472
177,WOLB.0323.00068,1,413945,415407,+,1462
177,WOLB.0323.00128,1,987296,988769,-,1473
177,WOLB.0323.00158,1,481980,483443,+,1463
177,WOLB.0323.00017,1,485796,487243,-,1447
177,WOLB.0323.00104,1,564104,565567,+,1463
177,WOLB.0323.00100,1,871109,872572,+,1463
177,WOLB.0323.00070,1,1119600,1121072,+,1472
177,WOLB.0323.00042,1,609694,611167,-,1473
177,WOLB.0323.00149,1,53595,55058,+,1463
176,WOLB.0323.00090,1,543738,544582,+,844
176,WOLB.0323.00002,1,1102700,1103556,+,856
176,WOLB.0323.00138,1,182165,183009,+,844
176,WOLB.0323.00132,1,806703,807559,+,856
176,WOLB.0323.00121,1,488319,489163,-,844
176,WOLB.0323.00039,1,35369,36201,+,832
176,WOLB.0323.00041,1,1332086,1332914,+,828
176,WOLB.0323.00142,1,414134,414978,-,844
176,WOLB.0323.00023,1,1765508,1766364,-,856
176,WOLB.0323.00153,1,612359,613203,+,844
176,WOLB.0323.00088,1,611393,612237,+,844
176,WOLB.0323.00024,1,1445088,1445944,-,856
176,WOLB.0323.00084,1,278641,279485,+,844
176,WOLB.0323.00043,1,577594,578450,-,856
176,WOLB.0323.00122,1,1055076,1055920,-,844
176,WOLB.0323.00118,1,450631,451475,+,844
176,WOLB.0323.00004,1,411699,412543,-,844
176,WOLB.0323.00035,1,546508,547352,+,844
176,WOLB.0323.00012,1,615497,616341,+,844
176,WOLB.0323.00018,1,973188,974044,-,856
176,WOLB.0323.00010,1,1284891,1285747,+,856
176,WOLB.0323.00068,1,413011,413855,+,844
176,WOLB.0323.00128,1,988859,989715,-,856
176,WOLB.0323.00158,1,481046,481890,+,844
176,WOLB.0323.00017,1,488453,489297,-,844
176,WOLB.0323.00104,1,563170,564014,+,844
176,WOLB.0323.00100,1,870175,871019,+,844
176,WOLB.0323.00070,1,1118654,1119510,+,856
176,WOLB.0323.00042,1,613558,614414,-,856
176,WOLB.0323.00149,1,52661,53505,+,844
175,WOLB.0323.00090,1,540897,541822,+,925
175,WOLB.0323.00138,1,179324,180249,+,925
175,WOLB.0323.00121,1,491078,492004,-,926
175,WOLB.0323.00060,1,102913,103838,+,925
175,WOLB.0323.00039,1,220477,221400,-,923
175,WOLB.0323.00142,1,416893,417819,-,926
175,WOLB.0323.00153,1,609518,610443,+,925
175,WOLB.0323.00084,1,275801,276726,+,925
175,WOLB.0323.00118,1,447790,448715,+,925
175,WOLB.0323.00004,1,414458,415384,-,926
175,WOLB.0323.00068,1,410178,411095,+,917
175,WOLB.0323.00158,1,478205,479130,+,925
175,WOLB.0323.00017,1,491212,492138,-,926
175,WOLB.0323.00007,1,1001895,1002821,-,926
175,WOLB.0323.00149,1,49820,50745,+,925
174,WOLB.0323.00090,1,539675,540543,+,868
174,WOLB.0323.00138,1,178102,178970,+,868
174,WOLB.0323.00121,1,492357,493226,-,869
174,WOLB.0323.00060,1,101691,102559,+,868
174,WOLB.0323.00039,1,221753,222618,-,865
174,WOLB.0323.00142,1,418172,419041,-,869
174,WOLB.0323.00153,1,608296,609164,+,868
174,WOLB.0323.00084,1,274579,275447,+,868
174,WOLB.0323.00118,1,446569,447436,+,867
174,WOLB.0323.00004,1,415737,416606,-,869
174,WOLB.0323.00068,1,407528,408397,-,869
174,WOLB.0323.00158,1,476983,477851,+,868
174,WOLB.0323.00017,1,492491,493360,-,869
174,WOLB.0323.00007,1,1003174,1004043,-,869
174,WOLB.0323.00149,1,48598,49466,+,868
173,WOLB.0323.00090,1,539135,539673,+,538
173,WOLB.0323.00138,1,177562,178100,+,538
173,WOLB.0323.00121,1,493227,493765,-,538
173,WOLB.0323.00060,1,101151,101689,+,538
173,WOLB.0323.00039,1,222620,223161,-,541
173,WOLB.0323.00142,1,419042,419580,-,538
173,WOLB.0323.00153,1,607756,608294,+,538
173,WOLB.0323.00084,1,274039,274577,+,538
173,WOLB.0323.00118,1,446029,446567,+,538
173,WOLB.0323.00004,1,416607,417145,-,538
173,WOLB.0323.00068,1,404870,405395,+,525
173,WOLB.0323.00158,1,476443,476981,+,538
173,WOLB.0323.00017,1,493361,493899,-,538
173,WOLB.0323.00007,1,1004044,1004582,-,538
173,WOLB.0323.00149,1,48058,48596,+,538
172,WOLB.0323.00090,1,535284,536833,+,1549
172,WOLB.0323.00138,1,80000,81552,+,1552
172,WOLB.0323.00138,1,1073672,1075224,+,1552
172,WOLB.0323.00138,1,1518385,1519937,-,1552
172,WOLB.0323.00039,1,371556,373105,+,1549
172,WOLB.0323.00056,1,1234277,1235826,-,1549
172,WOLB.0323.00153,1,603905,605454,+,1549
172,WOLB.0323.00008,1,221846,223395,-,1549
172,WOLB.0323.00008,1,391240,392789,-,1549
172,WOLB.0323.00024,1,803016,804565,+,1549
172,WOLB.0323.00024,1,1401255,1402803,+,1548
172,WOLB.0323.00021,1,1145579,1147128,-,1549
172,WOLB.0323.00043,1,664978,666527,-,1549
172,WOLB.0323.00010,1,702324,703873,+,1549
172,WOLB.0323.00070,1,898063,899612,+,1549
172,WOLB.0323.00042,1,745388,746937,+,1549
172,WOLB.0323.00042,1,1584997,1586546,+,1549
172,WOLB.0323.00014,1,1274280,1275829,-,1549
172,WOLB.0323.00014,1,1345435,1346984,-,1549
171,WOLB.0323.00090,1,511200,511909,+,709
171,WOLB.0323.00060,1,283752,284459,+,707
171,WOLB.0323.00056,1,1314072,1314782,-,710
171,WOLB.0323.00153,1,578406,579115,+,709
171,WOLB.0323.00093,1,1071858,1072555,-,697
171,WOLB.0323.00088,1,518407,519116,+,709
171,WOLB.0323.00008,1,830244,830942,+,698
171,WOLB.0323.00030,1,483338,484047,+,709
171,WOLB.0323.00084,1,118035,118745,-,710
171,WOLB.0323.00012,1,519545,520254,+,709
171,WOLB.0323.00010,1,742298,743005,+,707
171,WOLB.0323.00010,1,880554,881270,-,716
171,WOLB.0323.00128,1,369251,369953,+,702
171,WOLB.0323.00104,1,605327,606036,+,709
171,WOLB.0323.00100,1,595141,595850,+,709
171,WOLB.0323.00100,1,651793,652502,+,709
171,WOLB.0323.00070,1,595902,596611,+,709
171,WOLB.0323.00014,1,1369706,1370417,-,711
170,WOLB.0323.00090,1,509126,509845,+,719
170,WOLB.0323.00002,1,648160,648879,-,719
170,WOLB.0323.00138,1,1483200,1483919,-,719
170,WOLB.0323.00039,1,265245,265964,+,719
170,WOLB.0323.00056,1,1316126,1316845,-,719
170,WOLB.0323.00023,1,471908,472620,+,712
170,WOLB.0323.00153,1,576343,577062,+,719
170,WOLB.0323.00088,1,516344,517063,+,719
170,WOLB.0323.00030,1,481275,481994,+,719
170,WOLB.0323.00084,1,120089,120808,-,719
170,WOLB.0323.00021,1,837811,838530,+,719
170,WOLB.0323.00035,1,447820,448539,+,719
170,WOLB.0323.00032,1,1392778,1393497,+,719
170,WOLB.0323.00012,1,517482,518201,+,719
170,WOLB.0323.00010,1,740236,740955,+,719
170,WOLB.0323.00068,1,1242721,1243440,+,719
170,WOLB.0323.00128,1,367188,367907,+,719
170,WOLB.0323.00104,1,603264,603983,+,719
170,WOLB.0323.00100,1,593078,593797,+,719
170,WOLB.0323.00100,1,649730,650449,+,719
170,WOLB.0323.00070,1,593839,594558,+,719
170,WOLB.0323.00070,1,1086766,1087485,+,719
170,WOLB.0323.00042,1,717031,717750,+,719
170,WOLB.0323.00014,1,1371761,1372480,-,719
169,WOLB.0323.00090,1,507175,508269,+,1094
169,WOLB.0323.00002,1,649736,650829,-,1093
169,WOLB.0323.00138,1,1484776,1485922,-,1146
169,WOLB.0323.00019,1,188387,189533,-,1146
169,WOLB.0323.00039,1,261969,263116,+,1147
169,WOLB.0323.00056,1,1317702,1318795,-,1093
169,WOLB.0323.00023,1,469929,471048,+,1119
169,WOLB.0323.00153,1,574392,575486,+,1094
169,WOLB.0323.00088,1,514393,515487,+,1094
169,WOLB.0323.00030,1,479324,480418,+,1094
169,WOLB.0323.00084,1,121665,122758,-,1093
169,WOLB.0323.00021,1,835851,836954,+,1103
169,WOLB.0323.00035,1,445869,446963,+,1094
169,WOLB.0323.00032,1,1390827,1391921,+,1094
169,WOLB.0323.00012,1,515531,516625,+,1094
169,WOLB.0323.00010,1,738286,739380,+,1094
169,WOLB.0323.00068,1,1240717,1241864,+,1147
169,WOLB.0323.00128,1,364249,365344,+,1095
169,WOLB.0323.00104,1,601313,602407,+,1094
169,WOLB.0323.00100,1,591127,592221,+,1094
169,WOLB.0323.00100,1,647779,648873,+,1094
169,WOLB.0323.00070,1,591888,592982,+,1094
169,WOLB.0323.00070,1,1084815,1085909,+,1094
169,WOLB.0323.00042,1,714136,715230,+,1094
169,WOLB.0323.00119,1,99508,100655,+,1147
169,WOLB.0323.00014,1,1373337,1374430,-,1093
168,WOLB.0323.00090,1,505092,507174,+,2082
168,WOLB.0323.00002,1,650831,652914,-,2083
168,WOLB.0323.00138,1,1485924,1487995,-,2071
168,WOLB.0323.00132,1,314743,316816,-,2073
168,WOLB.0323.00143,1,954343,956416,+,2073
168,WOLB.0323.00106,1,954346,956419,+,2073
168,WOLB.0323.00121,1,312691,314774,-,2083
168,WOLB.0323.00135,1,389237,391310,+,2073
168,WOLB.0323.00103,1,1451091,1453152,-,2061
168,WOLB.0323.00107,1,1449518,1451579,-,2061
168,WOLB.0323.00019,1,189535,191611,-,2076
168,WOLB.0323.00060,1,676028,678111,-,2083
168,WOLB.0323.00039,1,259891,261968,+,2077
168,WOLB.0323.00031,1,1104421,1106494,-,2073
168,WOLB.0323.00056,1,1318797,1320880,-,2083
168,WOLB.0323.00023,1,467857,469928,+,2071
168,WOLB.0323.00153,1,572308,574391,+,2083
168,WOLB.0323.00093,1,1231416,1233491,+,2075
168,WOLB.0323.00088,1,344103,346186,-,2083
168,WOLB.0323.00088,1,512309,514392,+,2083
168,WOLB.0323.00024,1,787317,789392,-,2075
168,WOLB.0323.00024,1,1465930,1468005,+,2075
168,WOLB.0323.00064,1,514066,516149,-,2083
168,WOLB.0323.00030,1,477240,479323,+,2083
168,WOLB.0323.00030,1,1329952,1332025,-,2073
168,WOLB.0323.00105,1,1451245,1453306,-,2061
168,WOLB.0323.00133,1,465161,467235,+,2074
168,WOLB.0323.00084,1,122760,124843,-,2083
168,WOLB.0323.00021,1,833767,835850,+,2083
168,WOLB.0323.00043,1,1560129,1562206,+,2077
168,WOLB.0323.00043,1,1618640,1620717,-,2077
168,WOLB.0323.00122,1,816033,818104,+,2071
168,WOLB.0323.00035,1,443785,445868,+,2083
168,WOLB.0323.00032,1,1150686,1152769,+,2083
168,WOLB.0323.00032,1,1388743,1390826,+,2083
168,WOLB.0323.00012,1,345259,347342,-,2083
168,WOLB.0323.00012,1,513447,515530,+,2083
168,WOLB.0323.00025,1,544490,546579,+,2089
168,WOLB.0323.00010,1,736203,738285,+,2082
168,WOLB.0323.00068,1,1238645,1240716,+,2071
168,WOLB.0323.00128,1,362177,364248,+,2071
168,WOLB.0323.00017,1,311688,313759,-,2071
168,WOLB.0323.00104,1,599229,601312,+,2083
168,WOLB.0323.00007,1,468372,470449,-,2077
168,WOLB.0323.00001,1,1451245,1453306,-,2061
168,WOLB.0323.00100,1,345271,347342,-,2071
168,WOLB.0323.00100,1,420848,422919,-,2071
168,WOLB.0323.00100,1,589055,591126,+,2071
168,WOLB.0323.00100,1,645707,647778,+,2071
168,WOLB.0323.00070,1,589804,591887,+,2083
168,WOLB.0323.00070,1,1082731,1084814,+,2083
168,WOLB.0323.00006,1,234316,236389,+,2073
168,WOLB.0323.00042,1,340501,342584,-,2083
168,WOLB.0323.00042,1,712052,714135,+,2083
168,WOLB.0323.00119,1,97431,99507,+,2076
168,WOLB.0323.00014,1,305870,307953,-,2083
168,WOLB.0323.00014,1,1374432,1376515,-,2083
167,WOLB.0323.00090,1,504030,504554,+,524
167,WOLB.0323.00002,1,653452,653976,-,524
167,WOLB.0323.00138,1,1488545,1489069,-,524
167,WOLB.0323.00132,1,317354,317878,-,524
167,WOLB.0323.00143,1,953281,953805,+,524
167,WOLB.0323.00106,1,953284,953808,+,524
167,WOLB.0323.00121,1,315312,315836,-,524
167,WOLB.0323.00135,1,388175,388699,+,524
167,WOLB.0323.00103,1,1453702,1454226,-,524
167,WOLB.0323.00107,1,1452129,1452653,-,524
167,WOLB.0323.00019,1,192155,192679,-,524
167,WOLB.0323.00060,1,678649,679173,-,524
167,WOLB.0323.00039,1,258823,259347,+,524
167,WOLB.0323.00031,1,1107032,1107556,-,524
167,WOLB.0323.00056,1,1321418,1321942,-,524
167,WOLB.0323.00023,1,466783,467307,+,524
167,WOLB.0323.00153,1,571246,571770,+,524
167,WOLB.0323.00093,1,1230348,1230872,+,524
167,WOLB.0323.00088,1,346724,347248,-,524
167,WOLB.0323.00088,1,511247,511771,+,524
167,WOLB.0323.00024,1,789936,790460,-,524
167,WOLB.0323.00024,1,1464862,1465386,+,524
167,WOLB.0323.00064,1,46,570,-,524
167,WOLB.0323.00064,1,516687,517211,-,524
167,WOLB.0323.00030,1,476178,476702,+,524
167,WOLB.0323.00030,1,1332563,1333087,-,524
167,WOLB.0323.00105,1,1453856,1454380,-,524
167,WOLB.0323.00133,1,464093,464617,+,524
167,WOLB.0323.00084,1,125381,125905,-,524
167,WOLB.0323.00021,1,832705,833229,+,524
167,WOLB.0323.00043,1,1559061,1559585,+,524
167,WOLB.0323.00043,1,1621261,1621785,-,524
167,WOLB.0323.00122,1,814959,815483,+,524
167,WOLB.0323.00035,1,442723,443247,+,524
167,WOLB.0323.00032,1,1149624,1150148,+,524
167,WOLB.0323.00032,1,1387681,1388205,+,524
167,WOLB.0323.00012,1,347880,348404,-,524
167,WOLB.0323.00012,1,512385,512909,+,524
167,WOLB.0323.00025,1,543422,543946,+,524
167,WOLB.0323.00010,1,735141,735665,+,524
167,WOLB.0323.00068,1,1237571,1238095,+,524
167,WOLB.0323.00128,1,361103,361627,+,524
167,WOLB.0323.00017,1,314309,314833,-,524
167,WOLB.0323.00104,1,598167,598691,+,524
167,WOLB.0323.00007,1,470993,471517,-,524
167,WOLB.0323.00001,1,1453856,1454380,-,524
167,WOLB.0323.00100,1,347892,348416,-,524
167,WOLB.0323.00100,1,423469,423993,-,524
167,WOLB.0323.00100,1,587981,588505,+,524
167,WOLB.0323.00100,1,644633,645157,+,524
167,WOLB.0323.00070,1,588742,589266,+,524
167,WOLB.0323.00070,1,1081669,1082193,+,524
167,WOLB.0323.00006,1,233254,233778,+,524
167,WOLB.0323.00042,1,344066,344590,-,524
167,WOLB.0323.00042,1,710990,711514,+,524
167,WOLB.0323.00119,1,96363,96887,+,524
167,WOLB.0323.00014,1,308491,309015,-,524
167,WOLB.0323.00014,1,1377053,1377577,-,524
166,WOLB.0323.00090,1,501125,503995,+,2870
166,WOLB.0323.00002,1,654011,656881,-,2870
166,WOLB.0323.00138,1,1489104,1491974,-,2870
166,WOLB.0323.00132,1,317913,320783,-,2870
166,WOLB.0323.00143,1,950359,953246,+,2887
166,WOLB.0323.00106,1,950362,953249,+,2887
166,WOLB.0323.00121,1,315871,318741,-,2870
166,WOLB.0323.00135,1,385270,388140,+,2870
166,WOLB.0323.00103,1,1454261,1457125,-,2864
166,WOLB.0323.00107,1,1452688,1455552,-,2864
166,WOLB.0323.00019,1,192714,195584,-,2870
166,WOLB.0323.00060,1,679208,682078,-,2870
166,WOLB.0323.00039,1,8640,11483,+,2843
166,WOLB.0323.00039,1,255918,258788,+,2870
166,WOLB.0323.00031,1,1107591,1110478,-,2887
166,WOLB.0323.00056,1,1321977,1324845,-,2868
166,WOLB.0323.00023,1,463878,466748,+,2870
166,WOLB.0323.00153,1,568341,571211,+,2870
166,WOLB.0323.00093,1,1227449,1230313,+,2864
166,WOLB.0323.00088,1,347283,350153,-,2870
166,WOLB.0323.00088,1,508342,511212,+,2870
166,WOLB.0323.00024,1,790495,793365,-,2870
166,WOLB.0323.00024,1,1461957,1464827,+,2870
166,WOLB.0323.00064,1,605,3475,-,2870
166,WOLB.0323.00064,1,517246,520116,-,2870
166,WOLB.0323.00030,1,473273,476143,+,2870
166,WOLB.0323.00030,1,1333122,1335992,-,2870
166,WOLB.0323.00105,1,1454415,1457279,-,2864
166,WOLB.0323.00133,1,461188,464058,+,2870
166,WOLB.0323.00084,1,125940,128810,-,2870
166,WOLB.0323.00021,1,829800,832670,+,2870
166,WOLB.0323.00043,1,1556156,1559026,+,2870
166,WOLB.0323.00043,1,1621820,1624690,-,2870
166,WOLB.0323.00122,1,812054,814924,+,2870
166,WOLB.0323.00035,1,439818,442688,+,2870
166,WOLB.0323.00032,1,1146719,1149589,+,2870
166,WOLB.0323.00032,1,1384776,1387646,+,2870
166,WOLB.0323.00012,1,348439,351309,-,2870
166,WOLB.0323.00012,1,509480,512350,+,2870
166,WOLB.0323.00025,1,540517,543387,+,2870
166,WOLB.0323.00010,1,732237,735106,+,2869
166,WOLB.0323.00068,1,1234666,1237536,+,2870
166,WOLB.0323.00128,1,358198,361068,+,2870
166,WOLB.0323.00017,1,314868,317738,-,2870
166,WOLB.0323.00104,1,595262,598132,+,2870
166,WOLB.0323.00007,1,471552,474422,-,2870
166,WOLB.0323.00001,1,1454415,1457279,-,2864
166,WOLB.0323.00100,1,348451,351321,-,2870
166,WOLB.0323.00100,1,424028,426898,-,2870
166,WOLB.0323.00100,1,585076,587946,+,2870
166,WOLB.0323.00100,1,641728,644598,+,2870
166,WOLB.0323.00070,1,585837,588707,+,2870
166,WOLB.0323.00070,1,1078764,1081634,+,2870
166,WOLB.0323.00006,1,230332,233219,+,2887
166,WOLB.0323.00042,1,344625,347495,-,2870
166,WOLB.0323.00042,1,708085,710955,+,2870
166,WOLB.0323.00119,1,93458,96328,+,2870
166,WOLB.0323.00014,1,309050,311920,-,2870
166,WOLB.0323.00014,1,1377612,1380483,-,2871
165,WOLB.0323.00090,1,499605,501123,+,1518
165,WOLB.0323.00002,1,656882,658400,-,1518
165,WOLB.0323.00138,1,1491975,1493493,-,1518
165,WOLB.0323.00132,1,320784,322293,-,1509
165,WOLB.0323.00143,1,948839,950357,+,1518
165,WOLB.0323.00106,1,948842,950360,+,1518
165,WOLB.0323.00121,1,318742,320260,-,1518
165,WOLB.0323.00135,1,383760,385268,+,1508
165,WOLB.0323.00103,1,1457126,1458644,-,1518
165,WOLB.0323.00107,1,1455553,1457071,-,1518
165,WOLB.0323.00019,1,195585,197103,-,1518
165,WOLB.0323.00060,1,682079,683597,-,1518
165,WOLB.0323.00039,1,7120,8638,+,1518
165,WOLB.0323.00039,1,254398,255916,+,1518
165,WOLB.0323.00031,1,1110479,1111997,-,1518
165,WOLB.0323.00056,1,1324846,1326364,-,1518
165,WOLB.0323.00023,1,462358,463876,+,1518
165,WOLB.0323.00153,1,566821,568339,+,1518
165,WOLB.0323.00093,1,1225929,1227447,+,1518
165,WOLB.0323.00088,1,350154,351672,-,1518
165,WOLB.0323.00088,1,506822,508340,+,1518
165,WOLB.0323.00024,1,793366,794884,-,1518
165,WOLB.0323.00024,1,1460437,1461955,+,1518
165,WOLB.0323.00064,1,3476,4994,-,1518
165,WOLB.0323.00064,1,520117,521635,-,1518
165,WOLB.0323.00030,1,471753,473271,+,1518
165,WOLB.0323.00030,1,1335993,1337511,-,1518
165,WOLB.0323.00105,1,1457280,1458798,-,1518
165,WOLB.0323.00133,1,459668,461186,+,1518
165,WOLB.0323.00084,1,128811,130329,-,1518
165,WOLB.0323.00021,1,828280,829798,+,1518
165,WOLB.0323.00043,1,1554637,1556154,+,1517
165,WOLB.0323.00043,1,1624691,1626209,-,1518
165,WOLB.0323.00122,1,810534,812052,+,1518
165,WOLB.0323.00035,1,438298,439816,+,1518
165,WOLB.0323.00032,1,1145199,1146717,+,1518
165,WOLB.0323.00032,1,1383256,1384774,+,1518
165,WOLB.0323.00012,1,351310,352828,-,1518
165,WOLB.0323.00012,1,507960,509478,+,1518
165,WOLB.0323.00025,1,538997,540515,+,1518
165,WOLB.0323.00010,1,730717,732235,+,1518
165,WOLB.0323.00068,1,1233146,1234664,+,1518
165,WOLB.0323.00128,1,356679,358196,+,1517
165,WOLB.0323.00017,1,317739,319257,-,1518
165,WOLB.0323.00104,1,593742,595260,+,1518
165,WOLB.0323.00007,1,474423,475941,-,1518
165,WOLB.0323.00001,1,1457280,1458798,-,1518
165,WOLB.0323.00100,1,351322,352840,-,1518
165,WOLB.0323.00100,1,426899,428417,-,1518
165,WOLB.0323.00100,1,583556,585074,+,1518
165,WOLB.0323.00100,1,640208,641726,+,1518
165,WOLB.0323.00070,1,584317,585835,+,1518
165,WOLB.0323.00070,1,1077244,1078762,+,1518
165,WOLB.0323.00006,1,228812,230330,+,1518
165,WOLB.0323.00042,1,347496,349014,-,1518
165,WOLB.0323.00042,1,706565,708083,+,1518
165,WOLB.0323.00119,1,91938,93456,+,1518
165,WOLB.0323.00014,1,311921,313439,-,1518
164,WOLB.0323.00090,1,498017,499604,+,1587
164,WOLB.0323.00002,1,658402,659989,-,1587
164,WOLB.0323.00138,1,1493495,1495082,-,1587
164,WOLB.0323.00132,1,322313,323891,-,1578
164,WOLB.0323.00143,1,947251,948838,+,1587
164,WOLB.0323.00106,1,947254,948841,+,1587
164,WOLB.0323.00121,1,320262,321849,-,1587
164,WOLB.0323.00135,1,382162,383740,+,1578
164,WOLB.0323.00103,1,1458646,1460233,-,1587
164,WOLB.0323.00107,1,1457073,1458660,-,1587
164,WOLB.0323.00019,1,197105,198692,-,1587
164,WOLB.0323.00060,1,683599,685186,-,1587
164,WOLB.0323.00039,1,5532,7119,+,1587
164,WOLB.0323.00039,1,252810,254397,+,1587
164,WOLB.0323.00031,1,1111999,1113586,-,1587
164,WOLB.0323.00056,1,1326366,1327953,-,1587
164,WOLB.0323.00023,1,460770,462357,+,1587
164,WOLB.0323.00023,1,1614849,1616416,+,1567
164,WOLB.0323.00153,1,565233,566820,+,1587
164,WOLB.0323.00093,1,1224341,1225928,+,1587
164,WOLB.0323.00088,1,351674,353261,-,1587
164,WOLB.0323.00088,1,505234,506821,+,1587
164,WOLB.0323.00024,1,794886,796473,-,1587
164,WOLB.0323.00024,1,1458849,1460436,+,1587
164,WOLB.0323.00064,1,4996,6583,-,1587
164,WOLB.0323.00064,1,521637,523224,-,1587
164,WOLB.0323.00030,1,470165,471752,+,1587
164,WOLB.0323.00030,1,1337513,1339100,-,1587
164,WOLB.0323.00105,1,1458800,1460387,-,1587
164,WOLB.0323.00133,1,458080,459667,+,1587
164,WOLB.0323.00084,1,130331,131918,-,1587
164,WOLB.0323.00021,1,826692,828279,+,1587
164,WOLB.0323.00043,1,1553048,1554635,+,1587
164,WOLB.0323.00043,1,1626211,1627798,-,1587
164,WOLB.0323.00122,1,808946,810533,+,1587
164,WOLB.0323.00035,1,436710,438297,+,1587
164,WOLB.0323.00032,1,1143611,1145198,+,1587
164,WOLB.0323.00032,1,1381668,1383255,+,1587
164,WOLB.0323.00012,1,352830,354417,-,1587
164,WOLB.0323.00012,1,506372,507959,+,1587
164,WOLB.0323.00025,1,537409,538996,+,1587
164,WOLB.0323.00010,1,729129,730716,+,1587
164,WOLB.0323.00068,1,1231558,1233145,+,1587
164,WOLB.0323.00128,1,355090,356677,+,1587
164,WOLB.0323.00017,1,319259,320846,-,1587
164,WOLB.0323.00104,1,592154,593741,+,1587
164,WOLB.0323.00007,1,475943,477530,-,1587
164,WOLB.0323.00001,1,1458800,1460387,-,1587
164,WOLB.0323.00100,1,352842,354429,-,1587
164,WOLB.0323.00100,1,428419,430006,-,1587
164,WOLB.0323.00100,1,581968,583555,+,1587
164,WOLB.0323.00100,1,638620,640207,+,1587
164,WOLB.0323.00070,1,582729,584316,+,1587
164,WOLB.0323.00070,1,1075656,1077243,+,1587
164,WOLB.0323.00006,1,227224,228811,+,1587
164,WOLB.0323.00042,1,349016,350603,-,1587
164,WOLB.0323.00042,1,704977,706564,+,1587
164,WOLB.0323.00119,1,90350,91937,+,1587
164,WOLB.0323.00014,1,313441,315028,-,1587
163,WOLB.0323.00090,1,495934,497680,+,1746
163,WOLB.0323.00002,1,660326,662072,-,1746
163,WOLB.0323.00138,1,1495419,1497165,-,1746
163,WOLB.0323.00132,1,324228,325974,-,1746
163,WOLB.0323.00143,1,945172,946914,+,1742
163,WOLB.0323.00106,1,945175,946917,+,1742
163,WOLB.0323.00121,1,322186,323928,-,1742
163,WOLB.0323.00135,1,380079,381825,+,1746
163,WOLB.0323.00103,1,1460570,1462316,-,1746
163,WOLB.0323.00107,1,1458997,1460743,-,1746
163,WOLB.0323.00019,1,199029,200771,-,1742
163,WOLB.0323.00060,1,685523,687269,-,1746
163,WOLB.0323.00039,1,3449,5195,+,1746
163,WOLB.0323.00039,1,250727,252473,+,1746
163,WOLB.0323.00031,1,1113923,1115665,-,1742
163,WOLB.0323.00056,1,1328290,1330036,-,1746
163,WOLB.0323.00023,1,458687,460433,+,1746
163,WOLB.0323.00023,1,1612766,1614512,+,1746
163,WOLB.0323.00153,1,563150,564896,+,1746
163,WOLB.0323.00093,1,1222258,1224004,+,1746
163,WOLB.0323.00088,1,353598,355344,-,1746
163,WOLB.0323.00088,1,503151,504897,+,1746
163,WOLB.0323.00024,1,1456770,1458512,+,1742
163,WOLB.0323.00064,1,6920,8666,-,1746
163,WOLB.0323.00064,1,523561,525307,-,1746
163,WOLB.0323.00030,1,468086,469828,+,1742
163,WOLB.0323.00030,1,1339437,1341183,-,1746
163,WOLB.0323.00105,1,1460724,1462470,-,1746
163,WOLB.0323.00133,1,456001,457743,+,1742
163,WOLB.0323.00084,1,132255,134001,-,1746
163,WOLB.0323.00021,1,824609,826355,+,1746
163,WOLB.0323.00043,1,1550965,1552711,+,1746
163,WOLB.0323.00043,1,1628135,1629881,-,1746
163,WOLB.0323.00020,1,472919,474623,+,1704
163,WOLB.0323.00122,1,806863,808609,+,1746
163,WOLB.0323.00035,1,434627,436373,+,1746
163,WOLB.0323.00032,1,1141528,1143274,+,1746
163,WOLB.0323.00032,1,1379585,1381331,+,1746
163,WOLB.0323.00012,1,354754,356496,-,1742
163,WOLB.0323.00012,1,504293,506035,+,1742
163,WOLB.0323.00025,1,535331,537072,+,1741
163,WOLB.0323.00010,1,727044,728790,+,1746
163,WOLB.0323.00068,1,1229475,1231221,+,1746
163,WOLB.0323.00128,1,353007,354753,+,1746
163,WOLB.0323.00017,1,321183,322929,-,1746
163,WOLB.0323.00104,1,590075,591817,+,1742
163,WOLB.0323.00007,1,477867,479613,-,1746
163,WOLB.0323.00001,1,1460724,1462470,-,1746
163,WOLB.0323.00100,1,354766,356512,-,1746
163,WOLB.0323.00100,1,430343,432089,-,1746
163,WOLB.0323.00100,1,579885,581631,+,1746
163,WOLB.0323.00100,1,636537,638283,+,1746
163,WOLB.0323.00070,1,580646,582392,+,1746
163,WOLB.0323.00070,1,1073573,1075319,+,1746
163,WOLB.0323.00006,1,225155,226887,+,1732
163,WOLB.0323.00042,1,350940,352682,-,1742
163,WOLB.0323.00042,1,702894,704640,+,1746
163,WOLB.0323.00119,1,88271,90013,+,1742
163,WOLB.0323.00014,1,315365,317111,-,1746
162,WOLB.0323.00090,1,494704,495240,+,536
162,WOLB.0323.00002,1,662766,663301,-,535
162,WOLB.0323.00138,1,1497859,1498394,-,535
162,WOLB.0323.00132,1,326668,327203,-,535
162,WOLB.0323.00143,1,943942,944478,+,536
162,WOLB.0323.00106,1,943945,944481,+,536
162,WOLB.0323.00121,1,324622,325157,-,535
162,WOLB.0323.00135,1,378849,379385,+,536
162,WOLB.0323.00103,1,1463011,1463546,-,535
162,WOLB.0323.00107,1,1461438,1461973,-,535
162,WOLB.0323.00019,1,201465,202000,-,535
162,WOLB.0323.00060,1,687963,688498,-,535
162,WOLB.0323.00039,1,2219,2755,+,536
162,WOLB.0323.00039,1,249497,250033,+,536
162,WOLB.0323.00031,1,1116359,1116894,-,535
162,WOLB.0323.00056,1,1330730,1331265,-,535
162,WOLB.0323.00023,1,457457,457993,+,536
162,WOLB.0323.00023,1,1611536,1612072,+,536
162,WOLB.0323.00153,1,561920,562456,+,536
162,WOLB.0323.00093,1,1221029,1221565,+,536
162,WOLB.0323.00088,1,356038,356573,-,535
162,WOLB.0323.00088,1,501921,502457,+,536
162,WOLB.0323.00024,1,1039429,1039932,+,503
162,WOLB.0323.00064,1,9365,9895,-,530
162,WOLB.0323.00064,1,526006,526536,-,530
162,WOLB.0323.00030,1,466856,467392,+,536
162,WOLB.0323.00030,1,1341877,1342412,-,535
162,WOLB.0323.00105,1,1463165,1463700,-,535
162,WOLB.0323.00133,1,454771,455307,+,536
162,WOLB.0323.00084,1,134695,135230,-,535
162,WOLB.0323.00021,1,823379,823915,+,536
162,WOLB.0323.00043,1,990774,991309,-,535
162,WOLB.0323.00043,1,1549735,1550271,+,536
162,WOLB.0323.00043,1,1630575,1631110,-,535
162,WOLB.0323.00020,1,471689,472225,+,536
162,WOLB.0323.00122,1,805633,806169,+,536
162,WOLB.0323.00035,1,433397,433933,+,536
162,WOLB.0323.00032,1,1140298,1140834,+,536
162,WOLB.0323.00032,1,1378355,1378891,+,536
162,WOLB.0323.00012,1,357190,357725,-,535
162,WOLB.0323.00012,1,503063,503599,+,536
162,WOLB.0323.00025,1,146278,146813,-,535
162,WOLB.0323.00010,1,725818,726351,+,533
162,WOLB.0323.00068,1,1228245,1228781,+,536
162,WOLB.0323.00128,1,351777,352313,+,536
162,WOLB.0323.00017,1,323623,324158,-,535
162,WOLB.0323.00104,1,588845,589381,+,536
162,WOLB.0323.00007,1,480307,480842,-,535
162,WOLB.0323.00001,1,1463165,1463700,-,535
162,WOLB.0323.00100,1,357206,357741,-,535
162,WOLB.0323.00100,1,432783,433318,-,535
162,WOLB.0323.00100,1,578655,579191,+,536
162,WOLB.0323.00100,1,635307,635843,+,536
162,WOLB.0323.00070,1,579416,579952,+,536
162,WOLB.0323.00070,1,1072343,1072879,+,536
162,WOLB.0323.00006,1,223915,224451,+,536
162,WOLB.0323.00042,1,353376,353911,-,535
162,WOLB.0323.00042,1,701664,702200,+,536
162,WOLB.0323.00119,1,87041,87577,+,536
162,WOLB.0323.00014,1,317805,318340,-,535
161,WOLB.0323.00090,1,493858,494703,+,845
161,WOLB.0323.00002,1,663303,664147,-,844
161,WOLB.0323.00138,1,1498396,1499240,-,844
161,WOLB.0323.00132,1,327205,328049,-,844
161,WOLB.0323.00143,1,943096,943941,+,845
161,WOLB.0323.00106,1,943099,943944,+,845
161,WOLB.0323.00121,1,325159,326003,-,844
161,WOLB.0323.00135,1,378003,378848,+,845
161,WOLB.0323.00103,1,1463548,1464384,-,836
161,WOLB.0323.00107,1,1461975,1462811,-,836
161,WOLB.0323.00019,1,202002,202846,-,844
161,WOLB.0323.00060,1,688500,689344,-,844
161,WOLB.0323.00039,1,1373,2218,+,845
161,WOLB.0323.00039,1,248651,249496,+,845
161,WOLB.0323.00031,1,1116896,1117740,-,844
161,WOLB.0323.00056,1,1331267,1332111,-,844
161,WOLB.0323.00023,1,456611,457456,+,845
161,WOLB.0323.00023,1,1610690,1611535,+,845
161,WOLB.0323.00153,1,561074,561919,+,845
161,WOLB.0323.00093,1,1220183,1221028,+,845
161,WOLB.0323.00088,1,356575,357419,-,844
161,WOLB.0323.00088,1,501075,501920,+,845
161,WOLB.0323.00024,1,1038583,1039428,+,845
161,WOLB.0323.00024,1,1131285,1132106,-,821
161,WOLB.0323.00064,1,9897,10733,-,836
161,WOLB.0323.00064,1,526538,527374,-,836
161,WOLB.0323.00030,1,466010,466855,+,845
161,WOLB.0323.00030,1,1342414,1343258,-,844
161,WOLB.0323.00105,1,1463702,1464538,-,836
161,WOLB.0323.00133,1,453925,454770,+,845
161,WOLB.0323.00084,1,135232,136076,-,844
161,WOLB.0323.00021,1,822533,823378,+,845
161,WOLB.0323.00043,1,991311,992155,-,844
161,WOLB.0323.00043,1,1548889,1549734,+,845
161,WOLB.0323.00043,1,1631112,1631956,-,844
161,WOLB.0323.00020,1,470843,471688,+,845
161,WOLB.0323.00122,1,804787,805632,+,845
161,WOLB.0323.00035,1,432551,433396,+,845
161,WOLB.0323.00032,1,1139452,1140297,+,845
161,WOLB.0323.00032,1,1377509,1378354,+,845
161,WOLB.0323.00012,1,357727,358571,-,844
161,WOLB.0323.00012,1,502217,503062,+,845
161,WOLB.0323.00025,1,146815,147659,-,844
161,WOLB.0323.00010,1,724972,725817,+,845
161,WOLB.0323.00068,1,1227399,1228244,+,845
161,WOLB.0323.00128,1,350931,351776,+,845
161,WOLB.0323.00017,1,324160,325004,-,844
161,WOLB.0323.00104,1,587999,588844,+,845
161,WOLB.0323.00007,1,480844,481688,-,844
161,WOLB.0323.00001,1,1463702,1464538,-,836
161,WOLB.0323.00100,1,357743,358587,-,844
161,WOLB.0323.00100,1,433320,434164,-,844
161,WOLB.0323.00100,1,577809,578654,+,845
161,WOLB.0323.00100,1,634461,635306,+,845
161,WOLB.0323.00070,1,578570,579415,+,845
161,WOLB.0323.00070,1,1071497,1072342,+,845
161,WOLB.0323.00006,1,223069,223914,+,845
161,WOLB.0323.00042,1,353913,354757,-,844
161,WOLB.0323.00042,1,700818,701663,+,845
161,WOLB.0323.00119,1,86195,87040,+,845
161,WOLB.0323.00014,1,318342,319186,-,844
160,WOLB.0323.00090,1,493284,493857,+,573
160,WOLB.0323.00002,1,664149,664722,-,573
160,WOLB.0323.00138,1,1499242,1499815,-,573
160,WOLB.0323.00132,1,328051,328624,-,573
160,WOLB.0323.00143,1,942522,943095,+,573
160,WOLB.0323.00106,1,942525,943098,+,573
160,WOLB.0323.00121,1,326005,326578,-,573
160,WOLB.0323.00135,1,377429,378002,+,573
160,WOLB.0323.00103,1,1464386,1464959,-,573
160,WOLB.0323.00107,1,1462813,1463386,-,573
160,WOLB.0323.00019,1,202848,203421,-,573
160,WOLB.0323.00060,1,133129,133700,-,571
160,WOLB.0323.00060,1,689346,689919,-,573
160,WOLB.0323.00039,1,799,1372,+,573
160,WOLB.0323.00039,1,248077,248650,+,573
160,WOLB.0323.00031,1,1117742,1118315,-,573
160,WOLB.0323.00056,1,1332113,1332686,-,573
160,WOLB.0323.00023,1,456037,456610,+,573
160,WOLB.0323.00023,1,1610116,1610689,+,573
160,WOLB.0323.00153,1,485846,486401,+,555
160,WOLB.0323.00153,1,560500,561073,+,573
160,WOLB.0323.00093,1,1219609,1220182,+,573
160,WOLB.0323.00088,1,357421,357994,-,573
160,WOLB.0323.00088,1,500501,501074,+,573
160,WOLB.0323.00024,1,1038009,1038582,+,573
160,WOLB.0323.00024,1,1132108,1132681,-,573
160,WOLB.0323.00064,1,10735,11308,-,573
160,WOLB.0323.00064,1,527376,527949,-,573
160,WOLB.0323.00064,1,698939,699494,+,555
160,WOLB.0323.00030,1,292149,292704,-,555
160,WOLB.0323.00030,1,465436,466009,+,573
160,WOLB.0323.00030,1,1343260,1343833,-,573
160,WOLB.0323.00105,1,1464540,1465113,-,573
160,WOLB.0323.00133,1,453364,453924,+,560
160,WOLB.0323.00084,1,136078,136651,-,573
160,WOLB.0323.00021,1,821959,822532,+,573
160,WOLB.0323.00043,1,992157,992730,-,573
160,WOLB.0323.00043,1,1548315,1548888,+,573
160,WOLB.0323.00043,1,1631958,1632531,-,573
160,WOLB.0323.00020,1,470269,470842,+,573
160,WOLB.0323.00122,1,804213,804786,+,573
160,WOLB.0323.00035,1,431977,432550,+,573
160,WOLB.0323.00032,1,1138878,1139451,+,573
160,WOLB.0323.00032,1,1376935,1377508,+,573
160,WOLB.0323.00012,1,358573,359146,-,573
160,WOLB.0323.00012,1,501643,502216,+,573
160,WOLB.0323.00025,1,147661,148234,-,573
160,WOLB.0323.00010,1,724398,724971,+,573
160,WOLB.0323.00068,1,1226825,1227398,+,573
160,WOLB.0323.00128,1,350357,350930,+,573
160,WOLB.0323.00017,1,325006,325579,-,573
160,WOLB.0323.00104,1,587425,587998,+,573
160,WOLB.0323.00007,1,481690,482263,-,573
160,WOLB.0323.00001,1,1464540,1465113,-,573
160,WOLB.0323.00100,1,358589,359162,-,573
160,WOLB.0323.00100,1,434166,434739,-,573
160,WOLB.0323.00100,1,577235,577808,+,573
160,WOLB.0323.00100,1,633887,634460,+,573
160,WOLB.0323.00070,1,577996,578569,+,573
160,WOLB.0323.00070,1,1070923,1071496,+,573
160,WOLB.0323.00006,1,222495,223068,+,573
160,WOLB.0323.00042,1,354759,355332,-,573
160,WOLB.0323.00042,1,700244,700817,+,573
160,WOLB.0323.00119,1,85621,86194,+,573
160,WOLB.0323.00014,1,319188,319761,-,573
159,WOLB.0323.00090,1,482124,483464,+,1340
159,WOLB.0323.00002,1,498218,499558,+,1340
159,WOLB.0323.00002,1,674379,675726,+,1347
159,WOLB.0323.00002,1,1145264,1146612,-,1348
159,WOLB.0323.00138,1,1077593,1078934,+,1341
159,WOLB.0323.00074,1,234577,235939,-,1362
159,WOLB.0323.00074,1,511120,512474,-,1354
159,WOLB.0323.00120,1,233807,235169,-,1362
159,WOLB.0323.00120,1,497291,498645,-,1354
159,WOLB.0323.00041,1,1227403,1228764,+,1361
159,WOLB.0323.00041,1,1392807,1394160,+,1353
159,WOLB.0323.00056,1,426925,428265,+,1340
159,WOLB.0323.00023,1,1619570,1620919,+,1349
159,WOLB.0323.00024,1,866495,867846,+,1351
159,WOLB.0323.00064,1,454039,455395,+,1356
159,WOLB.0323.00064,1,741546,742900,-,1354
159,WOLB.0323.00030,1,727468,728802,+,1334
159,WOLB.0323.00030,1,1162640,1163980,-,1340
159,WOLB.0323.00133,1,1015912,1017248,-,1336
159,WOLB.0323.00084,1,90591,91939,-,1348
159,WOLB.0323.00021,1,518172,519512,+,1340
159,WOLB.0323.00021,1,595946,597296,+,1350
159,WOLB.0323.00021,1,803405,804752,+,1347
159,WOLB.0323.00043,1,476460,477800,+,1340
159,WOLB.0323.00043,1,678888,680229,-,1341
159,WOLB.0323.00043,1,929455,930803,-,1348
159,WOLB.0323.00118,1,997161,998510,-,1349
159,WOLB.0323.00035,1,415044,416386,+,1342
159,WOLB.0323.00128,1,604532,605887,+,1355
159,WOLB.0323.00007,1,993314,994655,-,1341
159,WOLB.0323.00070,1,561056,562396,+,1340
159,WOLB.0323.00070,1,623534,624889,+,1355
159,WOLB.0323.00070,1,835111,836445,+,1334
159,WOLB.0323.00042,1,683304,684644,+,1340
159,WOLB.0323.00014,1,1270581,1271922,-,1341
159,WOLB.0323.00096,1,1156290,1157643,+,1353
159,WOLB.0323.00096,1,1417509,1418870,+,1361
158,WOLB.0323.00090,1,477338,478797,+,1459
158,WOLB.0323.00138,1,1470728,1472148,+,1420
158,WOLB.0323.00142,1,561470,562945,-,1475
158,WOLB.0323.00093,1,1324225,1325652,-,1427
158,WOLB.0323.00084,1,182195,183615,+,1420
158,WOLB.0323.00021,1,510648,512068,+,1420
158,WOLB.0323.00004,1,564602,566077,-,1475
158,WOLB.0323.00032,1,83474,84894,-,1420
158,WOLB.0323.00068,1,1199673,1201093,+,1420
158,WOLB.0323.00158,1,1219069,1220544,-,1475
157,WOLB.0323.00090,1,475044,476261,+,1217
157,WOLB.0323.00138,1,1468455,1469672,+,1217
157,WOLB.0323.00142,1,564022,565239,-,1217
157,WOLB.0323.00093,1,1326657,1327880,-,1223
157,WOLB.0323.00084,1,179922,181139,+,1217
157,WOLB.0323.00021,1,508375,509592,+,1217
157,WOLB.0323.00122,1,1142782,1144000,-,1218
157,WOLB.0323.00004,1,567133,568350,-,1217
157,WOLB.0323.00032,1,85950,87167,-,1217
157,WOLB.0323.00068,1,1197400,1198617,+,1217
157,WOLB.0323.00158,1,1221621,1222838,-,1217
156,WOLB.0323.00090,1,473895,474539,+,644
156,WOLB.0323.00138,1,1467307,1467951,+,644
156,WOLB.0323.00142,1,565744,566387,-,643
156,WOLB.0323.00084,1,178773,179417,+,644
156,WOLB.0323.00021,1,507226,507870,+,644
156,WOLB.0323.00122,1,1144505,1145148,-,643
156,WOLB.0323.00004,1,568855,569498,-,643
156,WOLB.0323.00032,1,87672,88315,-,643
156,WOLB.0323.00158,1,1223343,1223986,-,643
155,WOLB.0323.00090,1,471540,472364,+,824
155,WOLB.0323.00138,1,21327,22151,+,824
155,WOLB.0323.00138,1,188682,189506,-,824
155,WOLB.0323.00132,1,789252,790076,-,824
155,WOLB.0323.00121,1,481813,482637,+,824
155,WOLB.0323.00060,1,297808,298632,-,824
155,WOLB.0323.00056,1,1299547,1300371,+,824
155,WOLB.0323.00142,1,404752,405576,-,824
155,WOLB.0323.00023,1,1712934,1713758,-,824
155,WOLB.0323.00153,1,453251,454075,-,824
155,WOLB.0323.00153,1,524181,525005,-,824
155,WOLB.0323.00024,1,1307715,1308536,-,821
155,WOLB.0323.00030,1,628636,629460,-,824
155,WOLB.0323.00084,1,288042,288866,+,824
155,WOLB.0323.00021,1,790585,791409,-,824
155,WOLB.0323.00021,1,1239066,1239890,+,824
155,WOLB.0323.00043,1,538167,538991,-,824
155,WOLB.0323.00043,1,1112445,1113269,+,824
155,WOLB.0323.00122,1,1149554,1150378,+,824
155,WOLB.0323.00004,1,405193,406017,+,824
155,WOLB.0323.00011,1,1156338,1157162,+,824
155,WOLB.0323.00032,1,1348900,1349724,-,824
155,WOLB.0323.00010,1,1272597,1273421,-,824
155,WOLB.0323.00068,1,955582,956406,-,824
155,WOLB.0323.00128,1,813899,814723,-,824
155,WOLB.0323.00158,1,487571,488395,-,824
155,WOLB.0323.00017,1,480844,481668,+,824
155,WOLB.0323.00007,1,937379,938203,+,824
155,WOLB.0323.00070,1,610561,611385,-,824
155,WOLB.0323.00070,1,1106210,1107034,-,824
155,WOLB.0323.00070,1,1181920,1182744,+,824
155,WOLB.0323.00042,1,738023,738847,-,824
155,WOLB.0323.00149,1,59186,60010,-,824
155,WOLB.0323.00014,1,1283318,1284142,+,824
155,WOLB.0323.00014,1,1354473,1355297,+,824
154,WOLB.0323.00090,1,469597,470336,+,739
154,WOLB.0323.00138,1,190747,191449,-,702
154,WOLB.0323.00121,1,479870,480609,+,739
154,WOLB.0323.00135,1,1061810,1062549,+,739
154,WOLB.0323.00142,1,406781,407519,-,738
154,WOLB.0323.00153,1,455280,456018,-,738
154,WOLB.0323.00088,1,618851,619590,+,739
154,WOLB.0323.00084,1,286099,286801,+,702
154,WOLB.0323.00020,1,558591,559330,+,739
154,WOLB.0323.00122,1,1147611,1148350,+,739
154,WOLB.0323.00004,1,403250,403989,+,739
154,WOLB.0323.00011,1,1154395,1155134,+,739
154,WOLB.0323.00035,1,553966,554705,+,739
154,WOLB.0323.00032,1,1350965,1351667,-,702
154,WOLB.0323.00012,1,622955,623694,+,739
154,WOLB.0323.00018,1,837839,838577,-,738
154,WOLB.0323.00158,1,489600,490338,-,738
154,WOLB.0323.00017,1,478901,479640,+,739
154,WOLB.0323.00104,1,570628,571367,+,739
154,WOLB.0323.00100,1,877633,878372,+,739
154,WOLB.0323.00042,1,637689,638428,+,739
154,WOLB.0323.00042,1,769835,770573,-,738
154,WOLB.0323.00149,1,61215,61953,-,738
153,WOLB.0323.00090,1,461881,462455,+,574
153,WOLB.0323.00002,1,1187808,1188382,-,574
153,WOLB.0323.00138,1,93456,94030,+,574
153,WOLB.0323.00132,1,875681,876255,-,574
153,WOLB.0323.00143,1,628304,628878,+,574
153,WOLB.0323.00106,1,628305,628879,+,574
153,WOLB.0323.00121,1,530507,531081,+,574
153,WOLB.0323.00135,1,1022656,1023230,-,574
153,WOLB.0323.00103,1,1307448,1308022,+,574
153,WOLB.0323.00107,1,1305876,1306450,+,574
153,WOLB.0323.00019,1,747344,747918,-,574
153,WOLB.0323.00060,1,452326,452900,+,574
153,WOLB.0323.00039,1,91678,92252,+,574
153,WOLB.0323.00041,1,1344097,1344671,+,574
153,WOLB.0323.00031,1,158428,159002,-,574
153,WOLB.0323.00056,1,606133,606707,+,574
153,WOLB.0323.00142,1,621439,622013,+,574
153,WOLB.0323.00023,1,518253,518827,-,574
153,WOLB.0323.00153,1,464576,465150,-,574
153,WOLB.0323.00093,1,893376,893950,+,574
153,WOLB.0323.00088,1,660246,660820,+,574
153,WOLB.0323.00008,1,864730,865304,-,574
153,WOLB.0323.00024,1,1238280,1238853,+,573
153,WOLB.0323.00064,1,784370,784944,-,574
153,WOLB.0323.00030,1,1398803,1399377,-,574
153,WOLB.0323.00105,1,1307603,1308177,+,574
153,WOLB.0323.00133,1,406722,407290,+,568
153,WOLB.0323.00084,1,39874,40448,-,574
153,WOLB.0323.00021,1,441079,441653,-,574
153,WOLB.0323.00043,1,330941,331515,+,574
153,WOLB.0323.00020,1,601157,601731,+,574
153,WOLB.0323.00122,1,1032190,1032764,-,574
153,WOLB.0323.00118,1,425927,426501,+,574
153,WOLB.0323.00004,1,623645,624219,+,574
153,WOLB.0323.00011,1,34146,34720,+,574
153,WOLB.0323.00035,1,597386,597960,+,574
153,WOLB.0323.00032,1,1431478,1432052,+,574
153,WOLB.0323.00012,1,664348,664922,+,574
153,WOLB.0323.00018,1,454319,454893,+,574
153,WOLB.0323.00025,1,45023,45597,+,574
153,WOLB.0323.00010,1,1078309,1078883,-,574
153,WOLB.0323.00068,1,977931,978505,+,574
153,WOLB.0323.00128,1,1174461,1175035,-,574
153,WOLB.0323.00158,1,1254187,1254761,+,574
153,WOLB.0323.00017,1,611260,611834,+,574
153,WOLB.0323.00104,1,633803,634377,+,574
153,WOLB.0323.00007,1,740726,741300,-,574
153,WOLB.0323.00001,1,1307603,1308177,+,574
153,WOLB.0323.00100,1,924157,924731,+,574
153,WOLB.0323.00070,1,1506362,1506936,-,574
153,WOLB.0323.00006,1,1160311,1160885,+,574
153,WOLB.0323.00042,1,515040,515614,+,574
153,WOLB.0323.00119,1,430773,431347,+,574
153,WOLB.0323.00149,1,1218752,1219326,-,574
153,WOLB.0323.00014,1,1519392,1519966,-,574
152,WOLB.0323.00090,1,459158,461073,+,1915
152,WOLB.0323.00002,1,1189555,1191474,-,1919
152,WOLB.0323.00138,1,90733,92648,+,1915
152,WOLB.0323.00132,1,877332,879251,-,1919
152,WOLB.0323.00143,1,625567,627490,+,1923
152,WOLB.0323.00106,1,625568,627491,+,1923
152,WOLB.0323.00121,1,527784,529699,+,1915
152,WOLB.0323.00135,1,1024716,1026631,+,1915
152,WOLB.0323.00103,1,1304726,1306640,+,1914
152,WOLB.0323.00107,1,1303154,1305068,+,1914
152,WOLB.0323.00019,1,748725,750640,-,1915
152,WOLB.0323.00060,1,448923,450838,-,1915
152,WOLB.0323.00039,1,88956,90871,+,1915
152,WOLB.0323.00041,1,1341237,1343132,+,1895
152,WOLB.0323.00031,1,159816,161739,-,1923
152,WOLB.0323.00056,1,602730,604645,-,1915
152,WOLB.0323.00142,1,618716,620631,+,1915
152,WOLB.0323.00023,1,520000,521919,-,1919
152,WOLB.0323.00153,1,465958,467873,-,1915
152,WOLB.0323.00093,1,890668,892568,+,1900
152,WOLB.0323.00088,1,656851,658766,-,1915
152,WOLB.0323.00008,1,867219,869119,-,1900
152,WOLB.0323.00024,1,1235220,1237139,+,1919
152,WOLB.0323.00064,1,786117,788036,-,1919
152,WOLB.0323.00030,1,1400550,1402469,-,1919
152,WOLB.0323.00105,1,1304881,1306795,+,1914
152,WOLB.0323.00133,1,404010,405908,+,1898
152,WOLB.0323.00084,1,41256,43171,-,1915
152,WOLB.0323.00021,1,442461,444376,-,1915
152,WOLB.0323.00043,1,327849,329768,+,1919
152,WOLB.0323.00020,1,597762,599677,-,1915
152,WOLB.0323.00122,1,1033572,1035487,-,1915
152,WOLB.0323.00118,1,423226,425119,+,1893
152,WOLB.0323.00004,1,620922,622837,+,1915
152,WOLB.0323.00011,1,31423,33338,+,1915
152,WOLB.0323.00035,1,593991,595906,-,1915
152,WOLB.0323.00032,1,1428755,1430670,+,1915
152,WOLB.0323.00012,1,660953,662868,-,1915
152,WOLB.0323.00018,1,451227,453146,+,1919
152,WOLB.0323.00025,1,1097942,1099835,+,1893
152,WOLB.0323.00010,1,1080056,1081975,-,1919
152,WOLB.0323.00068,1,975208,977123,+,1915
152,WOLB.0323.00128,1,1176208,1178127,-,1919
152,WOLB.0323.00158,1,1251464,1253379,+,1915
152,WOLB.0323.00017,1,608537,610452,+,1915
152,WOLB.0323.00104,1,630408,632323,-,1915
152,WOLB.0323.00007,1,742788,744703,+,1915
152,WOLB.0323.00001,1,1304881,1306795,+,1914
152,WOLB.0323.00100,1,920762,922677,-,1915
152,WOLB.0323.00070,1,1508109,1510028,-,1919
152,WOLB.0323.00006,1,1157574,1159497,+,1923
152,WOLB.0323.00042,1,511108,513026,+,1918
152,WOLB.0323.00119,1,428051,429966,+,1915
152,WOLB.0323.00149,1,1220134,1222049,-,1915
152,WOLB.0323.00014,1,1521139,1523058,-,1919
151,WOLB.0323.00090,1,453950,455065,+,1115
151,WOLB.0323.00153,1,471965,473081,-,1116
150,WOLB.0323.00090,1,450531,451124,+,593
150,WOLB.0323.00060,1,414012,414605,+,593
150,WOLB.0323.00056,1,571037,571630,+,593
150,WOLB.0323.00142,1,568497,569090,+,593
150,WOLB.0323.00088,1,574335,574929,+,594
150,WOLB.0323.00084,1,264798,265390,-,592
150,WOLB.0323.00021,1,777973,778566,+,593
150,WOLB.0323.00020,1,507880,508474,+,594
150,WOLB.0323.00004,1,571608,572201,+,593
150,WOLB.0323.00035,1,509450,510044,+,594
150,WOLB.0323.00012,1,578439,579033,+,594
150,WOLB.0323.00104,1,526112,526706,+,594
150,WOLB.0323.00007,1,777897,778489,-,592
150,WOLB.0323.00100,1,833117,833711,+,594
149,WOLB.0323.00090,1,444666,446079,+,1413
149,WOLB.0323.00002,1,923863,925282,+,1419
149,WOLB.0323.00138,1,98140,99554,-,1414
149,WOLB.0323.00132,1,536611,538030,+,1419
149,WOLB.0323.00143,1,673023,674442,-,1419
149,WOLB.0323.00106,1,673024,674443,-,1419
149,WOLB.0323.00121,1,560473,561886,+,1413
149,WOLB.0323.00135,1,1098694,1100108,-,1414
149,WOLB.0323.00103,1,597290,598703,+,1413
149,WOLB.0323.00107,1,597287,598700,+,1413
149,WOLB.0323.00019,1,768934,770353,-,1419
149,WOLB.0323.00060,1,341141,342555,-,1414
149,WOLB.0323.00074,1,553002,554421,-,1419
149,WOLB.0323.00120,1,539173,540592,-,1419
149,WOLB.0323.00039,1,29365,30784,+,1419
149,WOLB.0323.00041,1,1076409,1077828,+,1419
149,WOLB.0323.00031,1,112864,114283,+,1419
149,WOLB.0323.00056,1,1266802,1268216,-,1414
149,WOLB.0323.00142,1,650633,652046,+,1413
149,WOLB.0323.00023,1,1870560,1871979,+,1419
149,WOLB.0323.00153,1,418164,419578,-,1414
149,WOLB.0323.00093,1,880302,881721,+,1419
149,WOLB.0323.00088,1,570024,571437,+,1413
149,WOLB.0323.00008,1,879758,881177,-,1419
149,WOLB.0323.00024,1,1561433,1562852,-,1419
149,WOLB.0323.00064,1,630306,631725,-,1419
149,WOLB.0323.00030,1,876102,877521,+,1419
149,WOLB.0323.00105,1,597299,598712,+,1413
149,WOLB.0323.00133,1,162234,163648,-,1414
149,WOLB.0323.00084,1,31851,33264,+,1413
149,WOLB.0323.00021,1,404814,406228,-,1414
149,WOLB.0323.00043,1,831894,833313,+,1419
149,WOLB.0323.00020,1,503204,504617,+,1413
149,WOLB.0323.00122,1,1002155,1003569,-,1414
149,WOLB.0323.00118,1,1071469,1072888,-,1419
149,WOLB.0323.00004,1,651736,653149,+,1413
149,WOLB.0323.00011,1,1161035,1162449,-,1414
149,WOLB.0323.00035,1,505139,506552,+,1413
149,WOLB.0323.00032,1,1440030,1441444,-,1414
149,WOLB.0323.00012,1,574128,575541,+,1413
149,WOLB.0323.00018,1,693849,695268,+,1419
149,WOLB.0323.00025,1,296553,297972,-,1419
149,WOLB.0323.00010,1,822292,823710,-,1418
149,WOLB.0323.00068,1,982615,984029,-,1414
149,WOLB.0323.00128,1,830052,831471,-,1419
149,WOLB.0323.00158,1,1282278,1283691,+,1413
149,WOLB.0323.00017,1,639351,640764,+,1413
149,WOLB.0323.00104,1,521838,523214,+,1376
149,WOLB.0323.00007,1,781387,782801,-,1414
149,WOLB.0323.00001,1,597299,598712,+,1413
149,WOLB.0323.00100,1,828806,830219,+,1413
149,WOLB.0323.00070,1,931110,932529,-,1419
149,WOLB.0323.00006,1,90264,91683,-,1419
149,WOLB.0323.00042,1,863805,865224,+,1419
149,WOLB.0323.00119,1,389401,390820,-,1419
149,WOLB.0323.00149,1,1189821,1191235,-,1414
149,WOLB.0323.00014,1,784440,785859,+,1419
149,WOLB.0323.00096,1,1114343,1115762,+,1419
148,WOLB.0323.00090,1,435677,444664,+,8987
148,WOLB.0323.00002,1,914874,923861,+,8987
148,WOLB.0323.00138,1,99555,108543,-,8988
148,WOLB.0323.00132,1,527622,536609,+,8987
148,WOLB.0323.00143,1,674443,683424,-,8981
148,WOLB.0323.00106,1,674444,683425,-,8981
148,WOLB.0323.00121,1,551484,560471,+,8987
148,WOLB.0323.00135,1,1100109,1109097,-,8988
148,WOLB.0323.00103,1,588316,597288,+,8972
148,WOLB.0323.00107,1,588313,597285,+,8972
148,WOLB.0323.00019,1,770354,779342,-,8988
148,WOLB.0323.00060,1,342556,351544,-,8988
148,WOLB.0323.00074,1,554422,563391,-,8969
148,WOLB.0323.00120,1,540593,549562,-,8969
148,WOLB.0323.00039,1,20376,29363,+,8987
148,WOLB.0323.00041,1,1067439,1076407,+,8968
148,WOLB.0323.00031,1,103882,112862,+,8980
148,WOLB.0323.00056,1,1268217,1277205,-,8988
148,WOLB.0323.00142,1,641644,650631,+,8987
148,WOLB.0323.00023,1,1861571,1870558,+,8987
148,WOLB.0323.00153,1,419579,428567,-,8988
148,WOLB.0323.00093,1,871332,880300,+,8968
148,WOLB.0323.00088,1,561035,570022,+,8987
148,WOLB.0323.00008,1,881178,890147,-,8969
148,WOLB.0323.00024,1,1562853,1571838,-,8985
148,WOLB.0323.00064,1,631726,640714,-,8988
148,WOLB.0323.00030,1,867113,876100,+,8987
148,WOLB.0323.00105,1,588325,597297,+,8972
148,WOLB.0323.00133,1,163649,172610,-,8961
148,WOLB.0323.00084,1,22862,31849,+,8987
148,WOLB.0323.00021,1,406229,415217,-,8988
148,WOLB.0323.00043,1,822905,831892,+,8987
148,WOLB.0323.00020,1,494215,503202,+,8987
148,WOLB.0323.00122,1,1003570,1012558,-,8988
148,WOLB.0323.00118,1,1072889,1081877,-,8988
148,WOLB.0323.00004,1,642747,651734,+,8987
148,WOLB.0323.00011,1,1162450,1171438,-,8988
148,WOLB.0323.00035,1,496150,505137,+,8987
148,WOLB.0323.00032,1,1441445,1450433,-,8988
148,WOLB.0323.00012,1,565139,574126,+,8987
148,WOLB.0323.00018,1,684860,693847,+,8987
148,WOLB.0323.00025,1,297973,306955,-,8982
148,WOLB.0323.00010,1,823711,832699,-,8988
148,WOLB.0323.00068,1,984030,993018,-,8988
148,WOLB.0323.00128,1,831472,840460,-,8988
148,WOLB.0323.00158,1,1273289,1282276,+,8987
148,WOLB.0323.00017,1,630362,639349,+,8987
148,WOLB.0323.00104,1,511870,520873,+,9003
148,WOLB.0323.00007,1,782802,791790,-,8988
148,WOLB.0323.00001,1,588325,597297,+,8972
148,WOLB.0323.00100,1,819817,828804,+,8987
148,WOLB.0323.00070,1,932530,941518,-,8988
148,WOLB.0323.00006,1,91684,100665,-,8981
148,WOLB.0323.00042,1,854816,863803,+,8987
148,WOLB.0323.00119,1,390821,399809,-,8988
148,WOLB.0323.00149,1,1191236,1200224,-,8988
148,WOLB.0323.00014,1,775451,784438,+,8987
148,WOLB.0323.00096,1,1105373,1114341,+,8968
147,WOLB.0323.00090,1,424877,425635,+,758
147,WOLB.0323.00138,1,118587,119344,-,757
147,WOLB.0323.00121,1,538809,539567,+,758
147,WOLB.0323.00103,1,570659,571411,+,752
147,WOLB.0323.00107,1,570657,571409,+,752
147,WOLB.0323.00060,1,365249,366006,-,757
147,WOLB.0323.00074,1,845872,846629,-,757
147,WOLB.0323.00120,1,831731,832488,-,757
147,WOLB.0323.00041,1,791875,792633,+,758
147,WOLB.0323.00056,1,1226829,1227586,-,757
147,WOLB.0323.00056,1,1287247,1288004,-,757
147,WOLB.0323.00142,1,629741,630499,+,758
147,WOLB.0323.00023,1,691112,691870,+,758
147,WOLB.0323.00153,1,438609,439366,-,757
147,WOLB.0323.00088,1,630292,631050,+,758
147,WOLB.0323.00024,1,154963,155718,+,755
147,WOLB.0323.00064,1,1222225,1222979,-,754
147,WOLB.0323.00030,1,1686720,1687475,+,755
147,WOLB.0323.00105,1,570668,571420,+,752
147,WOLB.0323.00133,1,251195,251949,-,754
147,WOLB.0323.00084,1,12061,12819,+,758
147,WOLB.0323.00021,1,425260,426017,-,757
147,WOLB.0323.00043,1,905076,905844,-,768
147,WOLB.0323.00020,1,570032,570790,+,758
147,WOLB.0323.00122,1,1022600,1023357,-,757
147,WOLB.0323.00004,1,631947,632705,+,758
147,WOLB.0323.00011,1,1181480,1182237,-,757
147,WOLB.0323.00035,1,565407,566165,+,758
147,WOLB.0323.00032,1,1460476,1461233,-,757
147,WOLB.0323.00012,1,634396,635154,+,758
147,WOLB.0323.00018,1,888157,888915,-,758
147,WOLB.0323.00010,1,384383,385152,+,769
147,WOLB.0323.00068,1,1003061,1003818,-,757
147,WOLB.0323.00128,1,494787,495555,+,768
147,WOLB.0323.00158,1,1262489,1263247,+,758
147,WOLB.0323.00017,1,619562,620320,+,758
147,WOLB.0323.00007,1,801832,802589,-,757
147,WOLB.0323.00007,1,840716,841473,-,757
147,WOLB.0323.00001,1,570668,571420,+,752
147,WOLB.0323.00100,1,894199,894957,+,758
147,WOLB.0323.00070,1,1356675,1357443,-,768
147,WOLB.0323.00006,1,117543,118296,-,753
147,WOLB.0323.00149,1,1210266,1211023,-,757
147,WOLB.0323.00096,1,829747,830505,+,758
146,WOLB.0323.00090,1,422978,423869,+,891
146,WOLB.0323.00138,1,120353,121244,-,891
146,WOLB.0323.00143,1,851379,852289,-,910
146,WOLB.0323.00106,1,851382,852292,-,910
146,WOLB.0323.00121,1,536910,537801,+,891
146,WOLB.0323.00103,1,568742,569654,+,912
146,WOLB.0323.00107,1,568740,569652,+,912
146,WOLB.0323.00060,1,367015,367906,-,891
146,WOLB.0323.00039,1,195109,196000,-,891
146,WOLB.0323.00041,1,1309470,1310355,+,885
146,WOLB.0323.00031,1,1208548,1209458,+,910
146,WOLB.0323.00056,1,1228595,1229469,-,874
146,WOLB.0323.00142,1,627842,628733,+,891
146,WOLB.0323.00153,1,440375,441266,-,891
146,WOLB.0323.00105,1,568751,569663,+,912
146,WOLB.0323.00133,1,252959,253851,-,892
146,WOLB.0323.00084,1,10162,11053,+,891
146,WOLB.0323.00021,1,427026,427917,-,891
146,WOLB.0323.00122,1,1024366,1025257,-,891
146,WOLB.0323.00004,1,630048,630939,+,891
146,WOLB.0323.00011,1,1183246,1184137,-,891
146,WOLB.0323.00032,1,1462242,1463133,-,891
146,WOLB.0323.00068,1,1004827,1005718,-,891
146,WOLB.0323.00158,1,1260590,1261481,+,891
146,WOLB.0323.00017,1,617663,618554,+,891
146,WOLB.0323.00007,1,842482,843373,-,891
146,WOLB.0323.00001,1,568751,569663,+,912
146,WOLB.0323.00006,1,1001198,1002108,+,910
146,WOLB.0323.00149,1,1212032,1212923,-,891
145,WOLB.0323.00090,1,420218,422839,+,2621
145,WOLB.0323.00143,1,852430,855048,-,2618
145,WOLB.0323.00106,1,852433,855051,-,2618
145,WOLB.0323.00103,1,565982,568603,+,2621
145,WOLB.0323.00107,1,565980,568601,+,2621
145,WOLB.0323.00060,1,368045,370666,-,2621
145,WOLB.0323.00039,1,196139,198760,-,2621
145,WOLB.0323.00041,1,1306711,1309331,+,2620
145,WOLB.0323.00031,1,1205789,1208407,+,2618
145,WOLB.0323.00153,1,441405,444026,-,2621
145,WOLB.0323.00105,1,565991,568612,+,2621
145,WOLB.0323.00133,1,253989,256577,-,2588
145,WOLB.0323.00007,1,843512,846133,-,2621
145,WOLB.0323.00001,1,565991,568612,+,2621
145,WOLB.0323.00006,1,998440,1001057,+,2617
144,WOLB.0323.00090,1,419063,420128,+,1065
144,WOLB.0323.00143,1,855138,856200,-,1062
144,WOLB.0323.00106,1,855141,856203,-,1062
144,WOLB.0323.00103,1,564827,565892,+,1065
144,WOLB.0323.00107,1,564825,565890,+,1065
144,WOLB.0323.00060,1,370756,371821,-,1065
144,WOLB.0323.00039,1,1334176,1335241,+,1065
144,WOLB.0323.00041,1,1305556,1306621,+,1065
144,WOLB.0323.00031,1,1204637,1205699,+,1062
144,WOLB.0323.00056,1,1230909,1231974,-,1065
144,WOLB.0323.00153,1,444116,445181,-,1065
144,WOLB.0323.00105,1,564836,565901,+,1065
144,WOLB.0323.00133,1,256667,257732,-,1065
144,WOLB.0323.00007,1,846223,847288,-,1065
144,WOLB.0323.00001,1,564836,565901,+,1065
144,WOLB.0323.00006,1,997288,998350,+,1062
143,WOLB.0323.00090,1,414838,415724,+,886
143,WOLB.0323.00002,1,1150389,1151276,-,887
143,WOLB.0323.00132,1,763294,764181,-,887
143,WOLB.0323.00143,1,651921,652806,+,885
143,WOLB.0323.00106,1,651922,652807,+,885
143,WOLB.0323.00121,1,516680,517566,+,886
143,WOLB.0323.00135,1,1069589,1070475,+,886
143,WOLB.0323.00019,1,813085,813971,-,886
143,WOLB.0323.00060,1,139162,140030,-,868
143,WOLB.0323.00039,1,403874,404761,-,887
143,WOLB.0323.00031,1,134499,135385,-,886
143,WOLB.0323.00056,1,567280,568167,-,887
143,WOLB.0323.00142,1,588036,588923,-,887
143,WOLB.0323.00023,1,1770811,1771698,-,887
143,WOLB.0323.00153,1,448519,449406,-,887
143,WOLB.0323.00088,1,626631,627517,+,886
143,WOLB.0323.00008,1,233773,234660,-,887
143,WOLB.0323.00024,1,1448608,1449495,-,887
143,WOLB.0323.00030,1,414553,415440,-,887
143,WOLB.0323.00084,1,269815,270701,+,886
143,WOLB.0323.00043,1,1023186,1024073,-,887
143,WOLB.0323.00020,1,566371,567257,+,886
143,WOLB.0323.00118,1,1061975,1062861,+,886
143,WOLB.0323.00004,1,590242,591129,-,887
143,WOLB.0323.00011,1,1201353,1202239,+,886
143,WOLB.0323.00035,1,561746,562632,+,886
143,WOLB.0323.00032,1,1356446,1357332,+,886
143,WOLB.0323.00012,1,630735,631621,+,886
143,WOLB.0323.00018,1,679328,680215,-,887
143,WOLB.0323.00010,1,348213,349099,+,886
143,WOLB.0323.00068,1,400646,401532,+,886
143,WOLB.0323.00128,1,711861,712747,+,886
143,WOLB.0323.00100,1,885413,886299,+,886
143,WOLB.0323.00100,1,890538,891424,+,886
143,WOLB.0323.00070,1,668233,669120,-,887
143,WOLB.0323.00006,1,1183927,1184812,+,885
143,WOLB.0323.00042,1,1142556,1143443,-,887
143,WOLB.0323.00119,1,815739,816625,-,886
143,WOLB.0323.00149,1,1323609,1324495,+,886
143,WOLB.0323.00149,1,1346153,1347040,-,887
143,WOLB.0323.00014,1,907063,907950,-,887
142,WOLB.0323.00090,1,412922,413460,+,538
142,WOLB.0323.00090,1,447484,448023,-,539
142,WOLB.0323.00121,1,514764,515302,+,538
142,WOLB.0323.00121,1,563291,563830,-,539
142,WOLB.0323.00135,1,1067674,1068212,+,538
142,WOLB.0323.00135,1,1096752,1097290,+,538
142,WOLB.0323.00060,1,141407,141946,-,539
142,WOLB.0323.00060,1,412519,413058,-,539
142,WOLB.0323.00056,1,569544,570083,-,539
142,WOLB.0323.00056,1,1264859,1265397,+,538
142,WOLB.0323.00142,1,590300,590839,-,539
142,WOLB.0323.00142,1,653451,653990,-,539
142,WOLB.0323.00153,1,416232,416770,+,538
142,WOLB.0323.00153,1,450783,451322,-,539
142,WOLB.0323.00088,1,572842,573381,-,539
142,WOLB.0323.00088,1,624715,625253,+,538
142,WOLB.0323.00030,1,416817,417356,-,539
142,WOLB.0323.00084,1,34669,35208,-,539
142,WOLB.0323.00084,1,267899,268437,+,538
142,WOLB.0323.00020,1,564455,564993,+,538
142,WOLB.0323.00122,1,1000212,1000750,+,538
142,WOLB.0323.00118,1,1029185,1029724,-,539
142,WOLB.0323.00004,1,592506,593045,-,539
142,WOLB.0323.00004,1,654554,655093,-,539
142,WOLB.0323.00011,1,1159092,1159630,+,538
142,WOLB.0323.00011,1,1199437,1199975,+,538
142,WOLB.0323.00035,1,507957,508496,-,539
142,WOLB.0323.00035,1,559830,560368,+,538
142,WOLB.0323.00032,1,1354530,1355068,+,538
142,WOLB.0323.00032,1,1438087,1438625,+,538
142,WOLB.0323.00012,1,576946,577485,-,539
142,WOLB.0323.00012,1,628819,629357,+,538
142,WOLB.0323.00068,1,1171881,1172419,+,538
142,WOLB.0323.00158,1,1285096,1285635,-,539
142,WOLB.0323.00017,1,642169,642708,-,539
142,WOLB.0323.00104,1,524619,525158,-,539
142,WOLB.0323.00007,1,779444,779982,+,538
142,WOLB.0323.00100,1,831624,832163,-,539
142,WOLB.0323.00100,1,883497,884035,+,538
142,WOLB.0323.00100,1,888622,889160,+,538
142,WOLB.0323.00149,1,1187878,1188416,+,538
142,WOLB.0323.00149,1,1321693,1322231,+,538
142,WOLB.0323.00149,1,1348417,1348956,-,539
141,WOLB.0323.00090,1,406912,409682,+,2770
141,WOLB.0323.00002,1,1181394,1184194,-,2800
141,WOLB.0323.00138,1,131312,134112,-,2800
141,WOLB.0323.00132,1,870602,873396,-,2794
141,WOLB.0323.00143,1,631171,633971,+,2800
141,WOLB.0323.00106,1,631172,633972,+,2800
141,WOLB.0323.00121,1,571366,574166,-,2800
141,WOLB.0323.00135,1,1078961,1081761,-,2800
141,WOLB.0323.00103,1,1311501,1314301,+,2800
141,WOLB.0323.00107,1,1309929,1312729,+,2800
141,WOLB.0323.00019,1,635675,638475,-,2800
141,WOLB.0323.00060,1,359968,362768,-,2800
141,WOLB.0323.00074,1,69040,71840,-,2800
141,WOLB.0323.00120,1,69035,71835,-,2800
141,WOLB.0323.00039,1,1320741,1323540,-,2799
141,WOLB.0323.00041,1,69035,71835,-,2800
141,WOLB.0323.00031,1,153335,156135,-,2800
141,WOLB.0323.00056,1,1221548,1224348,-,2800
141,WOLB.0323.00142,1,661526,664326,-,2800
141,WOLB.0323.00023,1,513176,515976,-,2800
141,WOLB.0323.00153,1,410213,412992,+,2779
141,WOLB.0323.00093,1,720612,723373,+,2761
141,WOLB.0323.00088,1,549755,552555,+,2800
141,WOLB.0323.00008,1,685221,687982,-,2761
141,WOLB.0323.00024,1,1244768,1247568,+,2800
141,WOLB.0323.00064,1,779293,782093,-,2800
141,WOLB.0323.00030,1,1202220,1205020,-,2800
141,WOLB.0323.00105,1,1311656,1314456,+,2800
141,WOLB.0323.00133,1,494017,496814,+,2797
141,WOLB.0323.00084,1,2398,5198,-,2800
141,WOLB.0323.00021,1,432881,435681,+,2800
141,WOLB.0323.00043,1,333784,336584,+,2800
141,WOLB.0323.00020,1,482935,485735,+,2800
141,WOLB.0323.00122,1,987683,990483,+,2800
141,WOLB.0323.00118,1,1022324,1025124,+,2800
141,WOLB.0323.00004,1,662629,665429,-,2800
141,WOLB.0323.00011,1,1189101,1191901,+,2800
141,WOLB.0323.00035,1,484870,487670,+,2800
141,WOLB.0323.00032,1,1471832,1474632,-,2800
141,WOLB.0323.00012,1,553859,556659,+,2800
141,WOLB.0323.00018,1,457155,459955,+,2800
141,WOLB.0323.00025,1,1100374,1103174,+,2800
141,WOLB.0323.00010,1,1073247,1076047,-,2800
141,WOLB.0323.00068,1,559111,561911,+,2800
141,WOLB.0323.00128,1,1169392,1172192,-,2800
141,WOLB.0323.00158,1,1294274,1297074,-,2800
141,WOLB.0323.00017,1,651347,654147,-,2800
141,WOLB.0323.00104,1,500590,503390,+,2800
141,WOLB.0323.00007,1,835435,838235,-,2800
141,WOLB.0323.00001,1,1311656,1314456,+,2800
141,WOLB.0323.00100,1,808537,811337,+,2800
141,WOLB.0323.00070,1,1501293,1504093,-,2800
141,WOLB.0323.00006,1,1163177,1165977,+,2800
141,WOLB.0323.00042,1,518821,521621,+,2800
141,WOLB.0323.00119,1,540109,542909,+,2800
141,WOLB.0323.00149,1,1177542,1180342,+,2800
141,WOLB.0323.00014,1,1514323,1517123,-,2800
141,WOLB.0323.00096,1,82844,85644,-,2800
140,WOLB.0323.00090,1,404361,405321,+,960
140,WOLB.0323.00002,1,488582,489542,+,960
140,WOLB.0323.00138,1,83660,84620,+,960
140,WOLB.0323.00132,1,730256,731216,-,960
140,WOLB.0323.00143,1,619384,620344,+,960
140,WOLB.0323.00106,1,619385,620345,+,960
140,WOLB.0323.00121,1,520705,521665,+,960
140,WOLB.0323.00135,1,1235192,1236152,-,960
140,WOLB.0323.00103,1,1297915,1298875,+,960
140,WOLB.0323.00107,1,1296178,1297138,+,960
140,WOLB.0323.00019,1,791546,792506,-,960
140,WOLB.0323.00060,1,92447,93407,+,960
140,WOLB.0323.00074,1,834463,835419,+,956
140,WOLB.0323.00074,1,835469,836394,+,925
140,WOLB.0323.00120,1,820424,821384,+,960
140,WOLB.0323.00039,1,406693,407653,-,960
140,WOLB.0323.00041,1,802111,803071,-,960
140,WOLB.0323.00031,1,166962,167922,-,960
140,WOLB.0323.00056,1,418165,419125,+,960
140,WOLB.0323.00142,1,611637,612597,+,960
140,WOLB.0323.00023,1,321415,322375,-,960
140,WOLB.0323.00153,1,407662,408622,+,960
140,WOLB.0323.00093,1,277017,277977,-,960
140,WOLB.0323.00088,1,480797,481757,+,960
140,WOLB.0323.00008,1,123814,124774,+,960
140,WOLB.0323.00024,1,15860,16820,-,960
140,WOLB.0323.00064,1,224635,225595,+,960
140,WOLB.0323.00030,1,794140,795100,+,960
140,WOLB.0323.00105,1,1297923,1298883,+,960
140,WOLB.0323.00133,1,1211919,1212879,+,960
140,WOLB.0323.00084,1,49284,50245,-,961
140,WOLB.0323.00021,1,450489,451449,-,960
140,WOLB.0323.00043,1,1185196,1186156,-,960
140,WOLB.0323.00020,1,450565,451525,+,960
140,WOLB.0323.00122,1,1043812,1044772,-,960
140,WOLB.0323.00118,1,415017,415977,+,960
140,WOLB.0323.00004,1,613843,614803,+,960
140,WOLB.0323.00011,1,24344,25304,+,960
140,WOLB.0323.00035,1,406288,407248,+,960
140,WOLB.0323.00032,1,1421682,1422642,+,960
140,WOLB.0323.00012,1,481939,482899,+,960
140,WOLB.0323.00018,1,448280,449240,+,960
140,WOLB.0323.00025,1,1095773,1096733,+,960
140,WOLB.0323.00010,1,1083809,1084769,-,960
140,WOLB.0323.00068,1,968135,969095,+,960
140,WOLB.0323.00128,1,1000128,1001088,-,960
140,WOLB.0323.00158,1,1244385,1245345,+,960
140,WOLB.0323.00017,1,600355,601315,+,960
140,WOLB.0323.00104,1,409630,410590,+,960
140,WOLB.0323.00007,1,1012327,1013287,-,960
140,WOLB.0323.00001,1,1297923,1298883,+,960
140,WOLB.0323.00100,1,557532,558492,+,960
140,WOLB.0323.00070,1,825465,826425,+,960
140,WOLB.0323.00006,1,1151391,1152351,+,960
140,WOLB.0323.00042,1,503590,504550,+,960
140,WOLB.0323.00119,1,386187,387147,+,960
140,WOLB.0323.00149,1,1228168,1229128,-,960
140,WOLB.0323.00014,1,507744,508704,+,960
140,WOLB.0323.00096,1,839983,840943,-,960
139,WOLB.0323.00090,1,400899,402647,+,1748
139,WOLB.0323.00002,1,484861,486610,+,1749
139,WOLB.0323.00138,1,194094,195843,-,1749
139,WOLB.0323.00132,1,424699,426448,+,1749
139,WOLB.0323.00143,1,872574,874290,-,1716
139,WOLB.0323.00106,1,872577,874293,-,1716
139,WOLB.0323.00121,1,475476,477226,+,1750
139,WOLB.0323.00135,1,1238073,1239822,-,1749
139,WOLB.0323.00103,1,1293040,1294790,+,1750
139,WOLB.0323.00107,1,1291303,1293053,+,1750
139,WOLB.0323.00019,1,794290,796040,-,1750
139,WOLB.0323.00060,1,89056,90805,+,1749
139,WOLB.0323.00074,1,830793,832542,+,1749
139,WOLB.0323.00120,1,816754,818503,+,1749
139,WOLB.0323.00039,1,409437,411187,-,1750
139,WOLB.0323.00041,1,804992,806741,-,1749
139,WOLB.0323.00031,1,1186547,1188263,+,1716
139,WOLB.0323.00056,1,414774,416523,+,1749
139,WOLB.0323.00142,1,401291,403041,+,1750
139,WOLB.0323.00023,1,1381270,1383019,+,1749
139,WOLB.0323.00153,1,404200,405948,+,1748
139,WOLB.0323.00093,1,279634,281384,-,1750
139,WOLB.0323.00088,1,477335,479083,+,1748
139,WOLB.0323.00008,1,119322,121072,+,1750
139,WOLB.0323.00024,1,644640,646389,+,1749
139,WOLB.0323.00064,1,158889,160638,+,1749
139,WOLB.0323.00030,1,776209,777958,+,1749
139,WOLB.0323.00105,1,1293048,1294798,+,1750
139,WOLB.0323.00133,1,356322,358070,-,1748
139,WOLB.0323.00084,1,290570,292319,-,1749
139,WOLB.0323.00021,1,773934,775683,+,1749
139,WOLB.0323.00043,1,1188127,1189876,-,1749
139,WOLB.0323.00020,1,447107,448851,+,1744
139,WOLB.0323.00122,1,1152090,1153840,-,1750
139,WOLB.0323.00118,1,411348,413097,+,1749
139,WOLB.0323.00004,1,398856,400606,+,1750
139,WOLB.0323.00011,1,1150001,1151751,+,1750
139,WOLB.0323.00035,1,402826,404574,+,1748
139,WOLB.0323.00032,1,1345448,1347197,+,1749
139,WOLB.0323.00012,1,478481,480225,+,1744
139,WOLB.0323.00018,1,444746,446495,+,1749
139,WOLB.0323.00025,1,403798,405517,-,1719
139,WOLB.0323.00010,1,1086576,1088294,-,1718
139,WOLB.0323.00068,1,421604,423353,-,1749
139,WOLB.0323.00128,1,1003060,1004809,-,1749
139,WOLB.0323.00158,1,492983,494733,-,1750
139,WOLB.0323.00017,1,474507,476257,+,1750
139,WOLB.0323.00104,1,406168,407916,+,1748
139,WOLB.0323.00007,1,1014929,1016678,-,1749
139,WOLB.0323.00001,1,1293048,1294798,+,1750
139,WOLB.0323.00100,1,554074,555818,+,1744
139,WOLB.0323.00070,1,821744,823493,+,1749
139,WOLB.0323.00006,1,152654,154370,-,1716
139,WOLB.0323.00042,1,498960,500678,+,1718
139,WOLB.0323.00119,1,382653,384403,+,1750
139,WOLB.0323.00149,1,64598,66348,-,1750
139,WOLB.0323.00014,1,504023,505772,+,1749
139,WOLB.0323.00096,1,842864,844613,-,1749
138,WOLB.0323.00090,1,399043,400782,+,1739
138,WOLB.0323.00002,1,482400,484139,+,1739
138,WOLB.0323.00138,1,196566,198305,-,1739
138,WOLB.0323.00132,1,422238,423977,+,1739
138,WOLB.0323.00143,1,875033,876772,-,1739
138,WOLB.0323.00106,1,875036,876775,-,1739
138,WOLB.0323.00121,1,473014,474753,+,1739
138,WOLB.0323.00135,1,1240545,1242284,-,1739
138,WOLB.0323.00103,1,1291185,1292924,+,1739
138,WOLB.0323.00107,1,1289448,1291187,+,1739
138,WOLB.0323.00019,1,796157,797896,-,1739
138,WOLB.0323.00060,1,86594,88333,+,1739
138,WOLB.0323.00074,1,828331,830070,+,1739
138,WOLB.0323.00120,1,814292,816031,+,1739
138,WOLB.0323.00039,1,411304,413043,-,1739
138,WOLB.0323.00041,1,807464,809203,-,1739
138,WOLB.0323.00031,1,1184065,1185804,+,1739
138,WOLB.0323.00056,1,412312,414051,+,1739
138,WOLB.0323.00142,1,398829,400568,+,1739
138,WOLB.0323.00023,1,1378808,1380547,+,1739
138,WOLB.0323.00153,1,402344,404083,+,1739
138,WOLB.0323.00093,1,282107,283846,-,1739
138,WOLB.0323.00088,1,474873,476612,+,1739
138,WOLB.0323.00008,1,116861,118600,+,1739
138,WOLB.0323.00024,1,642179,643918,+,1739
138,WOLB.0323.00064,1,156427,158166,+,1739
138,WOLB.0323.00030,1,773746,775485,+,1739
138,WOLB.0323.00105,1,1291193,1292932,+,1739
138,WOLB.0323.00133,1,358189,359916,-,1727
138,WOLB.0323.00084,1,293042,294781,-,1739
138,WOLB.0323.00021,1,771472,773211,+,1739
138,WOLB.0323.00043,1,1190598,1192337,-,1739
138,WOLB.0323.00020,1,444641,446380,+,1739
138,WOLB.0323.00122,1,1153957,1155696,-,1739
138,WOLB.0323.00118,1,409492,411231,+,1739
138,WOLB.0323.00004,1,396394,398133,+,1739
138,WOLB.0323.00011,1,1147539,1149278,+,1739
138,WOLB.0323.00035,1,400364,402103,+,1739
138,WOLB.0323.00032,1,1342986,1344725,+,1739
138,WOLB.0323.00012,1,476015,477754,+,1739
138,WOLB.0323.00018,1,442284,444023,+,1739
138,WOLB.0323.00025,1,406298,408037,-,1739
138,WOLB.0323.00010,1,1089019,1090746,-,1727
138,WOLB.0323.00068,1,424076,425815,-,1739
138,WOLB.0323.00128,1,1005531,1007270,-,1739
138,WOLB.0323.00158,1,495456,497195,-,1739
138,WOLB.0323.00017,1,472045,473784,+,1739
138,WOLB.0323.00104,1,403706,405445,+,1739
138,WOLB.0323.00007,1,1017401,1019140,-,1739
138,WOLB.0323.00001,1,1291193,1292932,+,1739
138,WOLB.0323.00100,1,551608,553347,+,1739
138,WOLB.0323.00070,1,819283,821022,+,1739
138,WOLB.0323.00006,1,155113,156852,-,1739
138,WOLB.0323.00042,1,496502,498241,+,1739
138,WOLB.0323.00119,1,380797,382536,+,1739
138,WOLB.0323.00149,1,67071,68810,-,1739
138,WOLB.0323.00014,1,501562,503301,+,1739
138,WOLB.0323.00096,1,845336,847075,-,1739
137,WOLB.0323.00090,1,397014,398587,+,1573
137,WOLB.0323.00002,1,480371,481944,+,1573
137,WOLB.0323.00138,1,198761,200333,-,1572
137,WOLB.0323.00132,1,420190,421765,+,1575
137,WOLB.0323.00143,1,877248,878838,-,1590
137,WOLB.0323.00106,1,877251,878841,-,1590
137,WOLB.0323.00121,1,470985,472558,+,1573
137,WOLB.0323.00135,1,1242740,1244312,-,1572
137,WOLB.0323.00103,1,1289155,1290730,+,1575
137,WOLB.0323.00107,1,1287418,1288993,+,1575
137,WOLB.0323.00019,1,1272930,1274520,+,1590
137,WOLB.0323.00060,1,84565,86138,+,1573
137,WOLB.0323.00074,1,826296,827875,+,1579
137,WOLB.0323.00120,1,812257,813836,+,1579
137,WOLB.0323.00039,1,413519,415109,-,1590
137,WOLB.0323.00041,1,809659,811238,-,1579
137,WOLB.0323.00031,1,1181999,1183589,+,1590
137,WOLB.0323.00056,1,410283,411856,+,1573
137,WOLB.0323.00142,1,396800,398373,+,1573
137,WOLB.0323.00023,1,1376779,1378352,+,1573
137,WOLB.0323.00153,1,400315,401888,+,1573
137,WOLB.0323.00093,1,284322,285892,-,1570
137,WOLB.0323.00088,1,472844,474417,+,1573
137,WOLB.0323.00008,1,112854,114436,+,1582
137,WOLB.0323.00024,1,640150,641723,+,1573
137,WOLB.0323.00064,1,154398,155971,+,1573
137,WOLB.0323.00030,1,771717,773290,+,1573
137,WOLB.0323.00105,1,1289163,1290738,+,1575
137,WOLB.0323.00133,1,360404,361994,-,1590
137,WOLB.0323.00084,1,295237,296809,-,1572
137,WOLB.0323.00021,1,769443,771016,+,1573
137,WOLB.0323.00043,1,1192792,1194364,-,1572
137,WOLB.0323.00020,1,442612,444185,+,1573
137,WOLB.0323.00122,1,1156152,1157724,-,1572
137,WOLB.0323.00118,1,407440,409015,+,1575
137,WOLB.0323.00004,1,394365,395938,+,1573
137,WOLB.0323.00011,1,1145510,1147083,+,1573
137,WOLB.0323.00035,1,398335,399908,+,1573
137,WOLB.0323.00032,1,1340957,1342530,+,1573
137,WOLB.0323.00012,1,473986,475559,+,1573
137,WOLB.0323.00018,1,440255,441828,+,1573
137,WOLB.0323.00025,1,408513,410103,-,1590
137,WOLB.0323.00010,1,1091202,1092786,-,1584
137,WOLB.0323.00068,1,426271,427843,-,1572
137,WOLB.0323.00128,1,1007726,1009298,-,1572
137,WOLB.0323.00158,1,497651,499223,-,1572
137,WOLB.0323.00017,1,470016,471589,+,1573
137,WOLB.0323.00104,1,400735,402308,+,1573
137,WOLB.0323.00007,1,1019596,1021168,-,1572
137,WOLB.0323.00001,1,1289163,1290738,+,1575
137,WOLB.0323.00100,1,549579,551152,+,1573
137,WOLB.0323.00070,1,817254,818827,+,1573
137,WOLB.0323.00006,1,157328,158918,-,1590
137,WOLB.0323.00042,1,494473,496046,+,1573
137,WOLB.0323.00119,1,1215592,1217182,-,1590
137,WOLB.0323.00149,1,69266,70838,-,1572
137,WOLB.0323.00014,1,499533,501106,+,1573
137,WOLB.0323.00096,1,847531,849110,-,1579
136,WOLB.0323.00090,1,394474,396131,+,1657
136,WOLB.0323.00002,1,477831,479488,+,1657
136,WOLB.0323.00138,1,201244,202901,-,1657
136,WOLB.0323.00132,1,417650,419307,+,1657
136,WOLB.0323.00143,1,880781,882436,-,1655
136,WOLB.0323.00106,1,880784,882439,-,1655
136,WOLB.0323.00121,1,468445,470102,+,1657
136,WOLB.0323.00135,1,1245196,1246853,-,1657
136,WOLB.0323.00103,1,1282346,1284021,+,1675
136,WOLB.0323.00107,1,1280609,1282284,+,1675
136,WOLB.0323.00019,1,1269320,1270975,+,1655
136,WOLB.0323.00060,1,82025,83682,+,1657
136,WOLB.0323.00074,1,75217,76872,-,1655
136,WOLB.0323.00120,1,75212,76867,-,1655
136,WOLB.0323.00039,1,417064,418719,-,1655
136,WOLB.0323.00041,1,75212,76867,-,1655
136,WOLB.0323.00031,1,1178401,1180056,+,1655
136,WOLB.0323.00056,1,407743,409400,+,1657
136,WOLB.0323.00142,1,394260,395917,+,1657
136,WOLB.0323.00023,1,1374239,1375896,+,1657
136,WOLB.0323.00153,1,397775,399432,+,1657
136,WOLB.0323.00093,1,717916,719559,+,1643
136,WOLB.0323.00088,1,470277,471934,+,1657
136,WOLB.0323.00008,1,689035,690679,-,1644
136,WOLB.0323.00024,1,636560,638215,+,1655
136,WOLB.0323.00064,1,151858,153515,+,1657
136,WOLB.0323.00030,1,769177,770834,+,1657
136,WOLB.0323.00105,1,1282354,1284029,+,1675
136,WOLB.0323.00133,1,89083,90740,-,1657
136,WOLB.0323.00084,1,297720,299377,-,1657
136,WOLB.0323.00021,1,766876,768533,+,1657
136,WOLB.0323.00043,1,1195248,1196905,-,1657
136,WOLB.0323.00020,1,440045,441702,+,1657
136,WOLB.0323.00122,1,1158608,1160265,-,1657
136,WOLB.0323.00118,1,404900,406557,+,1657
136,WOLB.0323.00004,1,391825,393482,+,1657
136,WOLB.0323.00011,1,1142970,1144627,+,1657
136,WOLB.0323.00035,1,395768,397425,+,1657
136,WOLB.0323.00032,1,1338390,1340047,+,1657
136,WOLB.0323.00012,1,471419,473076,+,1657
136,WOLB.0323.00018,1,436679,438336,+,1657
136,WOLB.0323.00025,1,411747,413404,-,1657
136,WOLB.0323.00010,1,1093658,1095315,-,1657
136,WOLB.0323.00068,1,428754,430411,-,1657
136,WOLB.0323.00128,1,1010182,1011839,-,1657
136,WOLB.0323.00158,1,500107,501764,-,1657
136,WOLB.0323.00017,1,467476,469133,+,1657
136,WOLB.0323.00104,1,398168,399825,+,1657
136,WOLB.0323.00007,1,1022052,1023709,-,1657
136,WOLB.0323.00001,1,1282354,1284029,+,1675
136,WOLB.0323.00100,1,547012,548669,+,1657
136,WOLB.0323.00070,1,814714,816371,+,1657
136,WOLB.0323.00006,1,160861,162516,-,1655
136,WOLB.0323.00042,1,491933,493590,+,1657
136,WOLB.0323.00119,1,1219137,1220792,-,1655
136,WOLB.0323.00149,1,71722,73379,-,1657
136,WOLB.0323.00014,1,496993,498650,+,1657
136,WOLB.0323.00096,1,89021,90676,-,1655
135,WOLB.0323.00090,1,393090,393616,+,526
135,WOLB.0323.00002,1,476414,476973,+,559
135,WOLB.0323.00138,1,203759,204284,-,525
135,WOLB.0323.00132,1,416266,416792,+,526
135,WOLB.0323.00121,1,467061,467587,+,526
135,WOLB.0323.00135,1,1247711,1248236,-,525
135,WOLB.0323.00103,1,1278029,1278589,+,560
135,WOLB.0323.00107,1,1276292,1276852,+,560
135,WOLB.0323.00060,1,80641,81167,+,526
135,WOLB.0323.00056,1,406359,406885,+,526
135,WOLB.0323.00142,1,392876,393402,+,526
135,WOLB.0323.00023,1,1372855,1373381,+,526
135,WOLB.0323.00153,1,396391,396917,+,526
135,WOLB.0323.00093,1,714963,715474,+,511
135,WOLB.0323.00088,1,468893,469419,+,526
135,WOLB.0323.00008,1,691657,692182,-,525
135,WOLB.0323.00024,1,635055,635580,+,525
135,WOLB.0323.00064,1,150474,151000,+,526
135,WOLB.0323.00030,1,767793,768319,+,526
135,WOLB.0323.00105,1,1278037,1278597,+,560
135,WOLB.0323.00133,1,91719,92244,-,525
135,WOLB.0323.00084,1,300235,300760,-,525
135,WOLB.0323.00021,1,765492,766018,+,526
135,WOLB.0323.00043,1,1197763,1198321,-,558
135,WOLB.0323.00020,1,438661,439187,+,526
135,WOLB.0323.00122,1,1161123,1161648,-,525
135,WOLB.0323.00118,1,403516,404042,+,526
135,WOLB.0323.00004,1,390441,390967,+,526
135,WOLB.0323.00011,1,1141586,1142112,+,526
135,WOLB.0323.00035,1,394384,394910,+,526
135,WOLB.0323.00032,1,1337006,1337532,+,526
135,WOLB.0323.00012,1,470035,470561,+,526
135,WOLB.0323.00018,1,435295,435821,+,526
135,WOLB.0323.00025,1,436695,437255,-,560
135,WOLB.0323.00010,1,1096172,1096697,-,525
135,WOLB.0323.00068,1,431269,431794,-,525
135,WOLB.0323.00128,1,1012697,1013255,-,558
135,WOLB.0323.00158,1,502622,503147,-,525
135,WOLB.0323.00017,1,466092,466618,+,526
135,WOLB.0323.00104,1,396784,397310,+,526
135,WOLB.0323.00007,1,1024567,1025092,-,525
135,WOLB.0323.00001,1,1278037,1278597,+,560
135,WOLB.0323.00100,1,545628,546154,+,526
135,WOLB.0323.00070,1,465212,465771,+,559
135,WOLB.0323.00042,1,490549,491075,+,526
135,WOLB.0323.00149,1,74237,74762,-,525
134,WOLB.0323.00090,1,389450,391831,+,2381
134,WOLB.0323.00002,1,472774,475155,+,2381
134,WOLB.0323.00138,1,205561,207942,-,2381
134,WOLB.0323.00132,1,412632,415013,+,2381
134,WOLB.0323.00143,1,883833,886210,-,2377
134,WOLB.0323.00106,1,883836,886213,-,2377
134,WOLB.0323.00121,1,463404,465785,+,2381
134,WOLB.0323.00135,1,1249513,1251894,-,2381
134,WOLB.0323.00103,1,1273226,1275607,+,2381
134,WOLB.0323.00107,1,1271489,1273870,+,2381
134,WOLB.0323.00019,1,1265458,1267839,+,2381
134,WOLB.0323.00060,1,76984,79365,+,2381
134,WOLB.0323.00039,1,420200,422581,-,2381
134,WOLB.0323.00041,1,1371619,1374000,+,2381
134,WOLB.0323.00031,1,1174627,1177004,+,2377
134,WOLB.0323.00056,1,401050,403431,+,2381
134,WOLB.0323.00142,1,389219,391600,+,2381
134,WOLB.0323.00023,1,1369224,1371605,+,2381
134,WOLB.0323.00153,1,392751,395132,+,2381
134,WOLB.0323.00093,1,711305,713686,+,2381
134,WOLB.0323.00088,1,465253,467634,+,2381
134,WOLB.0323.00008,1,694329,696710,-,2381
134,WOLB.0323.00024,1,620880,623261,-,2381
134,WOLB.0323.00064,1,146843,149224,+,2381
134,WOLB.0323.00030,1,764162,766543,+,2381
134,WOLB.0323.00105,1,1273234,1275615,+,2381
134,WOLB.0323.00133,1,363260,365638,-,2378
134,WOLB.0323.00084,1,302037,304418,-,2381
134,WOLB.0323.00021,1,761835,764216,+,2381
134,WOLB.0323.00043,1,1199581,1201962,-,2381
134,WOLB.0323.00020,1,435021,437402,+,2381
134,WOLB.0323.00122,1,1162925,1165306,-,2381
134,WOLB.0323.00118,1,399859,402240,+,2381
134,WOLB.0323.00004,1,386784,389165,+,2381
134,WOLB.0323.00011,1,1137929,1140310,+,2381
134,WOLB.0323.00035,1,390744,393125,+,2381
134,WOLB.0323.00032,1,1333349,1335730,+,2381
134,WOLB.0323.00012,1,466395,468776,+,2381
134,WOLB.0323.00018,1,431783,434152,+,2369
134,WOLB.0323.00025,1,438050,440338,-,2288
134,WOLB.0323.00010,1,1097986,1100355,-,2369
134,WOLB.0323.00068,1,434841,437222,-,2381
134,WOLB.0323.00128,1,1014515,1016896,-,2381
134,WOLB.0323.00158,1,504424,506805,-,2381
134,WOLB.0323.00017,1,462435,464816,+,2381
134,WOLB.0323.00104,1,393144,395525,+,2381
134,WOLB.0323.00007,1,1026369,1028750,-,2381
134,WOLB.0323.00001,1,1273234,1275615,+,2381
134,WOLB.0323.00100,1,541988,544369,+,2381
134,WOLB.0323.00070,1,461572,463953,+,2381
134,WOLB.0323.00006,1,163808,166185,-,2377
134,WOLB.0323.00042,1,486857,489238,+,2381
134,WOLB.0323.00119,1,1222273,1224654,-,2381
134,WOLB.0323.00149,1,76039,78420,-,2381
134,WOLB.0323.00014,1,492232,494613,+,2381
133,WOLB.0323.00090,1,386983,388917,+,1934
133,WOLB.0323.00002,1,470299,472241,+,1942
133,WOLB.0323.00138,1,208475,210417,-,1942
133,WOLB.0323.00132,1,410154,412096,+,1942
133,WOLB.0323.00143,1,886748,888698,-,1950
133,WOLB.0323.00106,1,886751,888701,-,1950
133,WOLB.0323.00121,1,460937,462871,+,1934
133,WOLB.0323.00135,1,1252426,1254368,-,1942
133,WOLB.0323.00103,1,1269756,1271706,+,1950
133,WOLB.0323.00107,1,1268019,1269969,+,1950
133,WOLB.0323.00019,1,1262969,1264911,+,1942
133,WOLB.0323.00060,1,74517,76451,+,1934
133,WOLB.0323.00039,1,423127,425069,-,1942
133,WOLB.0323.00041,1,1359607,1361543,-,1936
133,WOLB.0323.00031,1,1172139,1174089,+,1950
133,WOLB.0323.00056,1,398583,400517,+,1934
133,WOLB.0323.00142,1,386752,388686,+,1934
133,WOLB.0323.00023,1,1366749,1368691,+,1942
133,WOLB.0323.00153,1,390284,392218,+,1934
133,WOLB.0323.00093,1,1149690,1151614,+,1924
133,WOLB.0323.00088,1,462786,464720,+,1934
133,WOLB.0323.00008,1,842498,844430,+,1932
133,WOLB.0323.00024,1,623808,625750,-,1942
133,WOLB.0323.00064,1,144362,146304,+,1942
133,WOLB.0323.00030,1,761681,763623,+,1942
133,WOLB.0323.00105,1,1269764,1271714,+,1950
133,WOLB.0323.00133,1,366188,368130,-,1942
133,WOLB.0323.00084,1,304951,306893,-,1942
133,WOLB.0323.00021,1,759360,761302,+,1942
133,WOLB.0323.00043,1,1202497,1204439,-,1942
133,WOLB.0323.00020,1,432554,434488,+,1934
133,WOLB.0323.00122,1,1167192,1169118,-,1926
133,WOLB.0323.00118,1,397392,399326,+,1934
133,WOLB.0323.00004,1,384317,386251,+,1934
133,WOLB.0323.00011,1,1135462,1137396,+,1934
133,WOLB.0323.00035,1,388277,390211,+,1934
133,WOLB.0323.00032,1,1330874,1332816,+,1942
133,WOLB.0323.00012,1,463928,465862,+,1934
133,WOLB.0323.00018,1,429310,431252,+,1942
133,WOLB.0323.00025,1,441253,443203,-,1950
133,WOLB.0323.00010,1,1100890,1102832,-,1942
133,WOLB.0323.00068,1,437755,439697,-,1942
133,WOLB.0323.00128,1,1017431,1019373,-,1942
133,WOLB.0323.00158,1,507338,509272,-,1934
133,WOLB.0323.00017,1,459968,461902,+,1934
133,WOLB.0323.00104,1,390677,392611,+,1934
133,WOLB.0323.00007,1,1029287,1031217,-,1930
133,WOLB.0323.00001,1,1269764,1271714,+,1950
133,WOLB.0323.00100,1,539521,541455,+,1934
133,WOLB.0323.00070,1,459097,461039,+,1942
133,WOLB.0323.00006,1,166723,168673,-,1950
133,WOLB.0323.00042,1,484388,486330,+,1942
133,WOLB.0323.00119,1,1225201,1227143,-,1942
133,WOLB.0323.00149,1,78953,80887,-,1934
133,WOLB.0323.00014,1,489757,491699,+,1942
132,WOLB.0323.00090,1,382245,385673,+,3428
132,WOLB.0323.00002,1,465499,468933,+,3434
132,WOLB.0323.00138,1,212271,215700,-,3429
132,WOLB.0323.00132,1,405344,408787,+,3443
132,WOLB.0323.00143,1,890548,893981,-,3433
132,WOLB.0323.00106,1,890551,893984,-,3433
132,WOLB.0323.00121,1,455671,459099,+,3428
132,WOLB.0323.00135,1,1256230,1259659,-,3429
132,WOLB.0323.00103,1,1260150,1263592,+,3442
132,WOLB.0323.00107,1,1258413,1261855,+,3442
132,WOLB.0323.00019,1,1257671,1261114,+,3443
132,WOLB.0323.00060,1,69234,72662,+,3428
132,WOLB.0323.00039,1,426913,430355,-,3442
132,WOLB.0323.00041,1,1363404,1366847,-,3443
132,WOLB.0323.00031,1,1166856,1170288,+,3432
132,WOLB.0323.00056,1,393300,396728,+,3428
132,WOLB.0323.00142,1,381486,384914,+,3428
132,WOLB.0323.00023,1,1360827,1364270,+,3443
132,WOLB.0323.00153,1,385546,388974,+,3428
132,WOLB.0323.00093,1,1144394,1147828,+,3434
132,WOLB.0323.00088,1,457992,461420,+,3428
132,WOLB.0323.00008,1,644324,647759,-,3435
132,WOLB.0323.00024,1,627115,630558,-,3443
132,WOLB.0323.00064,1,139553,142996,+,3443
132,WOLB.0323.00030,1,756872,760315,+,3443
132,WOLB.0323.00105,1,1260158,1263600,+,3442
132,WOLB.0323.00133,1,369878,373322,-,3444
132,WOLB.0323.00084,1,308747,312176,-,3429
132,WOLB.0323.00021,1,754077,757505,+,3428
132,WOLB.0323.00043,1,1205804,1209236,-,3432
132,WOLB.0323.00020,1,427770,431198,+,3428
132,WOLB.0323.00122,1,1170972,1174401,-,3429
132,WOLB.0323.00118,1,392598,396026,+,3428
132,WOLB.0323.00004,1,379051,382479,+,3428
132,WOLB.0323.00011,1,1130196,1133624,+,3428
132,WOLB.0323.00035,1,383483,386911,+,3428
132,WOLB.0323.00032,1,1325591,1329019,+,3428
132,WOLB.0323.00012,1,459144,462572,+,3428
132,WOLB.0323.00018,1,424507,427943,+,3436
132,WOLB.0323.00025,1,378801,382196,-,3395
132,WOLB.0323.00010,1,1104198,1107642,-,3444
132,WOLB.0323.00068,1,441551,444980,-,3429
132,WOLB.0323.00128,1,1020738,1024182,-,3444
132,WOLB.0323.00158,1,511109,514538,-,3429
132,WOLB.0323.00017,1,454702,458130,+,3428
132,WOLB.0323.00104,1,385883,389311,+,3428
132,WOLB.0323.00007,1,1033071,1036498,-,3427
132,WOLB.0323.00001,1,1260158,1263600,+,3442
132,WOLB.0323.00100,1,534737,538165,+,3428
132,WOLB.0323.00070,1,454297,457731,+,3434
132,WOLB.0323.00006,1,170523,173956,-,3433
132,WOLB.0323.00042,1,479579,483022,+,3443
132,WOLB.0323.00119,1,1228997,1232441,-,3444
132,WOLB.0323.00149,1,82724,86153,-,3429
132,WOLB.0323.00014,1,484957,488391,+,3434
131,WOLB.0323.00090,1,381353,382069,+,716
131,WOLB.0323.00002,1,463408,464124,+,716
131,WOLB.0323.00138,1,216974,217690,-,716
131,WOLB.0323.00132,1,403441,404157,+,716
131,WOLB.0323.00143,1,894171,894887,-,716
131,WOLB.0323.00106,1,894174,894890,-,716
131,WOLB.0323.00121,1,454779,455495,+,716
131,WOLB.0323.00135,1,1259835,1260550,-,715
131,WOLB.0323.00103,1,1259264,1259980,+,716
131,WOLB.0323.00107,1,1257527,1258243,+,716
131,WOLB.0323.00019,1,1256776,1257492,+,716
131,WOLB.0323.00060,1,68342,69058,+,716
131,WOLB.0323.00039,1,430534,431250,-,716
131,WOLB.0323.00041,1,1367017,1367733,-,716
131,WOLB.0323.00031,1,1165950,1166666,+,716
131,WOLB.0323.00056,1,392408,393124,+,716
131,WOLB.0323.00142,1,380594,381310,+,716
131,WOLB.0323.00023,1,1358834,1359550,+,716
131,WOLB.0323.00153,1,384654,385370,+,716
131,WOLB.0323.00093,1,1143508,1144224,+,716
131,WOLB.0323.00088,1,457100,457816,+,716
131,WOLB.0323.00008,1,647929,648645,-,716
131,WOLB.0323.00024,1,1493758,1494474,-,716
131,WOLB.0323.00064,1,137579,138295,+,716
131,WOLB.0323.00030,1,754898,755614,+,716
131,WOLB.0323.00105,1,1259272,1259988,+,716
131,WOLB.0323.00133,1,373505,374217,-,712
131,WOLB.0323.00084,1,313450,314166,-,716
131,WOLB.0323.00021,1,752087,752803,+,716
131,WOLB.0323.00043,1,1210599,1211315,-,716
131,WOLB.0323.00020,1,426878,427594,+,716
131,WOLB.0323.00122,1,1174577,1175293,-,716
131,WOLB.0323.00118,1,391706,392422,+,716
131,WOLB.0323.00004,1,378159,378875,+,716
131,WOLB.0323.00011,1,1129304,1130020,+,716
131,WOLB.0323.00035,1,382591,383307,+,716
131,WOLB.0323.00032,1,1323601,1324317,+,716
131,WOLB.0323.00012,1,458252,458968,+,716
131,WOLB.0323.00018,1,423641,424339,+,698
131,WOLB.0323.00025,1,382375,383091,-,716
131,WOLB.0323.00010,1,1108986,1109702,-,716
131,WOLB.0323.00068,1,1293623,1294339,-,716
131,WOLB.0323.00128,1,1026646,1027362,-,716
131,WOLB.0323.00158,1,514714,515430,-,716
131,WOLB.0323.00017,1,453810,454526,+,716
131,WOLB.0323.00104,1,384991,385707,+,716
131,WOLB.0323.00007,1,1036674,1037390,-,716
131,WOLB.0323.00001,1,1259272,1259988,+,716
131,WOLB.0323.00100,1,533845,534561,+,716
131,WOLB.0323.00070,1,452206,452922,+,716
131,WOLB.0323.00006,1,174146,174862,-,716
131,WOLB.0323.00042,1,477593,478309,+,716
131,WOLB.0323.00119,1,1232620,1233336,-,716
131,WOLB.0323.00149,1,86329,87045,-,716
131,WOLB.0323.00014,1,482882,483598,+,716
130,WOLB.0323.00090,1,379795,381200,+,1405
130,WOLB.0323.00002,1,461851,463256,+,1405
130,WOLB.0323.00138,1,217843,219248,-,1405
130,WOLB.0323.00132,1,401883,403288,+,1405
130,WOLB.0323.00143,1,895040,896453,-,1413
130,WOLB.0323.00106,1,895043,896456,-,1413
130,WOLB.0323.00121,1,453221,454626,+,1405
130,WOLB.0323.00135,1,1260703,1262108,-,1405
130,WOLB.0323.00103,1,1257706,1259111,+,1405
130,WOLB.0323.00107,1,1255969,1257374,+,1405
130,WOLB.0323.00019,1,805789,807202,+,1413
130,WOLB.0323.00060,1,66784,68189,+,1405
130,WOLB.0323.00039,1,431405,432818,-,1413
130,WOLB.0323.00041,1,1367886,1369275,-,1389
130,WOLB.0323.00031,1,1164384,1165797,+,1413
130,WOLB.0323.00056,1,390850,392255,+,1405
130,WOLB.0323.00142,1,379036,380441,+,1405
130,WOLB.0323.00023,1,1355692,1357096,+,1404
130,WOLB.0323.00153,1,383096,384501,+,1405
130,WOLB.0323.00093,1,1141951,1143356,+,1405
130,WOLB.0323.00088,1,455542,456947,+,1405
130,WOLB.0323.00008,1,648797,650202,-,1405
130,WOLB.0323.00024,1,1494627,1496031,-,1404
130,WOLB.0323.00064,1,136021,137426,+,1405
130,WOLB.0323.00030,1,753340,754745,+,1405
130,WOLB.0323.00105,1,1257714,1259119,+,1405
130,WOLB.0323.00133,1,374375,375783,-,1408
130,WOLB.0323.00084,1,314319,315724,-,1405
130,WOLB.0323.00021,1,750529,751934,+,1405
130,WOLB.0323.00043,1,1211467,1212872,-,1405
130,WOLB.0323.00020,1,425320,426725,+,1405
130,WOLB.0323.00122,1,1175446,1176851,-,1405
130,WOLB.0323.00118,1,390148,391553,+,1405
130,WOLB.0323.00004,1,376601,378006,+,1405
130,WOLB.0323.00011,1,1127746,1129151,+,1405
130,WOLB.0323.00035,1,381033,382438,+,1405
130,WOLB.0323.00032,1,1322043,1323448,+,1405
130,WOLB.0323.00012,1,456694,458099,+,1405
130,WOLB.0323.00018,1,422065,423470,+,1405
130,WOLB.0323.00025,1,383244,384657,-,1413
130,WOLB.0323.00010,1,1109854,1111259,-,1405
130,WOLB.0323.00068,1,1294492,1295897,-,1405
130,WOLB.0323.00128,1,1027514,1028919,-,1405
130,WOLB.0323.00158,1,515583,516988,-,1405
130,WOLB.0323.00017,1,452252,453657,+,1405
130,WOLB.0323.00104,1,383433,384838,+,1405
130,WOLB.0323.00007,1,1037543,1038948,-,1405
130,WOLB.0323.00001,1,1257714,1259119,+,1405
130,WOLB.0323.00100,1,532287,533692,+,1405
130,WOLB.0323.00070,1,450649,452054,+,1405
130,WOLB.0323.00006,1,175015,176427,-,1412
130,WOLB.0323.00042,1,476035,477440,+,1405
130,WOLB.0323.00119,1,371491,372904,-,1413
130,WOLB.0323.00149,1,87198,88603,-,1405
130,WOLB.0323.00014,1,481325,482730,+,1405
129,WOLB.0323.00090,1,376845,378577,+,1732
129,WOLB.0323.00002,1,458871,460603,+,1732
129,WOLB.0323.00138,1,220466,222198,-,1732
129,WOLB.0323.00132,1,398978,400710,+,1732
129,WOLB.0323.00143,1,897650,899383,-,1733
129,WOLB.0323.00106,1,897653,899386,-,1733
129,WOLB.0323.00121,1,450271,452003,+,1732
129,WOLB.0323.00135,1,1263326,1265058,-,1732
129,WOLB.0323.00103,1,1254757,1256489,+,1732
129,WOLB.0323.00107,1,1253020,1254752,+,1732
129,WOLB.0323.00019,1,802859,804591,+,1732
129,WOLB.0323.00060,1,63834,65566,+,1732
129,WOLB.0323.00039,1,434015,435747,-,1732
129,WOLB.0323.00041,1,1369397,1371126,-,1729
129,WOLB.0323.00031,1,1161454,1163187,+,1733
129,WOLB.0323.00056,1,387900,389632,+,1732
129,WOLB.0323.00142,1,376086,377818,+,1732
129,WOLB.0323.00023,1,1352754,1354486,+,1732
129,WOLB.0323.00153,1,380146,381878,+,1732
129,WOLB.0323.00093,1,708993,710725,-,1732
129,WOLB.0323.00088,1,452637,454369,+,1732
129,WOLB.0323.00008,1,651420,653152,-,1732
129,WOLB.0323.00024,1,1497236,1498968,-,1732
129,WOLB.0323.00064,1,133083,134815,+,1732
129,WOLB.0323.00030,1,750402,752134,+,1732
129,WOLB.0323.00105,1,1254765,1256497,+,1732
129,WOLB.0323.00133,1,376981,378713,-,1732
129,WOLB.0323.00084,1,316942,318674,-,1732
129,WOLB.0323.00021,1,747579,749311,+,1732
129,WOLB.0323.00043,1,1214120,1215852,-,1732
129,WOLB.0323.00020,1,422415,424147,+,1732
129,WOLB.0323.00122,1,1178069,1179801,-,1732
129,WOLB.0323.00118,1,387198,388930,+,1732
129,WOLB.0323.00004,1,373651,375383,+,1732
129,WOLB.0323.00011,1,1124796,1126528,+,1732
129,WOLB.0323.00035,1,378128,379860,+,1732
129,WOLB.0323.00032,1,1319093,1320825,+,1732
129,WOLB.0323.00012,1,453789,455521,+,1732
129,WOLB.0323.00018,1,419127,420859,+,1732
129,WOLB.0323.00025,1,455332,457064,-,1732
129,WOLB.0323.00010,1,1112509,1114241,-,1732
129,WOLB.0323.00068,1,1297115,1298847,-,1732
129,WOLB.0323.00128,1,1030167,1031899,-,1732
129,WOLB.0323.00158,1,518205,519937,-,1732
129,WOLB.0323.00017,1,449302,451034,+,1732
129,WOLB.0323.00104,1,380528,382260,+,1732
129,WOLB.0323.00007,1,1040166,1041898,-,1732
129,WOLB.0323.00001,1,1254765,1256497,+,1732
129,WOLB.0323.00100,1,529382,531114,+,1732
129,WOLB.0323.00070,1,447669,449401,+,1732
129,WOLB.0323.00006,1,177624,179357,-,1733
129,WOLB.0323.00042,1,473094,474826,+,1732
129,WOLB.0323.00119,1,374102,375834,-,1732
129,WOLB.0323.00149,1,89821,91553,-,1732
129,WOLB.0323.00014,1,478345,480077,+,1732
128,WOLB.0323.00090,1,373527,376636,+,3109
128,WOLB.0323.00002,1,455554,458662,+,3108
128,WOLB.0323.00138,1,222407,225516,-,3109
128,WOLB.0323.00132,1,395660,398769,+,3109
128,WOLB.0323.00143,1,899596,902705,-,3109
128,WOLB.0323.00106,1,899599,902708,-,3109
128,WOLB.0323.00121,1,446953,450062,+,3109
128,WOLB.0323.00135,1,1265267,1268376,-,3109
128,WOLB.0323.00103,1,1251436,1254547,+,3111
128,WOLB.0323.00107,1,1249699,1252810,+,3111
128,WOLB.0323.00019,1,799548,802650,+,3102
128,WOLB.0323.00060,1,60516,63625,+,3109
128,WOLB.0323.00074,1,578250,581348,-,3098
128,WOLB.0323.00120,1,564421,567519,-,3098
128,WOLB.0323.00039,1,435956,439059,-,3103
128,WOLB.0323.00041,1,1049482,1052580,+,3098
128,WOLB.0323.00031,1,1158132,1161241,+,3109
128,WOLB.0323.00056,1,384582,387691,+,3109
128,WOLB.0323.00142,1,372768,375877,+,3109
128,WOLB.0323.00023,1,1349436,1352545,+,3109
128,WOLB.0323.00153,1,376828,379937,+,3109
128,WOLB.0323.00093,1,845466,848574,+,3108
128,WOLB.0323.00088,1,448027,451136,+,3109
128,WOLB.0323.00008,1,906720,909830,-,3110
128,WOLB.0323.00024,1,1501937,1505046,-,3109
128,WOLB.0323.00064,1,129765,132874,+,3109
128,WOLB.0323.00030,1,1206488,1209597,-,3109
128,WOLB.0323.00105,1,1251444,1254555,+,3111
128,WOLB.0323.00133,1,378922,382030,-,3108
128,WOLB.0323.00084,1,318883,321992,-,3109
128,WOLB.0323.00021,1,744261,747370,+,3109
128,WOLB.0323.00043,1,1216061,1219169,-,3108
128,WOLB.0323.00020,1,417805,420914,+,3109
128,WOLB.0323.00122,1,1180010,1183119,-,3109
128,WOLB.0323.00118,1,383880,386989,+,3109
128,WOLB.0323.00004,1,370333,373442,+,3109
128,WOLB.0323.00011,1,1121478,1124587,+,3109
128,WOLB.0323.00035,1,373518,376627,+,3109
128,WOLB.0323.00032,1,1315775,1318884,+,3109
128,WOLB.0323.00012,1,449179,452288,+,3109
128,WOLB.0323.00018,1,415809,418918,+,3109
128,WOLB.0323.00025,1,457281,460392,-,3111
128,WOLB.0323.00010,1,1114450,1117559,-,3109
128,WOLB.0323.00068,1,1299056,1302165,-,3109
128,WOLB.0323.00128,1,1032108,1035216,-,3108
128,WOLB.0323.00158,1,520146,523255,-,3109
128,WOLB.0323.00017,1,445984,449093,+,3109
128,WOLB.0323.00104,1,375918,379027,+,3109
128,WOLB.0323.00007,1,1042107,1045216,-,3109
128,WOLB.0323.00001,1,1251444,1254555,+,3111
128,WOLB.0323.00100,1,524772,527881,+,3109
128,WOLB.0323.00070,1,444352,447460,+,3108
128,WOLB.0323.00006,1,179570,182677,-,3107
128,WOLB.0323.00042,1,469776,472885,+,3109
128,WOLB.0323.00119,1,376043,379145,-,3102
128,WOLB.0323.00149,1,91762,94871,-,3109
128,WOLB.0323.00014,1,474854,478136,+,3282
128,WOLB.0323.00096,1,1087416,1090514,+,3098
59,WOLB.0323.00090,1,160119,162665,+,2546
59,WOLB.0323.00002,1,168545,171101,-,2556
59,WOLB.0323.00138,1,446330,448876,-,2546
59,WOLB.0323.00132,1,1248334,1250890,+,2556
59,WOLB.0323.00143,1,1143900,1146465,+,2565
59,WOLB.0323.00106,1,1143903,1146468,+,2565
59,WOLB.0323.00121,1,154987,157533,+,2546
59,WOLB.0323.00135,1,202100,204646,-,2546
59,WOLB.0323.00103,1,178854,181418,+,2564
59,WOLB.0323.00107,1,178853,181417,+,2564
59,WOLB.0323.00019,1,932047,934603,-,2556
59,WOLB.0323.00060,1,1500617,1503163,-,2546
59,WOLB.0323.00074,1,803420,805975,+,2555
59,WOLB.0323.00120,1,789381,791936,+,2555
59,WOLB.0323.00039,1,651118,653678,+,2560
59,WOLB.0323.00041,1,831559,834114,-,2555
59,WOLB.0323.00031,1,914372,916937,-,2565
59,WOLB.0323.00056,1,159384,161930,+,2546
59,WOLB.0323.00142,1,154544,157090,+,2546
59,WOLB.0323.00023,1,1053136,1055661,-,2525
59,WOLB.0323.00153,1,161770,164316,+,2546
59,WOLB.0323.00093,1,304185,306714,-,2529
59,WOLB.0323.00088,1,154349,156896,+,2547
59,WOLB.0323.00008,1,1348663,1351218,-,2555
59,WOLB.0323.00024,1,1897414,1899970,+,2556
59,WOLB.0323.00064,1,1302646,1305202,-,2556
59,WOLB.0323.00030,1,1602614,1605170,+,2556
59,WOLB.0323.00105,1,178853,181417,+,2564
59,WOLB.0323.00133,1,675071,677627,+,2556
59,WOLB.0323.00084,1,540686,543232,-,2546
59,WOLB.0323.00021,1,154609,157155,+,2546
59,WOLB.0323.00043,1,166052,168608,-,2556
59,WOLB.0323.00020,1,156692,159239,+,2547
59,WOLB.0323.00122,1,162385,164931,+,2546
59,WOLB.0323.00118,1,169101,171656,+,2555
59,WOLB.0323.00004,1,155417,157963,+,2546
59,WOLB.0323.00011,1,906571,909117,+,2546
59,WOLB.0323.00035,1,154347,156894,+,2547
59,WOLB.0323.00032,1,954332,956878,-,2546
59,WOLB.0323.00012,1,154334,156881,+,2547
59,WOLB.0323.00018,1,203010,205557,-,2547
59,WOLB.0323.00025,1,812875,815440,+,2565
59,WOLB.0323.00010,1,171413,173968,-,2555
59,WOLB.0323.00068,1,152626,155172,+,2546
59,WOLB.0323.00128,1,166430,168986,-,2556
59,WOLB.0323.00158,1,837245,839791,+,2546
59,WOLB.0323.00017,1,155463,158009,+,2546
59,WOLB.0323.00104,1,156648,159195,+,2547
59,WOLB.0323.00007,1,1338043,1340589,-,2546
59,WOLB.0323.00001,1,178853,181417,+,2564
59,WOLB.0323.00100,1,154348,156895,+,2547
59,WOLB.0323.00070,1,166024,168580,-,2556
59,WOLB.0323.00006,1,422486,425051,+,2565
59,WOLB.0323.00042,1,173276,175823,-,2547
59,WOLB.0323.00119,1,934701,937257,-,2556
59,WOLB.0323.00149,1,307241,309787,-,2546
59,WOLB.0323.00014,1,168740,171296,-,2556
59,WOLB.0323.00096,1,869431,871986,-,2555
58,WOLB.0323.00090,1,158634,159579,+,945
58,WOLB.0323.00138,1,450514,451458,-,944
58,WOLB.0323.00121,1,153502,154447,+,945
58,WOLB.0323.00135,1,205186,206130,-,944
58,WOLB.0323.00103,1,185119,186060,-,941
58,WOLB.0323.00107,1,185118,186059,-,941
58,WOLB.0323.00060,1,1503703,1504656,-,953
58,WOLB.0323.00074,1,809101,810043,-,942
58,WOLB.0323.00120,1,795062,796004,-,942
58,WOLB.0323.00041,1,827490,828433,+,943
58,WOLB.0323.00056,1,157899,158844,+,945
58,WOLB.0323.00142,1,153059,154004,+,945
58,WOLB.0323.00153,1,160285,161230,+,945
58,WOLB.0323.00088,1,152863,153809,+,946
58,WOLB.0323.00105,1,185118,186059,-,941
58,WOLB.0323.00133,1,679749,680692,-,943
58,WOLB.0323.00084,1,543772,544716,-,944
58,WOLB.0323.00021,1,153124,154069,+,945
58,WOLB.0323.00020,1,155206,156152,+,946
58,WOLB.0323.00122,1,160899,161845,+,946
58,WOLB.0323.00118,1,166575,167520,+,945
58,WOLB.0323.00004,1,153932,154877,+,945
58,WOLB.0323.00011,1,905086,906031,+,945
58,WOLB.0323.00035,1,152861,153807,+,946
58,WOLB.0323.00032,1,1123653,1124598,+,945
58,WOLB.0323.00012,1,152848,153794,+,946
58,WOLB.0323.00068,1,151141,152086,+,945
58,WOLB.0323.00158,1,835760,836705,+,945
58,WOLB.0323.00017,1,153978,154923,+,945
58,WOLB.0323.00104,1,155162,156108,+,946
58,WOLB.0323.00007,1,1341129,1342073,-,944
58,WOLB.0323.00001,1,185118,186059,-,941
58,WOLB.0323.00100,1,152862,153808,+,946
58,WOLB.0323.00149,1,310327,311271,-,944
58,WOLB.0323.00096,1,865362,866305,+,943
57,WOLB.0323.00090,1,157660,158288,+,628
57,WOLB.0323.00002,1,96584,97212,+,628
57,WOLB.0323.00138,1,451805,452433,-,628
57,WOLB.0323.00132,1,1132180,1132808,-,628
57,WOLB.0323.00143,1,1148602,1149230,-,628
57,WOLB.0323.00106,1,1148605,1149233,-,628
57,WOLB.0323.00121,1,152528,153156,+,628
57,WOLB.0323.00135,1,206477,207105,-,628
57,WOLB.0323.00103,1,186393,187021,-,628
57,WOLB.0323.00107,1,186392,187020,-,628
57,WOLB.0323.00019,1,928203,928831,+,628
57,WOLB.0323.00060,1,1505003,1505631,-,628
57,WOLB.0323.00074,1,810375,811003,-,628
57,WOLB.0323.00120,1,796336,796964,-,628
57,WOLB.0323.00039,1,656917,657545,-,628
57,WOLB.0323.00041,1,826531,827159,+,628
57,WOLB.0323.00031,1,911607,912235,+,628
57,WOLB.0323.00056,1,156925,157553,+,628
57,WOLB.0323.00142,1,152085,152713,+,628
57,WOLB.0323.00023,1,883511,884139,+,628
57,WOLB.0323.00153,1,159311,159939,+,628
57,WOLB.0323.00093,1,301532,302160,+,628
57,WOLB.0323.00088,1,151889,152517,+,628
57,WOLB.0323.00008,1,1346010,1346638,+,628
57,WOLB.0323.00024,1,1167840,1168468,+,628
57,WOLB.0323.00064,1,1042023,1042651,-,628
57,WOLB.0323.00030,1,96655,97283,+,628
57,WOLB.0323.00105,1,186392,187020,-,628
57,WOLB.0323.00133,1,681017,681645,-,628
57,WOLB.0323.00084,1,545063,545691,-,628
57,WOLB.0323.00021,1,152150,152778,+,628
57,WOLB.0323.00043,1,95281,95909,+,628
57,WOLB.0323.00020,1,154232,154860,+,628
57,WOLB.0323.00122,1,159925,160553,+,628
57,WOLB.0323.00118,1,165601,166229,+,628
57,WOLB.0323.00004,1,152958,153586,+,628
57,WOLB.0323.00011,1,904112,904740,+,628
57,WOLB.0323.00035,1,151887,152515,+,628
57,WOLB.0323.00032,1,1122679,1123307,+,628
57,WOLB.0323.00012,1,151875,152503,+,628
57,WOLB.0323.00018,1,128836,129464,+,628
57,WOLB.0323.00025,1,833829,834457,-,628
57,WOLB.0323.00010,1,100701,101329,+,628
57,WOLB.0323.00068,1,150167,150795,+,628
57,WOLB.0323.00128,1,95906,96534,+,628
57,WOLB.0323.00158,1,834786,835414,+,628
57,WOLB.0323.00017,1,153004,153632,+,628
57,WOLB.0323.00104,1,154188,154816,+,628
57,WOLB.0323.00007,1,1342420,1343048,-,628
57,WOLB.0323.00001,1,186392,187020,-,628
57,WOLB.0323.00100,1,151888,152516,+,628
57,WOLB.0323.00070,1,95253,95881,+,628
57,WOLB.0323.00006,1,427188,427816,-,628
57,WOLB.0323.00042,1,98493,99121,+,628
57,WOLB.0323.00119,1,930857,931485,+,628
57,WOLB.0323.00149,1,311618,312246,-,628
57,WOLB.0323.00014,1,96596,97224,+,628
57,WOLB.0323.00096,1,864403,865031,+,628
56,WOLB.0323.00090,1,156883,157634,+,751
56,WOLB.0323.00002,1,95807,96553,+,746
56,WOLB.0323.00138,1,452459,453209,-,750
56,WOLB.0323.00132,1,1132839,1133584,-,745
56,WOLB.0323.00143,1,1149256,1150006,-,750
56,WOLB.0323.00106,1,1149259,1150009,-,750
56,WOLB.0323.00121,1,151751,152497,+,746
56,WOLB.0323.00135,1,207131,207881,-,750
56,WOLB.0323.00103,1,187052,187797,-,745
56,WOLB.0323.00107,1,187051,187796,-,745
56,WOLB.0323.00019,1,927426,928172,+,746
56,WOLB.0323.00060,1,1505657,1506407,-,750
56,WOLB.0323.00074,1,811034,811780,-,746
56,WOLB.0323.00120,1,796995,797741,-,746
56,WOLB.0323.00039,1,657576,658322,-,746
56,WOLB.0323.00041,1,825753,826500,+,747
56,WOLB.0323.00031,1,910830,911581,+,751
56,WOLB.0323.00056,1,156148,156899,+,751
56,WOLB.0323.00142,1,151308,152054,+,746
56,WOLB.0323.00023,1,882734,883485,+,751
56,WOLB.0323.00153,1,158534,159285,+,751
56,WOLB.0323.00093,1,300755,301506,+,751
56,WOLB.0323.00088,1,151112,151863,+,751
56,WOLB.0323.00008,1,1345233,1345984,+,751
56,WOLB.0323.00024,1,1167063,1167809,+,746
56,WOLB.0323.00064,1,1042682,1043427,-,745
56,WOLB.0323.00030,1,95878,96624,+,746
56,WOLB.0323.00105,1,187051,187796,-,745
56,WOLB.0323.00133,1,681676,682421,-,745
56,WOLB.0323.00084,1,545717,546467,-,750
56,WOLB.0323.00021,1,151373,152124,+,751
56,WOLB.0323.00043,1,94504,95250,+,746
56,WOLB.0323.00020,1,152282,153005,+,723
56,WOLB.0323.00122,1,159148,159899,+,751
56,WOLB.0323.00118,1,164824,165575,+,751
56,WOLB.0323.00004,1,152181,152927,+,746
56,WOLB.0323.00011,1,903335,904081,+,746
56,WOLB.0323.00035,1,151110,151861,+,751
56,WOLB.0323.00032,1,1121886,1122653,+,767
56,WOLB.0323.00012,1,151098,151849,+,751
56,WOLB.0323.00018,1,128059,128805,+,746
56,WOLB.0323.00025,1,834483,835233,-,750
56,WOLB.0323.00010,1,99924,100670,+,746
56,WOLB.0323.00068,1,149390,150141,+,751
56,WOLB.0323.00128,1,95129,95875,+,746
56,WOLB.0323.00158,1,834009,834755,+,746
56,WOLB.0323.00017,1,152227,152973,+,746
56,WOLB.0323.00104,1,153411,154162,+,751
56,WOLB.0323.00007,1,1343074,1343824,-,750
56,WOLB.0323.00001,1,187051,187796,-,745
56,WOLB.0323.00100,1,151111,151862,+,751
56,WOLB.0323.00070,1,94476,95222,+,746
56,WOLB.0323.00006,1,427842,428592,-,750
56,WOLB.0323.00042,1,97716,98467,+,751
56,WOLB.0323.00119,1,930080,930826,+,746
56,WOLB.0323.00149,1,312277,313022,-,745
56,WOLB.0323.00014,1,95819,96565,+,746
56,WOLB.0323.00096,1,863625,864372,+,747
55,WOLB.0323.00090,1,155580,156882,+,1302
55,WOLB.0323.00002,1,94500,95806,+,1306
55,WOLB.0323.00138,1,453211,454513,-,1302
55,WOLB.0323.00132,1,1133586,1134897,-,1311
55,WOLB.0323.00143,1,1150008,1151310,-,1302
55,WOLB.0323.00106,1,1150011,1151313,-,1302
55,WOLB.0323.00121,1,150439,151750,+,1311
55,WOLB.0323.00135,1,207883,209184,-,1301
55,WOLB.0323.00103,1,187799,189110,-,1311
55,WOLB.0323.00107,1,187798,189109,-,1311
55,WOLB.0323.00019,1,926114,927425,+,1311
55,WOLB.0323.00060,1,1506409,1507711,-,1302
55,WOLB.0323.00074,1,811782,813092,-,1310
55,WOLB.0323.00120,1,797743,799053,-,1310
55,WOLB.0323.00039,1,658324,659635,-,1311
55,WOLB.0323.00041,1,824442,825752,+,1310
55,WOLB.0323.00031,1,909527,910829,+,1302
55,WOLB.0323.00056,1,154845,156147,+,1302
55,WOLB.0323.00142,1,149996,151307,+,1311
55,WOLB.0323.00023,1,881422,882733,+,1311
55,WOLB.0323.00153,1,157231,158533,+,1302
55,WOLB.0323.00093,1,299443,300754,+,1311
55,WOLB.0323.00088,1,149809,151111,+,1302
55,WOLB.0323.00008,1,1343921,1345232,+,1311
55,WOLB.0323.00024,1,1165751,1167062,+,1311
55,WOLB.0323.00064,1,1043429,1044740,-,1311
55,WOLB.0323.00030,1,94566,95877,+,1311
55,WOLB.0323.00105,1,187798,189109,-,1311
55,WOLB.0323.00133,1,682423,683734,-,1311
55,WOLB.0323.00084,1,546469,547771,-,1302
55,WOLB.0323.00021,1,150070,151372,+,1302
55,WOLB.0323.00043,1,93192,94503,+,1311
55,WOLB.0323.00020,1,150979,152281,+,1302
55,WOLB.0323.00122,1,157845,159147,+,1302
55,WOLB.0323.00118,1,163534,164823,+,1289
55,WOLB.0323.00004,1,150869,152180,+,1311
55,WOLB.0323.00011,1,902023,903334,+,1311
55,WOLB.0323.00035,1,149808,151109,+,1301
55,WOLB.0323.00032,1,1119090,1120345,+,1255
55,WOLB.0323.00012,1,149795,151097,+,1302
55,WOLB.0323.00018,1,126747,128058,+,1311
55,WOLB.0323.00025,1,835235,836537,-,1302
55,WOLB.0323.00010,1,98612,99923,+,1311
55,WOLB.0323.00068,1,148087,149389,+,1302
55,WOLB.0323.00128,1,93817,95128,+,1311
55,WOLB.0323.00158,1,832697,834008,+,1311
55,WOLB.0323.00017,1,150914,152226,+,1312
55,WOLB.0323.00104,1,152108,153410,+,1302
55,WOLB.0323.00007,1,1343826,1345128,-,1302
55,WOLB.0323.00001,1,187798,189109,-,1311
55,WOLB.0323.00100,1,149808,151110,+,1302
55,WOLB.0323.00070,1,93164,94475,+,1311
55,WOLB.0323.00006,1,428594,429896,-,1302
55,WOLB.0323.00042,1,96404,97715,+,1311
55,WOLB.0323.00119,1,928768,930079,+,1311
55,WOLB.0323.00149,1,313024,314335,-,1311
55,WOLB.0323.00014,1,94507,95818,+,1311
55,WOLB.0323.00096,1,862314,863624,+,1310
54,WOLB.0323.00090,1,152536,153485,+,949
54,WOLB.0323.00002,1,91442,92391,+,949
54,WOLB.0323.00138,1,456608,457557,-,949
54,WOLB.0323.00132,1,1137078,1138027,-,949
54,WOLB.0323.00143,1,1153410,1154359,-,949
54,WOLB.0323.00106,1,1153413,1154362,-,949
54,WOLB.0323.00121,1,147416,148353,+,937
54,WOLB.0323.00135,1,211279,212228,-,949
54,WOLB.0323.00103,1,194565,195514,-,949
54,WOLB.0323.00107,1,194581,195512,-,931
54,WOLB.0323.00019,1,923170,924119,+,949
54,WOLB.0323.00060,1,1509794,1510743,-,949
54,WOLB.0323.00074,1,815160,816112,-,952
54,WOLB.0323.00120,1,801121,802073,-,952
54,WOLB.0323.00039,1,661630,662579,-,949
54,WOLB.0323.00041,1,821422,822374,+,952
54,WOLB.0323.00031,1,906478,907427,+,949
54,WOLB.0323.00056,1,151812,152762,+,950
54,WOLB.0323.00142,1,146973,147910,+,937
54,WOLB.0323.00023,1,878360,879309,+,949
54,WOLB.0323.00153,1,154187,155136,+,949
54,WOLB.0323.00093,1,296379,297331,+,952
54,WOLB.0323.00088,1,146773,147722,+,949
54,WOLB.0323.00008,1,99187,100139,-,952
54,WOLB.0323.00024,1,1162695,1163644,+,949
54,WOLB.0323.00064,1,1046981,1047930,-,949
54,WOLB.0323.00030,1,91376,92325,+,949
54,WOLB.0323.00105,1,194564,195513,-,949
54,WOLB.0323.00133,1,684744,685693,-,949
54,WOLB.0323.00084,1,549866,550815,-,949
54,WOLB.0323.00021,1,147026,147975,+,949
54,WOLB.0323.00043,1,90134,91083,+,949
54,WOLB.0323.00020,1,147943,148892,+,949
54,WOLB.0323.00122,1,154801,155750,+,949
54,WOLB.0323.00118,1,159737,160686,+,949
54,WOLB.0323.00004,1,147846,148783,+,937
54,WOLB.0323.00011,1,899000,899937,+,937
54,WOLB.0323.00035,1,146772,147721,+,949
54,WOLB.0323.00032,1,1116037,1116986,+,949
54,WOLB.0323.00012,1,146759,147708,+,949
54,WOLB.0323.00018,1,123729,124666,+,937
54,WOLB.0323.00025,1,174702,175651,+,949
54,WOLB.0323.00010,1,95563,96512,+,949
54,WOLB.0323.00068,1,145043,145992,+,949
54,WOLB.0323.00128,1,90745,91694,+,949
54,WOLB.0323.00158,1,829674,830611,+,937
54,WOLB.0323.00017,1,147891,148828,+,937
54,WOLB.0323.00104,1,149072,150021,+,949
54,WOLB.0323.00007,1,1347211,1348160,-,949
54,WOLB.0323.00001,1,194564,195513,-,949
54,WOLB.0323.00100,1,146772,147721,+,949
54,WOLB.0323.00070,1,90106,91055,+,949
54,WOLB.0323.00006,1,431998,432947,-,949
54,WOLB.0323.00042,1,93370,94319,+,949
54,WOLB.0323.00119,1,925824,926773,+,949
54,WOLB.0323.00149,1,316421,317358,-,937
54,WOLB.0323.00014,1,91449,92398,+,949
54,WOLB.0323.00096,1,859294,860246,+,952
53,WOLB.0323.00090,1,149631,151603,+,1972
53,WOLB.0323.00002,1,88526,90498,+,1972
53,WOLB.0323.00138,1,458515,460492,-,1977
53,WOLB.0323.00132,1,1138969,1140946,-,1977
53,WOLB.0323.00143,1,1155291,1157268,-,1977
53,WOLB.0323.00106,1,1155294,1157271,-,1977
53,WOLB.0323.00121,1,144484,146456,+,1972
53,WOLB.0323.00135,1,213170,215141,-,1971
53,WOLB.0323.00103,1,196466,198443,-,1977
53,WOLB.0323.00107,1,196464,198441,-,1977
53,WOLB.0323.00019,1,918776,920748,+,1972
53,WOLB.0323.00060,1,1511685,1513656,-,1971
53,WOLB.0323.00074,1,817073,819051,-,1978
53,WOLB.0323.00120,1,803034,805012,-,1978
53,WOLB.0323.00039,1,663561,665532,-,1971
53,WOLB.0323.00041,1,818482,820461,+,1979
53,WOLB.0323.00031,1,903568,905546,+,1978
53,WOLB.0323.00056,1,148898,150870,+,1972
53,WOLB.0323.00142,1,144053,146025,+,1972
53,WOLB.0323.00023,1,874754,876732,+,1978
53,WOLB.0323.00153,1,151282,153254,+,1972
53,WOLB.0323.00093,1,293455,295413,+,1958
53,WOLB.0323.00088,1,143853,145831,+,1978
53,WOLB.0323.00008,1,101107,103084,-,1977
53,WOLB.0323.00024,1,1159750,1161738,+,1988
53,WOLB.0323.00064,1,1048871,1050848,-,1977
53,WOLB.0323.00030,1,88457,90435,+,1978
53,WOLB.0323.00105,1,196465,198442,-,1977
53,WOLB.0323.00133,1,686629,688615,-,1986
53,WOLB.0323.00084,1,551773,553750,-,1977
53,WOLB.0323.00021,1,144090,146068,+,1978
53,WOLB.0323.00043,1,87185,89157,+,1972
53,WOLB.0323.00020,1,145023,147001,+,1978
53,WOLB.0323.00122,1,151218,153190,+,1972
53,WOLB.0323.00118,1,156823,158795,+,1972
53,WOLB.0323.00004,1,144914,146886,+,1972
53,WOLB.0323.00011,1,896068,898040,+,1972
53,WOLB.0323.00035,1,143852,145830,+,1978
53,WOLB.0323.00032,1,1113101,1115079,+,1978
53,WOLB.0323.00012,1,143839,145817,+,1978
53,WOLB.0323.00018,1,120792,122760,+,1968
53,WOLB.0323.00025,1,73953,75846,-,1893
53,WOLB.0323.00010,1,92624,94596,+,1972
53,WOLB.0323.00068,1,142107,144085,+,1978
53,WOLB.0323.00128,1,87155,89127,+,1972
53,WOLB.0323.00158,1,826742,828714,+,1972
53,WOLB.0323.00017,1,144959,146931,+,1972
53,WOLB.0323.00104,1,146152,148130,+,1978
53,WOLB.0323.00007,1,1349102,1351073,-,1971
53,WOLB.0323.00001,1,196465,198442,-,1977
53,WOLB.0323.00100,1,143852,145830,+,1978
53,WOLB.0323.00070,1,87190,89162,+,1972
53,WOLB.0323.00006,1,433878,435855,-,1977
53,WOLB.0323.00042,1,90242,92221,+,1979
53,WOLB.0323.00119,1,921430,923402,+,1972
53,WOLB.0323.00149,1,318318,320289,-,1971
53,WOLB.0323.00014,1,88532,90504,+,1972
53,WOLB.0323.00096,1,856354,858333,+,1979
52,WOLB.0323.00090,1,148655,149211,+,556
52,WOLB.0323.00002,1,87569,88106,+,537
52,WOLB.0323.00138,1,460912,461469,-,557
52,WOLB.0323.00132,1,1141366,1141923,-,557
52,WOLB.0323.00143,1,1157688,1158245,-,557
52,WOLB.0323.00106,1,1157691,1158248,-,557
52,WOLB.0323.00121,1,143508,144064,+,556
52,WOLB.0323.00135,1,215561,216118,-,557
52,WOLB.0323.00103,1,198863,199420,-,557
52,WOLB.0323.00107,1,198861,199418,-,557
52,WOLB.0323.00019,1,917800,918356,+,556
52,WOLB.0323.00060,1,1514076,1514633,-,557
52,WOLB.0323.00074,1,819471,820019,-,548
52,WOLB.0323.00120,1,805432,805980,-,548
52,WOLB.0323.00039,1,665952,666509,-,557
52,WOLB.0323.00041,1,817515,818062,+,547
52,WOLB.0323.00031,1,902592,903148,+,556
52,WOLB.0323.00056,1,147922,148478,+,556
52,WOLB.0323.00142,1,143077,143633,+,556
52,WOLB.0323.00023,1,873778,874334,+,556
52,WOLB.0323.00153,1,150306,150862,+,556
52,WOLB.0323.00093,1,292479,293035,+,556
52,WOLB.0323.00088,1,142877,143433,+,556
52,WOLB.0323.00008,1,104611,105152,-,541
52,WOLB.0323.00024,1,1158774,1159330,+,556
52,WOLB.0323.00064,1,1051268,1051825,-,557
52,WOLB.0323.00030,1,87481,88037,+,556
52,WOLB.0323.00105,1,198862,199419,-,557
52,WOLB.0323.00133,1,689035,689592,-,557
52,WOLB.0323.00084,1,554170,554727,-,557
52,WOLB.0323.00021,1,143114,143670,+,556
52,WOLB.0323.00043,1,86209,86765,+,556
52,WOLB.0323.00020,1,144047,144603,+,556
52,WOLB.0323.00122,1,150242,150798,+,556
52,WOLB.0323.00118,1,155473,156029,+,556
52,WOLB.0323.00004,1,143938,144494,+,556
52,WOLB.0323.00011,1,895092,895648,+,556
52,WOLB.0323.00035,1,142876,143432,+,556
52,WOLB.0323.00032,1,1112125,1112681,+,556
52,WOLB.0323.00012,1,142863,143419,+,556
52,WOLB.0323.00018,1,119816,120372,+,556
52,WOLB.0323.00010,1,91648,92204,+,556
52,WOLB.0323.00068,1,141131,141687,+,556
52,WOLB.0323.00128,1,86197,86735,+,538
52,WOLB.0323.00158,1,825766,826322,+,556
52,WOLB.0323.00017,1,143983,144539,+,556
52,WOLB.0323.00104,1,145176,145732,+,556
52,WOLB.0323.00007,1,1351493,1352050,-,557
52,WOLB.0323.00001,1,198862,199419,-,557
52,WOLB.0323.00100,1,142876,143432,+,556
52,WOLB.0323.00070,1,86232,86770,+,538
52,WOLB.0323.00006,1,436275,436832,-,557
52,WOLB.0323.00042,1,89275,89822,+,547
52,WOLB.0323.00119,1,920454,921010,+,556
52,WOLB.0323.00149,1,320709,321266,-,557
52,WOLB.0323.00014,1,87574,88112,+,538
52,WOLB.0323.00096,1,855387,855934,+,547
51,WOLB.0323.00090,1,146094,148357,+,2263
51,WOLB.0323.00002,1,85008,87272,+,2264
51,WOLB.0323.00138,1,461767,464054,-,2287
51,WOLB.0323.00132,1,1142220,1144484,-,2264
51,WOLB.0323.00143,1,1158543,1160786,-,2243
51,WOLB.0323.00106,1,1158546,1160789,-,2243
51,WOLB.0323.00121,1,140947,143210,+,2263
51,WOLB.0323.00135,1,216416,218703,-,2287
51,WOLB.0323.00103,1,199718,201981,-,2263
51,WOLB.0323.00107,1,199716,201979,-,2263
51,WOLB.0323.00019,1,1109952,1112218,-,2266
51,WOLB.0323.00060,1,1514931,1517218,-,2287
51,WOLB.0323.00074,1,820317,822529,-,2212
51,WOLB.0323.00120,1,806278,808490,-,2212
51,WOLB.0323.00039,1,666807,669073,-,2266
51,WOLB.0323.00041,1,815005,817217,+,2212
51,WOLB.0323.00031,1,900051,902294,+,2243
51,WOLB.0323.00056,1,145337,147624,+,2287
51,WOLB.0323.00142,1,140516,142779,+,2263
51,WOLB.0323.00023,1,871217,873481,+,2264
51,WOLB.0323.00153,1,147745,150008,+,2263
51,WOLB.0323.00093,1,289915,292181,+,2266
51,WOLB.0323.00088,1,140316,142579,+,2263
51,WOLB.0323.00008,1,106573,108839,-,2266
51,WOLB.0323.00024,1,1156213,1158477,+,2264
51,WOLB.0323.00064,1,1052122,1054350,-,2228
51,WOLB.0323.00030,1,84920,87184,+,2264
51,WOLB.0323.00105,1,199717,201980,-,2263
51,WOLB.0323.00133,1,689890,692154,-,2264
51,WOLB.0323.00084,1,555025,557312,-,2287
51,WOLB.0323.00021,1,140529,142816,+,2287
51,WOLB.0323.00043,1,83648,85912,+,2264
51,WOLB.0323.00020,1,141486,143749,+,2263
51,WOLB.0323.00122,1,147678,149944,+,2266
51,WOLB.0323.00118,1,152912,155175,+,2263
51,WOLB.0323.00004,1,141377,143640,+,2263
51,WOLB.0323.00011,1,892531,894794,+,2263
51,WOLB.0323.00035,1,140315,142578,+,2263
51,WOLB.0323.00032,1,1109540,1111827,+,2287
51,WOLB.0323.00012,1,140302,142565,+,2263
51,WOLB.0323.00018,1,117261,119527,+,2266
51,WOLB.0323.00025,1,610044,612338,-,2294
51,WOLB.0323.00010,1,89087,91351,+,2264
51,WOLB.0323.00068,1,138546,140833,+,2287
51,WOLB.0323.00128,1,83636,85900,+,2264
51,WOLB.0323.00158,1,823205,825468,+,2263
51,WOLB.0323.00017,1,141422,143685,+,2263
51,WOLB.0323.00104,1,142615,144878,+,2263
51,WOLB.0323.00007,1,1352348,1354635,-,2287
51,WOLB.0323.00001,1,199717,201980,-,2263
51,WOLB.0323.00100,1,140315,142578,+,2263
51,WOLB.0323.00070,1,83671,85935,+,2264
51,WOLB.0323.00006,1,437130,439373,-,2243
51,WOLB.0323.00042,1,86700,88986,+,2286
51,WOLB.0323.00119,1,1114047,1116313,-,2266
51,WOLB.0323.00149,1,321564,323827,-,2263
51,WOLB.0323.00014,1,85013,87277,+,2264
51,WOLB.0323.00096,1,852877,855089,+,2212
50,WOLB.0323.00090,1,144695,145390,+,695
50,WOLB.0323.00002,1,83618,84304,+,686
50,WOLB.0323.00138,1,464484,465179,-,695
50,WOLB.0323.00132,1,1144913,1145599,-,686
50,WOLB.0323.00143,1,1161498,1162193,-,695
50,WOLB.0323.00106,1,1161501,1162196,-,695
50,WOLB.0323.00121,1,139559,140245,+,686
50,WOLB.0323.00135,1,219133,219819,-,686
50,WOLB.0323.00103,1,202408,203093,-,685
50,WOLB.0323.00107,1,202406,203091,-,685
50,WOLB.0323.00019,1,1112655,1113350,-,695
50,WOLB.0323.00060,1,1517648,1518343,-,695
50,WOLB.0323.00074,1,822872,823558,-,686
50,WOLB.0323.00120,1,808833,809519,-,686
50,WOLB.0323.00039,1,669510,670205,-,695
50,WOLB.0323.00041,1,813976,814662,+,686
50,WOLB.0323.00031,1,898644,899339,+,695
50,WOLB.0323.00056,1,144212,144907,+,695
50,WOLB.0323.00142,1,139128,139814,+,686
50,WOLB.0323.00023,1,870102,870788,+,686
50,WOLB.0323.00153,1,146346,147041,+,695
50,WOLB.0323.00093,1,288527,289213,+,686
50,WOLB.0323.00088,1,139200,139886,+,686
50,WOLB.0323.00008,1,109541,110227,-,686
50,WOLB.0323.00024,1,1152839,1153534,+,695
50,WOLB.0323.00064,1,1054780,1055466,-,686
50,WOLB.0323.00030,1,83804,84490,+,686
50,WOLB.0323.00105,1,202407,203092,-,685
50,WOLB.0323.00133,1,692682,693377,-,695
50,WOLB.0323.00084,1,557742,558437,-,695
50,WOLB.0323.00021,1,139404,140099,+,695
50,WOLB.0323.00043,1,82258,82944,+,686
50,WOLB.0323.00020,1,140370,141056,+,686
50,WOLB.0323.00122,1,146290,146976,+,686
50,WOLB.0323.00118,1,151787,152482,+,695
50,WOLB.0323.00004,1,139989,140675,+,686
50,WOLB.0323.00011,1,891143,891829,+,686
50,WOLB.0323.00035,1,139199,139885,+,686
50,WOLB.0323.00032,1,1108415,1109110,+,695
50,WOLB.0323.00012,1,139186,139872,+,686
50,WOLB.0323.00018,1,115871,116557,+,686
50,WOLB.0323.00025,1,852960,853642,+,682
50,WOLB.0323.00010,1,87697,88383,+,686
50,WOLB.0323.00068,1,137421,138116,+,695
50,WOLB.0323.00128,1,82246,82932,+,686
50,WOLB.0323.00158,1,821817,822503,+,686
50,WOLB.0323.00017,1,140034,140720,+,686
50,WOLB.0323.00104,1,141499,142185,+,686
50,WOLB.0323.00007,1,1355065,1355760,-,695
50,WOLB.0323.00001,1,202407,203092,-,685
50,WOLB.0323.00100,1,139199,139885,+,686
50,WOLB.0323.00070,1,82281,82967,+,686
50,WOLB.0323.00006,1,440085,440780,-,695
50,WOLB.0323.00042,1,85310,85996,+,686
50,WOLB.0323.00119,1,1116750,1117445,-,695
50,WOLB.0323.00149,1,324529,325215,-,686
50,WOLB.0323.00014,1,82246,82932,+,686
50,WOLB.0323.00096,1,851848,852534,+,686
49,WOLB.0323.00090,1,140107,142398,+,2291
49,WOLB.0323.00002,1,78581,80872,+,2291
49,WOLB.0323.00138,1,467497,469788,-,2291
49,WOLB.0323.00132,1,1149898,1152189,-,2291
49,WOLB.0323.00143,1,1164399,1166701,-,2302
49,WOLB.0323.00106,1,1164402,1166704,-,2302
49,WOLB.0323.00121,1,134992,137283,+,2291
49,WOLB.0323.00135,1,222095,224386,-,2291
49,WOLB.0323.00103,1,226650,228941,+,2291
49,WOLB.0323.00107,1,226648,228939,+,2291
49,WOLB.0323.00019,1,1116206,1118497,-,2291
49,WOLB.0323.00060,1,1520661,1522952,-,2291
49,WOLB.0323.00074,1,933263,935565,-,2302
49,WOLB.0323.00074,1,938852,941143,+,2291
49,WOLB.0323.00120,1,917714,920005,+,2291
49,WOLB.0323.00039,1,673046,675337,-,2291
49,WOLB.0323.00041,1,702738,705029,-,2291
49,WOLB.0323.00031,1,894136,896438,+,2302
49,WOLB.0323.00056,1,139603,141894,+,2291
49,WOLB.0323.00142,1,134561,136852,+,2291
49,WOLB.0323.00023,1,864139,866429,+,2290
49,WOLB.0323.00153,1,141758,144049,+,2291
49,WOLB.0323.00093,1,106249,108540,-,2291
49,WOLB.0323.00088,1,134598,136889,+,2291
49,WOLB.0323.00008,1,1192463,1194754,-,2291
49,WOLB.0323.00024,1,570995,573231,-,2236
49,WOLB.0323.00064,1,1059278,1061569,-,2291
49,WOLB.0323.00030,1,77702,79993,+,2291
49,WOLB.0323.00105,1,226649,228940,+,2291
49,WOLB.0323.00133,1,696985,699272,-,2287
49,WOLB.0323.00084,1,560755,563046,-,2291
49,WOLB.0323.00021,1,134795,137086,+,2291
49,WOLB.0323.00043,1,77221,79512,+,2291
49,WOLB.0323.00020,1,135768,138059,+,2291
49,WOLB.0323.00122,1,140620,142911,+,2291
49,WOLB.0323.00118,1,147184,149475,+,2291
49,WOLB.0323.00004,1,135422,137713,+,2291
49,WOLB.0323.00011,1,886576,888867,+,2291
49,WOLB.0323.00035,1,134597,136888,+,2291
49,WOLB.0323.00032,1,1103806,1106097,+,2291
49,WOLB.0323.00012,1,134584,136875,+,2291
49,WOLB.0323.00018,1,110031,112322,+,2291
49,WOLB.0323.00025,1,847788,850079,+,2291
49,WOLB.0323.00010,1,80528,82819,+,2291
49,WOLB.0323.00068,1,132812,135103,+,2291
49,WOLB.0323.00128,1,77209,79500,+,2291
49,WOLB.0323.00158,1,817250,819541,+,2291
49,WOLB.0323.00017,1,135467,137758,+,2291
49,WOLB.0323.00104,1,136897,139188,+,2291
49,WOLB.0323.00007,1,1358078,1360369,-,2291
49,WOLB.0323.00001,1,226649,228940,+,2291
49,WOLB.0323.00100,1,134597,136888,+,2291
49,WOLB.0323.00070,1,77245,79536,+,2291
49,WOLB.0323.00006,1,442987,445273,-,2286
49,WOLB.0323.00042,1,78787,81078,+,2291
49,WOLB.0323.00119,1,1120301,1122592,-,2291
49,WOLB.0323.00149,1,327491,329782,-,2291
49,WOLB.0323.00014,1,77210,79501,+,2291
49,WOLB.0323.00096,1,741227,743518,-,2291
48,WOLB.0323.00090,1,139441,140083,+,642
48,WOLB.0323.00002,1,77915,78557,+,642
48,WOLB.0323.00138,1,469812,470454,-,642
48,WOLB.0323.00132,1,1152213,1152855,-,642
48,WOLB.0323.00143,1,1166725,1167367,-,642
48,WOLB.0323.00106,1,1166728,1167370,-,642
48,WOLB.0323.00121,1,134326,134968,+,642
48,WOLB.0323.00135,1,224410,225052,-,642
48,WOLB.0323.00103,1,225984,226626,+,642
48,WOLB.0323.00107,1,225982,226624,+,642
48,WOLB.0323.00019,1,1118521,1119163,-,642
48,WOLB.0323.00060,1,1522976,1523618,-,642
48,WOLB.0323.00074,1,931189,931794,+,605
48,WOLB.0323.00074,1,935590,936235,-,645
48,WOLB.0323.00074,1,938186,938828,+,642
48,WOLB.0323.00120,1,917048,917690,+,642
48,WOLB.0323.00039,1,675361,676003,-,642
48,WOLB.0323.00041,1,705053,705695,-,642
48,WOLB.0323.00031,1,893470,894112,+,642
48,WOLB.0323.00056,1,138937,139579,+,642
48,WOLB.0323.00142,1,133895,134537,+,642
48,WOLB.0323.00023,1,863456,864098,+,642
48,WOLB.0323.00153,1,141092,141734,+,642
48,WOLB.0323.00093,1,108564,109206,-,642
48,WOLB.0323.00088,1,133932,134574,+,642
48,WOLB.0323.00008,1,1194778,1195420,-,642
48,WOLB.0323.00024,1,574737,575379,-,642
48,WOLB.0323.00064,1,1061593,1062235,-,642
48,WOLB.0323.00030,1,77036,77678,+,642
48,WOLB.0323.00105,1,225983,226625,+,642
48,WOLB.0323.00133,1,699300,699942,-,642
48,WOLB.0323.00084,1,563070,563712,-,642
48,WOLB.0323.00021,1,134129,134771,+,642
48,WOLB.0323.00043,1,76555,77197,+,642
48,WOLB.0323.00020,1,135102,135744,+,642
48,WOLB.0323.00122,1,139954,140596,+,642
48,WOLB.0323.00118,1,146518,147160,+,642
48,WOLB.0323.00004,1,134756,135398,+,642
48,WOLB.0323.00011,1,885910,886552,+,642
48,WOLB.0323.00035,1,133931,134573,+,642
48,WOLB.0323.00032,1,1103140,1103782,+,642
48,WOLB.0323.00012,1,133918,134560,+,642
48,WOLB.0323.00018,1,109365,110007,+,642
48,WOLB.0323.00025,1,847153,847764,+,611
48,WOLB.0323.00010,1,79862,80504,+,642
48,WOLB.0323.00068,1,132146,132788,+,642
48,WOLB.0323.00128,1,76543,77185,+,642
48,WOLB.0323.00158,1,816584,817226,+,642
48,WOLB.0323.00017,1,134801,135443,+,642
48,WOLB.0323.00104,1,136231,136873,+,642
48,WOLB.0323.00007,1,1360393,1361035,-,642
48,WOLB.0323.00001,1,225983,226625,+,642
48,WOLB.0323.00100,1,133931,134573,+,642
48,WOLB.0323.00070,1,76579,77221,+,642
48,WOLB.0323.00006,1,445297,445939,-,642
48,WOLB.0323.00042,1,78121,78763,+,642
48,WOLB.0323.00119,1,1122616,1123258,-,642
48,WOLB.0323.00149,1,329806,330448,-,642
48,WOLB.0323.00014,1,76544,77186,+,642
48,WOLB.0323.00096,1,743542,744184,-,642
47,WOLB.0323.00090,1,138617,139439,+,822
47,WOLB.0323.00002,1,77091,77913,+,822
47,WOLB.0323.00138,1,470455,471278,-,823
47,WOLB.0323.00132,1,1152856,1153679,-,823
47,WOLB.0323.00143,1,1167368,1168191,-,823
47,WOLB.0323.00106,1,1167371,1168194,-,823
47,WOLB.0323.00121,1,133502,134324,+,822
47,WOLB.0323.00135,1,225053,225876,-,823
47,WOLB.0323.00103,1,225160,225982,+,822
47,WOLB.0323.00107,1,225158,225980,+,822
47,WOLB.0323.00019,1,1119164,1119987,-,823
47,WOLB.0323.00060,1,1523619,1524442,-,823
47,WOLB.0323.00074,1,930365,931187,+,822
47,WOLB.0323.00074,1,936236,937026,-,790
47,WOLB.0323.00074,1,937362,938184,+,822
47,WOLB.0323.00120,1,916224,917046,+,822
47,WOLB.0323.00039,1,676004,676827,-,823
47,WOLB.0323.00041,1,705696,706519,-,823
47,WOLB.0323.00031,1,892646,893468,+,822
47,WOLB.0323.00056,1,138113,138935,+,822
47,WOLB.0323.00142,1,133071,133893,+,822
47,WOLB.0323.00023,1,862632,863454,+,822
47,WOLB.0323.00153,1,140268,141090,+,822
47,WOLB.0323.00093,1,109207,110030,-,823
47,WOLB.0323.00088,1,133108,133930,+,822
47,WOLB.0323.00008,1,1195421,1196244,-,823
47,WOLB.0323.00024,1,575380,576203,-,823
47,WOLB.0323.00064,1,1062236,1063059,-,823
47,WOLB.0323.00030,1,76212,77034,+,822
47,WOLB.0323.00105,1,225159,225981,+,822
47,WOLB.0323.00133,1,699943,700766,-,823
47,WOLB.0323.00084,1,563713,564536,-,823
47,WOLB.0323.00021,1,133305,134127,+,822
47,WOLB.0323.00043,1,75731,76553,+,822
47,WOLB.0323.00020,1,134278,135100,+,822
47,WOLB.0323.00122,1,139130,139952,+,822
47,WOLB.0323.00118,1,145694,146516,+,822
47,WOLB.0323.00004,1,133932,134754,+,822
47,WOLB.0323.00011,1,885086,885908,+,822
47,WOLB.0323.00035,1,133107,133929,+,822
47,WOLB.0323.00032,1,1102316,1103138,+,822
47,WOLB.0323.00012,1,133094,133916,+,822
47,WOLB.0323.00018,1,108541,109363,+,822
47,WOLB.0323.00025,1,509824,510662,+,838
47,WOLB.0323.00010,1,79038,79860,+,822
47,WOLB.0323.00068,1,131322,132144,+,822
47,WOLB.0323.00128,1,75719,76541,+,822
47,WOLB.0323.00158,1,815760,816582,+,822
47,WOLB.0323.00017,1,133977,134799,+,822
47,WOLB.0323.00104,1,135407,136229,+,822
47,WOLB.0323.00007,1,1361036,1361859,-,823
47,WOLB.0323.00001,1,225159,225981,+,822
47,WOLB.0323.00100,1,133107,133929,+,822
47,WOLB.0323.00070,1,75755,76577,+,822
47,WOLB.0323.00006,1,445940,446763,-,823
47,WOLB.0323.00042,1,77297,78119,+,822
47,WOLB.0323.00119,1,1123259,1124082,-,823
47,WOLB.0323.00149,1,330449,331272,-,823
47,WOLB.0323.00014,1,75720,76542,+,822
47,WOLB.0323.00096,1,744185,745008,-,823
46,WOLB.0323.00090,1,135623,138332,+,2709
46,WOLB.0323.00002,1,74097,76806,+,2709
46,WOLB.0323.00138,1,471562,474272,-,2710
46,WOLB.0323.00132,1,1153963,1156673,-,2710
46,WOLB.0323.00143,1,1168475,1171185,-,2710
46,WOLB.0323.00106,1,1168478,1171188,-,2710
46,WOLB.0323.00121,1,130508,133217,+,2709
46,WOLB.0323.00135,1,226160,228870,-,2710
46,WOLB.0323.00103,1,222166,224875,+,2709
46,WOLB.0323.00107,1,222164,224873,+,2709
46,WOLB.0323.00019,1,1120271,1122986,-,2715
46,WOLB.0323.00060,1,1524726,1527436,-,2710
46,WOLB.0323.00074,1,927371,930080,+,2709
46,WOLB.0323.00120,1,913230,915939,+,2709
46,WOLB.0323.00039,1,677111,679826,-,2715
46,WOLB.0323.00041,1,706803,709513,-,2710
46,WOLB.0323.00031,1,889652,892361,+,2709
46,WOLB.0323.00056,1,135119,137828,+,2709
46,WOLB.0323.00142,1,130077,132786,+,2709
46,WOLB.0323.00023,1,859638,862347,+,2709
46,WOLB.0323.00153,1,137274,139983,+,2709
46,WOLB.0323.00093,1,110314,113024,-,2710
46,WOLB.0323.00088,1,130114,132823,+,2709
46,WOLB.0323.00008,1,1196528,1199238,-,2710
46,WOLB.0323.00024,1,576487,579197,-,2710
46,WOLB.0323.00064,1,1063343,1066053,-,2710
46,WOLB.0323.00030,1,73218,75927,+,2709
46,WOLB.0323.00105,1,222165,224874,+,2709
46,WOLB.0323.00133,1,701050,703765,-,2715
46,WOLB.0323.00084,1,564820,567530,-,2710
46,WOLB.0323.00021,1,130311,133020,+,2709
46,WOLB.0323.00043,1,72737,75446,+,2709
46,WOLB.0323.00020,1,131284,133993,+,2709
46,WOLB.0323.00122,1,136136,138845,+,2709
46,WOLB.0323.00118,1,142700,145409,+,2709
46,WOLB.0323.00004,1,130938,133647,+,2709
46,WOLB.0323.00011,1,882092,884801,+,2709
46,WOLB.0323.00035,1,130113,132822,+,2709
46,WOLB.0323.00032,1,1099322,1102031,+,2709
46,WOLB.0323.00012,1,130100,132809,+,2709
46,WOLB.0323.00018,1,105547,108256,+,2709
46,WOLB.0323.00025,1,506830,509539,+,2709
46,WOLB.0323.00010,1,76044,78753,+,2709
46,WOLB.0323.00068,1,128328,131037,+,2709
46,WOLB.0323.00128,1,72725,75434,+,2709
46,WOLB.0323.00158,1,812766,815475,+,2709
46,WOLB.0323.00017,1,130983,133692,+,2709
46,WOLB.0323.00104,1,132413,135122,+,2709
46,WOLB.0323.00007,1,1362143,1364853,-,2710
46,WOLB.0323.00001,1,222165,224874,+,2709
46,WOLB.0323.00100,1,130113,132822,+,2709
46,WOLB.0323.00070,1,72761,75470,+,2709
46,WOLB.0323.00006,1,447047,449757,-,2710
46,WOLB.0323.00042,1,74303,77012,+,2709
46,WOLB.0323.00119,1,1124366,1127081,-,2715
46,WOLB.0323.00149,1,331556,334266,-,2710
46,WOLB.0323.00014,1,72726,75435,+,2709
46,WOLB.0323.00096,1,745292,748002,-,2710
45,WOLB.0323.00090,1,134298,135438,+,1140
45,WOLB.0323.00002,1,72776,73912,+,1136
45,WOLB.0323.00138,1,474456,475597,-,1141
45,WOLB.0323.00132,1,1156857,1157998,-,1141
45,WOLB.0323.00143,1,1171369,1172510,-,1141
45,WOLB.0323.00106,1,1171372,1172513,-,1141
45,WOLB.0323.00121,1,129183,130323,+,1140
45,WOLB.0323.00135,1,229054,230195,-,1141
45,WOLB.0323.00103,1,220841,221981,+,1140
45,WOLB.0323.00107,1,220839,221979,+,1140
45,WOLB.0323.00019,1,1123170,1124311,-,1141
45,WOLB.0323.00060,1,1527620,1528761,-,1141
45,WOLB.0323.00074,1,926046,927186,+,1140
45,WOLB.0323.00120,1,911905,913045,+,1140
45,WOLB.0323.00039,1,680010,681151,-,1141
45,WOLB.0323.00041,1,709697,710838,-,1141
45,WOLB.0323.00031,1,888327,889467,+,1140
45,WOLB.0323.00056,1,133794,134934,+,1140
45,WOLB.0323.00142,1,128752,129892,+,1140
45,WOLB.0323.00023,1,858317,859453,+,1136
45,WOLB.0323.00153,1,135949,137089,+,1140
45,WOLB.0323.00093,1,113208,114340,-,1132
45,WOLB.0323.00088,1,128789,129929,+,1140
45,WOLB.0323.00008,1,1199422,1200554,-,1132
45,WOLB.0323.00024,1,579381,580522,-,1141
45,WOLB.0323.00064,1,1066237,1067378,-,1141
45,WOLB.0323.00030,1,71893,73033,+,1140
45,WOLB.0323.00105,1,220840,221980,+,1140
45,WOLB.0323.00133,1,703949,705090,-,1141
45,WOLB.0323.00084,1,567714,568855,-,1141
45,WOLB.0323.00021,1,128986,130126,+,1140
45,WOLB.0323.00043,1,71416,72552,+,1136
45,WOLB.0323.00020,1,129959,131099,+,1140
45,WOLB.0323.00122,1,134811,135951,+,1140
45,WOLB.0323.00118,1,141375,142515,+,1140
45,WOLB.0323.00004,1,129613,130753,+,1140
45,WOLB.0323.00011,1,880767,881907,+,1140
45,WOLB.0323.00035,1,128788,129928,+,1140
45,WOLB.0323.00032,1,1097997,1099137,+,1140
45,WOLB.0323.00012,1,128775,129915,+,1140
45,WOLB.0323.00018,1,104222,105362,+,1140
45,WOLB.0323.00025,1,505505,506645,+,1140
45,WOLB.0323.00010,1,74723,75859,+,1136
45,WOLB.0323.00068,1,127003,128143,+,1140
45,WOLB.0323.00128,1,71404,72540,+,1136
45,WOLB.0323.00158,1,811441,812581,+,1140
45,WOLB.0323.00017,1,129658,130798,+,1140
45,WOLB.0323.00104,1,131088,132228,+,1140
45,WOLB.0323.00007,1,1365037,1366178,-,1141
45,WOLB.0323.00001,1,220840,221980,+,1140
45,WOLB.0323.00100,1,128788,129928,+,1140
45,WOLB.0323.00070,1,71440,72576,+,1136
45,WOLB.0323.00006,1,449941,451082,-,1141
45,WOLB.0323.00042,1,72978,74118,+,1140
45,WOLB.0323.00119,1,1127265,1128406,-,1141
45,WOLB.0323.00149,1,334450,335591,-,1141
45,WOLB.0323.00014,1,71405,72541,+,1136
45,WOLB.0323.00096,1,748186,749327,-,1141
44,WOLB.0323.00090,1,132683,133372,+,689
44,WOLB.0323.00002,1,71147,71836,+,689
44,WOLB.0323.00138,1,476523,477212,-,689
44,WOLB.0323.00132,1,1158931,1159620,-,689
44,WOLB.0323.00143,1,1173437,1174126,-,689
44,WOLB.0323.00106,1,1173440,1174129,-,689
44,WOLB.0323.00121,1,127568,128257,+,689
44,WOLB.0323.00135,1,231128,231817,-,689
44,WOLB.0323.00060,1,1529694,1530383,-,689
44,WOLB.0323.00074,1,924431,925120,+,689
44,WOLB.0323.00120,1,910290,910979,+,689
44,WOLB.0323.00041,1,711764,712453,-,689
44,WOLB.0323.00031,1,886711,887400,+,689
44,WOLB.0323.00056,1,132172,132861,+,689
44,WOLB.0323.00142,1,127137,127826,+,689
44,WOLB.0323.00153,1,134335,135024,+,689
44,WOLB.0323.00088,1,127174,127863,+,689
44,WOLB.0323.00024,1,581455,582144,-,689
44,WOLB.0323.00064,1,1068311,1068998,-,687
44,WOLB.0323.00030,1,70273,70960,+,687
44,WOLB.0323.00084,1,569781,570470,-,689
44,WOLB.0323.00021,1,127371,128060,+,689
44,WOLB.0323.00043,1,69787,70476,+,689
44,WOLB.0323.00020,1,128344,129033,+,689
44,WOLB.0323.00122,1,133196,133885,+,689
44,WOLB.0323.00118,1,139753,140442,+,689
44,WOLB.0323.00004,1,127998,128687,+,689
44,WOLB.0323.00011,1,879152,879841,+,689
44,WOLB.0323.00035,1,127173,127862,+,689
44,WOLB.0323.00032,1,1096382,1097071,+,689
44,WOLB.0323.00012,1,127160,127849,+,689
44,WOLB.0323.00025,1,503882,504542,+,660
44,WOLB.0323.00010,1,73094,73783,+,689
44,WOLB.0323.00068,1,125388,126077,+,689
44,WOLB.0323.00128,1,69775,70464,+,689
44,WOLB.0323.00158,1,809826,810515,+,689
44,WOLB.0323.00017,1,128043,128732,+,689
44,WOLB.0323.00104,1,129473,130162,+,689
44,WOLB.0323.00007,1,1367111,1367800,-,689
44,WOLB.0323.00100,1,127173,127862,+,689
44,WOLB.0323.00070,1,69811,70500,+,689
44,WOLB.0323.00006,1,452008,452697,-,689
44,WOLB.0323.00149,1,336517,337206,-,689
44,WOLB.0323.00014,1,69776,70465,+,689
44,WOLB.0323.00096,1,750253,750942,-,689
43,WOLB.0323.00090,1,129748,132348,+,2600
43,WOLB.0323.00002,1,68208,70806,+,2598
43,WOLB.0323.00138,1,477547,480147,-,2600
43,WOLB.0323.00132,1,1159961,1162559,-,2598
43,WOLB.0323.00143,1,1174476,1177076,-,2600
43,WOLB.0323.00106,1,1174479,1177079,-,2600
43,WOLB.0323.00121,1,124633,127233,+,2600
43,WOLB.0323.00135,1,232152,234752,-,2600
43,WOLB.0323.00103,1,216321,218921,+,2600
43,WOLB.0323.00107,1,216319,218919,+,2600
43,WOLB.0323.00019,1,1126244,1128842,-,2598
43,WOLB.0323.00060,1,1530743,1533343,-,2600
43,WOLB.0323.00074,1,921496,924096,+,2600
43,WOLB.0323.00120,1,907355,909955,+,2600
43,WOLB.0323.00039,1,683084,685682,-,2598
43,WOLB.0323.00041,1,712788,715388,-,2600
43,WOLB.0323.00031,1,883761,886361,+,2600
43,WOLB.0323.00056,1,129212,131812,+,2600
43,WOLB.0323.00142,1,124202,126802,+,2600
43,WOLB.0323.00023,1,853777,856377,+,2600
43,WOLB.0323.00153,1,131400,134000,+,2600
43,WOLB.0323.00093,1,116269,118867,-,2598
43,WOLB.0323.00088,1,124336,126936,+,2600
43,WOLB.0323.00008,1,1202480,1205078,-,2598
43,WOLB.0323.00024,1,582493,585093,-,2600
43,WOLB.0323.00064,1,1069339,1071937,-,2598
43,WOLB.0323.00030,1,67334,69932,+,2598
43,WOLB.0323.00105,1,216320,218920,+,2600
43,WOLB.0323.00133,1,707005,709603,-,2598
43,WOLB.0323.00084,1,570805,573405,-,2600
43,WOLB.0323.00021,1,124436,127036,+,2600
43,WOLB.0323.00043,1,66848,69446,+,2598
43,WOLB.0323.00020,1,125506,128106,+,2600
43,WOLB.0323.00122,1,130261,132861,+,2600
43,WOLB.0323.00118,1,136818,139418,+,2600
43,WOLB.0323.00004,1,125063,127663,+,2600
43,WOLB.0323.00011,1,876217,878817,+,2600
43,WOLB.0323.00035,1,124335,126935,+,2600
43,WOLB.0323.00032,1,1093447,1096047,+,2600
43,WOLB.0323.00012,1,124322,126922,+,2600
43,WOLB.0323.00018,1,100983,103581,+,2598
43,WOLB.0323.00025,1,500936,503536,+,2600
43,WOLB.0323.00010,1,70162,72760,+,2598
43,WOLB.0323.00068,1,122453,125053,+,2600
43,WOLB.0323.00128,1,66836,69434,+,2598
43,WOLB.0323.00158,1,806891,809491,+,2600
43,WOLB.0323.00017,1,125108,127708,+,2600
43,WOLB.0323.00104,1,126635,129235,+,2600
43,WOLB.0323.00007,1,1368160,1370760,-,2600
43,WOLB.0323.00001,1,216320,218920,+,2600
43,WOLB.0323.00100,1,124335,126935,+,2600
43,WOLB.0323.00070,1,66872,69470,+,2598
43,WOLB.0323.00006,1,453047,455647,-,2600
43,WOLB.0323.00042,1,69774,72343,+,2569
43,WOLB.0323.00119,1,1130339,1132937,-,2598
43,WOLB.0323.00149,1,337541,340141,-,2600
43,WOLB.0323.00014,1,66837,69435,+,2598
43,WOLB.0323.00096,1,751277,753877,-,2600
42,WOLB.0323.00090,1,123212,123858,+,646
42,WOLB.0323.00138,1,484950,485596,-,646
42,WOLB.0323.00132,1,1164562,1165161,-,599
42,WOLB.0323.00143,1,1180458,1181104,-,646
42,WOLB.0323.00106,1,1180461,1181107,-,646
42,WOLB.0323.00121,1,117740,118386,+,646
42,WOLB.0323.00135,1,239384,240030,-,646
42,WOLB.0323.00019,1,1133557,1134194,-,637
42,WOLB.0323.00060,1,1638656,1639302,+,646
42,WOLB.0323.00074,1,915898,916545,+,647
42,WOLB.0323.00120,1,901757,902404,+,647
42,WOLB.0323.00039,1,687683,688320,-,637
42,WOLB.0323.00041,1,720338,720985,-,647
42,WOLB.0323.00031,1,879732,880378,+,646
42,WOLB.0323.00056,1,123849,124495,+,646
42,WOLB.0323.00142,1,118818,119464,+,646
42,WOLB.0323.00153,1,124864,125510,+,646
42,WOLB.0323.00088,1,118973,119619,+,646
42,WOLB.0323.00008,1,1208561,1209207,-,646
42,WOLB.0323.00133,1,712928,713565,-,637
42,WOLB.0323.00084,1,578208,578854,-,646
42,WOLB.0323.00021,1,118986,119632,+,646
42,WOLB.0323.00020,1,120143,120789,+,646
42,WOLB.0323.00122,1,124897,125543,+,646
42,WOLB.0323.00118,1,131456,132102,+,646
42,WOLB.0323.00004,1,119679,120325,+,646
42,WOLB.0323.00011,1,868848,869494,+,646
42,WOLB.0323.00035,1,118972,119618,+,646
42,WOLB.0323.00032,1,1086488,1087134,+,646
42,WOLB.0323.00012,1,118959,119605,+,646
42,WOLB.0323.00025,1,351555,352202,-,647
42,WOLB.0323.00068,1,117003,117649,+,646
42,WOLB.0323.00158,1,801507,802153,+,646
42,WOLB.0323.00017,1,117739,118385,+,646
42,WOLB.0323.00104,1,121272,121918,+,646
42,WOLB.0323.00007,1,1375476,1376122,-,646
42,WOLB.0323.00100,1,118972,119618,+,646
42,WOLB.0323.00006,1,459029,459675,-,646
42,WOLB.0323.00119,1,1134946,1135583,-,637
42,WOLB.0323.00149,1,344878,345524,-,646
42,WOLB.0323.00096,1,758827,759474,-,647
41,WOLB.0323.00090,1,118745,122770,+,4025
41,WOLB.0323.00002,1,61189,65173,+,3984
41,WOLB.0323.00138,1,486039,490064,-,4025
41,WOLB.0323.00132,1,58859,62884,+,4025
41,WOLB.0323.00143,1,1181555,1185583,-,4028
41,WOLB.0323.00106,1,1181558,1185586,-,4028
41,WOLB.0323.00121,1,113273,117298,+,4025
41,WOLB.0323.00135,1,240473,244498,-,4025
41,WOLB.0323.00103,1,207535,211561,-,4026
41,WOLB.0323.00107,1,207533,211559,-,4026
41,WOLB.0323.00019,1,1134645,1138671,-,4026
41,WOLB.0323.00060,1,1634189,1638214,+,4025
41,WOLB.0323.00074,1,911423,915448,+,4025
41,WOLB.0323.00120,1,897282,901307,+,4025
41,WOLB.0323.00039,1,688771,692797,-,4026
41,WOLB.0323.00041,1,721436,725461,-,4025
41,WOLB.0323.00031,1,875254,879282,+,4028
41,WOLB.0323.00056,1,119382,123407,+,4025
41,WOLB.0323.00142,1,114351,118376,+,4025
41,WOLB.0323.00023,1,846667,850693,+,4026
41,WOLB.0323.00153,1,120397,124422,+,4025
41,WOLB.0323.00093,1,124351,128377,-,4026
41,WOLB.0323.00088,1,114506,118531,+,4025
41,WOLB.0323.00008,1,1211532,1215558,-,4026
41,WOLB.0323.00024,1,586748,590773,-,4025
41,WOLB.0323.00064,1,1075000,1079025,-,4025
41,WOLB.0323.00030,1,60246,64271,+,4025
41,WOLB.0323.00105,1,207534,211560,-,4026
41,WOLB.0323.00133,1,714016,718042,-,4026
41,WOLB.0323.00084,1,579297,583322,-,4025
41,WOLB.0323.00021,1,114519,118544,+,4025
41,WOLB.0323.00043,1,59828,63853,+,4025
41,WOLB.0323.00020,1,115676,119701,+,4025
41,WOLB.0323.00122,1,120430,124455,+,4025
41,WOLB.0323.00118,1,126978,131006,+,4028
41,WOLB.0323.00004,1,115212,119237,+,4025
41,WOLB.0323.00011,1,864381,868406,+,4025
41,WOLB.0323.00035,1,114505,118530,+,4025
41,WOLB.0323.00032,1,1082021,1086046,+,4025
41,WOLB.0323.00012,1,114492,118517,+,4025
41,WOLB.0323.00018,1,93957,97982,+,4025
41,WOLB.0323.00025,1,352653,356677,-,4024
41,WOLB.0323.00010,1,63143,67168,+,4025
41,WOLB.0323.00068,1,112536,116561,+,4025
41,WOLB.0323.00128,1,59817,63842,+,4025
41,WOLB.0323.00158,1,797040,801065,+,4025
41,WOLB.0323.00017,1,113272,117297,+,4025
41,WOLB.0323.00104,1,116805,120830,+,4025
41,WOLB.0323.00007,1,1376565,1380590,-,4025
41,WOLB.0323.00001,1,207534,211560,-,4026
41,WOLB.0323.00100,1,114505,118530,+,4025
41,WOLB.0323.00070,1,59853,63878,+,4025
41,WOLB.0323.00006,1,460126,464154,-,4028
41,WOLB.0323.00042,1,61226,65252,+,4026
41,WOLB.0323.00119,1,1136034,1140060,-,4026
41,WOLB.0323.00149,1,345967,349992,-,4025
41,WOLB.0323.00014,1,59818,63843,+,4025
41,WOLB.0323.00096,1,759925,763950,-,4025
40,WOLB.0323.00090,1,112272,117705,+,5433
40,WOLB.0323.00002,1,54712,60136,+,5424
40,WOLB.0323.00138,1,490311,495747,-,5436
40,WOLB.0323.00132,1,53187,58611,+,5424
40,WOLB.0323.00143,1,1186637,1192046,-,5409
40,WOLB.0323.00106,1,1186640,1192049,-,5409
40,WOLB.0323.00121,1,106800,112233,+,5433
40,WOLB.0323.00135,1,244745,250172,-,5427
40,WOLB.0323.00103,1,147560,153033,+,5473
40,WOLB.0323.00107,1,147559,153032,+,5473
40,WOLB.0323.00019,1,1138916,1144343,-,5427
40,WOLB.0323.00060,1,1628505,1633941,+,5436
40,WOLB.0323.00074,1,905740,911176,+,5436
40,WOLB.0323.00120,1,891599,897035,+,5436
40,WOLB.0323.00039,1,693043,698470,-,5427
40,WOLB.0323.00041,1,725708,731144,-,5436
40,WOLB.0323.00031,1,868791,874200,+,5409
40,WOLB.0323.00056,1,113698,119134,+,5436
40,WOLB.0323.00142,1,107878,113311,+,5433
40,WOLB.0323.00023,1,840995,846422,+,5427
40,WOLB.0323.00153,1,113924,119357,+,5433
40,WOLB.0323.00093,1,129422,134837,-,5415
40,WOLB.0323.00088,1,108832,114259,+,5427
40,WOLB.0323.00008,1,1216611,1222035,-,5424
40,WOLB.0323.00024,1,591019,596447,-,5428
40,WOLB.0323.00064,1,1079272,1084744,-,5472
40,WOLB.0323.00030,1,54528,59999,+,5471
40,WOLB.0323.00105,1,147559,153032,+,5473
40,WOLB.0323.00133,1,718288,723697,-,5409
40,WOLB.0323.00084,1,583569,589005,-,5436
40,WOLB.0323.00021,1,108837,114272,+,5435
40,WOLB.0323.00043,1,53351,58775,+,5424
40,WOLB.0323.00020,1,110002,115429,+,5427
40,WOLB.0323.00122,1,112863,118287,+,5424
40,WOLB.0323.00118,1,121465,126731,+,5266
40,WOLB.0323.00004,1,108739,114172,+,5433
40,WOLB.0323.00011,1,857908,863341,+,5433
40,WOLB.0323.00035,1,108831,114258,+,5427
40,WOLB.0323.00032,1,1076338,1081774,+,5436
40,WOLB.0323.00012,1,108818,114245,+,5427
40,WOLB.0323.00018,1,88280,93710,+,5430
40,WOLB.0323.00025,1,279064,284475,-,5411
40,WOLB.0323.00010,1,55378,60802,+,5424
40,WOLB.0323.00068,1,106853,112289,+,5436
40,WOLB.0323.00128,1,53340,58764,+,5424
40,WOLB.0323.00158,1,790567,796000,+,5433
40,WOLB.0323.00017,1,106799,112232,+,5433
40,WOLB.0323.00104,1,111131,116558,+,5427
40,WOLB.0323.00007,1,1380838,1386274,-,5436
40,WOLB.0323.00001,1,147559,153032,+,5473
40,WOLB.0323.00100,1,108831,114258,+,5427
40,WOLB.0323.00070,1,53376,58800,+,5424
40,WOLB.0323.00006,1,465208,470632,-,5424
40,WOLB.0323.00042,1,55554,60981,+,5427
40,WOLB.0323.00119,1,1140305,1145732,-,5427
40,WOLB.0323.00149,1,351032,356465,-,5433
40,WOLB.0323.00014,1,53341,58765,+,5424
40,WOLB.0323.00096,1,764197,769633,-,5436
39,WOLB.0323.00090,1,106173,110907,+,4734
39,WOLB.0323.00002,1,48655,53387,+,4732
39,WOLB.0323.00138,1,497112,501850,-,4738
39,WOLB.0323.00132,1,47086,51820,+,4734
39,WOLB.0323.00143,1,1192561,1197279,-,4718
39,WOLB.0323.00106,1,1192564,1197282,-,4718
39,WOLB.0323.00121,1,100651,105385,+,4734
39,WOLB.0323.00135,1,251537,256271,-,4734
39,WOLB.0323.00103,1,141448,146182,+,4734
39,WOLB.0323.00107,1,141447,146181,+,4734
39,WOLB.0323.00019,1,1145732,1150464,-,4732
39,WOLB.0323.00060,1,1622406,1627140,+,4734
39,WOLB.0323.00074,1,899706,904435,+,4729
39,WOLB.0323.00120,1,885565,890294,+,4729
39,WOLB.0323.00039,1,699868,704599,-,4731
39,WOLB.0323.00041,1,732449,737178,-,4729
39,WOLB.0323.00031,1,863558,868276,+,4718
39,WOLB.0323.00056,1,107611,112345,+,4734
39,WOLB.0323.00142,1,101729,106463,+,4734
39,WOLB.0323.00023,1,834899,839633,+,4734
39,WOLB.0323.00153,1,107825,112559,+,4734
39,WOLB.0323.00093,1,136527,141256,-,4729
39,WOLB.0323.00088,1,102739,107473,+,4734
39,WOLB.0323.00008,1,1223450,1228179,-,4729
39,WOLB.0323.00024,1,73781,78515,-,4734
39,WOLB.0323.00064,1,1086114,1090848,-,4734
39,WOLB.0323.00030,1,48436,53170,+,4734
39,WOLB.0323.00105,1,141447,146181,+,4734
39,WOLB.0323.00133,1,724991,729723,-,4732
39,WOLB.0323.00084,1,590370,595108,-,4738
39,WOLB.0323.00021,1,102734,107472,+,4738
39,WOLB.0323.00043,1,47285,52017,+,4732
39,WOLB.0323.00020,1,103910,108644,+,4734
39,WOLB.0323.00122,1,106714,111448,+,4734
39,WOLB.0323.00118,1,115908,120646,+,4738
39,WOLB.0323.00004,1,102590,107324,+,4734
39,WOLB.0323.00011,1,851759,856493,+,4734
39,WOLB.0323.00035,1,102739,107473,+,4734
39,WOLB.0323.00032,1,1070235,1074973,+,4738
39,WOLB.0323.00012,1,102726,107460,+,4734
39,WOLB.0323.00018,1,82130,86862,+,4732
39,WOLB.0323.00025,1,818675,823409,-,4734
39,WOLB.0323.00010,1,49281,54017,+,4736
39,WOLB.0323.00068,1,100750,105488,+,4738
39,WOLB.0323.00128,1,47286,52018,+,4732
39,WOLB.0323.00158,1,784418,789152,+,4734
39,WOLB.0323.00017,1,100650,105384,+,4734
39,WOLB.0323.00104,1,105039,109773,+,4734
39,WOLB.0323.00007,1,1387639,1392373,-,4734
39,WOLB.0323.00001,1,141447,146181,+,4734
39,WOLB.0323.00100,1,102739,107473,+,4734
39,WOLB.0323.00070,1,47310,52042,+,4732
39,WOLB.0323.00006,1,471147,475865,-,4718
39,WOLB.0323.00042,1,48539,53272,+,4733
39,WOLB.0323.00119,1,1147121,1151853,-,4732
39,WOLB.0323.00149,1,357880,362614,-,4734
39,WOLB.0323.00014,1,47287,52019,+,4732
39,WOLB.0323.00096,1,770938,775667,-,4729
38,WOLB.0323.00090,1,100240,105703,+,5463
38,WOLB.0323.00002,1,42778,48185,+,5407
38,WOLB.0323.00138,1,502321,507724,-,5403
38,WOLB.0323.00132,1,41138,46544,+,5406
38,WOLB.0323.00143,1,93837,99262,+,5425
38,WOLB.0323.00106,1,93838,99263,+,5425
38,WOLB.0323.00121,1,94778,100181,+,5403
38,WOLB.0323.00135,1,256741,262204,-,5463
38,WOLB.0323.00103,1,135572,140978,+,5406
38,WOLB.0323.00107,1,135571,140977,+,5406
38,WOLB.0323.00019,1,1151000,1156406,-,5406
38,WOLB.0323.00060,1,1616530,1621936,+,5406
38,WOLB.0323.00074,1,893701,899164,+,5463
38,WOLB.0323.00120,1,879560,885023,+,5463
38,WOLB.0323.00039,1,705135,710556,-,5421
38,WOLB.0323.00041,1,737720,743183,-,5463
38,WOLB.0323.00031,1,856307,861732,+,5425
38,WOLB.0323.00056,1,101735,107141,+,5406
38,WOLB.0323.00142,1,95856,101259,+,5403
38,WOLB.0323.00023,1,828942,834357,+,5415
38,WOLB.0323.00153,1,101892,107355,+,5463
38,WOLB.0323.00093,1,141798,147261,-,5463
38,WOLB.0323.00088,1,96806,102269,+,5463
38,WOLB.0323.00008,1,1228721,1234184,-,5463
38,WOLB.0323.00024,1,78985,84391,-,5406
38,WOLB.0323.00064,1,1091390,1096796,-,5406
38,WOLB.0323.00030,1,42488,47894,+,5406
38,WOLB.0323.00105,1,135571,140977,+,5406
38,WOLB.0323.00133,1,730193,735599,-,5406
38,WOLB.0323.00084,1,595579,600982,-,5403
38,WOLB.0323.00021,1,96860,102263,+,5403
38,WOLB.0323.00043,1,41408,46815,+,5407
38,WOLB.0323.00020,1,97977,103440,+,5463
38,WOLB.0323.00122,1,100841,106244,+,5403
38,WOLB.0323.00118,1,109960,115366,+,5406
38,WOLB.0323.00004,1,96717,102120,+,5403
38,WOLB.0323.00011,1,845886,851289,+,5403
38,WOLB.0323.00035,1,96806,102269,+,5463
38,WOLB.0323.00032,1,1064361,1069764,+,5403
38,WOLB.0323.00012,1,96793,102256,+,5463
38,WOLB.0323.00018,1,76197,81660,+,5463
38,WOLB.0323.00025,1,823880,829333,-,5453
38,WOLB.0323.00010,1,43273,48739,+,5466
38,WOLB.0323.00068,1,94876,100279,+,5403
38,WOLB.0323.00128,1,41409,46816,+,5407
38,WOLB.0323.00158,1,778545,783948,+,5403
38,WOLB.0323.00017,1,94777,100180,+,5403
38,WOLB.0323.00104,1,99106,104569,+,5463
38,WOLB.0323.00007,1,1392843,1398249,-,5406
38,WOLB.0323.00001,1,135571,140977,+,5406
38,WOLB.0323.00100,1,96806,102269,+,5463
38,WOLB.0323.00070,1,41433,46840,+,5407
38,WOLB.0323.00006,1,477710,483135,-,5425
38,WOLB.0323.00042,1,42528,47937,+,5409
38,WOLB.0323.00119,1,1152389,1157795,-,5406
38,WOLB.0323.00149,1,363084,368487,-,5403
38,WOLB.0323.00014,1,41410,46817,+,5407
38,WOLB.0323.00096,1,776209,781672,-,5463
37,WOLB.0323.00090,1,99206,100238,+,1032
37,WOLB.0323.00135,1,262205,263242,-,1037
37,WOLB.0323.00153,1,100859,101890,+,1031
36,WOLB.0323.00090,1,93876,97214,+,3338
36,WOLB.0323.00002,1,39347,42682,+,3335
36,WOLB.0323.00138,1,507818,511165,-,3347
36,WOLB.0323.00132,1,37694,41044,+,3350
36,WOLB.0323.00143,1,90405,93743,+,3338
36,WOLB.0323.00106,1,90406,93744,+,3338
36,WOLB.0323.00121,1,91169,94684,+,3515
36,WOLB.0323.00135,1,263578,266916,-,3338
36,WOLB.0323.00103,1,132149,135478,+,3329
36,WOLB.0323.00107,1,132148,135477,+,3329
36,WOLB.0323.00019,1,1156500,1159838,-,3338
36,WOLB.0323.00060,1,1613095,1616436,+,3341
36,WOLB.0323.00074,1,890269,893607,+,3338
36,WOLB.0323.00120,1,876128,879466,+,3338
36,WOLB.0323.00039,1,710650,713987,-,3337
36,WOLB.0323.00041,1,743277,746615,-,3338
36,WOLB.0323.00031,1,852875,856213,+,3338
36,WOLB.0323.00056,1,98300,101641,+,3341
36,WOLB.0323.00142,1,92247,95762,+,3515
36,WOLB.0323.00023,1,825498,828848,+,3350
36,WOLB.0323.00153,1,95529,98867,+,3338
36,WOLB.0323.00093,1,147355,150693,-,3338
36,WOLB.0323.00088,1,93362,96712,+,3350
36,WOLB.0323.00008,1,1234278,1237616,-,3338
36,WOLB.0323.00024,1,84487,87804,-,3317
36,WOLB.0323.00064,1,1096890,1100240,-,3350
36,WOLB.0323.00030,1,39044,42394,+,3350
36,WOLB.0323.00105,1,132148,135477,+,3329
36,WOLB.0323.00133,1,735693,739031,-,3338
36,WOLB.0323.00084,1,601076,604423,-,3347
36,WOLB.0323.00021,1,93449,96766,+,3317
36,WOLB.0323.00043,1,37977,41312,+,3335
36,WOLB.0323.00020,1,94533,97883,+,3350
36,WOLB.0323.00122,1,97409,100747,+,3338
36,WOLB.0323.00118,1,106529,109864,+,3335
36,WOLB.0323.00004,1,93108,96623,+,3515
36,WOLB.0323.00011,1,842277,845792,+,3515
36,WOLB.0323.00035,1,93362,96712,+,3350
36,WOLB.0323.00032,1,1060920,1064267,+,3347
36,WOLB.0323.00012,1,93349,96699,+,3350
36,WOLB.0323.00018,1,72766,76101,+,3335
36,WOLB.0323.00025,1,190307,193628,-,3321
36,WOLB.0323.00010,1,39842,43177,+,3335
36,WOLB.0323.00068,1,91435,94782,+,3347
36,WOLB.0323.00128,1,37978,41313,+,3335
36,WOLB.0323.00158,1,774936,778451,+,3515
36,WOLB.0323.00017,1,91168,94683,+,3515
36,WOLB.0323.00104,1,95662,99012,+,3350
36,WOLB.0323.00007,1,1398343,1401684,-,3341
36,WOLB.0323.00001,1,132148,135477,+,3329
36,WOLB.0323.00100,1,93362,96712,+,3350
36,WOLB.0323.00070,1,38002,41337,+,3335
36,WOLB.0323.00006,1,483229,486567,-,3338
36,WOLB.0323.00042,1,39103,42432,+,3329
36,WOLB.0323.00119,1,1157889,1161227,-,3338
36,WOLB.0323.00149,1,368581,372096,-,3515
36,WOLB.0323.00014,1,37979,41314,+,3335
36,WOLB.0323.00096,1,781766,785104,-,3338
35,WOLB.0323.00090,1,90232,92379,+,2147
35,WOLB.0323.00002,1,37095,39246,+,2151
35,WOLB.0323.00138,1,511580,513727,-,2147
35,WOLB.0323.00132,1,35458,37605,+,2147
35,WOLB.0323.00143,1,88174,90304,+,2130
35,WOLB.0323.00106,1,88175,90305,+,2130
35,WOLB.0323.00121,1,88910,91033,+,2123
35,WOLB.0323.00135,1,267331,269478,-,2147
35,WOLB.0323.00103,1,129931,132054,+,2123
35,WOLB.0323.00107,1,129930,132053,+,2123
35,WOLB.0323.00019,1,1159939,1162069,-,2130
35,WOLB.0323.00060,1,1610533,1612680,+,2147
35,WOLB.0323.00074,1,888028,890168,+,2140
35,WOLB.0323.00120,1,873887,876027,+,2140
35,WOLB.0323.00039,1,714088,716218,-,2130
35,WOLB.0323.00041,1,746716,748856,-,2140
35,WOLB.0323.00031,1,850644,852774,+,2130
35,WOLB.0323.00056,1,95738,97885,+,2147
35,WOLB.0323.00142,1,89988,92111,+,2123
35,WOLB.0323.00023,1,823262,825409,+,2147
35,WOLB.0323.00153,1,91885,94032,+,2147
35,WOLB.0323.00093,1,150800,152913,-,2113
35,WOLB.0323.00088,1,90800,92947,+,2147
35,WOLB.0323.00008,1,1237723,1239854,-,2131
35,WOLB.0323.00024,1,89909,92053,-,2144
35,WOLB.0323.00064,1,1100329,1102482,-,2153
35,WOLB.0323.00030,1,36802,38955,+,2153
35,WOLB.0323.00105,1,129930,132053,+,2123
35,WOLB.0323.00133,1,739135,741262,-,2127
35,WOLB.0323.00084,1,604838,606985,-,2147
35,WOLB.0323.00021,1,88872,91019,+,2147
35,WOLB.0323.00043,1,35725,37876,+,2151
35,WOLB.0323.00020,1,91971,94118,+,2147
35,WOLB.0323.00122,1,95161,97308,+,2147
35,WOLB.0323.00118,1,104289,106428,+,2139
35,WOLB.0323.00004,1,90849,92972,+,2123
35,WOLB.0323.00011,1,840018,842141,+,2123
35,WOLB.0323.00035,1,90800,92947,+,2147
35,WOLB.0323.00032,1,1058358,1060505,+,2147
35,WOLB.0323.00012,1,90787,92934,+,2147
35,WOLB.0323.00018,1,70518,72662,+,2144
35,WOLB.0323.00025,1,127713,129843,-,2130
35,WOLB.0323.00010,1,37595,39742,+,2147
35,WOLB.0323.00068,1,88873,91020,+,2147
35,WOLB.0323.00128,1,35726,37877,+,2151
35,WOLB.0323.00158,1,772677,774800,+,2123
35,WOLB.0323.00017,1,88909,91032,+,2123
35,WOLB.0323.00104,1,93100,95247,+,2147
35,WOLB.0323.00007,1,1402099,1404246,-,2147
35,WOLB.0323.00001,1,129930,132053,+,2123
35,WOLB.0323.00100,1,90800,92947,+,2147
35,WOLB.0323.00070,1,35750,37901,+,2151
35,WOLB.0323.00006,1,486668,488798,-,2130
35,WOLB.0323.00042,1,36855,38999,+,2144
35,WOLB.0323.00119,1,1161328,1163458,-,2130
35,WOLB.0323.00149,1,372232,374355,-,2123
35,WOLB.0323.00014,1,35727,37878,+,2151
35,WOLB.0323.00096,1,785205,787345,-,2140
34,WOLB.0323.00090,1,86991,88226,+,1235
34,WOLB.0323.00002,1,1484888,1486123,+,1235
34,WOLB.0323.00138,1,515731,516966,-,1235
34,WOLB.0323.00132,1,1288755,1289990,+,1235
34,WOLB.0323.00143,1,84671,85864,+,1193
34,WOLB.0323.00106,1,84672,85865,+,1193
34,WOLB.0323.00121,1,85669,86904,+,1235
34,WOLB.0323.00135,1,271473,272708,-,1235
34,WOLB.0323.00103,1,127821,129047,+,1226
34,WOLB.0323.00107,1,127820,129046,+,1226
34,WOLB.0323.00019,1,40411,41646,-,1235
34,WOLB.0323.00060,1,1604993,1606228,+,1235
34,WOLB.0323.00074,1,884849,886071,+,1222
34,WOLB.0323.00120,1,870708,871930,+,1222
34,WOLB.0323.00039,1,769372,770607,+,1235
34,WOLB.0323.00041,1,750813,752035,-,1222
34,WOLB.0323.00031,1,847141,848334,+,1193
34,WOLB.0323.00056,1,92497,93732,+,1235
34,WOLB.0323.00142,1,86747,87982,+,1235
34,WOLB.0323.00023,1,663375,664610,-,1235
34,WOLB.0323.00153,1,88644,89879,+,1235
34,WOLB.0323.00093,1,236342,237556,-,1214
34,WOLB.0323.00088,1,87568,88803,+,1235
34,WOLB.0323.00024,1,215292,216527,-,1235
34,WOLB.0323.00064,1,1252809,1254032,+,1223
34,WOLB.0323.00030,1,1655612,1656835,-,1223
34,WOLB.0323.00105,1,127820,129046,+,1226
34,WOLB.0323.00133,1,743219,744454,-,1235
34,WOLB.0323.00084,1,608989,610224,-,1235
34,WOLB.0323.00021,1,85633,86868,+,1235
34,WOLB.0323.00043,1,1661355,1662590,-,1235
34,WOLB.0323.00020,1,87568,88803,+,1235
34,WOLB.0323.00122,1,90575,91810,+,1235
34,WOLB.0323.00118,1,89125,90360,+,1235
34,WOLB.0323.00004,1,87608,88843,+,1235
34,WOLB.0323.00011,1,836777,838012,+,1235
34,WOLB.0323.00035,1,87568,88803,+,1235
34,WOLB.0323.00032,1,1055119,1056354,+,1235
34,WOLB.0323.00012,1,87555,88790,+,1235
34,WOLB.0323.00018,1,1231239,1232450,+,1211
34,WOLB.0323.00025,1,662670,663872,-,1202
34,WOLB.0323.00010,1,1616482,1617717,+,1235
34,WOLB.0323.00068,1,85634,86869,+,1235
34,WOLB.0323.00128,1,1446702,1447937,-,1235
34,WOLB.0323.00158,1,769436,770671,+,1235
34,WOLB.0323.00017,1,85668,86903,+,1235
34,WOLB.0323.00104,1,89868,91103,+,1235
34,WOLB.0323.00007,1,1406252,1407487,-,1235
34,WOLB.0323.00001,1,127820,129046,+,1226
34,WOLB.0323.00100,1,87568,88803,+,1235
34,WOLB.0323.00070,1,1795723,1796958,+,1235
34,WOLB.0323.00006,1,491108,492301,-,1193
34,WOLB.0323.00042,1,1498248,1499483,-,1235
34,WOLB.0323.00119,1,40370,41605,-,1235
34,WOLB.0323.00149,1,376361,377596,-,1235
34,WOLB.0323.00014,1,669228,670463,-,1235
34,WOLB.0323.00096,1,789302,790524,-,1222
33,WOLB.0323.00090,1,83608,84888,+,1280
33,WOLB.0323.00002,1,1481622,1482902,+,1280
33,WOLB.0323.00138,1,519069,520349,-,1280
33,WOLB.0323.00132,1,1285354,1286634,+,1280
33,WOLB.0323.00143,1,81257,82564,+,1307
33,WOLB.0323.00106,1,81258,82565,+,1307
33,WOLB.0323.00121,1,82286,83566,+,1280
33,WOLB.0323.00135,1,274694,275974,-,1280
33,WOLB.0323.00103,1,124564,125844,+,1280
33,WOLB.0323.00107,1,124563,125843,+,1280
33,WOLB.0323.00019,1,43767,45045,-,1278
33,WOLB.0323.00060,1,1601727,1603007,+,1280
33,WOLB.0323.00074,1,881466,882746,+,1280
33,WOLB.0323.00120,1,867325,868605,+,1280
33,WOLB.0323.00039,1,765973,767251,+,1278
33,WOLB.0323.00041,1,754138,755418,-,1280
33,WOLB.0323.00031,1,843727,845034,+,1307
33,WOLB.0323.00056,1,89231,90511,+,1280
33,WOLB.0323.00142,1,82261,83541,+,1280
33,WOLB.0323.00023,1,666722,668002,-,1280
33,WOLB.0323.00153,1,85261,86541,+,1280
33,WOLB.0323.00093,1,239542,240822,-,1280
33,WOLB.0323.00088,1,84185,85465,+,1280
33,WOLB.0323.00008,1,1241885,1243144,-,1259
33,WOLB.0323.00024,1,218648,219928,-,1280
33,WOLB.0323.00064,1,1249408,1250688,+,1280
33,WOLB.0323.00030,1,1658944,1660224,-,1280
33,WOLB.0323.00105,1,124563,125843,+,1280
33,WOLB.0323.00133,1,746575,747855,-,1280
33,WOLB.0323.00084,1,612327,613607,-,1280
33,WOLB.0323.00021,1,82250,83530,+,1280
33,WOLB.0323.00043,1,1664576,1665856,-,1280
33,WOLB.0323.00020,1,84185,85465,+,1280
33,WOLB.0323.00122,1,87192,88472,+,1280
33,WOLB.0323.00118,1,85742,87022,+,1280
33,WOLB.0323.00004,1,84225,85505,+,1280
33,WOLB.0323.00011,1,833394,834674,+,1280
33,WOLB.0323.00035,1,84185,85465,+,1280
33,WOLB.0323.00032,1,1051736,1053016,+,1280
33,WOLB.0323.00012,1,84172,85452,+,1280
33,WOLB.0323.00018,1,1227847,1229127,+,1280
33,WOLB.0323.00025,1,765114,766421,-,1307
33,WOLB.0323.00010,1,1613229,1614486,+,1257
33,WOLB.0323.00068,1,82251,83531,+,1280
33,WOLB.0323.00128,1,1449923,1451203,-,1280
33,WOLB.0323.00158,1,766053,767333,+,1280
33,WOLB.0323.00017,1,82285,83565,+,1280
33,WOLB.0323.00104,1,86485,87765,+,1280
33,WOLB.0323.00007,1,1409473,1410746,-,1273
33,WOLB.0323.00001,1,124563,125843,+,1280
33,WOLB.0323.00100,1,84185,85465,+,1280
33,WOLB.0323.00070,1,1792457,1793737,+,1280
33,WOLB.0323.00006,1,494408,495715,-,1307
33,WOLB.0323.00042,1,1501478,1502758,-,1280
33,WOLB.0323.00119,1,43726,45004,-,1278
33,WOLB.0323.00149,1,379699,380979,-,1280
33,WOLB.0323.00014,1,672449,673729,-,1280
33,WOLB.0323.00096,1,792627,793907,-,1280
32,WOLB.0323.00090,1,82273,83559,+,1286
32,WOLB.0323.00002,1,1480269,1481573,+,1304
32,WOLB.0323.00138,1,520398,521684,-,1286
32,WOLB.0323.00132,1,1283671,1284978,+,1307
32,WOLB.0323.00143,1,79659,80963,+,1304
32,WOLB.0323.00106,1,79660,80964,+,1304
32,WOLB.0323.00121,1,80951,82237,+,1286
32,WOLB.0323.00135,1,276023,277309,-,1286
32,WOLB.0323.00103,1,123244,124515,+,1271
32,WOLB.0323.00107,1,123243,124514,+,1271
32,WOLB.0323.00019,1,45622,46940,-,1318
32,WOLB.0323.00060,1,1600392,1601678,+,1286
32,WOLB.0323.00074,1,879678,880964,+,1286
32,WOLB.0323.00120,1,865537,866823,+,1286
32,WOLB.0323.00039,1,764078,765396,+,1318
32,WOLB.0323.00041,1,755920,757206,-,1286
32,WOLB.0323.00031,1,842129,843433,+,1304
32,WOLB.0323.00056,1,87896,89182,+,1286
32,WOLB.0323.00142,1,80926,82212,+,1286
32,WOLB.0323.00023,1,668051,669358,-,1307
32,WOLB.0323.00153,1,83926,85212,+,1286
32,WOLB.0323.00093,1,240871,242175,-,1304
32,WOLB.0323.00088,1,82358,83683,+,1325
32,WOLB.0323.00008,1,1243193,1244479,-,1286
32,WOLB.0323.00024,1,220304,221611,-,1307
32,WOLB.0323.00064,1,1247725,1249032,+,1307
32,WOLB.0323.00030,1,1660600,1661907,-,1307
32,WOLB.0323.00105,1,123243,124514,+,1271
32,WOLB.0323.00133,1,748240,749556,-,1316
32,WOLB.0323.00084,1,613656,614942,-,1286
32,WOLB.0323.00021,1,80915,82201,+,1286
32,WOLB.0323.00043,1,1665905,1667209,-,1304
32,WOLB.0323.00020,1,82358,83683,+,1325
32,WOLB.0323.00122,1,85857,87143,+,1286
32,WOLB.0323.00118,1,84407,85693,+,1286
32,WOLB.0323.00004,1,82890,84176,+,1286
32,WOLB.0323.00011,1,832059,833345,+,1286
32,WOLB.0323.00035,1,82358,83683,+,1325
32,WOLB.0323.00032,1,1050401,1051687,+,1286
32,WOLB.0323.00012,1,82345,83670,+,1325
32,WOLB.0323.00018,1,1226512,1227798,+,1286
32,WOLB.0323.00025,1,766715,768019,-,1304
32,WOLB.0323.00010,1,1611876,1613180,+,1304
32,WOLB.0323.00068,1,80916,82202,+,1286
32,WOLB.0323.00128,1,1451252,1452556,-,1304
32,WOLB.0323.00158,1,764718,766004,+,1286
32,WOLB.0323.00017,1,80950,82236,+,1286
32,WOLB.0323.00104,1,84658,85983,+,1325
32,WOLB.0323.00007,1,1410795,1412081,-,1286
32,WOLB.0323.00001,1,123243,124514,+,1271
32,WOLB.0323.00100,1,82358,83683,+,1325
32,WOLB.0323.00070,1,1791104,1792408,+,1304
32,WOLB.0323.00006,1,496009,497313,-,1304
32,WOLB.0323.00042,1,1502807,1504084,-,1277
32,WOLB.0323.00119,1,45581,46899,-,1318
32,WOLB.0323.00149,1,381028,382314,-,1286
32,WOLB.0323.00014,1,673778,675082,-,1304
32,WOLB.0323.00096,1,794409,795695,-,1286
31,WOLB.0323.00090,1,78661,80194,+,1533
31,WOLB.0323.00002,1,149780,151310,+,1530
31,WOLB.0323.00138,1,523773,525306,-,1533
31,WOLB.0323.00132,1,1373125,1374655,+,1530
31,WOLB.0323.00143,1,76044,77572,+,1528
31,WOLB.0323.00106,1,76045,77573,+,1528
31,WOLB.0323.00121,1,77354,78887,+,1533
31,WOLB.0323.00135,1,279375,280900,-,1525
31,WOLB.0323.00103,1,119616,121156,+,1540
31,WOLB.0323.00107,1,119615,121155,+,1540
31,WOLB.0323.00019,1,49323,50859,-,1536
31,WOLB.0323.00060,1,1596788,1598321,+,1533
31,WOLB.0323.00074,1,876140,877676,+,1536
31,WOLB.0323.00120,1,861999,863535,+,1536
31,WOLB.0323.00039,1,760160,761696,+,1536
31,WOLB.0323.00041,1,759208,760744,-,1536
31,WOLB.0323.00031,1,838514,840042,+,1528
31,WOLB.0323.00056,1,84299,85825,+,1526
31,WOLB.0323.00142,1,77329,78862,+,1533
31,WOLB.0323.00023,1,718191,719722,-,1531
31,WOLB.0323.00153,1,80313,81846,+,1533
31,WOLB.0323.00093,1,244253,245789,-,1536
31,WOLB.0323.00088,1,78763,80296,+,1533
31,WOLB.0323.00008,1,1248986,1250522,-,1536
31,WOLB.0323.00024,1,138349,139878,+,1529
31,WOLB.0323.00064,1,1165410,1166940,-,1530
31,WOLB.0323.00030,1,1742771,1744301,+,1530
31,WOLB.0323.00105,1,119615,121155,+,1540
31,WOLB.0323.00133,1,751692,753232,-,1540
31,WOLB.0323.00084,1,617031,618564,-,1533
31,WOLB.0323.00021,1,77293,78826,+,1533
31,WOLB.0323.00043,1,147287,148817,+,1530
31,WOLB.0323.00020,1,78763,80296,+,1533
31,WOLB.0323.00122,1,82250,83783,+,1533
31,WOLB.0323.00118,1,80794,82327,+,1533
31,WOLB.0323.00004,1,79293,80826,+,1533
31,WOLB.0323.00011,1,828462,829995,+,1533
31,WOLB.0323.00035,1,78763,80296,+,1533
31,WOLB.0323.00032,1,1046779,1048312,+,1533
31,WOLB.0323.00012,1,78750,80283,+,1533
31,WOLB.0323.00018,1,153220,154750,-,1530
31,WOLB.0323.00025,1,855271,856790,-,1519
31,WOLB.0323.00010,1,152707,154236,+,1529
31,WOLB.0323.00068,1,77294,78827,+,1533
31,WOLB.0323.00128,1,147665,149195,+,1530
31,WOLB.0323.00158,1,761121,762654,+,1533
31,WOLB.0323.00017,1,77353,78886,+,1533
31,WOLB.0323.00104,1,81070,82596,+,1526
31,WOLB.0323.00007,1,1414152,1415685,-,1533
31,WOLB.0323.00001,1,119615,121155,+,1540
31,WOLB.0323.00100,1,78763,80296,+,1533
31,WOLB.0323.00070,1,147258,148788,+,1530
31,WOLB.0323.00006,1,499399,500927,-,1528
31,WOLB.0323.00042,1,153714,155244,+,1530
31,WOLB.0323.00119,1,49208,50744,-,1536
31,WOLB.0323.00149,1,384378,385911,-,1533
31,WOLB.0323.00014,1,149975,151505,+,1530
31,WOLB.0323.00096,1,798701,800237,-,1536
30,WOLB.0323.00090,1,77255,77773,+,518
30,WOLB.0323.00135,1,284096,284614,-,518
30,WOLB.0323.00103,1,118291,118799,+,508
30,WOLB.0323.00107,1,118290,118798,+,508
30,WOLB.0323.00153,1,77255,77773,+,518
30,WOLB.0323.00088,1,77357,77875,+,518
30,WOLB.0323.00105,1,118290,118798,+,508
30,WOLB.0323.00020,1,77357,77875,+,518
30,WOLB.0323.00035,1,77357,77875,+,518
30,WOLB.0323.00012,1,77344,77862,+,518
30,WOLB.0323.00025,1,857581,858099,-,518
30,WOLB.0323.00104,1,77357,77875,+,518
30,WOLB.0323.00001,1,118290,118798,+,508
30,WOLB.0323.00100,1,77357,77875,+,518
13,WOLB.0323.00090,1,42711,43796,+,1085
13,WOLB.0323.00002,1,113882,114967,+,1085
13,WOLB.0323.00138,1,558993,560077,-,1084
13,WOLB.0323.00132,1,1338166,1339251,+,1085
13,WOLB.0323.00143,1,1230741,1231804,-,1063
13,WOLB.0323.00106,1,1230744,1231807,-,1063
13,WOLB.0323.00121,1,42533,43618,+,1085
13,WOLB.0323.00135,1,318078,319162,-,1084
13,WOLB.0323.00103,1,500965,502044,+,1079
13,WOLB.0323.00107,1,500967,502046,+,1079
13,WOLB.0323.00019,1,1170298,1171383,+,1085
13,WOLB.0323.00060,1,1555371,1556454,+,1083
13,WOLB.0323.00074,1,951521,952606,+,1085
13,WOLB.0323.00120,1,937238,938323,+,1085
13,WOLB.0323.00039,1,724467,725552,+,1085
13,WOLB.0323.00041,1,691275,692359,-,1084
13,WOLB.0323.00031,1,719684,720747,-,1063
13,WOLB.0323.00056,1,42815,43898,+,1083
13,WOLB.0323.00142,1,42509,43594,+,1085
13,WOLB.0323.00023,1,756213,757297,-,1084
13,WOLB.0323.00153,1,42711,43796,+,1085
13,WOLB.0323.00093,1,92842,93917,+,1075
13,WOLB.0323.00088,1,41462,42547,+,1085
13,WOLB.0323.00008,1,1179882,1180957,-,1075
13,WOLB.0323.00024,1,178461,179546,+,1085
13,WOLB.0323.00064,1,1202803,1203887,-,1084
13,WOLB.0323.00030,1,1705824,1706909,+,1085
13,WOLB.0323.00105,1,500974,502053,+,1079
13,WOLB.0323.00133,1,786392,787476,-,1084
13,WOLB.0323.00084,1,652251,653335,-,1084
13,WOLB.0323.00021,1,42521,43606,+,1085
13,WOLB.0323.00043,1,112590,113675,+,1085
13,WOLB.0323.00020,1,41462,42547,+,1085
13,WOLB.0323.00122,1,45015,46100,+,1085
13,WOLB.0323.00118,1,43598,44683,+,1085
13,WOLB.0323.00004,1,42509,43594,+,1085
13,WOLB.0323.00011,1,793642,794727,+,1085
13,WOLB.0323.00035,1,41462,42547,+,1085
13,WOLB.0323.00032,1,1012008,1013093,+,1085
13,WOLB.0323.00012,1,41449,42534,+,1085
13,WOLB.0323.00018,1,189445,190534,-,1089
13,WOLB.0323.00025,1,633663,634726,-,1063
13,WOLB.0323.00010,1,118009,119094,+,1085
13,WOLB.0323.00068,1,42522,43607,+,1085
13,WOLB.0323.00128,1,113216,114301,+,1085
13,WOLB.0323.00158,1,726301,727386,+,1085
13,WOLB.0323.00017,1,42533,43618,+,1085
13,WOLB.0323.00104,1,41462,42547,+,1085
13,WOLB.0323.00007,1,44335,45418,+,1083
13,WOLB.0323.00001,1,500974,502053,+,1079
13,WOLB.0323.00100,1,41462,42547,+,1085
13,WOLB.0323.00070,1,112563,113648,+,1085
13,WOLB.0323.00006,1,538375,539438,-,1063
13,WOLB.0323.00042,1,116735,117824,+,1089
13,WOLB.0323.00119,1,1171687,1172772,+,1085
13,WOLB.0323.00149,1,419646,420730,-,1084
13,WOLB.0323.00014,1,113906,114991,+,1085
13,WOLB.0323.00096,1,729764,730848,-,1084
12,WOLB.0323.00090,1,40356,42710,+,2354
12,WOLB.0323.00002,1,111520,113881,+,2361
12,WOLB.0323.00138,1,560079,562433,-,2354
12,WOLB.0323.00132,1,1335804,1338165,+,2361
12,WOLB.0323.00143,1,1231806,1234164,-,2358
12,WOLB.0323.00106,1,1231809,1234167,-,2358
12,WOLB.0323.00121,1,40178,42532,+,2354
12,WOLB.0323.00135,1,319164,321518,-,2354
12,WOLB.0323.00103,1,498617,500964,+,2347
12,WOLB.0323.00107,1,498619,500966,+,2347
12,WOLB.0323.00019,1,1167936,1170297,+,2361
12,WOLB.0323.00060,1,1553064,1555370,+,2306
12,WOLB.0323.00074,1,949159,951520,+,2361
12,WOLB.0323.00120,1,925885,928241,-,2356
12,WOLB.0323.00120,1,934876,937237,+,2361
12,WOLB.0323.00039,1,722105,724466,+,2361
12,WOLB.0323.00041,1,692361,694722,-,2361
12,WOLB.0323.00031,1,720749,723107,-,2358
12,WOLB.0323.00056,1,40460,42814,+,2354
12,WOLB.0323.00142,1,40154,42508,+,2354
12,WOLB.0323.00023,1,757299,759660,-,2361
12,WOLB.0323.00153,1,40356,42710,+,2354
12,WOLB.0323.00093,1,90487,92841,+,2354
12,WOLB.0323.00088,1,39107,41461,+,2354
12,WOLB.0323.00008,1,1180959,1183313,-,2354
12,WOLB.0323.00024,1,176099,178460,+,2361
12,WOLB.0323.00064,1,1203889,1206248,-,2359
12,WOLB.0323.00030,1,1703464,1705823,+,2359
12,WOLB.0323.00105,1,498626,500973,+,2347
12,WOLB.0323.00133,1,787478,789839,-,2361
12,WOLB.0323.00084,1,653337,655642,-,2305
12,WOLB.0323.00021,1,40166,42520,+,2354
12,WOLB.0323.00043,1,110228,112589,+,2361
12,WOLB.0323.00020,1,39107,41461,+,2354
12,WOLB.0323.00122,1,42660,45014,+,2354
12,WOLB.0323.00118,1,41243,43597,+,2354
12,WOLB.0323.00004,1,40154,42508,+,2354
12,WOLB.0323.00011,1,791287,793641,+,2354
12,WOLB.0323.00035,1,39107,41461,+,2354
12,WOLB.0323.00032,1,1009653,1012007,+,2354
12,WOLB.0323.00012,1,39094,41448,+,2354
12,WOLB.0323.00018,1,190536,192897,-,2361
12,WOLB.0323.00025,1,634728,637086,-,2358
12,WOLB.0323.00010,1,115647,118008,+,2361
12,WOLB.0323.00068,1,40167,42521,+,2354
12,WOLB.0323.00128,1,110854,113215,+,2361
12,WOLB.0323.00158,1,723946,726300,+,2354
12,WOLB.0323.00017,1,40178,42532,+,2354
12,WOLB.0323.00104,1,39107,41461,+,2354
12,WOLB.0323.00007,1,41980,44334,+,2354
12,WOLB.0323.00001,1,498626,500973,+,2347
12,WOLB.0323.00100,1,39107,41461,+,2354
12,WOLB.0323.00070,1,110201,112562,+,2361
12,WOLB.0323.00006,1,539440,541798,-,2358
12,WOLB.0323.00042,1,114373,116734,+,2361
12,WOLB.0323.00119,1,1169325,1171686,+,2361
12,WOLB.0323.00149,1,420732,423086,-,2354
12,WOLB.0323.00014,1,111544,113905,+,2361
12,WOLB.0323.00096,1,730850,733211,-,2361
11,WOLB.0323.00090,1,39287,40348,+,1061
11,WOLB.0323.00002,1,110450,111518,+,1068
11,WOLB.0323.00138,1,562441,563502,-,1061
11,WOLB.0323.00132,1,1334734,1335802,+,1068
11,WOLB.0323.00143,1,1234165,1235240,-,1075
11,WOLB.0323.00106,1,1234168,1235243,-,1075
11,WOLB.0323.00121,1,39109,40170,+,1061
11,WOLB.0323.00135,1,321526,322587,-,1061
11,WOLB.0323.00103,1,497542,498609,+,1067
11,WOLB.0323.00107,1,497544,498611,+,1067
11,WOLB.0323.00019,1,1166867,1167928,+,1061
11,WOLB.0323.00060,1,1369028,1370117,+,1089
11,WOLB.0323.00074,1,948083,949147,+,1064
11,WOLB.0323.00120,1,928253,929320,-,1067
11,WOLB.0323.00120,1,933800,934864,+,1064
11,WOLB.0323.00039,1,721036,722097,+,1061
11,WOLB.0323.00041,1,694734,695798,-,1064
11,WOLB.0323.00031,1,723108,724183,-,1075
11,WOLB.0323.00056,1,39391,40452,+,1061
11,WOLB.0323.00142,1,39085,40146,+,1061
11,WOLB.0323.00023,1,759661,760736,-,1075
11,WOLB.0323.00153,1,39287,40348,+,1061
11,WOLB.0323.00093,1,89412,90479,+,1067
11,WOLB.0323.00088,1,38038,39099,+,1061
11,WOLB.0323.00008,1,1183321,1184388,-,1067
11,WOLB.0323.00024,1,175023,176097,+,1074
11,WOLB.0323.00064,1,1206249,1207326,-,1077
11,WOLB.0323.00030,1,1702386,1703462,+,1076
11,WOLB.0323.00105,1,497551,498618,+,1067
11,WOLB.0323.00133,1,789840,790912,-,1072
11,WOLB.0323.00084,1,657323,658412,-,1089
11,WOLB.0323.00021,1,39097,40158,+,1061
11,WOLB.0323.00043,1,109158,110226,+,1068
11,WOLB.0323.00020,1,38038,39099,+,1061
11,WOLB.0323.00122,1,41591,42652,+,1061
11,WOLB.0323.00118,1,40174,41235,+,1061
11,WOLB.0323.00004,1,39085,40146,+,1061
11,WOLB.0323.00011,1,790218,791279,+,1061
11,WOLB.0323.00035,1,38038,39099,+,1061
11,WOLB.0323.00032,1,1008584,1009645,+,1061
11,WOLB.0323.00012,1,38025,39086,+,1061
11,WOLB.0323.00018,1,192898,193973,-,1075
11,WOLB.0323.00025,1,637087,638162,-,1075
11,WOLB.0323.00010,1,114577,115645,+,1068
11,WOLB.0323.00068,1,39098,40159,+,1061
11,WOLB.0323.00128,1,109784,110852,+,1068
11,WOLB.0323.00158,1,722877,723938,+,1061
11,WOLB.0323.00017,1,39109,40170,+,1061
11,WOLB.0323.00104,1,38038,39099,+,1061
11,WOLB.0323.00007,1,40911,41972,+,1061
11,WOLB.0323.00001,1,497551,498618,+,1067
11,WOLB.0323.00100,1,38038,39099,+,1061
11,WOLB.0323.00070,1,109131,110199,+,1068
11,WOLB.0323.00006,1,541799,542874,-,1075
11,WOLB.0323.00042,1,113297,114371,+,1074
11,WOLB.0323.00119,1,1168256,1169317,+,1061
11,WOLB.0323.00149,1,423094,424155,-,1061
11,WOLB.0323.00014,1,110474,111542,+,1068
11,WOLB.0323.00096,1,733223,734287,-,1064
10,WOLB.0323.00090,1,38209,38899,+,690
10,WOLB.0323.00002,1,109372,110062,+,690
10,WOLB.0323.00138,1,563890,564580,-,690
10,WOLB.0323.00132,1,1333656,1334346,+,690
10,WOLB.0323.00143,1,1235628,1236318,-,690
10,WOLB.0323.00106,1,1235631,1236321,-,690
10,WOLB.0323.00135,1,322975,323665,-,690
10,WOLB.0323.00019,1,1165789,1166479,+,690
10,WOLB.0323.00060,1,1367950,1368640,+,690
10,WOLB.0323.00039,1,719958,720648,+,690
10,WOLB.0323.00031,1,724571,725261,-,690
10,WOLB.0323.00056,1,38313,39003,+,690
10,WOLB.0323.00023,1,761124,761813,-,689
10,WOLB.0323.00153,1,38209,38899,+,690
10,WOLB.0323.00088,1,36960,37650,+,690
10,WOLB.0323.00064,1,1207714,1208404,-,690
10,WOLB.0323.00030,1,1701308,1701998,+,690
10,WOLB.0323.00133,1,791303,791982,-,679
10,WOLB.0323.00084,1,658800,659500,-,700
10,WOLB.0323.00021,1,38019,38709,+,690
10,WOLB.0323.00043,1,108080,108770,+,690
10,WOLB.0323.00020,1,36960,37650,+,690
10,WOLB.0323.00122,1,40513,41203,+,690
10,WOLB.0323.00035,1,36960,37650,+,690
10,WOLB.0323.00032,1,1007506,1008196,+,690
10,WOLB.0323.00012,1,36947,37637,+,690
10,WOLB.0323.00025,1,638550,639249,-,699
10,WOLB.0323.00010,1,113500,114189,+,689
10,WOLB.0323.00068,1,38020,38710,+,690
10,WOLB.0323.00128,1,108706,109396,+,690
10,WOLB.0323.00104,1,36960,37650,+,690
10,WOLB.0323.00007,1,39833,40523,+,690
10,WOLB.0323.00100,1,36960,37650,+,690
10,WOLB.0323.00070,1,108053,108743,+,690
10,WOLB.0323.00006,1,543262,543952,-,690
10,WOLB.0323.00119,1,1167178,1167868,+,690
10,WOLB.0323.00014,1,109396,110086,+,690
9,WOLB.0323.00090,1,34418,36587,+,2169
9,WOLB.0323.00002,1,105814,107983,+,2169
9,WOLB.0323.00138,1,566209,568379,-,2170
9,WOLB.0323.00132,1,1330105,1332274,+,2169
9,WOLB.0323.00143,1,1237684,1239853,-,2169
9,WOLB.0323.00106,1,1237687,1239856,-,2169
9,WOLB.0323.00121,1,34323,36492,+,2169
9,WOLB.0323.00135,1,325286,327456,-,2170
9,WOLB.0323.00103,1,492986,495155,+,2169
9,WOLB.0323.00107,1,492988,495157,+,2169
9,WOLB.0323.00019,1,35896,38073,+,2177
9,WOLB.0323.00060,1,1364159,1366328,+,2169
9,WOLB.0323.00074,1,943310,945487,+,2177
9,WOLB.0323.00120,1,922172,924349,+,2177
9,WOLB.0323.00039,1,772846,775024,-,2178
9,WOLB.0323.00041,1,698393,700571,-,2178
9,WOLB.0323.00031,1,726627,728796,-,2169
9,WOLB.0323.00056,1,34522,36691,+,2169
9,WOLB.0323.00142,1,34299,36468,+,2169
9,WOLB.0323.00023,1,763197,765367,-,2170
9,WOLB.0323.00153,1,34418,36587,+,2169
9,WOLB.0323.00093,1,101910,104080,-,2170
9,WOLB.0323.00088,1,33169,35338,+,2169
9,WOLB.0323.00008,1,1187028,1189198,-,2170
9,WOLB.0323.00024,1,170203,172372,+,2169
9,WOLB.0323.00064,1,1209775,1211945,-,2170
9,WOLB.0323.00030,1,1697767,1699936,+,2169
9,WOLB.0323.00105,1,492995,495164,+,2169
9,WOLB.0323.00133,1,280754,282924,-,2170
9,WOLB.0323.00084,1,661129,663299,-,2170
9,WOLB.0323.00021,1,34220,36389,+,2169
9,WOLB.0323.00043,1,104522,106691,+,2169
9,WOLB.0323.00020,1,33169,35338,+,2169
9,WOLB.0323.00122,1,36722,38891,+,2169
9,WOLB.0323.00118,1,34252,36421,+,2169
9,WOLB.0323.00004,1,34299,36468,+,2169
9,WOLB.0323.00011,1,785432,787601,+,2169
9,WOLB.0323.00035,1,33169,35338,+,2169
9,WOLB.0323.00032,1,1003707,1005876,+,2169
9,WOLB.0323.00012,1,33156,35325,+,2169
9,WOLB.0323.00018,1,196360,198530,-,2170
9,WOLB.0323.00025,1,640621,642790,-,2169
9,WOLB.0323.00010,1,109968,112137,+,2169
9,WOLB.0323.00068,1,34221,36390,+,2169
9,WOLB.0323.00128,1,105148,107317,+,2169
9,WOLB.0323.00158,1,718091,720260,+,2169
9,WOLB.0323.00017,1,34323,36492,+,2169
9,WOLB.0323.00104,1,33169,35338,+,2169
9,WOLB.0323.00007,1,36042,38211,+,2169
9,WOLB.0323.00001,1,492995,495164,+,2169
9,WOLB.0323.00100,1,33169,35338,+,2169
9,WOLB.0323.00070,1,104495,106664,+,2169
9,WOLB.0323.00006,1,545318,547487,-,2169
9,WOLB.0323.00042,1,108704,110873,+,2169
9,WOLB.0323.00119,1,35915,38092,+,2177
9,WOLB.0323.00149,1,426771,428941,-,2170
9,WOLB.0323.00014,1,105838,108007,+,2169
9,WOLB.0323.00096,1,736882,739060,-,2178
8,WOLB.0323.00090,1,31586,32754,+,1168
8,WOLB.0323.00002,1,30479,31656,+,1177
8,WOLB.0323.00138,1,570044,571211,-,1167
8,WOLB.0323.00132,1,31413,32578,+,1165
8,WOLB.0323.00143,1,1241660,1242835,-,1175
8,WOLB.0323.00106,1,1241663,1242838,-,1175
8,WOLB.0323.00121,1,31491,32659,+,1168
8,WOLB.0323.00135,1,329155,330322,-,1167
8,WOLB.0323.00103,1,33048,34215,-,1167
8,WOLB.0323.00107,1,33048,34215,-,1167
8,WOLB.0323.00019,1,31901,33073,+,1172
8,WOLB.0323.00060,1,1361326,1362494,+,1168
8,WOLB.0323.00074,1,1081103,1082279,+,1176
8,WOLB.0323.00120,1,1065739,1066915,+,1176
8,WOLB.0323.00039,1,777860,779031,-,1171
8,WOLB.0323.00041,1,575914,577089,-,1175
8,WOLB.0323.00031,1,730603,731778,-,1175
8,WOLB.0323.00056,1,31689,32857,+,1168
8,WOLB.0323.00142,1,31467,32635,+,1168
8,WOLB.0323.00023,1,779029,780204,-,1175
8,WOLB.0323.00153,1,31586,32754,+,1168
8,WOLB.0323.00093,1,33102,34278,+,1176
8,WOLB.0323.00088,1,30302,31470,+,1168
8,WOLB.0323.00008,1,1313574,1314749,-,1175
8,WOLB.0323.00024,1,2022531,2023694,-,1163
8,WOLB.0323.00064,1,1106652,1107827,-,1175
8,WOLB.0323.00030,1,31373,32549,+,1176
8,WOLB.0323.00105,1,33048,34215,-,1167
8,WOLB.0323.00133,1,793515,794684,-,1169
8,WOLB.0323.00084,1,664964,666131,-,1167
8,WOLB.0323.00021,1,31387,32555,+,1168
8,WOLB.0323.00043,1,30455,31631,+,1176
8,WOLB.0323.00020,1,30302,31470,+,1168
8,WOLB.0323.00122,1,33855,35023,+,1168
8,WOLB.0323.00118,1,31399,32567,+,1168
8,WOLB.0323.00004,1,31467,32635,+,1168
8,WOLB.0323.00011,1,782600,783768,+,1168
8,WOLB.0323.00035,1,30302,31470,+,1168
8,WOLB.0323.00032,1,1000874,1002042,+,1168
8,WOLB.0323.00012,1,30302,31456,+,1154
8,WOLB.0323.00018,1,30104,31280,+,1176
8,WOLB.0323.00025,1,644481,645656,-,1175
8,WOLB.0323.00010,1,30286,31465,+,1179
8,WOLB.0323.00068,1,31388,32556,+,1168
8,WOLB.0323.00128,1,30455,31632,+,1177
8,WOLB.0323.00158,1,715259,716427,+,1168
8,WOLB.0323.00017,1,31491,32659,+,1168
8,WOLB.0323.00104,1,30302,31470,+,1168
8,WOLB.0323.00007,1,33194,34377,+,1183
8,WOLB.0323.00001,1,33048,34215,-,1167
8,WOLB.0323.00100,1,30302,31470,+,1168
8,WOLB.0323.00070,1,30479,31656,+,1177
8,WOLB.0323.00006,1,549294,550469,-,1175
8,WOLB.0323.00042,1,30568,31743,+,1175
8,WOLB.0323.00119,1,31907,33079,+,1172
8,WOLB.0323.00149,1,430605,431772,-,1167
8,WOLB.0323.00014,1,30456,31633,+,1177
8,WOLB.0323.00096,1,614403,615578,-,1175
7,WOLB.0323.00090,1,30241,31585,+,1344
7,WOLB.0323.00002,1,29134,30478,+,1344
7,WOLB.0323.00138,1,571213,572557,-,1344
7,WOLB.0323.00132,1,30068,31412,+,1344
7,WOLB.0323.00143,1,1242837,1244199,-,1362
7,WOLB.0323.00106,1,1242840,1244202,-,1362
7,WOLB.0323.00121,1,30146,31490,+,1344
7,WOLB.0323.00135,1,330324,331668,-,1344
7,WOLB.0323.00103,1,34217,35561,-,1344
7,WOLB.0323.00107,1,34217,35561,-,1344
7,WOLB.0323.00019,1,30548,31900,+,1352
7,WOLB.0323.00060,1,1359981,1361325,+,1344
7,WOLB.0323.00074,1,1079758,1081102,+,1344
7,WOLB.0323.00120,1,1064394,1065738,+,1344
7,WOLB.0323.00039,1,779033,780385,-,1352
7,WOLB.0323.00041,1,577091,578435,-,1344
7,WOLB.0323.00031,1,731780,733142,-,1362
7,WOLB.0323.00056,1,30344,31688,+,1344
7,WOLB.0323.00142,1,30122,31466,+,1344
7,WOLB.0323.00023,1,780206,781550,-,1344
7,WOLB.0323.00153,1,30241,31585,+,1344
7,WOLB.0323.00093,1,31757,33101,+,1344
7,WOLB.0323.00088,1,28957,30301,+,1344
7,WOLB.0323.00008,1,1314751,1316095,-,1344
7,WOLB.0323.00024,1,2023696,2025040,-,1344
7,WOLB.0323.00064,1,1107829,1109173,-,1344
7,WOLB.0323.00030,1,30028,31372,+,1344
7,WOLB.0323.00105,1,34217,35561,-,1344
7,WOLB.0323.00133,1,794686,796038,-,1352
7,WOLB.0323.00084,1,666133,667477,-,1344
7,WOLB.0323.00021,1,30042,31386,+,1344
7,WOLB.0323.00043,1,29110,30454,+,1344
7,WOLB.0323.00020,1,28957,30301,+,1344
7,WOLB.0323.00122,1,32511,33854,+,1343
7,WOLB.0323.00118,1,30054,31398,+,1344
7,WOLB.0323.00004,1,30122,31466,+,1344
7,WOLB.0323.00011,1,781255,782599,+,1344
7,WOLB.0323.00035,1,28957,30301,+,1344
7,WOLB.0323.00032,1,999529,1000873,+,1344
7,WOLB.0323.00012,1,28957,30301,+,1344
7,WOLB.0323.00018,1,28759,30103,+,1344
7,WOLB.0323.00025,1,645658,647020,-,1362
7,WOLB.0323.00010,1,28943,30284,+,1341
7,WOLB.0323.00068,1,30043,31387,+,1344
7,WOLB.0323.00128,1,29110,30454,+,1344
7,WOLB.0323.00158,1,713943,715258,+,1315
7,WOLB.0323.00017,1,30146,31490,+,1344
7,WOLB.0323.00104,1,28957,30301,+,1344
7,WOLB.0323.00007,1,30355,31669,+,1314
7,WOLB.0323.00001,1,34217,35561,-,1344
7,WOLB.0323.00100,1,28957,30301,+,1344
7,WOLB.0323.00070,1,29134,30478,+,1344
7,WOLB.0323.00006,1,550471,551833,-,1362
7,WOLB.0323.00042,1,29223,30567,+,1344
7,WOLB.0323.00119,1,30554,31906,+,1352
7,WOLB.0323.00149,1,431774,433118,-,1344
7,WOLB.0323.00014,1,29111,30455,+,1344
7,WOLB.0323.00096,1,615580,616924,-,1344
6,WOLB.0323.00090,1,25926,28880,+,2954
6,WOLB.0323.00002,1,24819,27773,+,2954
6,WOLB.0323.00138,1,573918,576872,-,2954
6,WOLB.0323.00132,1,25753,28707,+,2954
6,WOLB.0323.00143,1,1245560,1248521,-,2961
6,WOLB.0323.00106,1,1245563,1248524,-,2961
6,WOLB.0323.00121,1,25831,28785,+,2954
6,WOLB.0323.00135,1,333029,335983,-,2954
6,WOLB.0323.00103,1,36922,39876,-,2954
6,WOLB.0323.00107,1,36922,39876,-,2954
6,WOLB.0323.00019,1,26224,29187,+,2963
6,WOLB.0323.00060,1,1355666,1358620,+,2954
6,WOLB.0323.00074,1,1075443,1078397,+,2954
6,WOLB.0323.00120,1,1060079,1063033,+,2954
6,WOLB.0323.00039,1,781746,784709,-,2963
6,WOLB.0323.00041,1,579796,582750,-,2954
6,WOLB.0323.00031,1,734503,737464,-,2961
6,WOLB.0323.00056,1,26035,28983,+,2948
6,WOLB.0323.00142,1,25807,28761,+,2954
6,WOLB.0323.00023,1,782911,785865,-,2954
6,WOLB.0323.00153,1,25926,28880,+,2954
6,WOLB.0323.00093,1,27442,30396,+,2954
6,WOLB.0323.00088,1,24642,27596,+,2954
6,WOLB.0323.00008,1,1317456,1320410,-,2954
6,WOLB.0323.00024,1,2026401,2029355,-,2954
6,WOLB.0323.00064,1,1110534,1113488,-,2954
6,WOLB.0323.00030,1,25713,28667,+,2954
6,WOLB.0323.00105,1,36922,39876,-,2954
6,WOLB.0323.00133,1,796417,799351,-,2934
6,WOLB.0323.00084,1,668838,671792,-,2954
6,WOLB.0323.00021,1,25727,28681,+,2954
6,WOLB.0323.00043,1,24795,27749,+,2954
6,WOLB.0323.00020,1,24642,27596,+,2954
6,WOLB.0323.00122,1,27092,30046,+,2954
6,WOLB.0323.00118,1,25739,28693,+,2954
6,WOLB.0323.00004,1,25807,28761,+,2954
6,WOLB.0323.00011,1,776940,779894,+,2954
6,WOLB.0323.00035,1,24642,27596,+,2954
6,WOLB.0323.00032,1,995214,998168,+,2954
6,WOLB.0323.00012,1,24642,27596,+,2954
6,WOLB.0323.00018,1,24444,27398,+,2954
6,WOLB.0323.00025,1,648381,651342,-,2961
6,WOLB.0323.00010,1,24628,27582,+,2954
6,WOLB.0323.00068,1,25728,28682,+,2954
6,WOLB.0323.00128,1,24795,27749,+,2954
6,WOLB.0323.00158,1,708496,711450,+,2954
6,WOLB.0323.00017,1,25831,28785,+,2954
6,WOLB.0323.00104,1,24642,27596,+,2954
6,WOLB.0323.00007,1,26040,28994,+,2954
6,WOLB.0323.00001,1,36922,39876,-,2954
6,WOLB.0323.00100,1,24642,27596,+,2954
6,WOLB.0323.00070,1,24819,27773,+,2954
6,WOLB.0323.00006,1,553194,556155,-,2961
6,WOLB.0323.00042,1,24908,27862,+,2954
6,WOLB.0323.00119,1,26230,29193,+,2963
6,WOLB.0323.00149,1,434479,437433,-,2954
6,WOLB.0323.00014,1,24796,27750,+,2954
6,WOLB.0323.00096,1,618285,621239,-,2954
5,WOLB.0323.00090,1,16032,24735,+,8703
5,WOLB.0323.00002,1,16018,24720,+,8702
5,WOLB.0323.00138,1,578063,586766,-,8703
5,WOLB.0323.00132,1,15859,24562,+,8703
5,WOLB.0323.00143,1,1248638,1257307,-,8669
5,WOLB.0323.00106,1,1248641,1257310,-,8669
5,WOLB.0323.00121,1,15835,24528,+,8693
5,WOLB.0323.00135,1,336082,344785,-,8703
5,WOLB.0323.00103,1,19996,28694,+,8698
5,WOLB.0323.00107,1,19996,28694,+,8698
5,WOLB.0323.00019,1,16277,24974,+,8697
5,WOLB.0323.00060,1,1345726,1354431,+,8705
5,WOLB.0323.00074,1,1065486,1074178,+,8692
5,WOLB.0323.00120,1,1050122,1058814,+,8692
5,WOLB.0323.00039,1,785941,794633,-,8692
5,WOLB.0323.00041,1,584015,592707,-,8692
5,WOLB.0323.00031,1,737581,746250,-,8669
5,WOLB.0323.00056,1,16089,24794,+,8705
5,WOLB.0323.00142,1,15835,24504,+,8669
5,WOLB.0323.00023,1,788656,797348,-,8692
5,WOLB.0323.00153,1,16032,24735,+,8703
5,WOLB.0323.00093,1,17398,26185,+,8787
5,WOLB.0323.00088,1,15840,24543,+,8703
5,WOLB.0323.00008,1,1322929,1331602,-,8673
5,WOLB.0323.00024,1,604083,612779,+,8696
5,WOLB.0323.00064,1,1114747,1123439,-,8692
5,WOLB.0323.00030,1,15762,24454,+,8692
5,WOLB.0323.00105,1,19996,28694,+,8698
5,WOLB.0323.00133,1,800593,809268,-,8675
5,WOLB.0323.00084,1,672983,681686,-,8703
5,WOLB.0323.00021,1,15833,24536,+,8703
5,WOLB.0323.00043,1,16018,24696,+,8678
5,WOLB.0323.00020,1,15840,24543,+,8703
5,WOLB.0323.00122,1,17154,25856,+,8702
5,WOLB.0323.00118,1,16950,25640,+,8690
5,WOLB.0323.00004,1,15835,24504,+,8669
5,WOLB.0323.00011,1,766944,775637,+,8693
5,WOLB.0323.00035,1,15840,24543,+,8703
5,WOLB.0323.00032,1,985320,994023,+,8703
5,WOLB.0323.00012,1,15840,24543,+,8703
5,WOLB.0323.00018,1,15646,24345,+,8699
5,WOLB.0323.00025,1,651459,660128,-,8669
5,WOLB.0323.00010,1,15830,24529,+,8699
5,WOLB.0323.00068,1,15833,24536,+,8703
5,WOLB.0323.00128,1,16018,24696,+,8678
5,WOLB.0323.00158,1,698524,707193,+,8669
5,WOLB.0323.00017,1,15835,24528,+,8693
5,WOLB.0323.00104,1,15840,24543,+,8703
5,WOLB.0323.00007,1,16089,24794,+,8705
5,WOLB.0323.00001,1,19996,28694,+,8698
5,WOLB.0323.00100,1,15840,24543,+,8703
5,WOLB.0323.00070,1,16018,24720,+,8702
5,WOLB.0323.00006,1,556272,564941,-,8669
5,WOLB.0323.00042,1,16109,24809,+,8700
5,WOLB.0323.00119,1,16277,24974,+,8697
5,WOLB.0323.00149,1,441036,449729,-,8693
5,WOLB.0323.00014,1,16018,24697,+,8679
5,WOLB.0323.00096,1,622504,631196,-,8692
4,WOLB.0323.00090,1,10910,13857,+,2947
4,WOLB.0323.00002,1,10882,13829,+,2947
4,WOLB.0323.00138,1,588742,591689,-,2947
4,WOLB.0323.00132,1,10715,13662,+,2947
4,WOLB.0323.00143,1,1259224,1262171,-,2947
4,WOLB.0323.00106,1,1259227,1262174,-,2947
4,WOLB.0323.00121,1,10910,13857,+,2947
4,WOLB.0323.00135,1,347017,349964,-,2947
4,WOLB.0323.00103,1,11119,14057,+,2938
4,WOLB.0323.00107,1,11119,14057,+,2938
4,WOLB.0323.00019,1,11294,14234,+,2940
4,WOLB.0323.00060,1,1340547,1343494,+,2947
4,WOLB.0323.00074,1,1060673,1063611,+,2938
4,WOLB.0323.00120,1,1045309,1048247,+,2938
4,WOLB.0323.00039,1,796676,799616,-,2940
4,WOLB.0323.00041,1,594582,597520,-,2938
4,WOLB.0323.00031,1,748167,751114,-,2947
4,WOLB.0323.00056,1,10910,13857,+,2947
4,WOLB.0323.00142,1,10910,13857,+,2947
4,WOLB.0323.00023,1,800714,803661,-,2947
4,WOLB.0323.00153,1,10910,13857,+,2947
4,WOLB.0323.00093,1,10901,13848,+,2947
4,WOLB.0323.00088,1,10910,13857,+,2947
4,WOLB.0323.00008,1,1336639,1339586,+,2947
4,WOLB.0323.00024,1,599141,602059,+,2918
4,WOLB.0323.00064,1,1125442,1128384,-,2942
4,WOLB.0323.00030,1,10817,13759,+,2942
4,WOLB.0323.00105,1,11119,14057,+,2938
4,WOLB.0323.00133,1,480439,483386,-,2947
4,WOLB.0323.00084,1,683662,686609,-,2947
4,WOLB.0323.00021,1,10910,13857,+,2947
4,WOLB.0323.00043,1,10882,13829,+,2947
4,WOLB.0323.00020,1,10910,13857,+,2947
4,WOLB.0323.00122,1,12014,14961,+,2947
4,WOLB.0323.00118,1,10916,13863,+,2947
4,WOLB.0323.00004,1,10910,13857,+,2947
4,WOLB.0323.00011,1,762019,764966,+,2947
4,WOLB.0323.00035,1,10910,13857,+,2947
4,WOLB.0323.00032,1,980418,983365,+,2947
4,WOLB.0323.00012,1,10910,13857,+,2947
4,WOLB.0323.00018,1,10764,13711,+,2947
4,WOLB.0323.00025,1,471519,474466,-,2947
4,WOLB.0323.00010,1,10883,13830,+,2947
4,WOLB.0323.00068,1,10910,13857,+,2947
4,WOLB.0323.00128,1,10882,13829,+,2947
4,WOLB.0323.00158,1,693599,696546,+,2947
4,WOLB.0323.00017,1,10910,13857,+,2947
4,WOLB.0323.00104,1,10910,13857,+,2947
4,WOLB.0323.00007,1,10910,13857,+,2947
4,WOLB.0323.00001,1,11119,14057,+,2938
4,WOLB.0323.00100,1,10910,13857,+,2947
4,WOLB.0323.00070,1,10882,13829,+,2947
4,WOLB.0323.00006,1,566858,569805,-,2947
4,WOLB.0323.00042,1,10899,13846,+,2947
4,WOLB.0323.00119,1,11294,14234,+,2940
4,WOLB.0323.00149,1,451707,454654,-,2947
4,WOLB.0323.00014,1,10882,13829,+,2947
4,WOLB.0323.00096,1,633071,636009,-,2938
3,WOLB.0323.00090,1,8987,10908,+,1921
3,WOLB.0323.00002,1,8961,10880,+,1919
3,WOLB.0323.00138,1,591690,593612,-,1922
3,WOLB.0323.00132,1,8794,10713,+,1919
3,WOLB.0323.00143,1,1262172,1264094,-,1922
3,WOLB.0323.00106,1,1262175,1264097,-,1922
3,WOLB.0323.00121,1,8987,10908,+,1921
3,WOLB.0323.00135,1,349965,351887,-,1922
3,WOLB.0323.00103,1,9199,11117,+,1918
3,WOLB.0323.00107,1,9199,11117,+,1918
3,WOLB.0323.00019,1,9363,11292,+,1929
3,WOLB.0323.00060,1,1338624,1340545,+,1921
3,WOLB.0323.00074,1,1058750,1060671,+,1921
3,WOLB.0323.00120,1,1043386,1045307,+,1921
3,WOLB.0323.00039,1,799617,801547,-,1930
3,WOLB.0323.00041,1,597521,599443,-,1922
3,WOLB.0323.00031,1,751115,753037,-,1922
3,WOLB.0323.00056,1,8987,10908,+,1921
3,WOLB.0323.00142,1,8987,10908,+,1921
3,WOLB.0323.00023,1,803662,805582,-,1920
3,WOLB.0323.00153,1,8987,10908,+,1921
3,WOLB.0323.00093,1,8972,10899,+,1927
3,WOLB.0323.00088,1,8987,10908,+,1921
3,WOLB.0323.00008,1,1334711,1336637,+,1926
3,WOLB.0323.00024,1,8802,10831,+,2029
3,WOLB.0323.00064,1,1128385,1130398,-,2013
3,WOLB.0323.00030,1,8803,10815,+,2012
3,WOLB.0323.00105,1,9199,11117,+,1918
3,WOLB.0323.00133,1,483387,485309,-,1922
3,WOLB.0323.00084,1,686610,688532,-,1922
3,WOLB.0323.00021,1,8987,10908,+,1921
3,WOLB.0323.00043,1,8961,10880,+,1919
3,WOLB.0323.00020,1,8987,10908,+,1921
3,WOLB.0323.00122,1,10091,12012,+,1921
3,WOLB.0323.00118,1,8986,10914,+,1928
3,WOLB.0323.00004,1,8987,10908,+,1921
3,WOLB.0323.00011,1,760096,762017,+,1921
3,WOLB.0323.00035,1,8987,10908,+,1921
3,WOLB.0323.00032,1,978495,980416,+,1921
3,WOLB.0323.00012,1,8987,10908,+,1921
3,WOLB.0323.00018,1,8843,10762,+,1919
3,WOLB.0323.00025,1,474467,476389,-,1922
3,WOLB.0323.00010,1,8963,10881,+,1918
3,WOLB.0323.00068,1,8987,10908,+,1921
3,WOLB.0323.00128,1,8961,10880,+,1919
3,WOLB.0323.00158,1,691676,693597,+,1921
3,WOLB.0323.00017,1,8987,10908,+,1921
3,WOLB.0323.00104,1,8987,10908,+,1921
3,WOLB.0323.00007,1,8987,10908,+,1921
3,WOLB.0323.00001,1,9199,11117,+,1918
3,WOLB.0323.00100,1,8987,10908,+,1921
3,WOLB.0323.00070,1,8961,10880,+,1919
3,WOLB.0323.00006,1,569806,571728,-,1922
3,WOLB.0323.00042,1,8978,10897,+,1919
3,WOLB.0323.00119,1,9363,11292,+,1929
3,WOLB.0323.00149,1,454655,456577,-,1922
3,WOLB.0323.00014,1,8961,10880,+,1919
3,WOLB.0323.00096,1,636010,637932,-,1922
2,WOLB.0323.00090,1,1371,7780,+,6409
2,WOLB.0323.00002,1,1354,7754,+,6400
2,WOLB.0323.00138,1,594819,601228,-,6409
2,WOLB.0323.00132,1,1187,7587,+,6400
2,WOLB.0323.00143,1,1265302,1271786,-,6484
2,WOLB.0323.00106,1,1265305,1271789,-,6484
2,WOLB.0323.00121,1,1371,7780,+,6409
2,WOLB.0323.00135,1,353094,359503,-,6409
2,WOLB.0323.00103,1,1589,7991,+,6402
2,WOLB.0323.00107,1,1589,7991,+,6402
2,WOLB.0323.00019,1,1740,8155,+,6415
2,WOLB.0323.00060,1,1331008,1337417,+,6409
2,WOLB.0323.00074,1,1051134,1057543,+,6409
2,WOLB.0323.00120,1,1035770,1042179,+,6409
2,WOLB.0323.00039,1,802755,809170,-,6415
2,WOLB.0323.00041,1,600650,607059,-,6409
2,WOLB.0323.00031,1,754245,760729,-,6484
2,WOLB.0323.00056,1,1371,7780,+,6409
2,WOLB.0323.00142,1,1371,7780,+,6409
2,WOLB.0323.00023,1,806788,813196,-,6408
2,WOLB.0323.00153,1,1371,7780,+,6409
2,WOLB.0323.00093,1,1363,7765,+,6402
2,WOLB.0323.00088,1,1371,7780,+,6409
2,WOLB.0323.00008,1,1362,7692,+,6330
2,WOLB.0323.00024,1,1187,7595,+,6408
2,WOLB.0323.00064,1,1131605,1138014,-,6409
2,WOLB.0323.00030,1,1187,7596,+,6409
2,WOLB.0323.00105,1,1589,7991,+,6402
2,WOLB.0323.00133,1,486531,492930,-,6399
2,WOLB.0323.00084,1,689739,696148,-,6409
2,WOLB.0323.00021,1,1371,7780,+,6409
2,WOLB.0323.00043,1,1354,7754,+,6400
2,WOLB.0323.00020,1,1371,7780,+,6409
2,WOLB.0323.00122,1,1371,7781,+,6410
2,WOLB.0323.00118,1,1370,7779,+,6409
2,WOLB.0323.00004,1,1371,7780,+,6409
2,WOLB.0323.00011,1,752480,758889,+,6409
2,WOLB.0323.00035,1,1371,7780,+,6409
2,WOLB.0323.00032,1,970879,977288,+,6409
2,WOLB.0323.00012,1,1371,7780,+,6409
2,WOLB.0323.00018,1,1187,7636,+,6449
2,WOLB.0323.00025,1,477597,484082,-,6485
2,WOLB.0323.00010,1,1354,7756,+,6402
2,WOLB.0323.00068,1,1371,7780,+,6409
2,WOLB.0323.00128,1,1354,7754,+,6400
2,WOLB.0323.00158,1,684060,690469,+,6409
2,WOLB.0323.00017,1,1371,7780,+,6409
2,WOLB.0323.00104,1,1371,7780,+,6409
2,WOLB.0323.00007,1,1371,7780,+,6409
2,WOLB.0323.00001,1,1589,7991,+,6402
2,WOLB.0323.00100,1,1371,7780,+,6409
2,WOLB.0323.00070,1,1354,7754,+,6400
2,WOLB.0323.00006,1,572936,579421,-,6485
2,WOLB.0323.00042,1,1363,7771,+,6408
2,WOLB.0323.00119,1,1740,8155,+,6415
2,WOLB.0323.00149,1,457255,463664,-,6409
2,WOLB.0323.00014,1,1354,7754,+,6400
2,WOLB.0323.00096,1,639139,645548,-,6409
1,WOLB.0323.00090,1,63,916,+,853
1,WOLB.0323.00002,1,63,916,+,853
1,WOLB.0323.00138,1,601683,602536,-,853
1,WOLB.0323.00132,1,63,916,+,853
1,WOLB.0323.00143,1,1272207,1273060,-,853
1,WOLB.0323.00106,1,1272210,1273063,-,853
1,WOLB.0323.00121,1,63,916,+,853
1,WOLB.0323.00135,1,359958,360811,-,853
1,WOLB.0323.00103,1,466,1319,+,853
1,WOLB.0323.00107,1,466,1319,+,853
1,WOLB.0323.00019,1,468,1321,+,853
1,WOLB.0323.00060,1,1329700,1330553,+,853
1,WOLB.0323.00074,1,1049826,1050679,+,853
1,WOLB.0323.00120,1,1034462,1035315,+,853
1,WOLB.0323.00039,1,809589,810442,-,853
1,WOLB.0323.00041,1,607514,608367,-,853
1,WOLB.0323.00031,1,761150,762003,-,853
1,WOLB.0323.00056,1,63,916,+,853
1,WOLB.0323.00142,1,63,916,+,853
1,WOLB.0323.00023,1,813467,814320,-,853
1,WOLB.0323.00153,1,63,916,+,853
1,WOLB.0323.00093,1,63,916,+,853
1,WOLB.0323.00088,1,63,916,+,853
1,WOLB.0323.00008,1,63,916,+,853
1,WOLB.0323.00024,1,63,916,+,853
1,WOLB.0323.00064,1,1138285,1139138,-,853
1,WOLB.0323.00030,1,63,916,+,853
1,WOLB.0323.00105,1,466,1319,+,853
1,WOLB.0323.00133,1,507113,507966,-,853
1,WOLB.0323.00084,1,696603,697456,-,853
1,WOLB.0323.00021,1,63,916,+,853
1,WOLB.0323.00043,1,63,916,+,853
1,WOLB.0323.00020,1,63,916,+,853
1,WOLB.0323.00122,1,63,916,+,853
1,WOLB.0323.00118,1,63,916,+,853
1,WOLB.0323.00004,1,63,916,+,853
1,WOLB.0323.00011,1,751172,752025,+,853
1,WOLB.0323.00035,1,63,916,+,853
1,WOLB.0323.00032,1,969571,970424,+,853
1,WOLB.0323.00012,1,63,916,+,853
1,WOLB.0323.00018,1,63,916,+,853
1,WOLB.0323.00025,1,484652,485505,-,853
1,WOLB.0323.00010,1,63,916,+,853
1,WOLB.0323.00068,1,63,916,+,853
1,WOLB.0323.00128,1,63,916,+,853
1,WOLB.0323.00158,1,682752,683605,+,853
1,WOLB.0323.00017,1,63,916,+,853
1,WOLB.0323.00104,1,63,916,+,853
1,WOLB.0323.00007,1,63,916,+,853
1,WOLB.0323.00001,1,466,1319,+,853
1,WOLB.0323.00100,1,63,916,+,853
1,WOLB.0323.00070,1,63,916,+,853
1,WOLB.0323.00006,1,579842,580695,-,853
1,WOLB.0323.00042,1,63,916,+,853
1,WOLB.0323.00119,1,468,1321,+,853
1,WOLB.0323.00149,1,464119,464972,-,853
1,WOLB.0323.00014,1,63,916,+,853
1,WOLB.0323.00096,1,646003,646856,-,853
14,WOLB.0323.00090,1,44015,44909,+,894
14,WOLB.0323.00002,1,115190,116065,+,875
14,WOLB.0323.00138,1,557880,558774,-,894
14,WOLB.0323.00132,1,1339470,1340349,+,879
14,WOLB.0323.00143,1,1229624,1230501,-,877
14,WOLB.0323.00106,1,1229627,1230504,-,877
14,WOLB.0323.00121,1,43837,44731,+,894
14,WOLB.0323.00135,1,316980,317859,-,879
14,WOLB.0323.00103,1,502259,503153,+,894
14,WOLB.0323.00107,1,502261,503155,+,894
14,WOLB.0323.00019,1,1171602,1172478,+,876
14,WOLB.0323.00060,1,1556673,1557567,+,894
14,WOLB.0323.00074,1,952825,953719,+,894
14,WOLB.0323.00120,1,938542,939436,+,894
14,WOLB.0323.00039,1,725771,726647,+,876
14,WOLB.0323.00041,1,690162,691056,-,894
14,WOLB.0323.00031,1,718567,719444,-,877
14,WOLB.0323.00056,1,44117,45011,+,894
14,WOLB.0323.00142,1,43813,44707,+,894
14,WOLB.0323.00023,1,755115,755994,-,879
14,WOLB.0323.00153,1,44015,44909,+,894
14,WOLB.0323.00093,1,94136,95030,+,894
14,WOLB.0323.00088,1,42766,43645,+,879
14,WOLB.0323.00008,1,1178769,1179663,-,894
14,WOLB.0323.00024,1,179765,180644,+,879
14,WOLB.0323.00064,1,1201705,1202584,-,879
14,WOLB.0323.00030,1,1707128,1708007,+,879
14,WOLB.0323.00105,1,502268,503162,+,894
14,WOLB.0323.00133,1,785297,786173,-,876
14,WOLB.0323.00084,1,651138,652032,-,894
14,WOLB.0323.00021,1,43825,44719,+,894
14,WOLB.0323.00043,1,113894,114773,+,879
14,WOLB.0323.00020,1,42766,43645,+,879
14,WOLB.0323.00122,1,46319,47213,+,894
14,WOLB.0323.00118,1,46003,46897,+,894
14,WOLB.0323.00004,1,43813,44707,+,894
14,WOLB.0323.00011,1,794946,795840,+,894
14,WOLB.0323.00035,1,42766,43645,+,879
14,WOLB.0323.00032,1,1013312,1014206,+,894
14,WOLB.0323.00012,1,42753,43632,+,879
14,WOLB.0323.00018,1,188336,189215,-,879
14,WOLB.0323.00025,1,632546,633423,-,877
14,WOLB.0323.00010,1,119313,120192,+,879
14,WOLB.0323.00068,1,43826,44720,+,894
14,WOLB.0323.00128,1,114524,115399,+,875
14,WOLB.0323.00158,1,727605,728499,+,894
14,WOLB.0323.00017,1,43837,44731,+,894
14,WOLB.0323.00104,1,42766,43645,+,879
14,WOLB.0323.00007,1,45637,46531,+,894
14,WOLB.0323.00001,1,502268,503162,+,894
14,WOLB.0323.00100,1,42766,43645,+,879
14,WOLB.0323.00070,1,113871,114746,+,875
14,WOLB.0323.00006,1,537258,538135,-,877
14,WOLB.0323.00042,1,118054,118930,+,876
14,WOLB.0323.00119,1,1172991,1173867,+,876
14,WOLB.0323.00149,1,418533,419427,-,894
14,WOLB.0323.00014,1,115214,116089,+,875
14,WOLB.0323.00096,1,728651,729545,-,894
15,WOLB.0323.00090,1,45139,45978,+,839
15,WOLB.0323.00002,1,116310,117149,+,839
15,WOLB.0323.00138,1,556811,557650,-,839
15,WOLB.0323.00132,1,1340802,1341639,+,837
15,WOLB.0323.00143,1,1228332,1229169,-,837
15,WOLB.0323.00106,1,1228335,1229172,-,837
15,WOLB.0323.00121,1,44961,45800,+,839
15,WOLB.0323.00135,1,315896,316735,-,839
15,WOLB.0323.00103,1,504732,505569,+,837
15,WOLB.0323.00107,1,504734,505535,+,801
15,WOLB.0323.00019,1,1172734,1173565,+,831
15,WOLB.0323.00060,1,1560014,1560850,+,836
15,WOLB.0323.00074,1,954157,954993,+,836
15,WOLB.0323.00120,1,939874,940710,+,836
15,WOLB.0323.00039,1,726903,727734,+,831
15,WOLB.0323.00041,1,688888,689724,-,836
15,WOLB.0323.00031,1,717275,718112,-,837
15,WOLB.0323.00056,1,46592,47428,+,836
15,WOLB.0323.00142,1,44937,45776,+,839
15,WOLB.0323.00023,1,752682,753519,-,837
15,WOLB.0323.00153,1,45139,45978,+,839
15,WOLB.0323.00093,1,96611,97447,+,836
15,WOLB.0323.00088,1,45242,46079,+,837
15,WOLB.0323.00008,1,1176352,1177188,-,836
15,WOLB.0323.00024,1,183360,184197,+,837
15,WOLB.0323.00064,1,1200415,1201252,-,837
15,WOLB.0323.00030,1,1708460,1709297,+,837
15,WOLB.0323.00105,1,504741,505578,+,837
15,WOLB.0323.00133,1,784210,785041,-,831
15,WOLB.0323.00084,1,650069,650908,-,839
15,WOLB.0323.00021,1,44949,45788,+,839
15,WOLB.0323.00043,1,115018,115857,+,839
15,WOLB.0323.00020,1,45242,46079,+,837
15,WOLB.0323.00122,1,48794,49631,+,837
15,WOLB.0323.00118,1,48466,49303,+,837
15,WOLB.0323.00004,1,44937,45776,+,839
15,WOLB.0323.00011,1,796070,796909,+,839
15,WOLB.0323.00035,1,45242,46079,+,837
15,WOLB.0323.00032,1,1014436,1015275,+,839
15,WOLB.0323.00012,1,45229,46066,+,837
15,WOLB.0323.00018,1,187252,188091,-,839
15,WOLB.0323.00025,1,490786,491606,+,820
15,WOLB.0323.00010,1,120437,121276,+,839
15,WOLB.0323.00068,1,44950,45789,+,839
15,WOLB.0323.00128,1,115644,116483,+,839
15,WOLB.0323.00158,1,728729,729568,+,839
15,WOLB.0323.00017,1,44961,45800,+,839
15,WOLB.0323.00104,1,45242,46079,+,837
15,WOLB.0323.00007,1,48117,48953,+,836
15,WOLB.0323.00001,1,504741,505578,+,837
15,WOLB.0323.00100,1,45242,46079,+,837
15,WOLB.0323.00070,1,114991,115830,+,839
15,WOLB.0323.00006,1,535966,536803,-,837
15,WOLB.0323.00042,1,119385,120222,+,837
15,WOLB.0323.00119,1,1174123,1174954,+,831
15,WOLB.0323.00149,1,417464,418303,-,839
15,WOLB.0323.00014,1,116334,117173,+,839
15,WOLB.0323.00096,1,727377,728213,-,836
16,WOLB.0323.00090,1,48258,48991,+,733
16,WOLB.0323.00002,1,119414,120147,+,733
16,WOLB.0323.00138,1,553717,554450,-,733
16,WOLB.0323.00132,1,1343928,1344661,+,733
16,WOLB.0323.00143,1,1225178,1225911,-,733
16,WOLB.0323.00106,1,1225181,1225914,-,733
16,WOLB.0323.00121,1,48081,48814,+,733
16,WOLB.0323.00135,1,312882,313615,-,733
16,WOLB.0323.00103,1,507980,508709,+,729
16,WOLB.0323.00107,1,507982,508711,+,729
16,WOLB.0323.00019,1,1175847,1176581,+,734
16,WOLB.0323.00060,1,1563211,1563944,+,733
16,WOLB.0323.00074,1,849685,850409,+,724
16,WOLB.0323.00120,1,835544,836268,+,724
16,WOLB.0323.00039,1,730014,730747,+,733
16,WOLB.0323.00041,1,788096,788820,-,724
16,WOLB.0323.00031,1,714121,714854,-,733
16,WOLB.0323.00056,1,49789,50522,+,733
16,WOLB.0323.00142,1,48056,48789,+,733
16,WOLB.0323.00023,1,749669,750402,-,733
16,WOLB.0323.00153,1,48258,48991,+,733
16,WOLB.0323.00093,1,273183,273916,-,733
16,WOLB.0323.00088,1,48359,49092,+,733
16,WOLB.0323.00008,1,65005,65738,+,733
16,WOLB.0323.00024,1,67996,68729,+,733
16,WOLB.0323.00064,1,1197400,1198133,-,733
16,WOLB.0323.00030,1,1711577,1712310,+,733
16,WOLB.0323.00105,1,507989,508718,+,729
16,WOLB.0323.00133,1,781006,781739,-,733
16,WOLB.0323.00084,1,646975,647708,-,733
16,WOLB.0323.00021,1,48149,48882,+,733
16,WOLB.0323.00043,1,118122,118855,+,733
16,WOLB.0323.00020,1,48359,49092,+,733
16,WOLB.0323.00122,1,51992,52725,+,733
16,WOLB.0323.00118,1,51583,52316,+,733
16,WOLB.0323.00004,1,48056,48789,+,733
16,WOLB.0323.00011,1,799189,799922,+,733
16,WOLB.0323.00035,1,48359,49092,+,733
16,WOLB.0323.00032,1,1017634,1018367,+,733
16,WOLB.0323.00012,1,48346,49079,+,733
16,WOLB.0323.00018,1,183250,183971,-,721
16,WOLB.0323.00025,1,493988,494721,+,733
16,WOLB.0323.00010,1,123547,124280,+,733
16,WOLB.0323.00068,1,48150,48883,+,733
16,WOLB.0323.00128,1,118748,119481,+,733
16,WOLB.0323.00158,1,731848,732581,+,733
16,WOLB.0323.00017,1,48080,48813,+,733
16,WOLB.0323.00104,1,48359,49092,+,733
16,WOLB.0323.00007,1,51314,52047,+,733
16,WOLB.0323.00001,1,507989,508718,+,729
16,WOLB.0323.00100,1,48359,49092,+,733
16,WOLB.0323.00070,1,118095,118828,+,733
16,WOLB.0323.00006,1,532812,533545,-,733
16,WOLB.0323.00042,1,123527,124260,+,733
16,WOLB.0323.00119,1,1177236,1177970,+,734
16,WOLB.0323.00149,1,414451,415184,-,733
16,WOLB.0323.00014,1,120815,121548,+,733
16,WOLB.0323.00096,1,825968,826692,-,724
17,WOLB.0323.00090,1,49008,50543,+,1535
17,WOLB.0323.00002,1,120164,121699,+,1535
17,WOLB.0323.00138,1,552165,553700,-,1535
17,WOLB.0323.00132,1,1344678,1346213,+,1535
17,WOLB.0323.00143,1,1223626,1225161,-,1535
17,WOLB.0323.00106,1,1223629,1225164,-,1535
17,WOLB.0323.00121,1,48831,50362,+,1531
17,WOLB.0323.00135,1,311330,312865,-,1535
17,WOLB.0323.00103,1,510018,511545,+,1527
17,WOLB.0323.00107,1,510020,511547,+,1527
17,WOLB.0323.00019,1,1176598,1178133,+,1535
17,WOLB.0323.00060,1,1563961,1565496,+,1535
17,WOLB.0323.00074,1,850426,851961,+,1535
17,WOLB.0323.00120,1,836285,837820,+,1535
17,WOLB.0323.00039,1,730764,732299,+,1535
17,WOLB.0323.00041,1,786544,788079,-,1535
17,WOLB.0323.00031,1,712569,714104,-,1535
17,WOLB.0323.00056,1,50539,52050,+,1511
17,WOLB.0323.00142,1,48806,50337,+,1531
17,WOLB.0323.00023,1,748117,749652,-,1535
17,WOLB.0323.00153,1,49008,50543,+,1535
17,WOLB.0323.00093,1,271631,273166,-,1535
17,WOLB.0323.00088,1,49109,50644,+,1535
17,WOLB.0323.00008,1,65755,67290,+,1535
17,WOLB.0323.00024,1,68746,70281,+,1535
17,WOLB.0323.00064,1,1195848,1197383,-,1535
17,WOLB.0323.00030,1,1712327,1713862,+,1535
17,WOLB.0323.00105,1,510027,511554,+,1527
17,WOLB.0323.00133,1,779454,780989,-,1535
17,WOLB.0323.00084,1,645423,646958,-,1535
17,WOLB.0323.00021,1,48899,50434,+,1535
17,WOLB.0323.00043,1,118872,120407,+,1535
17,WOLB.0323.00020,1,49109,50644,+,1535
17,WOLB.0323.00122,1,52742,54273,+,1531
17,WOLB.0323.00118,1,52333,53868,+,1535
17,WOLB.0323.00004,1,48806,50337,+,1531
17,WOLB.0323.00011,1,799939,801470,+,1531
17,WOLB.0323.00035,1,49109,50644,+,1535
17,WOLB.0323.00032,1,1018384,1019919,+,1535
17,WOLB.0323.00012,1,49096,50631,+,1535
17,WOLB.0323.00018,1,181698,183233,-,1535
17,WOLB.0323.00025,1,494738,496273,+,1535
17,WOLB.0323.00010,1,124297,125832,+,1535
17,WOLB.0323.00068,1,48900,50435,+,1535
17,WOLB.0323.00128,1,119498,121033,+,1535
17,WOLB.0323.00158,1,732598,734129,+,1531
17,WOLB.0323.00017,1,48830,50361,+,1531
17,WOLB.0323.00104,1,49109,50644,+,1535
17,WOLB.0323.00007,1,52064,53599,+,1535
17,WOLB.0323.00001,1,510027,511554,+,1527
17,WOLB.0323.00100,1,49109,50644,+,1535
17,WOLB.0323.00070,1,118845,120380,+,1535
17,WOLB.0323.00006,1,531260,532795,-,1535
17,WOLB.0323.00042,1,124277,125808,+,1531
17,WOLB.0323.00119,1,1177987,1179522,+,1535
17,WOLB.0323.00149,1,412903,414434,-,1531
17,WOLB.0323.00014,1,121565,123097,+,1532
17,WOLB.0323.00096,1,824416,825951,-,1535
18,WOLB.0323.00090,1,51417,53201,+,1784
18,WOLB.0323.00002,1,122573,124357,+,1784
18,WOLB.0323.00138,1,549507,551291,-,1784
18,WOLB.0323.00132,1,1347081,1348865,+,1784
18,WOLB.0323.00143,1,1220968,1222753,-,1785
18,WOLB.0323.00106,1,1220971,1222756,-,1785
18,WOLB.0323.00121,1,51236,53020,+,1784
18,WOLB.0323.00135,1,308672,310456,-,1784
18,WOLB.0323.00103,1,515816,517593,+,1777
18,WOLB.0323.00107,1,515818,517595,+,1777
18,WOLB.0323.00019,1,1179007,1180792,+,1785
18,WOLB.0323.00060,1,1567745,1569529,+,1784
18,WOLB.0323.00074,1,852835,854611,+,1776
18,WOLB.0323.00120,1,838694,840470,+,1776
18,WOLB.0323.00039,1,733173,734958,+,1785
18,WOLB.0323.00041,1,783894,785670,-,1776
18,WOLB.0323.00031,1,709911,711696,-,1785
18,WOLB.0323.00056,1,54458,56242,+,1784
18,WOLB.0323.00142,1,51211,52995,+,1784
18,WOLB.0323.00023,1,743971,745755,-,1784
18,WOLB.0323.00153,1,51417,53201,+,1784
18,WOLB.0323.00093,1,268981,270757,-,1776
18,WOLB.0323.00088,1,51518,53302,+,1784
18,WOLB.0323.00008,1,68164,69906,+,1742
18,WOLB.0323.00024,1,110425,112209,+,1784
18,WOLB.0323.00064,1,1193196,1194980,-,1784
18,WOLB.0323.00030,1,1714730,1716514,+,1784
18,WOLB.0323.00105,1,515825,517602,+,1777
18,WOLB.0323.00133,1,776797,778582,-,1785
18,WOLB.0323.00084,1,642765,644549,-,1784
18,WOLB.0323.00021,1,51308,53092,+,1784
18,WOLB.0323.00043,1,121281,123065,+,1784
18,WOLB.0323.00020,1,51518,53302,+,1784
18,WOLB.0323.00122,1,56250,58034,+,1784
18,WOLB.0323.00118,1,54742,56526,+,1784
18,WOLB.0323.00004,1,51211,52995,+,1784
18,WOLB.0323.00011,1,802344,804128,+,1784
18,WOLB.0323.00035,1,51518,53302,+,1784
18,WOLB.0323.00032,1,1020793,1022577,+,1784
18,WOLB.0323.00012,1,51505,53289,+,1784
18,WOLB.0323.00018,1,179040,180810,-,1770
18,WOLB.0323.00025,1,523368,525143,-,1775
18,WOLB.0323.00010,1,126706,128482,+,1776
18,WOLB.0323.00068,1,51309,53093,+,1784
18,WOLB.0323.00128,1,121907,123691,+,1784
18,WOLB.0323.00158,1,735003,736787,+,1784
18,WOLB.0323.00017,1,51235,53019,+,1784
18,WOLB.0323.00104,1,51518,53302,+,1784
18,WOLB.0323.00007,1,54473,56257,+,1784
18,WOLB.0323.00001,1,515825,517602,+,1777
18,WOLB.0323.00100,1,51518,53302,+,1784
18,WOLB.0323.00070,1,121254,123038,+,1784
18,WOLB.0323.00006,1,528601,530386,-,1785
18,WOLB.0323.00042,1,126682,128466,+,1784
18,WOLB.0323.00119,1,1180396,1182181,+,1785
18,WOLB.0323.00149,1,410245,412029,-,1784
18,WOLB.0323.00014,1,123971,125755,+,1784
18,WOLB.0323.00096,1,821766,823542,-,1776
19,WOLB.0323.00090,1,54480,55816,+,1336
19,WOLB.0323.00002,1,125646,126982,+,1336
19,WOLB.0323.00138,1,546892,548228,-,1336
19,WOLB.0323.00132,1,1350127,1351463,+,1336
19,WOLB.0323.00143,1,1218331,1219667,-,1336
19,WOLB.0323.00106,1,1218334,1219670,-,1336
19,WOLB.0323.00121,1,54299,55635,+,1336
19,WOLB.0323.00135,1,306057,307393,-,1336
19,WOLB.0323.00103,1,518864,520200,+,1336
19,WOLB.0323.00107,1,518866,520202,+,1336
19,WOLB.0323.00019,1,1182081,1183417,+,1336
19,WOLB.0323.00060,1,1570808,1572144,+,1336
19,WOLB.0323.00074,1,855900,857236,+,1336
19,WOLB.0323.00120,1,841759,843095,+,1336
19,WOLB.0323.00039,1,736247,737583,+,1336
19,WOLB.0323.00041,1,781269,782605,-,1336
19,WOLB.0323.00031,1,707274,708610,-,1336
19,WOLB.0323.00056,1,57521,58857,+,1336
19,WOLB.0323.00142,1,54274,55610,+,1336
19,WOLB.0323.00023,1,741346,742682,-,1336
19,WOLB.0323.00153,1,54480,55816,+,1336
19,WOLB.0323.00093,1,264943,266131,-,1188
19,WOLB.0323.00088,1,54581,55917,+,1336
19,WOLB.0323.00008,1,72407,73595,+,1188
19,WOLB.0323.00024,1,113498,114834,+,1336
19,WOLB.0323.00064,1,1190571,1191907,-,1336
19,WOLB.0323.00030,1,1717803,1719139,+,1336
19,WOLB.0323.00105,1,518873,520209,+,1336
19,WOLB.0323.00133,1,774172,775508,-,1336
19,WOLB.0323.00084,1,640150,641486,-,1336
19,WOLB.0323.00021,1,54371,55707,+,1336
19,WOLB.0323.00043,1,124354,125690,+,1336
19,WOLB.0323.00020,1,54581,55917,+,1336
19,WOLB.0323.00122,1,59313,60649,+,1336
19,WOLB.0323.00118,1,57805,59141,+,1336
19,WOLB.0323.00004,1,54274,55610,+,1336
19,WOLB.0323.00011,1,805407,806743,+,1336
19,WOLB.0323.00035,1,54581,55917,+,1336
19,WOLB.0323.00032,1,1023856,1025192,+,1336
19,WOLB.0323.00012,1,54568,55904,+,1336
19,WOLB.0323.00018,1,176415,177751,-,1336
19,WOLB.0323.00010,1,129771,131107,+,1336
19,WOLB.0323.00068,1,54372,55708,+,1336
19,WOLB.0323.00128,1,124980,126316,+,1336
19,WOLB.0323.00158,1,738066,739402,+,1336
19,WOLB.0323.00017,1,54298,55634,+,1336
19,WOLB.0323.00104,1,54581,55917,+,1336
19,WOLB.0323.00007,1,57536,58872,+,1336
19,WOLB.0323.00001,1,518873,520209,+,1336
19,WOLB.0323.00100,1,54581,55917,+,1336
19,WOLB.0323.00070,1,124327,125663,+,1336
19,WOLB.0323.00006,1,525964,527300,-,1336
19,WOLB.0323.00042,1,129755,131091,+,1336
19,WOLB.0323.00119,1,1183470,1184806,+,1336
19,WOLB.0323.00149,1,407630,408966,-,1336
19,WOLB.0323.00014,1,127044,128380,+,1336
19,WOLB.0323.00096,1,819141,820477,-,1336
20,WOLB.0323.00090,1,56382,57044,+,662
20,WOLB.0323.00002,1,127548,128214,+,666
20,WOLB.0323.00138,1,545663,546326,-,663
20,WOLB.0323.00132,1,1352029,1352695,+,666
20,WOLB.0323.00143,1,1217095,1217765,-,670
20,WOLB.0323.00106,1,1217098,1217768,-,670
20,WOLB.0323.00121,1,56201,56863,+,662
20,WOLB.0323.00135,1,304828,305491,-,663
20,WOLB.0323.00103,1,520766,521418,+,652
20,WOLB.0323.00107,1,520768,521420,+,652
20,WOLB.0323.00019,1,1183983,1184652,+,669
20,WOLB.0323.00060,1,1574085,1574747,+,662
20,WOLB.0323.00074,1,857802,858453,+,651
20,WOLB.0323.00120,1,843661,844312,+,651
20,WOLB.0323.00039,1,738149,738818,+,669
20,WOLB.0323.00041,1,780051,780703,-,652
20,WOLB.0323.00031,1,706038,706708,-,670
20,WOLB.0323.00056,1,59423,60085,+,662
20,WOLB.0323.00142,1,56176,56838,+,662
20,WOLB.0323.00023,1,740113,740780,-,667
20,WOLB.0323.00153,1,56382,57044,+,662
20,WOLB.0323.00093,1,263710,264377,-,667
20,WOLB.0323.00088,1,56483,57145,+,662
20,WOLB.0323.00008,1,74161,74811,+,650
20,WOLB.0323.00064,1,1189338,1190005,-,667
20,WOLB.0323.00030,1,1719705,1720371,+,666
20,WOLB.0323.00105,1,520775,521427,+,652
20,WOLB.0323.00133,1,772936,773606,-,670
20,WOLB.0323.00084,1,638921,639584,-,663
20,WOLB.0323.00021,1,56273,56935,+,662
20,WOLB.0323.00043,1,126256,126922,+,666
20,WOLB.0323.00020,1,56483,57145,+,662
20,WOLB.0323.00122,1,61215,61877,+,662
20,WOLB.0323.00118,1,59707,60369,+,662
20,WOLB.0323.00004,1,56176,56838,+,662
20,WOLB.0323.00011,1,807309,807971,+,662
20,WOLB.0323.00035,1,56483,57145,+,662
20,WOLB.0323.00032,1,1025758,1026420,+,662
20,WOLB.0323.00012,1,56470,57132,+,662
20,WOLB.0323.00018,1,175182,175849,-,667
20,WOLB.0323.00025,1,89125,89646,-,521
20,WOLB.0323.00010,1,131672,132338,+,666
20,WOLB.0323.00068,1,56274,56936,+,662
20,WOLB.0323.00128,1,126882,127548,+,666
20,WOLB.0323.00158,1,739968,740630,+,662
20,WOLB.0323.00017,1,56200,56862,+,662
20,WOLB.0323.00104,1,56483,57145,+,662
20,WOLB.0323.00007,1,59438,60100,+,662
20,WOLB.0323.00001,1,520775,521427,+,652
20,WOLB.0323.00100,1,56483,57145,+,662
20,WOLB.0323.00070,1,126229,126895,+,666
20,WOLB.0323.00006,1,524728,525398,-,670
20,WOLB.0323.00042,1,131657,132323,+,666
20,WOLB.0323.00119,1,1185372,1186041,+,669
20,WOLB.0323.00149,1,406401,407064,-,663
20,WOLB.0323.00014,1,128946,129612,+,666
20,WOLB.0323.00096,1,817923,818575,-,652
21,WOLB.0323.00090,1,57046,57970,+,924
21,WOLB.0323.00002,1,128216,129140,+,924
21,WOLB.0323.00138,1,544738,545662,-,924
21,WOLB.0323.00132,1,1352697,1353621,+,924
21,WOLB.0323.00143,1,1216172,1217094,-,922
21,WOLB.0323.00106,1,1216175,1217097,-,922
21,WOLB.0323.00121,1,56865,57789,+,924
21,WOLB.0323.00135,1,303903,304827,-,924
21,WOLB.0323.00103,1,521420,522344,+,924
21,WOLB.0323.00107,1,521422,522346,+,924
21,WOLB.0323.00019,1,1184654,1185578,+,924
21,WOLB.0323.00060,1,1574749,1575673,+,924
21,WOLB.0323.00074,1,858455,859379,+,924
21,WOLB.0323.00120,1,844314,845238,+,924
21,WOLB.0323.00039,1,738820,739744,+,924
21,WOLB.0323.00041,1,779126,780050,-,924
21,WOLB.0323.00031,1,705115,706037,-,922
21,WOLB.0323.00056,1,60087,61011,+,924
21,WOLB.0323.00142,1,56840,57764,+,924
21,WOLB.0323.00023,1,739188,740112,-,924
21,WOLB.0323.00153,1,57046,57970,+,924
21,WOLB.0323.00093,1,262783,263701,-,918
21,WOLB.0323.00088,1,57147,58071,+,924
21,WOLB.0323.00008,1,74820,75738,+,918
21,WOLB.0323.00024,1,116472,117396,+,924
21,WOLB.0323.00064,1,1188413,1189337,-,924
21,WOLB.0323.00030,1,1720373,1721297,+,924
21,WOLB.0323.00105,1,521429,522353,+,924
21,WOLB.0323.00133,1,772011,772935,-,924
21,WOLB.0323.00084,1,637996,638920,-,924
21,WOLB.0323.00021,1,56937,57861,+,924
21,WOLB.0323.00043,1,126924,127848,+,924
21,WOLB.0323.00020,1,57147,58071,+,924
21,WOLB.0323.00122,1,61879,62803,+,924
21,WOLB.0323.00118,1,60371,61295,+,924
21,WOLB.0323.00004,1,56840,57764,+,924
21,WOLB.0323.00011,1,807973,808897,+,924
21,WOLB.0323.00035,1,57147,58071,+,924
21,WOLB.0323.00032,1,1026422,1027346,+,924
21,WOLB.0323.00012,1,57134,58058,+,924
21,WOLB.0323.00018,1,174257,175181,-,924
21,WOLB.0323.00025,1,88202,89124,-,922
21,WOLB.0323.00010,1,132340,133264,+,924
21,WOLB.0323.00068,1,56938,57862,+,924
21,WOLB.0323.00128,1,127550,128474,+,924
21,WOLB.0323.00158,1,740632,741556,+,924
21,WOLB.0323.00017,1,56864,57788,+,924
21,WOLB.0323.00104,1,57147,58071,+,924
21,WOLB.0323.00007,1,60102,61026,+,924
21,WOLB.0323.00001,1,521429,522353,+,924
21,WOLB.0323.00100,1,57147,58071,+,924
21,WOLB.0323.00070,1,126897,127821,+,924
21,WOLB.0323.00006,1,523805,524727,-,922
21,WOLB.0323.00042,1,132325,133249,+,924
21,WOLB.0323.00119,1,1186043,1186967,+,924
21,WOLB.0323.00149,1,405476,406400,-,924
21,WOLB.0323.00014,1,129614,130538,+,924
21,WOLB.0323.00096,1,816998,817922,-,924
22,WOLB.0323.00090,1,58123,61780,+,3657
22,WOLB.0323.00002,1,129292,132949,+,3657
22,WOLB.0323.00138,1,540928,544585,-,3657
22,WOLB.0323.00132,1,1353773,1357430,+,3657
22,WOLB.0323.00143,1,1212360,1216017,-,3657
22,WOLB.0323.00106,1,1212363,1216020,-,3657
22,WOLB.0323.00121,1,57942,61599,+,3657
22,WOLB.0323.00135,1,300093,303750,-,3657
22,WOLB.0323.00103,1,522496,526153,+,3657
22,WOLB.0323.00107,1,522498,526155,+,3657
22,WOLB.0323.00019,1,1185730,1189387,+,3657
22,WOLB.0323.00060,1,1575826,1579483,+,3657
22,WOLB.0323.00074,1,859532,863202,+,3670
22,WOLB.0323.00120,1,845391,849061,+,3670
22,WOLB.0323.00039,1,739896,743553,+,3657
22,WOLB.0323.00041,1,775303,778973,-,3670
22,WOLB.0323.00031,1,701303,704960,-,3657
22,WOLB.0323.00056,1,61164,64821,+,3657
22,WOLB.0323.00142,1,57917,61574,+,3657
22,WOLB.0323.00023,1,735379,739036,-,3657
22,WOLB.0323.00153,1,58123,61780,+,3657
22,WOLB.0323.00093,1,258973,262631,-,3658
22,WOLB.0323.00088,1,58224,61881,+,3657
22,WOLB.0323.00008,1,82486,86128,+,3642
22,WOLB.0323.00024,1,117548,121205,+,3657
22,WOLB.0323.00064,1,1184626,1188261,-,3635
22,WOLB.0323.00030,1,1721449,1725084,+,3635
22,WOLB.0323.00105,1,522505,526162,+,3657
22,WOLB.0323.00133,1,768202,771858,-,3656
22,WOLB.0323.00084,1,634186,637843,-,3657
22,WOLB.0323.00021,1,58014,61671,+,3657
22,WOLB.0323.00043,1,128000,131657,+,3657
22,WOLB.0323.00020,1,58224,61881,+,3657
22,WOLB.0323.00122,1,62956,66613,+,3657
22,WOLB.0323.00118,1,61448,65105,+,3657
22,WOLB.0323.00004,1,57917,61574,+,3657
22,WOLB.0323.00011,1,809050,812707,+,3657
22,WOLB.0323.00035,1,58224,61881,+,3657
22,WOLB.0323.00032,1,1027499,1031156,+,3657
22,WOLB.0323.00012,1,58211,61868,+,3657
22,WOLB.0323.00018,1,170435,174105,-,3670
22,WOLB.0323.00025,1,84406,88047,-,3641
22,WOLB.0323.00010,1,133416,137073,+,3657
22,WOLB.0323.00068,1,58015,61672,+,3657
22,WOLB.0323.00128,1,128626,132283,+,3657
22,WOLB.0323.00158,1,741709,745366,+,3657
22,WOLB.0323.00017,1,57941,61598,+,3657
22,WOLB.0323.00104,1,58224,61881,+,3657
22,WOLB.0323.00007,1,61179,64836,+,3657
22,WOLB.0323.00001,1,522505,526162,+,3657
22,WOLB.0323.00100,1,58224,61881,+,3657
22,WOLB.0323.00070,1,127973,131630,+,3657
22,WOLB.0323.00006,1,519993,523650,-,3657
22,WOLB.0323.00042,1,133401,137058,+,3657
22,WOLB.0323.00119,1,1187119,1190776,+,3657
22,WOLB.0323.00149,1,401666,405323,-,3657
22,WOLB.0323.00014,1,130690,134347,+,3657
22,WOLB.0323.00096,1,813175,816845,-,3670
23,WOLB.0323.00090,1,61785,63193,+,1408
23,WOLB.0323.00002,1,134157,135565,+,1408
23,WOLB.0323.00138,1,539515,540923,-,1408
23,WOLB.0323.00132,1,1357435,1358843,+,1408
23,WOLB.0323.00143,1,1210947,1212355,-,1408
23,WOLB.0323.00106,1,1210950,1212358,-,1408
23,WOLB.0323.00121,1,61604,63012,+,1408
23,WOLB.0323.00135,1,298680,300088,-,1408
23,WOLB.0323.00103,1,526158,527557,+,1399
23,WOLB.0323.00107,1,526160,527559,+,1399
23,WOLB.0323.00019,1,1189392,1190795,+,1403
23,WOLB.0323.00060,1,1579488,1580896,+,1408
23,WOLB.0323.00074,1,863207,864615,+,1408
23,WOLB.0323.00120,1,849066,850474,+,1408
23,WOLB.0323.00039,1,743558,744961,+,1403
23,WOLB.0323.00041,1,773890,775298,-,1408
23,WOLB.0323.00031,1,699890,701298,-,1408
23,WOLB.0323.00056,1,64826,66234,+,1408
23,WOLB.0323.00142,1,61579,62987,+,1408
23,WOLB.0323.00023,1,733966,735374,-,1408
23,WOLB.0323.00153,1,61785,63193,+,1408
23,WOLB.0323.00093,1,257560,258968,-,1408
23,WOLB.0323.00088,1,61886,63294,+,1408
23,WOLB.0323.00008,1,86133,87540,+,1407
23,WOLB.0323.00024,1,121210,122618,+,1408
23,WOLB.0323.00064,1,1181339,1182747,-,1408
23,WOLB.0323.00030,1,1726965,1728373,+,1408
23,WOLB.0323.00105,1,526167,527566,+,1399
23,WOLB.0323.00133,1,766789,768197,-,1408
23,WOLB.0323.00084,1,632773,634181,-,1408
23,WOLB.0323.00021,1,61676,63084,+,1408
23,WOLB.0323.00043,1,131662,133070,+,1408
23,WOLB.0323.00020,1,61886,63294,+,1408
23,WOLB.0323.00122,1,66618,68026,+,1408
23,WOLB.0323.00118,1,65110,66554,+,1444
23,WOLB.0323.00004,1,61579,62987,+,1408
23,WOLB.0323.00011,1,812712,814120,+,1408
23,WOLB.0323.00035,1,61886,63294,+,1408
23,WOLB.0323.00032,1,1031161,1032569,+,1408
23,WOLB.0323.00012,1,61873,63281,+,1408
23,WOLB.0323.00018,1,169022,170430,-,1408
23,WOLB.0323.00025,1,841009,842329,-,1320
23,WOLB.0323.00010,1,137078,138486,+,1408
23,WOLB.0323.00068,1,61677,63085,+,1408
23,WOLB.0323.00128,1,132288,133607,+,1319
23,WOLB.0323.00158,1,745371,746779,+,1408
23,WOLB.0323.00017,1,61603,63011,+,1408
23,WOLB.0323.00104,1,61886,63294,+,1408
23,WOLB.0323.00007,1,64841,66249,+,1408
23,WOLB.0323.00001,1,526167,527566,+,1399
23,WOLB.0323.00100,1,61886,63294,+,1408
23,WOLB.0323.00070,1,131635,133043,+,1408
23,WOLB.0323.00006,1,518580,519988,-,1408
23,WOLB.0323.00042,1,137063,138471,+,1408
23,WOLB.0323.00119,1,1190781,1192184,+,1403
23,WOLB.0323.00149,1,400253,401661,-,1408
23,WOLB.0323.00014,1,134352,135760,+,1408
23,WOLB.0323.00096,1,811762,813170,-,1408
24,WOLB.0323.00090,1,63194,64529,+,1335
24,WOLB.0323.00002,1,135566,136901,+,1335
24,WOLB.0323.00138,1,538179,539513,-,1334
24,WOLB.0323.00132,1,1358844,1360179,+,1335
24,WOLB.0323.00143,1,1209615,1210945,-,1330
24,WOLB.0323.00106,1,1209618,1210948,-,1330
24,WOLB.0323.00121,1,63013,64348,+,1335
24,WOLB.0323.00135,1,297344,298678,-,1334
24,WOLB.0323.00103,1,106224,107572,+,1348
24,WOLB.0323.00107,1,106223,107571,+,1348
24,WOLB.0323.00019,1,1190796,1192130,+,1334
24,WOLB.0323.00060,1,1580897,1582232,+,1335
24,WOLB.0323.00074,1,864616,865951,+,1335
24,WOLB.0323.00120,1,850475,851810,+,1335
24,WOLB.0323.00039,1,744962,746296,+,1334
24,WOLB.0323.00041,1,772554,773888,-,1334
24,WOLB.0323.00031,1,698558,699888,-,1330
24,WOLB.0323.00056,1,66235,67570,+,1335
24,WOLB.0323.00142,1,62988,64323,+,1335
24,WOLB.0323.00023,1,732630,733964,-,1334
24,WOLB.0323.00153,1,63194,64529,+,1335
24,WOLB.0323.00093,1,256224,257558,-,1334
24,WOLB.0323.00088,1,63295,64630,+,1335
24,WOLB.0323.00008,1,87541,88876,+,1335
24,WOLB.0323.00024,1,122619,123954,+,1335
24,WOLB.0323.00064,1,1180003,1181337,-,1334
24,WOLB.0323.00030,1,1728374,1729708,+,1334
24,WOLB.0323.00105,1,106223,107571,+,1348
24,WOLB.0323.00133,1,765453,766787,-,1334
24,WOLB.0323.00084,1,631437,632771,-,1334
24,WOLB.0323.00021,1,63085,64420,+,1335
24,WOLB.0323.00043,1,133071,134406,+,1335
24,WOLB.0323.00020,1,63295,64630,+,1335
24,WOLB.0323.00122,1,68027,69362,+,1335
24,WOLB.0323.00118,1,66555,67890,+,1335
24,WOLB.0323.00004,1,62988,64323,+,1335
24,WOLB.0323.00011,1,814121,815456,+,1335
24,WOLB.0323.00035,1,63295,64630,+,1335
24,WOLB.0323.00032,1,1032570,1033905,+,1335
24,WOLB.0323.00012,1,63282,64617,+,1335
24,WOLB.0323.00018,1,167686,169020,-,1334
24,WOLB.0323.00025,1,839634,841007,-,1373
24,WOLB.0323.00010,1,138487,139822,+,1335
24,WOLB.0323.00068,1,63086,64421,+,1335
24,WOLB.0323.00128,1,133608,134943,+,1335
24,WOLB.0323.00158,1,746780,748115,+,1335
24,WOLB.0323.00017,1,63012,64347,+,1335
24,WOLB.0323.00104,1,63295,64630,+,1335
24,WOLB.0323.00007,1,66250,67585,+,1335
24,WOLB.0323.00001,1,106223,107571,+,1348
24,WOLB.0323.00100,1,63295,64630,+,1335
24,WOLB.0323.00070,1,133044,134379,+,1335
24,WOLB.0323.00006,1,517248,518578,-,1330
24,WOLB.0323.00042,1,138472,139807,+,1335
24,WOLB.0323.00119,1,1192185,1193519,+,1334
24,WOLB.0323.00149,1,398917,400251,-,1334
24,WOLB.0323.00014,1,135761,137096,+,1335
24,WOLB.0323.00096,1,810426,811760,-,1334
25,WOLB.0323.00090,1,65283,67383,+,2100
25,WOLB.0323.00002,1,137655,139755,+,2100
25,WOLB.0323.00138,1,535325,537425,-,2100
25,WOLB.0323.00132,1,1360956,1363033,+,2077
25,WOLB.0323.00143,1,1206758,1208835,-,2077
25,WOLB.0323.00106,1,1206761,1208838,-,2077
25,WOLB.0323.00121,1,65102,67202,+,2100
25,WOLB.0323.00135,1,294490,296590,-,2100
25,WOLB.0323.00103,1,108326,110426,+,2100
25,WOLB.0323.00107,1,108325,110425,+,2100
25,WOLB.0323.00019,1,1192884,1194984,+,2100
25,WOLB.0323.00060,1,1582986,1585086,+,2100
25,WOLB.0323.00074,1,866705,868805,+,2100
25,WOLB.0323.00120,1,852564,854664,+,2100
25,WOLB.0323.00039,1,747050,749150,+,2100
25,WOLB.0323.00041,1,769700,771800,-,2100
25,WOLB.0323.00031,1,695701,697778,-,2077
25,WOLB.0323.00056,1,69833,71933,+,2100
25,WOLB.0323.00142,1,65077,67177,+,2100
25,WOLB.0323.00023,1,729776,731876,-,2100
25,WOLB.0323.00153,1,65283,67383,+,2100
25,WOLB.0323.00093,1,253370,255470,-,2100
25,WOLB.0323.00088,1,65407,67484,+,2077
25,WOLB.0323.00008,1,90928,93028,+,2100
25,WOLB.0323.00024,1,124730,126807,+,2077
25,WOLB.0323.00064,1,1177149,1179226,-,2077
25,WOLB.0323.00030,1,1730485,1732562,+,2077
25,WOLB.0323.00105,1,108325,110425,+,2100
25,WOLB.0323.00133,1,762591,764695,-,2104
25,WOLB.0323.00084,1,628583,630683,-,2100
25,WOLB.0323.00021,1,65174,67274,+,2100
25,WOLB.0323.00043,1,135160,137260,+,2100
25,WOLB.0323.00020,1,65407,67484,+,2077
25,WOLB.0323.00122,1,70116,72216,+,2100
25,WOLB.0323.00118,1,68644,70744,+,2100
25,WOLB.0323.00004,1,65077,67177,+,2100
25,WOLB.0323.00011,1,816210,818310,+,2100
25,WOLB.0323.00035,1,65407,67484,+,2077
25,WOLB.0323.00032,1,1034659,1036759,+,2100
25,WOLB.0323.00012,1,65394,67471,+,2077
25,WOLB.0323.00018,1,164832,166932,-,2100
25,WOLB.0323.00025,1,859691,861768,-,2077
25,WOLB.0323.00010,1,140575,142675,+,2100
25,WOLB.0323.00068,1,65175,67275,+,2100
25,WOLB.0323.00128,1,135697,137797,+,2100
25,WOLB.0323.00158,1,748869,750969,+,2100
25,WOLB.0323.00017,1,65101,67201,+,2100
25,WOLB.0323.00104,1,65407,67484,+,2077
25,WOLB.0323.00007,1,1428120,1430220,-,2100
25,WOLB.0323.00001,1,108325,110425,+,2100
25,WOLB.0323.00100,1,65407,67484,+,2077
25,WOLB.0323.00070,1,135133,137233,+,2100
25,WOLB.0323.00006,1,514391,516468,-,2077
25,WOLB.0323.00042,1,140561,142661,+,2100
25,WOLB.0323.00119,1,1194273,1196373,+,2100
25,WOLB.0323.00149,1,396063,398163,-,2100
25,WOLB.0323.00014,1,137850,139950,+,2100
25,WOLB.0323.00096,1,807572,809672,-,2100
26,WOLB.0323.00090,1,67458,68772,+,1314
26,WOLB.0323.00002,1,139871,141185,+,1314
26,WOLB.0323.00138,1,533935,535250,-,1315
26,WOLB.0323.00132,1,1363164,1364463,+,1299
26,WOLB.0323.00143,1,1205360,1206676,-,1316
26,WOLB.0323.00106,1,1205363,1206679,-,1316
26,WOLB.0323.00121,1,67277,68591,+,1314
26,WOLB.0323.00135,1,293100,294415,-,1315
26,WOLB.0323.00103,1,110501,111815,+,1314
26,WOLB.0323.00107,1,110500,111814,+,1314
26,WOLB.0323.00019,1,1195115,1196414,+,1299
26,WOLB.0323.00060,1,1585217,1586516,+,1299
26,WOLB.0323.00074,1,868886,870201,+,1315
26,WOLB.0323.00120,1,854745,856060,+,1315
26,WOLB.0323.00039,1,749281,750580,+,1299
26,WOLB.0323.00041,1,768303,769619,-,1316
26,WOLB.0323.00031,1,694303,695619,-,1316
26,WOLB.0323.00056,1,72064,73363,+,1299
26,WOLB.0323.00142,1,67252,68566,+,1314
26,WOLB.0323.00023,1,728345,729660,-,1315
26,WOLB.0323.00153,1,67458,68772,+,1314
26,WOLB.0323.00093,1,251980,253295,-,1315
26,WOLB.0323.00088,1,67559,68873,+,1314
26,WOLB.0323.00008,1,94337,95542,+,1205
26,WOLB.0323.00024,1,126923,128237,+,1314
26,WOLB.0323.00064,1,1175718,1177033,-,1315
26,WOLB.0323.00030,1,1732678,1733992,+,1314
26,WOLB.0323.00105,1,110500,111814,+,1314
26,WOLB.0323.00133,1,761188,762509,-,1321
26,WOLB.0323.00084,1,627193,628508,-,1315
26,WOLB.0323.00021,1,67349,68663,+,1314
26,WOLB.0323.00043,1,137376,138690,+,1314
26,WOLB.0323.00020,1,67559,68873,+,1314
26,WOLB.0323.00122,1,72291,73605,+,1314
26,WOLB.0323.00118,1,70819,72133,+,1314
26,WOLB.0323.00004,1,67252,68566,+,1314
26,WOLB.0323.00011,1,818385,819699,+,1314
26,WOLB.0323.00035,1,67559,68873,+,1314
26,WOLB.0323.00032,1,1036834,1038148,+,1314
26,WOLB.0323.00012,1,67546,68860,+,1314
26,WOLB.0323.00018,1,163401,164716,-,1315
26,WOLB.0323.00025,1,743885,745108,-,1223
26,WOLB.0323.00010,1,142791,144105,+,1314
26,WOLB.0323.00068,1,67350,68664,+,1314
26,WOLB.0323.00128,1,137913,139227,+,1314
26,WOLB.0323.00158,1,751044,752358,+,1314
26,WOLB.0323.00017,1,67276,68590,+,1314
26,WOLB.0323.00104,1,67559,68873,+,1314
26,WOLB.0323.00007,1,1426689,1427989,-,1300
26,WOLB.0323.00001,1,110500,111814,+,1314
26,WOLB.0323.00100,1,67559,68873,+,1314
26,WOLB.0323.00070,1,137349,138663,+,1314
26,WOLB.0323.00006,1,512993,514309,-,1316
26,WOLB.0323.00042,1,142777,144091,+,1314
26,WOLB.0323.00119,1,1196504,1197803,+,1299
26,WOLB.0323.00149,1,394673,395988,-,1315
26,WOLB.0323.00014,1,140066,141380,+,1314
26,WOLB.0323.00096,1,806175,807491,-,1316
27,WOLB.0323.00090,1,71999,72604,+,605
27,WOLB.0323.00002,1,144388,144990,+,602
27,WOLB.0323.00138,1,530103,530708,-,605
27,WOLB.0323.00132,1,1367707,1368309,+,602
27,WOLB.0323.00143,1,69629,70234,+,605
27,WOLB.0323.00106,1,69630,70235,+,605
27,WOLB.0323.00121,1,71934,72539,+,605
27,WOLB.0323.00135,1,289265,289870,-,605
27,WOLB.0323.00103,1,113109,113714,+,605
27,WOLB.0323.00107,1,113108,113713,+,605
27,WOLB.0323.00019,1,1214407,1215012,-,605
27,WOLB.0323.00060,1,1589744,1590300,+,556
27,WOLB.0323.00039,1,753813,754418,+,605
27,WOLB.0323.00031,1,832099,832704,+,605
27,WOLB.0323.00056,1,76591,77196,+,605
27,WOLB.0323.00142,1,71909,72514,+,605
27,WOLB.0323.00023,1,724529,725131,-,602
27,WOLB.0323.00153,1,71999,72604,+,605
27,WOLB.0323.00088,1,72101,72706,+,605
27,WOLB.0323.00024,1,132938,133543,+,605
27,WOLB.0323.00064,1,1171756,1172358,-,602
27,WOLB.0323.00030,1,1737353,1737955,+,602
27,WOLB.0323.00105,1,113108,113713,+,605
27,WOLB.0323.00084,1,623361,623966,-,605
27,WOLB.0323.00021,1,71891,72496,+,605
27,WOLB.0323.00043,1,141898,142500,+,602
27,WOLB.0323.00020,1,72101,72706,+,605
27,WOLB.0323.00122,1,76833,77435,+,602
27,WOLB.0323.00118,1,75377,75979,+,602
27,WOLB.0323.00004,1,73873,74478,+,605
27,WOLB.0323.00011,1,823042,823647,+,605
27,WOLB.0323.00035,1,72101,72706,+,605
27,WOLB.0323.00032,1,1041377,1041982,+,605
27,WOLB.0323.00012,1,72088,72693,+,605
27,WOLB.0323.00018,1,159566,160171,-,605
27,WOLB.0323.00025,1,739957,740559,-,602
27,WOLB.0323.00010,1,147314,147916,+,602
27,WOLB.0323.00068,1,71892,72497,+,605
27,WOLB.0323.00128,1,142273,142875,+,602
27,WOLB.0323.00158,1,755701,756306,+,605
27,WOLB.0323.00017,1,71933,72538,+,605
27,WOLB.0323.00104,1,72101,72706,+,605
27,WOLB.0323.00007,1,1420480,1421054,-,574
27,WOLB.0323.00001,1,113108,113713,+,605
27,WOLB.0323.00100,1,72101,72706,+,605
27,WOLB.0323.00070,1,141866,142468,+,602
27,WOLB.0323.00006,1,506737,507342,-,605
27,WOLB.0323.00042,1,147349,147954,+,605
27,WOLB.0323.00119,1,1287536,1288141,-,605
27,WOLB.0323.00149,1,390726,391331,-,605
27,WOLB.0323.00014,1,144583,145185,+,602
28,WOLB.0323.00090,1,74049,75973,+,1924
28,WOLB.0323.00002,1,146435,148359,+,1924
28,WOLB.0323.00138,1,526734,528658,-,1924
28,WOLB.0323.00132,1,1369754,1371678,+,1924
28,WOLB.0323.00143,1,71671,73595,+,1924
28,WOLB.0323.00106,1,71672,73596,+,1924
28,WOLB.0323.00121,1,73984,75908,+,1924
28,WOLB.0323.00135,1,285896,287820,-,1924
28,WOLB.0323.00103,1,115102,117026,+,1924
28,WOLB.0323.00107,1,115101,117025,+,1924
28,WOLB.0323.00019,1,53306,55230,-,1924
28,WOLB.0323.00060,1,1593444,1595368,+,1924
28,WOLB.0323.00074,1,872780,874704,+,1924
28,WOLB.0323.00120,1,858639,860563,+,1924
28,WOLB.0323.00039,1,755788,757712,+,1924
28,WOLB.0323.00041,1,763801,765725,-,1924
28,WOLB.0323.00031,1,834141,836065,+,1924
28,WOLB.0323.00056,1,78639,80563,+,1924
28,WOLB.0323.00142,1,73959,75883,+,1924
28,WOLB.0323.00023,1,721169,723093,-,1924
28,WOLB.0323.00153,1,74049,75973,+,1924
28,WOLB.0323.00093,1,247218,249118,-,1900
28,WOLB.0323.00088,1,74151,76075,+,1924
28,WOLB.0323.00008,1,1252884,1254808,-,1924
28,WOLB.0323.00024,1,134978,136902,+,1924
28,WOLB.0323.00064,1,1168387,1170311,-,1924
28,WOLB.0323.00030,1,1739400,1741324,+,1924
28,WOLB.0323.00105,1,115101,117025,+,1924
28,WOLB.0323.00133,1,754640,756564,-,1924
28,WOLB.0323.00084,1,619992,621916,-,1924
28,WOLB.0323.00021,1,73941,75865,+,1924
28,WOLB.0323.00043,1,143942,145866,+,1924
28,WOLB.0323.00020,1,74151,76075,+,1924
28,WOLB.0323.00122,1,78880,80804,+,1924
28,WOLB.0323.00118,1,77424,79348,+,1924
28,WOLB.0323.00004,1,75923,77847,+,1924
28,WOLB.0323.00011,1,825092,827016,+,1924
28,WOLB.0323.00035,1,74151,76075,+,1924
28,WOLB.0323.00032,1,1043427,1045351,+,1924
28,WOLB.0323.00012,1,74138,76062,+,1924
28,WOLB.0323.00018,1,156197,158121,-,1924
28,WOLB.0323.00025,1,736622,738527,-,1905
28,WOLB.0323.00010,1,149362,151286,+,1924
28,WOLB.0323.00068,1,73942,75866,+,1924
28,WOLB.0323.00128,1,144320,146244,+,1924
28,WOLB.0323.00158,1,757751,759675,+,1924
28,WOLB.0323.00017,1,73983,75907,+,1924
28,WOLB.0323.00104,1,74151,76075,+,1924
28,WOLB.0323.00007,1,1417113,1419037,-,1924
28,WOLB.0323.00001,1,115101,117025,+,1924
28,WOLB.0323.00100,1,74151,76075,+,1924
28,WOLB.0323.00070,1,143913,145837,+,1924
28,WOLB.0323.00006,1,503376,505300,-,1924
28,WOLB.0323.00042,1,149396,151320,+,1924
28,WOLB.0323.00119,1,53191,55115,-,1924
28,WOLB.0323.00149,1,387357,389281,-,1924
28,WOLB.0323.00014,1,146630,148554,+,1924
28,WOLB.0323.00096,1,801673,803597,-,1924
29,WOLB.0323.00090,1,76057,77124,+,1067
29,WOLB.0323.00002,1,148454,149484,+,1030
29,WOLB.0323.00138,1,525601,526653,-,1052
29,WOLB.0323.00132,1,1371762,1372829,+,1067
29,WOLB.0323.00143,1,73676,74728,+,1052
29,WOLB.0323.00106,1,73677,74729,+,1052
29,WOLB.0323.00121,1,75989,77059,+,1070
29,WOLB.0323.00135,1,284745,285812,-,1067
29,WOLB.0323.00103,1,117121,118160,+,1039
29,WOLB.0323.00107,1,117120,118159,+,1039
29,WOLB.0323.00019,1,52181,53211,-,1030
29,WOLB.0323.00060,1,1595449,1596493,+,1044
29,WOLB.0323.00074,1,874808,875844,+,1036
29,WOLB.0323.00120,1,860667,861703,+,1036
29,WOLB.0323.00039,1,757807,758837,+,1030
29,WOLB.0323.00041,1,762661,763697,-,1036
29,WOLB.0323.00031,1,836146,837198,+,1052
29,WOLB.0323.00056,1,80644,81696,+,1052
29,WOLB.0323.00142,1,75964,77034,+,1070
29,WOLB.0323.00023,1,720018,721085,-,1067
29,WOLB.0323.00153,1,76057,77124,+,1067
29,WOLB.0323.00093,1,246085,247137,-,1052
29,WOLB.0323.00088,1,76159,77226,+,1067
29,WOLB.0323.00008,1,1251751,1252803,-,1052
29,WOLB.0323.00024,1,136986,138053,+,1067
29,WOLB.0323.00064,1,1167236,1168303,-,1067
29,WOLB.0323.00030,1,1741408,1742475,+,1067
29,WOLB.0323.00105,1,117120,118159,+,1039
29,WOLB.0323.00133,1,753528,754558,-,1030
29,WOLB.0323.00084,1,618859,619911,-,1052
29,WOLB.0323.00021,1,75946,76998,+,1052
29,WOLB.0323.00043,1,145961,146991,+,1030
29,WOLB.0323.00020,1,76159,77226,+,1067
29,WOLB.0323.00122,1,80888,81955,+,1067
29,WOLB.0323.00118,1,79432,80499,+,1067
29,WOLB.0323.00004,1,77928,78998,+,1070
29,WOLB.0323.00011,1,827097,828167,+,1070
29,WOLB.0323.00035,1,76159,77226,+,1067
29,WOLB.0323.00032,1,1045432,1046484,+,1052
29,WOLB.0323.00012,1,76146,77213,+,1067
29,WOLB.0323.00018,1,155046,156113,-,1067
29,WOLB.0323.00025,1,858230,859282,-,1052
29,WOLB.0323.00010,1,151381,152411,+,1030
29,WOLB.0323.00068,1,75947,76999,+,1052
29,WOLB.0323.00128,1,146339,147369,+,1030
29,WOLB.0323.00158,1,759756,760826,+,1070
29,WOLB.0323.00017,1,75988,77058,+,1070
29,WOLB.0323.00104,1,76159,77226,+,1067
29,WOLB.0323.00007,1,1415980,1417032,-,1052
29,WOLB.0323.00001,1,117120,118159,+,1039
29,WOLB.0323.00100,1,76159,77226,+,1067
29,WOLB.0323.00070,1,145932,146962,+,1030
29,WOLB.0323.00006,1,502243,503295,-,1052
29,WOLB.0323.00042,1,151415,152460,+,1045
29,WOLB.0323.00119,1,52066,53096,-,1030
29,WOLB.0323.00149,1,386206,387276,-,1070
29,WOLB.0323.00014,1,148649,149679,+,1030
29,WOLB.0323.00096,1,800533,801569,-,1036
60,WOLB.0323.00090,1,162940,164382,+,1442
60,WOLB.0323.00002,1,166753,168196,-,1443
60,WOLB.0323.00138,1,444613,446055,-,1442
60,WOLB.0323.00132,1,1251166,1252608,+,1442
60,WOLB.0323.00143,1,1146820,1148259,+,1439
60,WOLB.0323.00106,1,1146823,1148262,+,1439
60,WOLB.0323.00121,1,157808,159250,+,1442
60,WOLB.0323.00135,1,22540,23982,+,1442
60,WOLB.0323.00103,1,183128,184570,+,1442
60,WOLB.0323.00107,1,183127,184569,+,1442
60,WOLB.0323.00019,1,930330,931772,-,1442
60,WOLB.0323.00060,1,23153,24595,+,1442
60,WOLB.0323.00074,1,806250,807691,+,1441
60,WOLB.0323.00120,1,792211,793652,+,1441
60,WOLB.0323.00039,1,653953,655395,+,1442
60,WOLB.0323.00041,1,829843,831284,-,1441
60,WOLB.0323.00031,1,912578,914017,-,1439
60,WOLB.0323.00056,1,347220,348662,+,1442
60,WOLB.0323.00142,1,157365,158807,+,1442
60,WOLB.0323.00023,1,613460,614903,+,1443
60,WOLB.0323.00153,1,164591,166033,+,1442
60,WOLB.0323.00093,1,302468,303910,-,1442
60,WOLB.0323.00088,1,410412,411854,-,1442
60,WOLB.0323.00008,1,1346946,1348388,-,1442
60,WOLB.0323.00024,1,669302,670744,+,1442
60,WOLB.0323.00064,1,1300928,1302370,-,1442
60,WOLB.0323.00030,1,1605446,1606888,+,1442
60,WOLB.0323.00105,1,183127,184569,+,1442
60,WOLB.0323.00133,1,677902,679344,+,1442
60,WOLB.0323.00084,1,538969,540411,-,1442
60,WOLB.0323.00021,1,157430,158872,+,1442
60,WOLB.0323.00043,1,164260,165703,-,1443
60,WOLB.0323.00020,1,380190,381632,-,1442
60,WOLB.0323.00122,1,165206,166648,+,1442
60,WOLB.0323.00118,1,173029,174471,+,1442
60,WOLB.0323.00004,1,158238,159680,+,1442
60,WOLB.0323.00011,1,909392,910834,+,1442
60,WOLB.0323.00035,1,335903,337345,-,1442
60,WOLB.0323.00032,1,952615,954057,-,1442
60,WOLB.0323.00012,1,411564,413006,-,1442
60,WOLB.0323.00018,1,201292,202735,-,1443
60,WOLB.0323.00025,1,832046,833485,+,1439
60,WOLB.0323.00010,1,169622,171065,-,1443
60,WOLB.0323.00068,1,155447,156889,+,1442
60,WOLB.0323.00128,1,164638,166081,-,1443
60,WOLB.0323.00158,1,840066,841508,+,1442
60,WOLB.0323.00017,1,158284,159726,+,1442
60,WOLB.0323.00104,1,338303,339745,-,1442
60,WOLB.0323.00007,1,1155672,1157114,-,1442
60,WOLB.0323.00001,1,183127,184569,+,1442
60,WOLB.0323.00100,1,487157,488599,-,1442
60,WOLB.0323.00070,1,164232,165675,-,1443
60,WOLB.0323.00006,1,425406,426845,+,1439
60,WOLB.0323.00042,1,171559,173001,-,1442
60,WOLB.0323.00119,1,932984,934426,-,1442
60,WOLB.0323.00149,1,305524,306966,-,1442
60,WOLB.0323.00014,1,166948,168391,-,1443
60,WOLB.0323.00096,1,867715,869156,-,1441
61,WOLB.0323.00090,1,164836,171446,+,6610
61,WOLB.0323.00002,1,171534,178095,+,6561
61,WOLB.0323.00138,1,437554,444164,-,6610
61,WOLB.0323.00132,1,1241186,1247901,-,6715
61,WOLB.0323.00143,1,1136860,1143467,-,6607
61,WOLB.0323.00106,1,1136863,1143470,-,6607
61,WOLB.0323.00121,1,159699,166309,+,6610
61,WOLB.0323.00135,1,159651,166261,+,6610
61,WOLB.0323.00103,1,170695,177257,-,6562
61,WOLB.0323.00107,1,170694,177256,-,6562
61,WOLB.0323.00019,1,935035,941759,+,6724
61,WOLB.0323.00060,1,1457858,1464468,+,6610
61,WOLB.0323.00074,1,796434,802987,-,6553
61,WOLB.0323.00120,1,782395,788948,-,6553
61,WOLB.0323.00039,1,643962,650686,-,6724
61,WOLB.0323.00041,1,834547,841100,+,6553
61,WOLB.0323.00031,1,917370,923977,+,6607
61,WOLB.0323.00056,1,199588,206198,-,6610
61,WOLB.0323.00142,1,159256,165865,+,6609
61,WOLB.0323.00023,1,1056094,1062809,+,6715
61,WOLB.0323.00153,1,166487,173097,+,6610
61,WOLB.0323.00093,1,307997,314553,+,6556
61,WOLB.0323.00088,1,193157,199767,-,6610
61,WOLB.0323.00008,1,1351651,1358213,+,6562
61,WOLB.0323.00024,1,1889166,1895889,-,6723
61,WOLB.0323.00064,1,1305635,1312350,+,6715
61,WOLB.0323.00030,1,1595466,1602181,-,6715
61,WOLB.0323.00105,1,170694,177256,-,6562
61,WOLB.0323.00133,1,668020,674638,-,6618
61,WOLB.0323.00084,1,531910,538520,-,6610
61,WOLB.0323.00021,1,159321,165931,+,6610
61,WOLB.0323.00043,1,169041,175602,+,6561
61,WOLB.0323.00020,1,195500,202110,-,6610
61,WOLB.0323.00122,1,167102,173712,+,6610
61,WOLB.0323.00118,1,92376,98986,-,6610
61,WOLB.0323.00004,1,160129,166739,+,6610
61,WOLB.0323.00011,1,911283,917893,+,6610
61,WOLB.0323.00035,1,193056,199666,-,6610
61,WOLB.0323.00032,1,945556,952166,-,6610
61,WOLB.0323.00012,1,193142,199752,-,6610
61,WOLB.0323.00018,1,205990,212705,+,6715
61,WOLB.0323.00025,1,805716,812355,-,6639
61,WOLB.0323.00010,1,174401,180971,+,6570
61,WOLB.0323.00068,1,157338,163948,+,6610
61,WOLB.0323.00128,1,169419,175980,+,6561
61,WOLB.0323.00158,1,841957,848567,+,6610
61,WOLB.0323.00017,1,160175,166785,+,6610
61,WOLB.0323.00104,1,195456,202066,-,6610
61,WOLB.0323.00007,1,1295284,1301894,+,6610
61,WOLB.0323.00001,1,170694,177256,-,6562
61,WOLB.0323.00100,1,193156,199766,-,6610
61,WOLB.0323.00070,1,169013,175574,+,6561
61,WOLB.0323.00006,1,415446,422053,-,6607
61,WOLB.0323.00042,1,176256,182817,+,6561
61,WOLB.0323.00119,1,937689,944413,+,6724
61,WOLB.0323.00149,1,298465,305075,-,6610
61,WOLB.0323.00014,1,171729,178290,+,6561
61,WOLB.0323.00096,1,872419,878972,+,6553
62,WOLB.0323.00090,1,174778,176303,+,1525
62,WOLB.0323.00002,1,179373,180900,+,1527
62,WOLB.0323.00138,1,432581,434161,-,1580
62,WOLB.0323.00132,1,1238181,1239769,-,1588
62,WOLB.0323.00143,1,1134182,1135713,-,1531
62,WOLB.0323.00106,1,1134185,1135716,-,1531
62,WOLB.0323.00121,1,168466,169991,+,1525
62,WOLB.0323.00135,1,155428,157008,-,1580
62,WOLB.0323.00103,1,167888,169415,-,1527
62,WOLB.0323.00107,1,167887,169414,-,1527
62,WOLB.0323.00019,1,943276,944803,+,1527
62,WOLB.0323.00060,1,1451678,1453258,-,1580
62,WOLB.0323.00074,1,794215,795733,-,1518
62,WOLB.0323.00120,1,780176,781694,-,1518
62,WOLB.0323.00039,1,640918,642445,-,1527
62,WOLB.0323.00041,1,841801,843319,+,1518
62,WOLB.0323.00031,1,925124,926655,+,1531
62,WOLB.0323.00056,1,209146,210726,+,1580
62,WOLB.0323.00142,1,168022,169547,+,1525
62,WOLB.0323.00023,1,1064159,1065747,+,1588
62,WOLB.0323.00153,1,176429,177954,+,1525
62,WOLB.0323.00093,1,315248,317021,+,1773
62,WOLB.0323.00088,1,202558,204340,+,1782
62,WOLB.0323.00008,1,1393825,1395596,-,1771
62,WOLB.0323.00024,1,1886058,1887589,-,1531
62,WOLB.0323.00064,1,1313950,1315475,+,1525
62,WOLB.0323.00030,1,1592388,1593913,-,1525
62,WOLB.0323.00105,1,167887,169414,-,1527
62,WOLB.0323.00133,1,665829,667347,-,1518
62,WOLB.0323.00084,1,528035,529615,-,1580
62,WOLB.0323.00021,1,169324,170904,+,1580
62,WOLB.0323.00043,1,176880,178407,+,1527
62,WOLB.0323.00020,1,204901,206683,+,1782
62,WOLB.0323.00122,1,175872,177397,+,1525
62,WOLB.0323.00118,1,177193,178709,+,1516
62,WOLB.0323.00004,1,168896,170421,+,1525
62,WOLB.0323.00011,1,920050,921575,+,1525
62,WOLB.0323.00035,1,202457,204239,+,1782
62,WOLB.0323.00032,1,940583,942163,-,1580
62,WOLB.0323.00012,1,202543,204325,+,1782
62,WOLB.0323.00018,1,213883,215471,+,1588
62,WOLB.0323.00025,1,276458,277983,-,1525
62,WOLB.0323.00010,1,182738,184274,+,1536
62,WOLB.0323.00068,1,267345,268925,-,1580
62,WOLB.0323.00128,1,177258,178785,+,1527
62,WOLB.0323.00158,1,850724,852249,+,1525
62,WOLB.0323.00017,1,168942,170467,+,1525
62,WOLB.0323.00104,1,204857,206639,+,1782
62,WOLB.0323.00007,1,1290756,1292336,-,1580
62,WOLB.0323.00001,1,167887,169414,-,1527
62,WOLB.0323.00100,1,202557,204339,+,1782
62,WOLB.0323.00070,1,176852,178379,+,1527
62,WOLB.0323.00006,1,412678,414209,-,1531
62,WOLB.0323.00042,1,184437,186025,+,1588
62,WOLB.0323.00119,1,945930,947457,+,1527
62,WOLB.0323.00149,1,294783,296308,-,1525
62,WOLB.0323.00014,1,179568,181095,+,1527
62,WOLB.0323.00096,1,879673,881191,+,1518
63,WOLB.0323.00090,1,178733,186894,+,8161
63,WOLB.0323.00002,1,184157,192407,+,8250
63,WOLB.0323.00138,1,420892,429053,-,8161
63,WOLB.0323.00132,1,1227833,1236028,-,8195
63,WOLB.0323.00143,1,1122625,1130720,-,8095
63,WOLB.0323.00106,1,1122628,1130723,-,8095
63,WOLB.0323.00121,1,172421,180582,+,8161
63,WOLB.0323.00135,1,143968,152136,-,8168
63,WOLB.0323.00103,1,296551,304684,+,8133
63,WOLB.0323.00107,1,296550,304683,+,8133
63,WOLB.0323.00019,1,949774,957959,+,8185
63,WOLB.0323.00060,1,1440063,1448224,-,8161
63,WOLB.0323.00074,1,779173,787417,-,8244
63,WOLB.0323.00120,1,765134,773378,-,8244
63,WOLB.0323.00039,1,628030,635946,-,7916
63,WOLB.0323.00041,1,850117,858361,+,8244
63,WOLB.0323.00031,1,930117,938212,+,8095
63,WOLB.0323.00056,1,214180,222341,+,8161
63,WOLB.0323.00142,1,173080,181241,+,8161
63,WOLB.0323.00023,1,1067905,1076142,+,8237
63,WOLB.0323.00153,1,180384,188545,+,8161
63,WOLB.0323.00093,1,322364,330609,+,8245
63,WOLB.0323.00088,1,206768,214942,+,8174
63,WOLB.0323.00008,1,129779,138017,+,8238
63,WOLB.0323.00024,1,1871560,1879774,-,8214
63,WOLB.0323.00064,1,1319457,1327694,+,8237
63,WOLB.0323.00030,1,1580189,1588405,-,8216
63,WOLB.0323.00105,1,296552,304685,+,8133
63,WOLB.0323.00133,1,654850,663018,-,8168
63,WOLB.0323.00084,1,517444,525605,-,8161
63,WOLB.0323.00021,1,174432,182593,+,8161
63,WOLB.0323.00043,1,181664,189918,+,8254
63,WOLB.0323.00020,1,209111,217285,+,8174
63,WOLB.0323.00122,1,179827,187988,+,8161
63,WOLB.0323.00118,1,184871,193054,+,8183
63,WOLB.0323.00004,1,172851,181012,+,8161
63,WOLB.0323.00011,1,924005,932166,+,8161
63,WOLB.0323.00035,1,206667,214841,+,8174
63,WOLB.0323.00032,1,928894,937055,-,8161
63,WOLB.0323.00012,1,206753,214927,+,8174
63,WOLB.0323.00018,1,217611,225803,+,8192
63,WOLB.0323.00025,1,753434,761532,-,8098
63,WOLB.0323.00010,1,187529,195758,+,8229
63,WOLB.0323.00068,1,255656,263817,-,8161
63,WOLB.0323.00128,1,182042,190292,+,8250
63,WOLB.0323.00158,1,854679,862840,+,8161
63,WOLB.0323.00017,1,172897,181058,+,8161
63,WOLB.0323.00104,1,209067,217241,+,8174
63,WOLB.0323.00007,1,1279141,1287302,-,8161
63,WOLB.0323.00001,1,296552,304685,+,8133
63,WOLB.0323.00100,1,206767,214941,+,8174
63,WOLB.0323.00070,1,181636,189907,+,8271
63,WOLB.0323.00006,1,401111,409210,-,8099
63,WOLB.0323.00042,1,191083,199246,+,8163
63,WOLB.0323.00119,1,952428,960613,+,8185
63,WOLB.0323.00149,1,284192,292353,-,8161
63,WOLB.0323.00014,1,184352,192581,+,8229
63,WOLB.0323.00096,1,887989,896233,+,8244
64,WOLB.0323.00090,1,186909,188336,+,1427
64,WOLB.0323.00002,1,192422,193849,+,1427
64,WOLB.0323.00138,1,419450,420877,-,1427
64,WOLB.0323.00132,1,1226391,1227818,-,1427
64,WOLB.0323.00143,1,1121199,1122610,-,1411
64,WOLB.0323.00106,1,1121202,1122613,-,1411
64,WOLB.0323.00121,1,180597,182024,+,1427
64,WOLB.0323.00135,1,142526,143953,-,1427
64,WOLB.0323.00103,1,304718,306052,+,1334
64,WOLB.0323.00107,1,304717,306051,+,1334
64,WOLB.0323.00019,1,957974,959401,+,1427
64,WOLB.0323.00060,1,1438621,1440048,-,1427
64,WOLB.0323.00074,1,777731,779158,-,1427
64,WOLB.0323.00120,1,763692,765119,-,1427
64,WOLB.0323.00039,1,626581,628008,-,1427
64,WOLB.0323.00041,1,858376,859803,+,1427
64,WOLB.0323.00031,1,938227,939638,+,1411
64,WOLB.0323.00056,1,222356,223783,+,1427
64,WOLB.0323.00142,1,181256,182683,+,1427
64,WOLB.0323.00023,1,1076157,1077584,+,1427
64,WOLB.0323.00153,1,188560,189987,+,1427
64,WOLB.0323.00093,1,330624,332051,+,1427
64,WOLB.0323.00088,1,214957,216384,+,1427
64,WOLB.0323.00008,1,138032,139459,+,1427
64,WOLB.0323.00024,1,1870110,1871537,-,1427
64,WOLB.0323.00064,1,1327709,1329136,+,1427
64,WOLB.0323.00030,1,1578747,1580174,-,1427
64,WOLB.0323.00105,1,304719,306053,+,1334
64,WOLB.0323.00133,1,653400,654827,-,1427
64,WOLB.0323.00084,1,516003,517429,-,1426
64,WOLB.0323.00021,1,182608,184035,+,1427
64,WOLB.0323.00043,1,189933,191360,+,1427
64,WOLB.0323.00020,1,217300,218727,+,1427
64,WOLB.0323.00122,1,188003,189430,+,1427
64,WOLB.0323.00118,1,193069,194496,+,1427
64,WOLB.0323.00004,1,181027,182454,+,1427
64,WOLB.0323.00011,1,932181,933608,+,1427
64,WOLB.0323.00035,1,214856,216283,+,1427
64,WOLB.0323.00032,1,927452,928879,-,1427
64,WOLB.0323.00012,1,214942,216369,+,1427
64,WOLB.0323.00018,1,225818,227245,+,1427
64,WOLB.0323.00025,1,752001,753419,-,1418
64,WOLB.0323.00010,1,195773,197200,+,1427
64,WOLB.0323.00068,1,254214,255641,-,1427
64,WOLB.0323.00128,1,191417,192832,+,1415
64,WOLB.0323.00158,1,862855,864282,+,1427
64,WOLB.0323.00017,1,181073,182500,+,1427
64,WOLB.0323.00104,1,217256,218683,+,1427
64,WOLB.0323.00007,1,1277699,1279126,-,1427
64,WOLB.0323.00001,1,304719,306053,+,1334
64,WOLB.0323.00100,1,214956,216383,+,1427
64,WOLB.0323.00070,1,189922,191349,+,1427
64,WOLB.0323.00006,1,399685,401096,-,1411
64,WOLB.0323.00042,1,199261,200688,+,1427
64,WOLB.0323.00119,1,960628,962055,+,1427
64,WOLB.0323.00149,1,282750,284177,-,1427
64,WOLB.0323.00014,1,192596,194023,+,1427
64,WOLB.0323.00096,1,896248,897675,+,1427
65,WOLB.0323.00090,1,188429,190036,+,1607
65,WOLB.0323.00002,1,193942,195549,+,1607
65,WOLB.0323.00138,1,417749,419357,-,1608
65,WOLB.0323.00132,1,1224691,1226298,-,1607
65,WOLB.0323.00143,1,1119497,1121106,-,1609
65,WOLB.0323.00106,1,1119500,1121109,-,1609
65,WOLB.0323.00121,1,182117,183724,+,1607
65,WOLB.0323.00135,1,140825,142433,-,1608
65,WOLB.0323.00103,1,306137,307744,+,1607
65,WOLB.0323.00107,1,306136,307743,+,1607
65,WOLB.0323.00019,1,961110,962700,+,1590
65,WOLB.0323.00060,1,1436921,1438528,-,1607
65,WOLB.0323.00074,1,776038,777646,-,1608
65,WOLB.0323.00120,1,761999,763607,-,1608
65,WOLB.0323.00039,1,623282,624872,-,1590
65,WOLB.0323.00041,1,859888,861496,+,1608
65,WOLB.0323.00031,1,939731,941340,+,1609
65,WOLB.0323.00056,1,223876,225483,+,1607
65,WOLB.0323.00142,1,182776,184383,+,1607
65,WOLB.0323.00023,1,1077677,1079285,+,1608
65,WOLB.0323.00153,1,190080,191687,+,1607
65,WOLB.0323.00093,1,332144,333754,+,1610
65,WOLB.0323.00088,1,216477,218084,+,1607
65,WOLB.0323.00008,1,139552,141159,+,1607
65,WOLB.0323.00024,1,1867026,1868634,-,1608
65,WOLB.0323.00064,1,1329229,1330836,+,1607
65,WOLB.0323.00030,1,1577047,1578654,-,1607
65,WOLB.0323.00105,1,306138,307745,+,1607
65,WOLB.0323.00133,1,651704,653307,-,1603
65,WOLB.0323.00084,1,514302,515910,-,1608
65,WOLB.0323.00021,1,184128,185736,+,1608
65,WOLB.0323.00043,1,191453,193060,+,1607
65,WOLB.0323.00020,1,218820,220427,+,1607
65,WOLB.0323.00122,1,189523,191131,+,1608
65,WOLB.0323.00118,1,194589,196197,+,1608
65,WOLB.0323.00004,1,182547,184154,+,1607
65,WOLB.0323.00011,1,933701,935308,+,1607
65,WOLB.0323.00035,1,216376,217983,+,1607
65,WOLB.0323.00032,1,925751,927359,-,1608
65,WOLB.0323.00012,1,216462,218069,+,1607
65,WOLB.0323.00018,1,228813,230421,+,1608
65,WOLB.0323.00025,1,750328,751908,-,1580
65,WOLB.0323.00010,1,197293,198900,+,1607
65,WOLB.0323.00068,1,252513,254121,-,1608
65,WOLB.0323.00128,1,192925,194532,+,1607
65,WOLB.0323.00158,1,864375,865982,+,1607
65,WOLB.0323.00017,1,182593,184200,+,1607
65,WOLB.0323.00104,1,218776,220383,+,1607
65,WOLB.0323.00007,1,1275999,1277606,-,1607
65,WOLB.0323.00001,1,306138,307745,+,1607
65,WOLB.0323.00100,1,216476,218083,+,1607
65,WOLB.0323.00070,1,191442,193049,+,1607
65,WOLB.0323.00006,1,397983,399592,-,1609
65,WOLB.0323.00042,1,200781,202388,+,1607
65,WOLB.0323.00119,1,963764,965354,+,1590
65,WOLB.0323.00149,1,281050,282657,-,1607
65,WOLB.0323.00014,1,194116,195723,+,1607
65,WOLB.0323.00096,1,897760,899368,+,1608
66,WOLB.0323.00090,1,191301,193413,+,2112
66,WOLB.0323.00002,1,196823,198920,+,2097
66,WOLB.0323.00138,1,414388,416485,-,2097
66,WOLB.0323.00132,1,1221371,1223462,-,2091
66,WOLB.0323.00143,1,1116195,1118244,-,2049
66,WOLB.0323.00106,1,1116198,1118247,-,2049
66,WOLB.0323.00121,1,184989,187089,+,2100
66,WOLB.0323.00135,1,137470,139547,-,2077
66,WOLB.0323.00103,1,310453,312501,+,2048
66,WOLB.0323.00107,1,310452,312500,+,2048
66,WOLB.0323.00019,1,963951,966003,+,2052
66,WOLB.0323.00060,1,1433560,1435657,-,2097
66,WOLB.0323.00074,1,771392,773468,-,2076
66,WOLB.0323.00120,1,757353,759429,-,2076
66,WOLB.0323.00039,1,619978,622030,-,2052
66,WOLB.0323.00041,1,864066,866142,+,2076
66,WOLB.0323.00031,1,942593,944642,+,2049
66,WOLB.0323.00056,1,226747,228844,+,2097
66,WOLB.0323.00142,1,186751,188851,+,2100
66,WOLB.0323.00023,1,1080514,1082626,+,2112
66,WOLB.0323.00153,1,192952,195064,+,2112
66,WOLB.0323.00093,1,335019,337110,+,2091
66,WOLB.0323.00088,1,219349,221440,+,2091
66,WOLB.0323.00008,1,143513,145556,+,2043
66,WOLB.0323.00024,1,1973359,1975456,-,2097
66,WOLB.0323.00064,1,1332065,1334156,+,2091
66,WOLB.0323.00030,1,1573727,1575818,-,2091
66,WOLB.0323.00105,1,310454,312502,+,2048
66,WOLB.0323.00133,1,648419,650457,-,2038
66,WOLB.0323.00084,1,510941,513038,-,2097
66,WOLB.0323.00021,1,187000,189097,+,2097
66,WOLB.0323.00043,1,194334,196431,+,2097
66,WOLB.0323.00020,1,221692,223783,+,2091
66,WOLB.0323.00122,1,192395,194495,+,2100
66,WOLB.0323.00118,1,198524,200633,+,2109
66,WOLB.0323.00004,1,185419,187519,+,2100
66,WOLB.0323.00011,1,936573,938673,+,2100
66,WOLB.0323.00035,1,219248,221339,+,2091
66,WOLB.0323.00032,1,922390,924487,-,2097
66,WOLB.0323.00012,1,219334,221425,+,2091
66,WOLB.0323.00018,1,231650,233741,+,2091
66,WOLB.0323.00025,1,802773,804822,-,2049
66,WOLB.0323.00010,1,200173,202270,+,2097
66,WOLB.0323.00068,1,248054,250151,-,2097
66,WOLB.0323.00128,1,195806,197903,+,2097
66,WOLB.0323.00158,1,867247,869347,+,2100
66,WOLB.0323.00017,1,185465,187565,+,2100
66,WOLB.0323.00104,1,221648,223739,+,2091
66,WOLB.0323.00007,1,1272638,1274735,-,2097
66,WOLB.0323.00001,1,310454,312502,+,2048
66,WOLB.0323.00100,1,219348,221439,+,2091
66,WOLB.0323.00070,1,194323,196420,+,2097
66,WOLB.0323.00006,1,394681,396730,-,2049
66,WOLB.0323.00042,1,204529,206626,+,2097
66,WOLB.0323.00119,1,968046,970098,+,2052
66,WOLB.0323.00149,1,277685,279785,-,2100
66,WOLB.0323.00014,1,196997,199094,+,2097
66,WOLB.0323.00096,1,901938,904014,+,2076
67,WOLB.0323.00090,1,194072,197459,+,3387
67,WOLB.0323.00002,1,199579,203005,+,3426
67,WOLB.0323.00138,1,410342,413729,-,3387
67,WOLB.0323.00132,1,1217268,1220673,-,3405
67,WOLB.0323.00143,1,1112113,1115536,-,3423
67,WOLB.0323.00106,1,1112116,1115539,-,3423
67,WOLB.0323.00121,1,187748,191135,+,3387
67,WOLB.0323.00135,1,133409,136796,-,3387
67,WOLB.0323.00103,1,313173,316566,+,3393
67,WOLB.0323.00107,1,313172,316565,+,3393
67,WOLB.0323.00019,1,966662,970049,+,3387
67,WOLB.0323.00060,1,1429514,1432901,-,3387
67,WOLB.0323.00074,1,767313,770721,-,3408
67,WOLB.0323.00120,1,753274,756682,-,3408
67,WOLB.0323.00039,1,615932,619319,-,3387
67,WOLB.0323.00041,1,866813,870221,+,3408
67,WOLB.0323.00031,1,945301,948724,+,3423
67,WOLB.0323.00056,1,229503,232890,+,3387
67,WOLB.0323.00142,1,189510,192897,+,3387
67,WOLB.0323.00023,1,1083321,1086717,+,3396
67,WOLB.0323.00153,1,195723,199110,+,3387
67,WOLB.0323.00093,1,337769,341156,+,3387
67,WOLB.0323.00088,1,222114,225501,+,3387
67,WOLB.0323.00008,1,146227,149614,+,3387
67,WOLB.0323.00024,1,1969307,1972700,-,3393
67,WOLB.0323.00064,1,1334851,1338256,+,3405
67,WOLB.0323.00030,1,1569627,1573032,-,3405
67,WOLB.0323.00105,1,313174,316567,+,3393
67,WOLB.0323.00133,1,644277,647760,-,3483
67,WOLB.0323.00084,1,506895,510282,-,3387
67,WOLB.0323.00021,1,189756,193143,+,3387
67,WOLB.0323.00043,1,197090,200516,+,3426
67,WOLB.0323.00020,1,224457,227844,+,3387
67,WOLB.0323.00122,1,195154,198544,+,3390
67,WOLB.0323.00118,1,201292,204679,+,3387
67,WOLB.0323.00004,1,188178,191565,+,3387
67,WOLB.0323.00011,1,939332,942719,+,3387
67,WOLB.0323.00035,1,222013,225400,+,3387
67,WOLB.0323.00032,1,918344,921731,-,3387
67,WOLB.0323.00012,1,222099,225486,+,3387
67,WOLB.0323.00018,1,234436,237853,+,3417
67,WOLB.0323.00025,1,798694,802114,-,3420
67,WOLB.0323.00010,1,202929,206322,+,3393
67,WOLB.0323.00068,1,244008,247389,-,3381
67,WOLB.0323.00128,1,198562,201988,+,3426
67,WOLB.0323.00158,1,870006,873393,+,3387
67,WOLB.0323.00017,1,188224,191611,+,3387
67,WOLB.0323.00104,1,224413,227800,+,3387
67,WOLB.0323.00007,1,1268592,1271979,-,3387
67,WOLB.0323.00001,1,313174,316567,+,3393
67,WOLB.0323.00100,1,222113,225500,+,3387
67,WOLB.0323.00070,1,197079,200505,+,3426
67,WOLB.0323.00006,1,390600,394022,-,3422
67,WOLB.0323.00042,1,207300,210696,+,3396
67,WOLB.0323.00119,1,970757,974144,+,3387
67,WOLB.0323.00149,1,273639,277026,-,3387
67,WOLB.0323.00014,1,199753,203179,+,3426
67,WOLB.0323.00096,1,904685,908093,+,3408
68,WOLB.0323.00090,1,198503,200028,+,1525
68,WOLB.0323.00002,1,203932,205458,+,1526
68,WOLB.0323.00138,1,407869,409394,-,1525
68,WOLB.0323.00132,1,1214803,1216329,-,1526
68,WOLB.0323.00143,1,1109551,1111077,-,1526
68,WOLB.0323.00106,1,1109554,1111080,-,1526
68,WOLB.0323.00121,1,192080,193606,+,1526
68,WOLB.0323.00135,1,130942,132467,-,1525
68,WOLB.0323.00103,1,317586,319129,+,1543
68,WOLB.0323.00107,1,317585,319128,+,1543
68,WOLB.0323.00019,1,970868,972394,+,1526
68,WOLB.0323.00060,1,1427046,1428572,-,1526
68,WOLB.0323.00074,1,764818,766344,-,1526
68,WOLB.0323.00120,1,750779,752305,-,1526
68,WOLB.0323.00039,1,613587,615113,-,1526
68,WOLB.0323.00041,1,871190,872716,+,1526
68,WOLB.0323.00031,1,949760,951286,+,1526
68,WOLB.0323.00056,1,233832,235358,+,1526
68,WOLB.0323.00142,1,193842,195368,+,1526
68,WOLB.0323.00023,1,1087761,1089287,+,1526
68,WOLB.0323.00153,1,200154,201679,+,1525
68,WOLB.0323.00093,1,342104,343630,+,1526
68,WOLB.0323.00088,1,226443,227969,+,1526
68,WOLB.0323.00008,1,150562,152088,+,1526
68,WOLB.0323.00024,1,1966853,1968379,-,1526
68,WOLB.0323.00064,1,1339201,1340727,+,1526
68,WOLB.0323.00030,1,1567156,1568682,-,1526
68,WOLB.0323.00105,1,317587,319130,+,1543
68,WOLB.0323.00133,1,641661,643180,-,1519
68,WOLB.0323.00084,1,504422,505947,-,1525
68,WOLB.0323.00021,1,194091,195616,+,1525
68,WOLB.0323.00043,1,201443,202969,+,1526
68,WOLB.0323.00020,1,228786,230312,+,1526
68,WOLB.0323.00122,1,199489,201014,+,1525
68,WOLB.0323.00118,1,205663,207189,+,1526
68,WOLB.0323.00004,1,192510,194036,+,1526
68,WOLB.0323.00011,1,943664,945190,+,1526
68,WOLB.0323.00035,1,226342,227868,+,1526
68,WOLB.0323.00032,1,915871,917396,-,1525
68,WOLB.0323.00012,1,226428,227954,+,1526
68,WOLB.0323.00018,1,238783,240309,+,1526
68,WOLB.0323.00025,1,796275,797801,-,1526
68,WOLB.0323.00010,1,207347,208873,+,1526
68,WOLB.0323.00068,1,241535,243060,-,1525
68,WOLB.0323.00128,1,202915,204441,+,1526
68,WOLB.0323.00158,1,874338,875864,+,1526
68,WOLB.0323.00017,1,192556,194082,+,1526
68,WOLB.0323.00104,1,228742,230268,+,1526
68,WOLB.0323.00007,1,1266124,1267650,-,1526
68,WOLB.0323.00001,1,317587,319130,+,1543
68,WOLB.0323.00100,1,226442,227968,+,1526
68,WOLB.0323.00070,1,201432,202958,+,1526
68,WOLB.0323.00006,1,388038,389564,-,1526
68,WOLB.0323.00042,1,211764,213290,+,1526
68,WOLB.0323.00119,1,974963,976489,+,1526
68,WOLB.0323.00149,1,271168,272694,-,1526
68,WOLB.0323.00014,1,204106,205632,+,1526
68,WOLB.0323.00096,1,909062,910588,+,1526
69,WOLB.0323.00090,1,200070,200908,+,838
69,WOLB.0323.00002,1,205499,206336,+,837
69,WOLB.0323.00138,1,406989,407827,-,838
69,WOLB.0323.00132,1,1213924,1214762,-,838
69,WOLB.0323.00143,1,1108674,1109510,-,836
69,WOLB.0323.00106,1,1108677,1109513,-,836
69,WOLB.0323.00121,1,193647,194485,+,838
69,WOLB.0323.00135,1,130062,130900,-,838
69,WOLB.0323.00103,1,319170,319997,+,827
69,WOLB.0323.00107,1,319169,319996,+,827
69,WOLB.0323.00019,1,972435,973282,+,847
69,WOLB.0323.00060,1,1426210,1427005,-,795
69,WOLB.0323.00074,1,762425,763196,-,771
69,WOLB.0323.00120,1,748386,749157,-,771
69,WOLB.0323.00039,1,612709,613546,-,837
69,WOLB.0323.00041,1,874338,875109,+,771
69,WOLB.0323.00031,1,951327,952163,+,836
69,WOLB.0323.00056,1,235399,236194,+,795
69,WOLB.0323.00142,1,195409,196247,+,838
69,WOLB.0323.00023,1,1089328,1090166,+,838
69,WOLB.0323.00153,1,201721,202559,+,838
69,WOLB.0323.00093,1,343671,344467,+,796
69,WOLB.0323.00088,1,228010,228848,+,838
69,WOLB.0323.00008,1,152129,152914,+,785
69,WOLB.0323.00024,1,1965975,1966812,-,837
69,WOLB.0323.00064,1,1340768,1341606,+,838
69,WOLB.0323.00030,1,1566277,1567115,-,838
69,WOLB.0323.00105,1,319171,319998,+,827
69,WOLB.0323.00133,1,640777,641613,-,836
69,WOLB.0323.00084,1,503542,504380,-,838
69,WOLB.0323.00021,1,195658,196496,+,838
69,WOLB.0323.00043,1,203010,203847,+,837
69,WOLB.0323.00020,1,230353,231191,+,838
69,WOLB.0323.00122,1,201056,201894,+,838
69,WOLB.0323.00118,1,207230,208036,+,806
69,WOLB.0323.00004,1,194077,194915,+,838
69,WOLB.0323.00011,1,945231,946069,+,838
69,WOLB.0323.00035,1,227909,228747,+,838
69,WOLB.0323.00032,1,914991,915829,-,838
69,WOLB.0323.00012,1,227995,228833,+,838
69,WOLB.0323.00018,1,240350,241187,+,837
69,WOLB.0323.00025,1,795397,796234,-,837
69,WOLB.0323.00010,1,208914,209751,+,837
69,WOLB.0323.00068,1,240655,241493,-,838
69,WOLB.0323.00128,1,204482,205319,+,837
69,WOLB.0323.00158,1,875905,876743,+,838
69,WOLB.0323.00017,1,194123,194961,+,838
69,WOLB.0323.00104,1,230309,231147,+,838
69,WOLB.0323.00007,1,1265288,1266083,-,795
69,WOLB.0323.00001,1,319171,319998,+,827
69,WOLB.0323.00100,1,228009,228847,+,838
69,WOLB.0323.00070,1,202999,203836,+,837
69,WOLB.0323.00006,1,387161,387997,-,836
69,WOLB.0323.00042,1,213331,214169,+,838
69,WOLB.0323.00119,1,976530,977377,+,847
69,WOLB.0323.00149,1,270289,271127,-,838
69,WOLB.0323.00014,1,205673,206510,+,837
69,WOLB.0323.00096,1,912210,912981,+,771
70,WOLB.0323.00090,1,200915,201560,+,645
70,WOLB.0323.00002,1,206343,206985,+,642
70,WOLB.0323.00138,1,406337,406982,-,645
70,WOLB.0323.00132,1,1213272,1213917,-,645
70,WOLB.0323.00143,1,1108022,1108667,-,645
70,WOLB.0323.00106,1,1108025,1108670,-,645
70,WOLB.0323.00121,1,194492,195137,+,645
70,WOLB.0323.00135,1,129410,130055,-,645
70,WOLB.0323.00103,1,320019,320660,+,641
70,WOLB.0323.00107,1,320018,320659,+,641
70,WOLB.0323.00019,1,973289,973934,+,645
70,WOLB.0323.00060,1,1425547,1426188,-,641
70,WOLB.0323.00074,1,761720,762365,-,645
70,WOLB.0323.00120,1,737495,738113,+,618
70,WOLB.0323.00120,1,747681,748326,-,645
70,WOLB.0323.00039,1,612057,612702,-,645
70,WOLB.0323.00041,1,875169,875814,+,645
70,WOLB.0323.00031,1,952170,952815,+,645
70,WOLB.0323.00056,1,236216,236857,+,641
70,WOLB.0323.00142,1,196254,196899,+,645
70,WOLB.0323.00023,1,1090173,1090818,+,645
70,WOLB.0323.00153,1,202566,203211,+,645
70,WOLB.0323.00093,1,344474,345119,+,645
70,WOLB.0323.00088,1,228855,229500,+,645
70,WOLB.0323.00008,1,152932,153577,+,645
70,WOLB.0323.00024,1,1965323,1965968,-,645
70,WOLB.0323.00064,1,1341613,1342258,+,645
70,WOLB.0323.00030,1,1565625,1566270,-,645
70,WOLB.0323.00105,1,320020,320661,+,641
70,WOLB.0323.00133,1,640125,640770,-,645
70,WOLB.0323.00084,1,502890,503535,-,645
70,WOLB.0323.00021,1,196503,197148,+,645
70,WOLB.0323.00043,1,203854,204496,+,642
70,WOLB.0323.00020,1,231198,231843,+,645
70,WOLB.0323.00122,1,201901,202546,+,645
70,WOLB.0323.00118,1,208043,208685,+,642
70,WOLB.0323.00004,1,194922,195567,+,645
70,WOLB.0323.00011,1,946076,946721,+,645
70,WOLB.0323.00035,1,228754,229399,+,645
70,WOLB.0323.00032,1,914339,914984,-,645
70,WOLB.0323.00012,1,228840,229485,+,645
70,WOLB.0323.00018,1,241194,241836,+,642
70,WOLB.0323.00025,1,794745,795390,-,645
70,WOLB.0323.00010,1,209758,210400,+,642
70,WOLB.0323.00068,1,240003,240648,-,645
70,WOLB.0323.00128,1,205326,205968,+,642
70,WOLB.0323.00158,1,876750,877395,+,645
70,WOLB.0323.00017,1,194968,195613,+,645
70,WOLB.0323.00104,1,231154,231799,+,645
70,WOLB.0323.00007,1,1264625,1265266,-,641
70,WOLB.0323.00001,1,320020,320661,+,641
70,WOLB.0323.00100,1,228854,229499,+,645
70,WOLB.0323.00070,1,203843,204485,+,642
70,WOLB.0323.00006,1,386509,387154,-,645
70,WOLB.0323.00042,1,214176,214821,+,645
70,WOLB.0323.00119,1,977384,978029,+,645
70,WOLB.0323.00149,1,269637,270282,-,645
70,WOLB.0323.00014,1,206517,207159,+,642
70,WOLB.0323.00096,1,913041,913686,+,645
71,WOLB.0323.00090,1,201641,203588,+,1947
71,WOLB.0323.00002,1,207069,209013,+,1944
71,WOLB.0323.00138,1,404309,406256,-,1947
71,WOLB.0323.00132,1,1211244,1213191,-,1947
71,WOLB.0323.00143,1,1105994,1107941,-,1947
71,WOLB.0323.00106,1,1105997,1107944,-,1947
71,WOLB.0323.00121,1,195218,197165,+,1947
71,WOLB.0323.00135,1,127381,129329,-,1948
71,WOLB.0323.00103,1,258783,260729,+,1946
71,WOLB.0323.00107,1,258782,260728,+,1946
71,WOLB.0323.00019,1,974015,975963,+,1948
71,WOLB.0323.00060,1,1423519,1425466,-,1947
71,WOLB.0323.00074,1,758324,760272,-,1948
71,WOLB.0323.00120,1,739561,741507,+,1946
71,WOLB.0323.00120,1,744285,746233,-,1948
71,WOLB.0323.00039,1,610028,611976,-,1948
71,WOLB.0323.00041,1,877262,879210,+,1948
71,WOLB.0323.00031,1,952896,954843,+,1947
71,WOLB.0323.00056,1,236938,238885,+,1947
71,WOLB.0323.00142,1,196980,198927,+,1947
71,WOLB.0323.00023,1,1090899,1092846,+,1947
71,WOLB.0323.00153,1,203292,205239,+,1947
71,WOLB.0323.00093,1,345200,347147,+,1947
71,WOLB.0323.00088,1,229581,231528,+,1947
71,WOLB.0323.00008,1,153658,155605,+,1947
71,WOLB.0323.00024,1,1963298,1965242,-,1944
71,WOLB.0323.00064,1,1342339,1344286,+,1947
71,WOLB.0323.00030,1,1563597,1565544,-,1947
71,WOLB.0323.00105,1,258784,260730,+,1946
71,WOLB.0323.00133,1,638096,640044,-,1948
71,WOLB.0323.00084,1,500862,502809,-,1947
71,WOLB.0323.00021,1,197229,199176,+,1947
71,WOLB.0323.00043,1,204580,206524,+,1944
71,WOLB.0323.00020,1,231924,233871,+,1947
71,WOLB.0323.00122,1,202627,204574,+,1947
71,WOLB.0323.00118,1,208769,210716,+,1947
71,WOLB.0323.00004,1,195648,197595,+,1947
71,WOLB.0323.00011,1,946802,948749,+,1947
71,WOLB.0323.00035,1,229480,231427,+,1947
71,WOLB.0323.00032,1,912310,914258,-,1948
71,WOLB.0323.00012,1,229566,231513,+,1947
71,WOLB.0323.00018,1,241920,243864,+,1944
71,WOLB.0323.00025,1,792720,794664,-,1944
71,WOLB.0323.00010,1,210484,212429,+,1945
71,WOLB.0323.00068,1,237975,239922,-,1947
71,WOLB.0323.00128,1,206052,207996,+,1944
71,WOLB.0323.00158,1,877476,879423,+,1947
71,WOLB.0323.00017,1,195694,197641,+,1947
71,WOLB.0323.00104,1,231880,233827,+,1947
71,WOLB.0323.00007,1,1262597,1264544,-,1947
71,WOLB.0323.00001,1,258784,260730,+,1946
71,WOLB.0323.00100,1,229580,231527,+,1947
71,WOLB.0323.00070,1,204569,206513,+,1944
71,WOLB.0323.00006,1,384481,386428,-,1947
71,WOLB.0323.00042,1,214902,216849,+,1947
71,WOLB.0323.00119,1,978110,980058,+,1948
71,WOLB.0323.00149,1,267609,269556,-,1947
71,WOLB.0323.00014,1,207243,209187,+,1944
71,WOLB.0323.00096,1,915134,917082,+,1948
72,WOLB.0323.00090,1,203988,204879,+,891
72,WOLB.0323.00002,1,209406,210297,+,891
72,WOLB.0323.00138,1,403019,403910,-,891
72,WOLB.0323.00132,1,1209954,1210845,-,891
72,WOLB.0323.00143,1,1104718,1105609,-,891
72,WOLB.0323.00106,1,1104721,1105612,-,891
72,WOLB.0323.00121,1,197564,198455,+,891
72,WOLB.0323.00135,1,126090,126981,-,891
72,WOLB.0323.00103,1,261129,262020,+,891
72,WOLB.0323.00107,1,261128,262019,+,891
72,WOLB.0323.00019,1,976355,977240,+,885
72,WOLB.0323.00060,1,1422228,1423119,-,891
72,WOLB.0323.00074,1,757036,757927,-,891
72,WOLB.0323.00120,1,736565,737454,-,889
72,WOLB.0323.00120,1,741905,742744,+,839
72,WOLB.0323.00120,1,742997,743888,-,891
72,WOLB.0323.00039,1,608751,609636,-,885
72,WOLB.0323.00041,1,879607,880498,+,891
72,WOLB.0323.00031,1,955228,956119,+,891
72,WOLB.0323.00056,1,239285,240176,+,891
72,WOLB.0323.00142,1,199326,200217,+,891
72,WOLB.0323.00023,1,1093246,1094137,+,891
72,WOLB.0323.00153,1,205639,206530,+,891
72,WOLB.0323.00093,1,347538,348429,+,891
72,WOLB.0323.00088,1,231928,232819,+,891
72,WOLB.0323.00008,1,155984,156875,+,891
72,WOLB.0323.00024,1,1962007,1962898,-,891
72,WOLB.0323.00064,1,1344686,1345577,+,891
72,WOLB.0323.00030,1,1562306,1563197,-,891
72,WOLB.0323.00105,1,261130,262021,+,891
72,WOLB.0323.00133,1,636544,637429,-,885
72,WOLB.0323.00084,1,499572,500463,-,891
72,WOLB.0323.00021,1,199575,200466,+,891
72,WOLB.0323.00043,1,206917,207808,+,891
72,WOLB.0323.00020,1,234271,235162,+,891
72,WOLB.0323.00122,1,204974,205865,+,891
72,WOLB.0323.00118,1,211116,212007,+,891
72,WOLB.0323.00004,1,197994,198885,+,891
72,WOLB.0323.00011,1,949148,950039,+,891
72,WOLB.0323.00035,1,231827,232718,+,891
72,WOLB.0323.00032,1,911020,911911,-,891
72,WOLB.0323.00012,1,231913,232804,+,891
72,WOLB.0323.00018,1,244264,245155,+,891
72,WOLB.0323.00025,1,791448,792333,-,885
72,WOLB.0323.00010,1,212822,213713,+,891
72,WOLB.0323.00068,1,236685,237576,-,891
72,WOLB.0323.00128,1,208389,209280,+,891
72,WOLB.0323.00158,1,879822,880713,+,891
72,WOLB.0323.00017,1,198040,198931,+,891
72,WOLB.0323.00104,1,234227,235118,+,891
72,WOLB.0323.00007,1,1261306,1262197,-,891
72,WOLB.0323.00001,1,261130,262021,+,891
72,WOLB.0323.00100,1,231927,232818,+,891
72,WOLB.0323.00070,1,206906,207797,+,891
72,WOLB.0323.00006,1,383205,384096,-,891
72,WOLB.0323.00042,1,217249,218140,+,891
72,WOLB.0323.00119,1,980450,981335,+,885
72,WOLB.0323.00149,1,266319,267210,-,891
72,WOLB.0323.00014,1,209580,210471,+,891
72,WOLB.0323.00096,1,917479,918370,+,891
73,WOLB.0323.00090,1,205150,209087,+,3937
73,WOLB.0323.00002,1,210568,214593,+,4025
73,WOLB.0323.00138,1,398729,402748,-,4019
73,WOLB.0323.00132,1,1205664,1209683,-,4019
73,WOLB.0323.00143,1,1100516,1104447,-,3931
73,WOLB.0323.00106,1,1100519,1104450,-,3931
73,WOLB.0323.00121,1,198726,202664,+,3938
73,WOLB.0323.00135,1,121866,125819,-,3953
73,WOLB.0323.00103,1,262291,266304,+,4013
73,WOLB.0323.00107,1,262290,266303,+,4013
73,WOLB.0323.00019,1,977511,981529,+,4018
73,WOLB.0323.00060,1,1417938,1421957,-,4019
73,WOLB.0323.00074,1,752828,756765,-,3937
73,WOLB.0323.00120,1,732357,736294,-,3937
73,WOLB.0323.00039,1,604462,608480,-,4018
73,WOLB.0323.00041,1,880769,884706,+,3937
73,WOLB.0323.00031,1,956390,960321,+,3931
73,WOLB.0323.00056,1,240447,244385,+,3938
73,WOLB.0323.00142,1,200488,204426,+,3938
73,WOLB.0323.00023,1,1094411,1098346,+,3935
73,WOLB.0323.00153,1,206801,210738,+,3937
73,WOLB.0323.00093,1,348700,352638,+,3938
73,WOLB.0323.00088,1,233090,237027,+,3937
73,WOLB.0323.00008,1,157146,161084,+,3938
73,WOLB.0323.00024,1,1957717,1961736,-,4019
73,WOLB.0323.00064,1,1345848,1349786,+,3938
73,WOLB.0323.00030,1,1558016,1562035,-,4019
73,WOLB.0323.00105,1,262292,266305,+,4013
73,WOLB.0323.00133,1,632278,636273,-,3995
73,WOLB.0323.00084,1,495282,499301,-,4019
73,WOLB.0323.00021,1,200737,204675,+,3938
73,WOLB.0323.00043,1,208079,212104,+,4025
73,WOLB.0323.00020,1,235433,239370,+,3937
73,WOLB.0323.00122,1,206136,210074,+,3938
73,WOLB.0323.00118,1,212278,216215,+,3937
73,WOLB.0323.00004,1,199156,203094,+,3938
73,WOLB.0323.00011,1,950310,954248,+,3938
73,WOLB.0323.00035,1,232989,236926,+,3937
73,WOLB.0323.00032,1,906730,910749,-,4019
73,WOLB.0323.00012,1,233075,237012,+,3937
73,WOLB.0323.00018,1,245426,249364,+,3938
73,WOLB.0323.00025,1,787245,791177,-,3932
73,WOLB.0323.00010,1,213984,218003,+,4019
73,WOLB.0323.00068,1,232395,236414,-,4019
73,WOLB.0323.00128,1,209551,213576,+,4025
73,WOLB.0323.00158,1,880984,884922,+,3938
73,WOLB.0323.00017,1,199202,203140,+,3938
73,WOLB.0323.00104,1,235389,239326,+,3937
73,WOLB.0323.00007,1,1257016,1261035,-,4019
73,WOLB.0323.00001,1,262292,266305,+,4013
73,WOLB.0323.00100,1,233089,237026,+,3937
73,WOLB.0323.00070,1,208068,212093,+,4025
73,WOLB.0323.00006,1,379003,382934,-,3931
73,WOLB.0323.00042,1,218411,222340,+,3929
73,WOLB.0323.00119,1,981606,985624,+,4018
73,WOLB.0323.00149,1,262029,266048,-,4019
73,WOLB.0323.00014,1,210742,214767,+,4025
73,WOLB.0323.00096,1,918641,922578,+,3937
74,WOLB.0323.00090,1,209498,210094,+,596
74,WOLB.0323.00002,1,214936,215519,+,583
74,WOLB.0323.00138,1,397803,398399,-,596
74,WOLB.0323.00132,1,1204738,1205321,-,583
74,WOLB.0323.00143,1,1099509,1100107,-,598
74,WOLB.0323.00106,1,1099512,1100110,-,598
74,WOLB.0323.00121,1,203075,203671,+,596
74,WOLB.0323.00135,1,120859,121457,-,598
74,WOLB.0323.00103,1,266713,267311,+,598
74,WOLB.0323.00107,1,266712,267310,+,598
74,WOLB.0323.00019,1,981859,982455,+,596
74,WOLB.0323.00060,1,1417012,1417595,-,583
74,WOLB.0323.00074,1,751821,752419,-,598
74,WOLB.0323.00120,1,731350,731948,-,598
74,WOLB.0323.00039,1,603536,604132,-,596
74,WOLB.0323.00041,1,885115,885713,+,598
74,WOLB.0323.00031,1,960730,961328,+,598
74,WOLB.0323.00056,1,244809,245392,+,583
74,WOLB.0323.00142,1,204837,205433,+,596
74,WOLB.0323.00023,1,1098770,1099353,+,583
74,WOLB.0323.00153,1,211149,211745,+,596
74,WOLB.0323.00093,1,353035,353627,+,592
74,WOLB.0323.00088,1,237451,238034,+,583
74,WOLB.0323.00008,1,161508,162091,+,583
74,WOLB.0323.00024,1,1956791,1957374,-,583
74,WOLB.0323.00064,1,1350210,1350793,+,583
74,WOLB.0323.00030,1,1557090,1557673,-,583
74,WOLB.0323.00105,1,266714,267312,+,598
74,WOLB.0323.00133,1,631351,631934,-,583
74,WOLB.0323.00084,1,494356,494952,-,596
74,WOLB.0323.00021,1,205086,205682,+,596
74,WOLB.0323.00043,1,212447,213030,+,583
74,WOLB.0323.00020,1,239794,240377,+,583
74,WOLB.0323.00122,1,210485,211081,+,596
74,WOLB.0323.00118,1,216639,217222,+,583
74,WOLB.0323.00004,1,203505,204101,+,596
74,WOLB.0323.00011,1,954659,955255,+,596
74,WOLB.0323.00035,1,237350,237933,+,583
74,WOLB.0323.00032,1,905804,906400,-,596
74,WOLB.0323.00012,1,237436,238019,+,583
74,WOLB.0323.00018,1,249695,250278,+,583
74,WOLB.0323.00025,1,786238,786836,-,598
74,WOLB.0323.00010,1,218376,218956,+,580
74,WOLB.0323.00068,1,231469,232065,-,596
74,WOLB.0323.00128,1,213919,214502,+,583
74,WOLB.0323.00158,1,885333,885929,+,596
74,WOLB.0323.00017,1,203551,204147,+,596
74,WOLB.0323.00104,1,239750,240333,+,583
74,WOLB.0323.00007,1,1256090,1256673,-,583
74,WOLB.0323.00001,1,266714,267312,+,598
74,WOLB.0323.00100,1,237450,238033,+,583
74,WOLB.0323.00070,1,212436,213019,+,583
74,WOLB.0323.00006,1,377996,378594,-,598
74,WOLB.0323.00042,1,222764,223344,+,580
74,WOLB.0323.00119,1,985954,986550,+,596
74,WOLB.0323.00149,1,261103,261699,-,596
74,WOLB.0323.00014,1,215110,215693,+,583
74,WOLB.0323.00096,1,922987,923585,+,598
75,WOLB.0323.00090,1,211711,217039,+,5328
75,WOLB.0323.00002,1,217342,222662,+,5320
75,WOLB.0323.00138,1,390851,396171,-,5320
75,WOLB.0323.00132,1,1197745,1203073,-,5328
75,WOLB.0323.00143,1,1092587,1097913,-,5326
75,WOLB.0323.00106,1,1092590,1097916,-,5326
75,WOLB.0323.00121,1,205291,210640,+,5349
75,WOLB.0323.00135,1,113918,119254,-,5336
75,WOLB.0323.00103,1,268916,274228,+,5312
75,WOLB.0323.00107,1,268915,274227,+,5312
75,WOLB.0323.00019,1,984054,989418,+,5364
75,WOLB.0323.00060,1,1410084,1415404,-,5320
75,WOLB.0323.00074,1,743541,748862,-,5321
75,WOLB.0323.00120,1,723070,728391,-,5321
75,WOLB.0323.00039,1,596572,601937,-,5365
75,WOLB.0323.00041,1,888672,893993,+,5321
75,WOLB.0323.00031,1,962924,968250,+,5326
75,WOLB.0323.00056,1,247000,252320,+,5320
75,WOLB.0323.00142,1,207053,212402,+,5349
75,WOLB.0323.00023,1,1100954,1106275,+,5321
75,WOLB.0323.00153,1,213362,218690,+,5328
75,WOLB.0323.00093,1,355577,360903,+,5326
75,WOLB.0323.00088,1,239639,244988,+,5349
75,WOLB.0323.00008,1,163687,169013,+,5326
75,WOLB.0323.00024,1,1949812,1955138,-,5326
75,WOLB.0323.00064,1,1352458,1357784,+,5326
75,WOLB.0323.00030,1,1550099,1555425,-,5326
75,WOLB.0323.00105,1,268917,274229,+,5312
75,WOLB.0323.00133,1,624393,629755,-,5362
75,WOLB.0323.00084,1,487404,492724,-,5320
75,WOLB.0323.00021,1,207314,212634,+,5320
75,WOLB.0323.00043,1,214853,220173,+,5320
75,WOLB.0323.00020,1,241982,247331,+,5349
75,WOLB.0323.00122,1,212686,218014,+,5328
75,WOLB.0323.00118,1,218881,224209,+,5328
75,WOLB.0323.00004,1,205721,211070,+,5349
75,WOLB.0323.00011,1,956875,962224,+,5349
75,WOLB.0323.00035,1,239538,244887,+,5349
75,WOLB.0323.00032,1,898852,904172,-,5320
75,WOLB.0323.00012,1,239624,244973,+,5349
75,WOLB.0323.00018,1,252144,257462,+,5318
75,WOLB.0323.00025,1,779367,784663,-,5296
75,WOLB.0323.00010,1,220783,226111,+,5328
75,WOLB.0323.00068,1,224516,229836,-,5320
75,WOLB.0323.00128,1,216325,221645,+,5320
75,WOLB.0323.00158,1,887549,892898,+,5349
75,WOLB.0323.00017,1,205767,211116,+,5349
75,WOLB.0323.00104,1,241938,247287,+,5349
75,WOLB.0323.00007,1,1249162,1254482,-,5320
75,WOLB.0323.00001,1,268917,274229,+,5312
75,WOLB.0323.00100,1,239638,244987,+,5349
75,WOLB.0323.00070,1,214842,220162,+,5320
75,WOLB.0323.00006,1,371074,376400,-,5326
75,WOLB.0323.00042,1,225171,230491,+,5320
75,WOLB.0323.00119,1,988149,993513,+,5364
75,WOLB.0323.00149,1,254134,259483,-,5349
75,WOLB.0323.00014,1,217516,222836,+,5320
75,WOLB.0323.00096,1,926544,931865,+,5321
76,WOLB.0323.00090,1,217068,221605,+,4537
76,WOLB.0323.00002,1,222691,227243,+,4552
76,WOLB.0323.00138,1,386285,390822,-,4537
76,WOLB.0323.00132,1,1193176,1197716,-,4540
76,WOLB.0323.00143,1,1088006,1092558,-,4552
76,WOLB.0323.00106,1,1088009,1092561,-,4552
76,WOLB.0323.00121,1,210669,215206,+,4537
76,WOLB.0323.00135,1,109352,113889,-,4537
76,WOLB.0323.00103,1,274257,278803,+,4546
76,WOLB.0323.00107,1,274256,278802,+,4546
76,WOLB.0323.00019,1,989447,993999,+,4552
76,WOLB.0323.00060,1,1405518,1410055,-,4537
76,WOLB.0323.00074,1,738975,743512,-,4537
76,WOLB.0323.00120,1,718504,723041,-,4537
76,WOLB.0323.00039,1,591991,596543,-,4552
76,WOLB.0323.00041,1,894022,898559,+,4537
76,WOLB.0323.00031,1,968279,972831,+,4552
76,WOLB.0323.00056,1,252349,256881,+,4532
76,WOLB.0323.00142,1,212431,216968,+,4537
76,WOLB.0323.00023,1,1106304,1110827,+,4523
76,WOLB.0323.00153,1,218719,223256,+,4537
76,WOLB.0323.00093,1,360932,365472,+,4540
76,WOLB.0323.00088,1,245017,249554,+,4537
76,WOLB.0323.00008,1,169042,173594,+,4552
76,WOLB.0323.00024,1,1945112,1949783,-,4671
76,WOLB.0323.00064,1,1357813,1362365,+,4552
76,WOLB.0323.00030,1,1545518,1550070,-,4552
76,WOLB.0323.00105,1,274258,278804,+,4546
76,WOLB.0323.00133,1,619812,624364,-,4552
76,WOLB.0323.00084,1,482838,487375,-,4537
76,WOLB.0323.00021,1,212663,217200,+,4537
76,WOLB.0323.00043,1,220202,224754,+,4552
76,WOLB.0323.00020,1,247360,251897,+,4537
76,WOLB.0323.00122,1,218043,222580,+,4537
76,WOLB.0323.00118,1,224238,228775,+,4537
76,WOLB.0323.00004,1,211099,215636,+,4537
76,WOLB.0323.00011,1,962253,966790,+,4537
76,WOLB.0323.00035,1,244916,249453,+,4537
76,WOLB.0323.00032,1,894286,898823,-,4537
76,WOLB.0323.00012,1,245002,249539,+,4537
76,WOLB.0323.00018,1,257491,262028,+,4537
76,WOLB.0323.00025,1,770330,774876,-,4546
76,WOLB.0323.00010,1,226140,230680,+,4540
76,WOLB.0323.00068,1,219950,224487,-,4537
76,WOLB.0323.00128,1,221674,226226,+,4552
76,WOLB.0323.00158,1,892927,897464,+,4537
76,WOLB.0323.00017,1,211145,215682,+,4537
76,WOLB.0323.00104,1,247316,251853,+,4537
76,WOLB.0323.00007,1,1244596,1249133,-,4537
76,WOLB.0323.00001,1,274258,278804,+,4546
76,WOLB.0323.00100,1,245016,249553,+,4537
76,WOLB.0323.00070,1,220191,224743,+,4552
76,WOLB.0323.00006,1,366493,371045,-,4552
76,WOLB.0323.00042,1,230520,235057,+,4537
76,WOLB.0323.00119,1,993542,998094,+,4552
76,WOLB.0323.00149,1,249568,254105,-,4537
76,WOLB.0323.00014,1,222865,227417,+,4552
76,WOLB.0323.00096,1,931894,936431,+,4537
77,WOLB.0323.00090,1,221655,223471,+,1816
77,WOLB.0323.00002,1,227299,229111,+,1812
77,WOLB.0323.00138,1,384398,386235,-,1837
77,WOLB.0323.00132,1,1191289,1193126,-,1837
77,WOLB.0323.00143,1,1086110,1087935,-,1825
77,WOLB.0323.00106,1,1086113,1087938,-,1825
77,WOLB.0323.00121,1,215256,217093,+,1837
77,WOLB.0323.00135,1,107465,109302,-,1837
77,WOLB.0323.00103,1,278876,280671,+,1795
77,WOLB.0323.00107,1,278875,280670,+,1795
77,WOLB.0323.00019,1,994049,995877,+,1828
77,WOLB.0323.00060,1,1403652,1405468,-,1816
77,WOLB.0323.00074,1,737088,738925,-,1837
77,WOLB.0323.00120,1,716617,718454,-,1837
77,WOLB.0323.00039,1,590113,591941,-,1828
77,WOLB.0323.00041,1,898609,900446,+,1837
77,WOLB.0323.00031,1,972902,974727,+,1825
77,WOLB.0323.00056,1,256931,258747,+,1816
77,WOLB.0323.00142,1,217018,218855,+,1837
77,WOLB.0323.00023,1,1112485,1114310,+,1825
77,WOLB.0323.00153,1,223306,225122,+,1816
77,WOLB.0323.00093,1,365522,367359,+,1837
77,WOLB.0323.00088,1,249604,251420,+,1816
77,WOLB.0323.00008,1,173665,175469,+,1804
77,WOLB.0323.00024,1,1943253,1945062,-,1809
77,WOLB.0323.00064,1,1362415,1364252,+,1837
77,WOLB.0323.00030,1,1543631,1545468,-,1837
77,WOLB.0323.00105,1,278877,280672,+,1795
77,WOLB.0323.00133,1,617925,619762,-,1837
77,WOLB.0323.00084,1,480951,482788,-,1837
77,WOLB.0323.00021,1,217250,219087,+,1837
77,WOLB.0323.00043,1,224804,226641,+,1837
77,WOLB.0323.00020,1,251947,253763,+,1816
77,WOLB.0323.00122,1,222630,224446,+,1816
77,WOLB.0323.00118,1,228825,230650,+,1825
77,WOLB.0323.00004,1,215686,217523,+,1837
77,WOLB.0323.00011,1,966840,968677,+,1837
77,WOLB.0323.00035,1,249503,251319,+,1816
77,WOLB.0323.00032,1,892399,894236,-,1837
77,WOLB.0323.00012,1,249589,251405,+,1816
77,WOLB.0323.00018,1,262078,263906,+,1828
77,WOLB.0323.00025,1,768456,770259,-,1803
77,WOLB.0323.00010,1,230730,232567,+,1837
77,WOLB.0323.00068,1,218063,219900,-,1837
77,WOLB.0323.00128,1,226276,228113,+,1837
77,WOLB.0323.00158,1,897514,899351,+,1837
77,WOLB.0323.00017,1,215732,217569,+,1837
77,WOLB.0323.00104,1,251903,253719,+,1816
77,WOLB.0323.00007,1,1242730,1244546,-,1816
77,WOLB.0323.00001,1,278877,280672,+,1795
77,WOLB.0323.00100,1,249603,251419,+,1816
77,WOLB.0323.00070,1,224793,226630,+,1837
77,WOLB.0323.00006,1,364597,366422,-,1825
77,WOLB.0323.00042,1,235107,236944,+,1837
77,WOLB.0323.00119,1,998144,999972,+,1828
77,WOLB.0323.00149,1,247681,249518,-,1837
77,WOLB.0323.00014,1,227467,229304,+,1837
77,WOLB.0323.00096,1,936481,938318,+,1837
78,WOLB.0323.00090,1,224783,229651,+,4868
78,WOLB.0323.00002,1,230430,235327,+,4897
78,WOLB.0323.00138,1,378198,383065,-,4867
78,WOLB.0323.00132,1,1185149,1189992,-,4843
78,WOLB.0323.00143,1,1079951,1084812,-,4861
78,WOLB.0323.00106,1,1079954,1084815,-,4861
78,WOLB.0323.00121,1,218405,223273,+,4868
78,WOLB.0323.00135,1,101265,106132,-,4867
78,WOLB.0323.00103,1,281980,286875,+,4895
78,WOLB.0323.00107,1,281979,286874,+,4895
78,WOLB.0323.00019,1,997212,1002068,+,4856
78,WOLB.0323.00060,1,1397474,1402341,-,4867
78,WOLB.0323.00074,1,730934,735783,-,4849
78,WOLB.0323.00120,1,710463,715312,-,4849
78,WOLB.0323.00039,1,583932,588787,-,4855
78,WOLB.0323.00041,1,901750,906600,+,4850
78,WOLB.0323.00031,1,976024,980886,+,4862
78,WOLB.0323.00056,1,260057,264925,+,4868
78,WOLB.0323.00142,1,220167,225035,+,4868
78,WOLB.0323.00023,1,1115629,1120478,+,4849
78,WOLB.0323.00153,1,226434,231302,+,4868
78,WOLB.0323.00093,1,368526,373385,+,4859
78,WOLB.0323.00088,1,252728,257584,+,4856
78,WOLB.0323.00008,1,176555,181426,+,4871
78,WOLB.0323.00024,1,1932790,1937639,-,4849
78,WOLB.0323.00064,1,1365453,1370297,+,4844
78,WOLB.0323.00030,1,1537586,1542429,-,4843
78,WOLB.0323.00105,1,281981,286876,+,4895
78,WOLB.0323.00133,1,611834,616695,-,4861
78,WOLB.0323.00084,1,474751,479618,-,4867
78,WOLB.0323.00021,1,220419,225287,+,4868
78,WOLB.0323.00043,1,227960,232845,+,4885
78,WOLB.0323.00020,1,255071,259927,+,4856
78,WOLB.0323.00122,1,225756,230624,+,4868
78,WOLB.0323.00118,1,231982,236838,+,4856
78,WOLB.0323.00004,1,218835,223703,+,4868
78,WOLB.0323.00011,1,969989,974857,+,4868
78,WOLB.0323.00035,1,252627,257483,+,4856
78,WOLB.0323.00032,1,886199,891066,-,4867
78,WOLB.0323.00012,1,252713,257569,+,4856
78,WOLB.0323.00018,1,265218,270068,+,4850
78,WOLB.0323.00025,1,715288,720162,-,4874
78,WOLB.0323.00010,1,233887,238760,+,4873
78,WOLB.0323.00068,1,211863,216730,-,4867
78,WOLB.0323.00128,1,229432,234329,+,4897
78,WOLB.0323.00158,1,900663,905531,+,4868
78,WOLB.0323.00017,1,218881,223749,+,4868
78,WOLB.0323.00104,1,255027,259883,+,4856
78,WOLB.0323.00007,1,1236552,1241419,-,4867
78,WOLB.0323.00001,1,281981,286876,+,4895
78,WOLB.0323.00100,1,252727,257583,+,4856
78,WOLB.0323.00070,1,227947,232844,+,4897
78,WOLB.0323.00006,1,358438,363299,-,4861
78,WOLB.0323.00042,1,238255,243141,+,4886
78,WOLB.0323.00119,1,1001307,1006163,+,4856
78,WOLB.0323.00149,1,241501,246368,-,4867
78,WOLB.0323.00014,1,230623,235520,+,4897
78,WOLB.0323.00096,1,939622,944472,+,4850
79,WOLB.0323.00090,1,231099,236075,+,4976
79,WOLB.0323.00002,1,237398,242377,+,4979
79,WOLB.0323.00138,1,371731,376706,-,4975
79,WOLB.0323.00132,1,1178202,1183174,-,4972
79,WOLB.0323.00143,1,1073359,1078339,-,4980
79,WOLB.0323.00106,1,1073362,1078342,-,4980
79,WOLB.0323.00121,1,225443,230419,+,4976
79,WOLB.0323.00135,1,94119,99094,-,4975
79,WOLB.0323.00103,1,236855,241842,+,4987
79,WOLB.0323.00107,1,236853,241840,+,4987
79,WOLB.0323.00019,1,862066,867046,-,4980
79,WOLB.0323.00060,1,1391007,1395982,-,4975
79,WOLB.0323.00074,1,721676,726645,-,4969
79,WOLB.0323.00120,1,701203,706172,-,4969
79,WOLB.0323.00039,1,577183,582163,-,4980
79,WOLB.0323.00041,1,910859,915829,+,4970
79,WOLB.0323.00031,1,982498,987478,+,4980
79,WOLB.0323.00056,1,266416,271392,+,4976
79,WOLB.0323.00142,1,227205,232181,+,4976
79,WOLB.0323.00023,1,1122639,1127612,+,4973
79,WOLB.0323.00153,1,232750,237726,+,4976
79,WOLB.0323.00093,1,375500,380474,+,4974
79,WOLB.0323.00088,1,259084,264060,+,4976
79,WOLB.0323.00008,1,184128,189101,+,4973
79,WOLB.0323.00024,1,1925953,1930940,-,4987
79,WOLB.0323.00064,1,1372307,1377280,+,4973
79,WOLB.0323.00030,1,1530604,1535576,-,4972
79,WOLB.0323.00105,1,236853,241840,+,4987
79,WOLB.0323.00133,1,605380,610414,-,5034
79,WOLB.0323.00084,1,468284,473259,-,4975
79,WOLB.0323.00021,1,226778,231754,+,4976
79,WOLB.0323.00043,1,234916,239895,+,4979
79,WOLB.0323.00020,1,261427,266403,+,4976
79,WOLB.0323.00122,1,232072,237048,+,4976
79,WOLB.0323.00118,1,239036,244012,+,4976
79,WOLB.0323.00004,1,225873,230849,+,4976
79,WOLB.0323.00011,1,977027,982003,+,4976
79,WOLB.0323.00035,1,258983,263959,+,4976
79,WOLB.0323.00032,1,878634,883609,-,4975
79,WOLB.0323.00012,1,259069,264045,+,4976
79,WOLB.0323.00018,1,272125,277104,+,4979
79,WOLB.0323.00025,1,696702,701682,+,4980
79,WOLB.0323.00010,1,240766,245745,+,4979
79,WOLB.0323.00068,1,205396,210371,-,4975
79,WOLB.0323.00128,1,236400,241379,+,4979
79,WOLB.0323.00158,1,907701,912677,+,4976
79,WOLB.0323.00017,1,225919,230895,+,4976
79,WOLB.0323.00104,1,261383,266359,+,4976
79,WOLB.0323.00007,1,1230085,1235060,-,4975
79,WOLB.0323.00001,1,236853,241840,+,4987
79,WOLB.0323.00100,1,259083,264059,+,4976
79,WOLB.0323.00070,1,234915,239894,+,4979
79,WOLB.0323.00006,1,351948,356928,-,4980
79,WOLB.0323.00042,1,246423,251401,+,4978
79,WOLB.0323.00119,1,864720,869700,-,4980
79,WOLB.0323.00149,1,234355,239330,-,4975
79,WOLB.0323.00014,1,237591,242570,+,4979
79,WOLB.0323.00096,1,948762,953732,+,4970
80,WOLB.0323.00090,1,236416,238507,+,2091
80,WOLB.0323.00002,1,242736,244826,+,2090
80,WOLB.0323.00138,1,369299,371390,-,2091
80,WOLB.0323.00132,1,1175770,1177852,-,2082
80,WOLB.0323.00143,1,1070971,1073008,-,2037
80,WOLB.0323.00106,1,1070974,1073011,-,2037
80,WOLB.0323.00121,1,230760,232851,+,2091
80,WOLB.0323.00135,1,91687,93778,-,2091
80,WOLB.0323.00103,1,242193,244275,+,2082
80,WOLB.0323.00107,1,242191,244273,+,2082
80,WOLB.0323.00019,1,859621,861715,-,2094
80,WOLB.0323.00060,1,1388575,1390666,-,2091
80,WOLB.0323.00074,1,719234,721325,-,2091
80,WOLB.0323.00120,1,698761,700852,-,2091
80,WOLB.0323.00039,1,574738,576832,-,2094
80,WOLB.0323.00041,1,916180,918271,+,2091
80,WOLB.0323.00031,1,987829,989866,+,2037
80,WOLB.0323.00056,1,271733,273824,+,2091
80,WOLB.0323.00142,1,232522,234613,+,2091
80,WOLB.0323.00023,1,1127962,1130044,+,2082
80,WOLB.0323.00153,1,238067,240158,+,2091
80,WOLB.0323.00093,1,380824,382906,+,2082
80,WOLB.0323.00088,1,264401,266492,+,2091
80,WOLB.0323.00008,1,189452,191534,+,2082
80,WOLB.0323.00024,1,1923508,1925602,-,2094
80,WOLB.0323.00064,1,1377630,1379691,+,2061
80,WOLB.0323.00030,1,1528193,1530254,-,2061
80,WOLB.0323.00105,1,242191,244273,+,2082
80,WOLB.0323.00133,1,603016,605029,-,2013
80,WOLB.0323.00084,1,465852,467943,-,2091
80,WOLB.0323.00021,1,232095,234186,+,2091
80,WOLB.0323.00043,1,240254,242344,+,2090
80,WOLB.0323.00020,1,266744,268835,+,2091
80,WOLB.0323.00122,1,237389,239480,+,2091
80,WOLB.0323.00118,1,244353,246450,+,2097
80,WOLB.0323.00004,1,231190,233281,+,2091
80,WOLB.0323.00011,1,982344,984435,+,2091
80,WOLB.0323.00035,1,264300,266391,+,2091
80,WOLB.0323.00032,1,876202,878293,-,2091
80,WOLB.0323.00012,1,264386,266477,+,2091
80,WOLB.0323.00018,1,277463,279553,+,2090
80,WOLB.0323.00025,1,702033,704070,+,2037
80,WOLB.0323.00010,1,246104,248194,+,2090
80,WOLB.0323.00068,1,202964,205055,-,2091
80,WOLB.0323.00128,1,241738,243828,+,2090
80,WOLB.0323.00158,1,913018,915109,+,2091
80,WOLB.0323.00017,1,231236,233327,+,2091
80,WOLB.0323.00104,1,266700,268791,+,2091
80,WOLB.0323.00007,1,1227653,1229744,-,2091
80,WOLB.0323.00001,1,242191,244273,+,2082
80,WOLB.0323.00100,1,264400,266491,+,2091
80,WOLB.0323.00070,1,240253,242343,+,2090
80,WOLB.0323.00006,1,349560,351597,-,2037
80,WOLB.0323.00042,1,251760,253851,+,2091
80,WOLB.0323.00119,1,862275,864369,-,2094
80,WOLB.0323.00149,1,231923,234014,-,2091
80,WOLB.0323.00014,1,242929,245019,+,2090
80,WOLB.0323.00096,1,954083,956174,+,2091
81,WOLB.0323.00090,1,239197,240666,+,1469
81,WOLB.0323.00002,1,245513,246982,+,1469
81,WOLB.0323.00138,1,367140,368609,-,1469
81,WOLB.0323.00132,1,1173452,1174921,-,1469
81,WOLB.0323.00143,1,1068764,1070233,-,1469
81,WOLB.0323.00106,1,1068767,1070236,-,1469
81,WOLB.0323.00121,1,233541,235010,+,1469
81,WOLB.0323.00135,1,89528,90992,-,1464
81,WOLB.0323.00103,1,244992,246452,+,1460
81,WOLB.0323.00107,1,244990,246450,+,1460
81,WOLB.0323.00019,1,857462,858931,-,1469
81,WOLB.0323.00060,1,1386416,1387885,-,1469
81,WOLB.0323.00074,1,717075,718544,-,1469
81,WOLB.0323.00120,1,696602,698071,-,1469
81,WOLB.0323.00039,1,572579,574048,-,1469
81,WOLB.0323.00041,1,918961,920430,+,1469
81,WOLB.0323.00031,1,990604,992073,+,1469
81,WOLB.0323.00056,1,274514,275983,+,1469
81,WOLB.0323.00142,1,235303,236772,+,1469
81,WOLB.0323.00023,1,1130893,1132362,+,1469
81,WOLB.0323.00153,1,240848,242317,+,1469
81,WOLB.0323.00093,1,383596,385034,+,1438
81,WOLB.0323.00088,1,267187,268651,+,1464
81,WOLB.0323.00008,1,192224,193693,+,1469
81,WOLB.0323.00024,1,1921190,1922659,-,1469
81,WOLB.0323.00064,1,1380540,1382009,+,1469
81,WOLB.0323.00030,1,1525875,1527344,-,1469
81,WOLB.0323.00105,1,244990,246450,+,1460
81,WOLB.0323.00133,1,600824,602293,-,1469
81,WOLB.0323.00084,1,463693,465162,-,1469
81,WOLB.0323.00021,1,234876,236345,+,1469
81,WOLB.0323.00043,1,243031,244500,+,1469
81,WOLB.0323.00020,1,269530,270994,+,1464
81,WOLB.0323.00122,1,240170,241639,+,1469
81,WOLB.0323.00118,1,247140,248609,+,1469
81,WOLB.0323.00004,1,233971,235440,+,1469
81,WOLB.0323.00011,1,985125,986594,+,1469
81,WOLB.0323.00035,1,267086,268550,+,1464
81,WOLB.0323.00032,1,874043,875512,-,1469
81,WOLB.0323.00012,1,267172,268636,+,1464
81,WOLB.0323.00018,1,280240,281709,+,1469
81,WOLB.0323.00025,1,704808,706277,+,1469
81,WOLB.0323.00010,1,249037,250506,+,1469
81,WOLB.0323.00068,1,200805,202274,-,1469
81,WOLB.0323.00128,1,244515,245984,+,1469
81,WOLB.0323.00158,1,915799,917268,+,1469
81,WOLB.0323.00017,1,234017,235486,+,1469
81,WOLB.0323.00104,1,269486,270950,+,1464
81,WOLB.0323.00007,1,1225494,1226963,-,1469
81,WOLB.0323.00001,1,244990,246450,+,1460
81,WOLB.0323.00100,1,267186,268650,+,1464
81,WOLB.0323.00070,1,243030,244499,+,1469
81,WOLB.0323.00006,1,347353,348822,-,1469
81,WOLB.0323.00042,1,254697,256166,+,1469
81,WOLB.0323.00119,1,860116,861585,-,1469
81,WOLB.0323.00149,1,229764,231233,-,1469
81,WOLB.0323.00014,1,245706,247175,+,1469
81,WOLB.0323.00096,1,956864,958333,+,1469
82,WOLB.0323.00090,1,241772,245393,+,3621
82,WOLB.0323.00002,1,248112,251724,+,3612
82,WOLB.0323.00138,1,362413,366034,-,3621
82,WOLB.0323.00132,1,1168728,1172340,-,3612
82,WOLB.0323.00143,1,1064045,1067652,-,3607
82,WOLB.0323.00106,1,1064048,1067655,-,3607
82,WOLB.0323.00121,1,236116,239737,+,3621
82,WOLB.0323.00135,1,84801,88422,-,3621
82,WOLB.0323.00103,1,247531,251137,+,3606
82,WOLB.0323.00107,1,247529,251135,+,3606
82,WOLB.0323.00019,1,852774,856383,-,3609
82,WOLB.0323.00060,1,1381689,1385310,-,3621
82,WOLB.0323.00074,1,712375,715961,-,3586
82,WOLB.0323.00120,1,691902,695488,-,3586
82,WOLB.0323.00039,1,567891,571500,-,3609
82,WOLB.0323.00041,1,921544,925130,+,3586
82,WOLB.0323.00031,1,993185,996792,+,3607
82,WOLB.0323.00056,1,277089,280710,+,3621
82,WOLB.0323.00142,1,237878,241499,+,3621
82,WOLB.0323.00023,1,1133474,1137086,+,3612
82,WOLB.0323.00153,1,243423,247044,+,3621
82,WOLB.0323.00093,1,386305,389831,+,3526
82,WOLB.0323.00088,1,269757,273378,+,3621
82,WOLB.0323.00008,1,194832,198441,+,3609
82,WOLB.0323.00024,1,1916457,1920078,-,3621
82,WOLB.0323.00064,1,1383121,1386739,+,3618
82,WOLB.0323.00030,1,1521145,1524763,-,3618
82,WOLB.0323.00105,1,247529,251135,+,3606
82,WOLB.0323.00133,1,596100,599712,-,3612
82,WOLB.0323.00084,1,458966,462587,-,3621
82,WOLB.0323.00021,1,237451,241072,+,3621
82,WOLB.0323.00043,1,245630,249242,+,3612
82,WOLB.0323.00020,1,272100,275721,+,3621
82,WOLB.0323.00122,1,242745,246366,+,3621
82,WOLB.0323.00118,1,249715,253417,+,3702
82,WOLB.0323.00004,1,236546,240167,+,3621
82,WOLB.0323.00011,1,987700,991321,+,3621
82,WOLB.0323.00035,1,269656,273277,+,3621
82,WOLB.0323.00032,1,869316,872937,-,3621
82,WOLB.0323.00012,1,269742,273363,+,3621
82,WOLB.0323.00018,1,282839,286451,+,3612
82,WOLB.0323.00025,1,707377,710984,+,3607
82,WOLB.0323.00010,1,251636,255248,+,3612
82,WOLB.0323.00068,1,196078,199699,-,3621
82,WOLB.0323.00128,1,247114,250726,+,3612
82,WOLB.0323.00158,1,918374,921995,+,3621
82,WOLB.0323.00017,1,236592,240213,+,3621
82,WOLB.0323.00104,1,272056,275677,+,3621
82,WOLB.0323.00007,1,1220767,1224388,-,3621
82,WOLB.0323.00001,1,247529,251135,+,3606
82,WOLB.0323.00100,1,269756,273377,+,3621
82,WOLB.0323.00070,1,245629,249241,+,3612
82,WOLB.0323.00006,1,342634,346241,-,3607
82,WOLB.0323.00042,1,257278,260899,+,3621
82,WOLB.0323.00119,1,855428,859037,-,3609
82,WOLB.0323.00149,1,225037,228658,-,3621
82,WOLB.0323.00014,1,248305,251917,+,3612
82,WOLB.0323.00096,1,959447,963033,+,3586
83,WOLB.0323.00090,1,249103,251316,+,2213
83,WOLB.0323.00002,1,255482,257690,+,2208
83,WOLB.0323.00138,1,356506,358703,-,2197
83,WOLB.0323.00132,1,68214,70428,+,2214
83,WOLB.0323.00143,1,1059065,1061285,-,2220
83,WOLB.0323.00106,1,1059068,1061288,-,2220
83,WOLB.0323.00121,1,243444,245657,+,2213
83,WOLB.0323.00135,1,78812,81022,-,2210
83,WOLB.0323.00103,1,291174,293392,-,2218
83,WOLB.0323.00107,1,291173,293391,-,2218
83,WOLB.0323.00019,1,846858,849066,-,2208
83,WOLB.0323.00060,1,1375769,1377979,-,2210
83,WOLB.0323.00074,1,640119,642334,+,2215
83,WOLB.0323.00120,1,626290,628505,+,2215
83,WOLB.0323.00039,1,561975,564183,-,2208
83,WOLB.0323.00041,1,988527,990742,-,2215
83,WOLB.0323.00031,1,999552,1001772,+,2220
83,WOLB.0323.00056,1,284420,286630,+,2210
83,WOLB.0323.00142,1,245206,247419,+,2213
83,WOLB.0323.00023,1,1140856,1143070,+,2214
83,WOLB.0323.00153,1,250754,252967,+,2213
83,WOLB.0323.00093,1,1109711,1111926,+,2215
83,WOLB.0323.00088,1,277159,279372,+,2213
83,WOLB.0323.00008,1,965505,967723,+,2218
83,WOLB.0323.00024,1,1906112,1908326,-,2214
83,WOLB.0323.00064,1,1390520,1392733,+,2213
83,WOLB.0323.00030,1,1515150,1517363,-,2213
83,WOLB.0323.00105,1,291175,293393,-,2218
83,WOLB.0323.00133,1,575332,577546,-,2214
83,WOLB.0323.00084,1,453059,455256,-,2197
83,WOLB.0323.00021,1,244782,246979,+,2197
83,WOLB.0323.00043,1,253000,255208,+,2208
83,WOLB.0323.00020,1,279502,281715,+,2213
83,WOLB.0323.00122,1,250076,252289,+,2213
83,WOLB.0323.00118,1,257127,259340,+,2213
83,WOLB.0323.00004,1,243874,246087,+,2213
83,WOLB.0323.00011,1,995028,997241,+,2213
83,WOLB.0323.00035,1,277058,279271,+,2213
83,WOLB.0323.00032,1,863409,865606,-,2197
83,WOLB.0323.00012,1,277144,279357,+,2213
83,WOLB.0323.00018,1,290224,292436,+,2212
83,WOLB.0323.00025,1,667767,669981,-,2214
83,WOLB.0323.00010,1,259030,261241,+,2211
83,WOLB.0323.00068,1,190171,192368,-,2197
83,WOLB.0323.00128,1,254484,256692,+,2208
83,WOLB.0323.00158,1,925702,927915,+,2213
83,WOLB.0323.00017,1,243920,246133,+,2213
83,WOLB.0323.00104,1,279458,281671,+,2213
83,WOLB.0323.00007,1,1214847,1217057,-,2210
83,WOLB.0323.00001,1,291175,293393,-,2218
83,WOLB.0323.00100,1,277158,279371,+,2213
83,WOLB.0323.00070,1,252999,255207,+,2208
83,WOLB.0323.00006,1,337654,339874,-,2220
83,WOLB.0323.00042,1,267977,270188,+,2211
83,WOLB.0323.00119,1,849512,851720,-,2208
83,WOLB.0323.00149,1,219117,221330,-,2213
83,WOLB.0323.00014,1,255675,257883,+,2208
83,WOLB.0323.00096,1,1026430,1028645,-,2215
84,WOLB.0323.00090,1,251512,252697,+,1185
84,WOLB.0323.00002,1,257886,259072,+,1186
84,WOLB.0323.00138,1,355365,356484,-,1119
84,WOLB.0323.00132,1,70624,71810,+,1186
84,WOLB.0323.00143,1,1057684,1058858,-,1174
84,WOLB.0323.00106,1,1057687,1058861,-,1174
84,WOLB.0323.00121,1,245853,247039,+,1186
84,WOLB.0323.00135,1,77428,78613,-,1185
84,WOLB.0323.00103,1,289793,290978,-,1185
84,WOLB.0323.00107,1,289792,290977,-,1185
84,WOLB.0323.00019,1,845585,846770,-,1185
84,WOLB.0323.00060,1,1374385,1375570,-,1185
84,WOLB.0323.00074,1,642530,643715,+,1185
84,WOLB.0323.00120,1,628701,629886,+,1185
84,WOLB.0323.00039,1,560702,561887,-,1185
84,WOLB.0323.00041,1,987146,988331,-,1185
84,WOLB.0323.00031,1,1001979,1003153,+,1174
84,WOLB.0323.00056,1,286829,288014,+,1185
84,WOLB.0323.00142,1,247615,248801,+,1186
84,WOLB.0323.00023,1,1144754,1145940,+,1186
84,WOLB.0323.00153,1,253163,254348,+,1185
84,WOLB.0323.00093,1,1112122,1113308,+,1186
84,WOLB.0323.00088,1,279568,280754,+,1186
84,WOLB.0323.00008,1,967919,969094,+,1175
84,WOLB.0323.00024,1,1860348,1861534,-,1186
84,WOLB.0323.00064,1,1392929,1394115,+,1186
84,WOLB.0323.00030,1,1513768,1514954,-,1186
84,WOLB.0323.00105,1,289794,290979,-,1185
84,WOLB.0323.00133,1,573950,575136,-,1186
84,WOLB.0323.00084,1,451918,453037,-,1119
84,WOLB.0323.00021,1,247001,248120,+,1119
84,WOLB.0323.00043,1,255404,256590,+,1186
84,WOLB.0323.00020,1,281911,283097,+,1186
84,WOLB.0323.00122,1,252485,253670,+,1185
84,WOLB.0323.00118,1,259536,260722,+,1186
84,WOLB.0323.00004,1,246283,247469,+,1186
84,WOLB.0323.00011,1,997437,998623,+,1186
84,WOLB.0323.00035,1,279467,280653,+,1186
84,WOLB.0323.00032,1,862268,863387,-,1119
84,WOLB.0323.00012,1,279553,280739,+,1186
84,WOLB.0323.00018,1,292635,293821,+,1186
84,WOLB.0323.00025,1,666386,667571,-,1185
84,WOLB.0323.00010,1,261437,262623,+,1186
84,WOLB.0323.00068,1,189030,190149,-,1119
84,WOLB.0323.00128,1,256888,258074,+,1186
84,WOLB.0323.00158,1,928111,929297,+,1186
84,WOLB.0323.00017,1,246329,247515,+,1186
84,WOLB.0323.00104,1,281867,283053,+,1186
84,WOLB.0323.00007,1,1213463,1214648,-,1185
84,WOLB.0323.00001,1,289794,290979,-,1185
84,WOLB.0323.00100,1,279567,280753,+,1186
84,WOLB.0323.00070,1,255403,256589,+,1186
84,WOLB.0323.00006,1,336273,337447,-,1174
84,WOLB.0323.00042,1,270387,271572,+,1185
84,WOLB.0323.00119,1,848239,849424,-,1185
84,WOLB.0323.00149,1,217735,218921,-,1186
84,WOLB.0323.00014,1,258079,259102,+,1023
84,WOLB.0323.00096,1,1025049,1026234,-,1185
85,WOLB.0323.00090,1,252698,253294,+,596
85,WOLB.0323.00002,1,259073,259669,+,596
85,WOLB.0323.00138,1,354768,355363,-,595
85,WOLB.0323.00132,1,71811,72407,+,596
85,WOLB.0323.00143,1,1057087,1057682,-,595
85,WOLB.0323.00106,1,1057090,1057685,-,595
85,WOLB.0323.00121,1,247040,247636,+,596
85,WOLB.0323.00135,1,76831,77426,-,595
85,WOLB.0323.00103,1,289196,289791,-,595
85,WOLB.0323.00107,1,289195,289790,-,595
85,WOLB.0323.00019,1,844988,845583,-,595
85,WOLB.0323.00060,1,1373788,1374383,-,595
85,WOLB.0323.00074,1,643716,644315,+,599
85,WOLB.0323.00120,1,629887,630486,+,599
85,WOLB.0323.00039,1,560105,560700,-,595
85,WOLB.0323.00041,1,986546,987144,-,598
85,WOLB.0323.00031,1,1003154,1003750,+,596
85,WOLB.0323.00056,1,288015,288611,+,596
85,WOLB.0323.00142,1,248802,249398,+,596
85,WOLB.0323.00023,1,1145941,1146537,+,596
85,WOLB.0323.00153,1,254349,254945,+,596
85,WOLB.0323.00093,1,1113309,1113905,+,596
85,WOLB.0323.00088,1,280755,281351,+,596
85,WOLB.0323.00008,1,970199,970809,+,610
85,WOLB.0323.00024,1,1859751,1860346,-,595
85,WOLB.0323.00064,1,1394116,1394712,+,596
85,WOLB.0323.00030,1,1513171,1513766,-,595
85,WOLB.0323.00105,1,289197,289792,-,595
85,WOLB.0323.00133,1,573353,573948,-,595
85,WOLB.0323.00084,1,451321,451916,-,595
85,WOLB.0323.00021,1,248121,248717,+,596
85,WOLB.0323.00043,1,256591,257187,+,596
85,WOLB.0323.00020,1,283098,283694,+,596
85,WOLB.0323.00122,1,253671,254267,+,596
85,WOLB.0323.00118,1,260723,261319,+,596
85,WOLB.0323.00004,1,247470,248066,+,596
85,WOLB.0323.00011,1,998624,999220,+,596
85,WOLB.0323.00035,1,280654,281250,+,596
85,WOLB.0323.00032,1,861671,862266,-,595
85,WOLB.0323.00012,1,280740,281336,+,596
85,WOLB.0323.00018,1,293822,294418,+,596
85,WOLB.0323.00025,1,665789,666384,-,595
85,WOLB.0323.00010,1,262624,263220,+,596
85,WOLB.0323.00068,1,188433,189028,-,595
85,WOLB.0323.00128,1,258075,258671,+,596
85,WOLB.0323.00158,1,929298,929894,+,596
85,WOLB.0323.00017,1,247516,248112,+,596
85,WOLB.0323.00104,1,283054,283650,+,596
85,WOLB.0323.00007,1,1212866,1213461,-,595
85,WOLB.0323.00001,1,289197,289792,-,595
85,WOLB.0323.00100,1,280754,281350,+,596
85,WOLB.0323.00070,1,256590,257186,+,596
85,WOLB.0323.00006,1,335676,336271,-,595
85,WOLB.0323.00042,1,271573,272169,+,596
85,WOLB.0323.00119,1,847642,848237,-,595
85,WOLB.0323.00149,1,217138,217733,-,595
85,WOLB.0323.00014,1,259103,259699,+,596
85,WOLB.0323.00096,1,1024449,1025047,-,598
86,WOLB.0323.00090,1,257003,265103,+,8100
86,WOLB.0323.00002,1,265347,273452,+,8105
86,WOLB.0323.00138,1,342196,349963,-,7767
86,WOLB.0323.00132,1,78067,86181,+,8114
86,WOLB.0323.00143,1,1045742,1053836,-,8094
86,WOLB.0323.00106,1,1045745,1053839,-,8094
86,WOLB.0323.00121,1,250789,258554,+,7765
86,WOLB.0323.00135,1,65910,73675,-,7765
86,WOLB.0323.00103,1,327778,335526,+,7748
86,WOLB.0323.00107,1,327777,335525,+,7748
86,WOLB.0323.00019,1,833814,841925,-,8111
86,WOLB.0323.00060,1,1542512,1550279,-,7767
86,WOLB.0323.00074,1,651629,659393,+,7764
86,WOLB.0323.00120,1,637800,645564,+,7764
86,WOLB.0323.00039,1,548930,557041,-,8111
86,WOLB.0323.00041,1,971468,979232,-,7764
86,WOLB.0323.00031,1,1007001,1015095,+,8094
86,WOLB.0323.00056,1,293416,301183,+,7767
86,WOLB.0323.00142,1,252551,260316,+,7765
86,WOLB.0323.00023,1,1152184,1160298,+,8114
86,WOLB.0323.00153,1,260304,268404,+,8100
86,WOLB.0323.00093,1,1117056,1124820,+,7764
86,WOLB.0323.00088,1,284507,292611,+,8104
86,WOLB.0323.00008,1,973712,981458,+,7746
86,WOLB.0323.00024,1,1845975,1854089,-,8114
86,WOLB.0323.00064,1,1400369,1408483,+,8114
86,WOLB.0323.00030,1,1499403,1507514,-,8111
86,WOLB.0323.00105,1,327779,335527,+,7748
86,WOLB.0323.00133,1,562069,570189,-,8120
86,WOLB.0323.00084,1,438749,446516,-,7767
86,WOLB.0323.00021,1,253522,261289,+,7767
86,WOLB.0323.00043,1,264182,272287,+,8105
86,WOLB.0323.00020,1,286850,294954,+,8104
86,WOLB.0323.00122,1,257978,266078,+,8100
86,WOLB.0323.00118,1,265031,272794,+,7763
86,WOLB.0323.00004,1,251219,258984,+,7765
86,WOLB.0323.00011,1,1002373,1010138,+,7765
86,WOLB.0323.00035,1,284406,292510,+,8104
86,WOLB.0323.00032,1,848981,856748,-,7767
86,WOLB.0323.00012,1,284492,292596,+,8104
86,WOLB.0323.00018,1,299983,308088,+,8105
86,WOLB.0323.00025,1,623970,632034,+,8064
86,WOLB.0323.00010,1,268854,276959,+,8105
86,WOLB.0323.00068,1,175743,183510,-,7767
86,WOLB.0323.00128,1,264386,272491,+,8105
86,WOLB.0323.00158,1,933047,940812,+,7765
86,WOLB.0323.00017,1,251265,259030,+,7765
86,WOLB.0323.00104,1,286806,294910,+,8104
86,WOLB.0323.00007,1,1200294,1208061,-,7767
86,WOLB.0323.00001,1,327779,335527,+,7748
86,WOLB.0323.00100,1,284506,292610,+,8104
86,WOLB.0323.00070,1,262901,271006,+,8105
86,WOLB.0323.00006,1,324325,332419,-,8094
86,WOLB.0323.00042,1,277749,285863,+,8114
86,WOLB.0323.00119,1,836468,844579,-,8111
86,WOLB.0323.00149,1,206220,213985,-,7765
86,WOLB.0323.00014,1,324017,332122,+,8105
86,WOLB.0323.00096,1,1009371,1017135,-,7764
87,WOLB.0323.00090,1,266593,267220,+,627
87,WOLB.0323.00002,1,275014,275630,+,616
87,WOLB.0323.00138,1,340039,340666,-,627
87,WOLB.0323.00132,1,87641,88257,+,616
87,WOLB.0323.00143,1,1043620,1044247,-,627
87,WOLB.0323.00106,1,1043623,1044250,-,627
87,WOLB.0323.00121,1,260083,260699,+,616
87,WOLB.0323.00135,1,63844,64471,-,627
87,WOLB.0323.00103,1,337536,338163,+,627
87,WOLB.0323.00107,1,337535,338162,+,627
87,WOLB.0323.00019,1,831763,832390,-,627
87,WOLB.0323.00060,1,1540405,1541021,-,616
87,WOLB.0323.00074,1,660859,661486,+,627
87,WOLB.0323.00120,1,647030,647657,+,627
87,WOLB.0323.00039,1,546879,547506,-,627
87,WOLB.0323.00041,1,969375,970002,-,627
87,WOLB.0323.00031,1,1016590,1017217,+,627
87,WOLB.0323.00056,1,302674,303301,+,627
87,WOLB.0323.00142,1,261845,262472,+,627
87,WOLB.0323.00023,1,1161766,1162381,+,615
87,WOLB.0323.00153,1,269894,270521,+,627
87,WOLB.0323.00093,1,1126340,1126956,+,616
87,WOLB.0323.00088,1,294144,294760,+,616
87,WOLB.0323.00008,1,982883,983510,+,627
87,WOLB.0323.00024,1,1843833,1844436,-,603
87,WOLB.0323.00064,1,1409971,1410587,+,616
87,WOLB.0323.00030,1,1497300,1497916,-,616
87,WOLB.0323.00105,1,337537,338164,+,627
87,WOLB.0323.00133,1,560002,560605,-,603
87,WOLB.0323.00084,1,436619,437219,-,600
87,WOLB.0323.00021,1,262819,263435,+,616
87,WOLB.0323.00043,1,273849,274476,+,627
87,WOLB.0323.00020,1,296487,297103,+,616
87,WOLB.0323.00122,1,267568,268184,+,616
87,WOLB.0323.00118,1,274294,274921,+,627
87,WOLB.0323.00004,1,260513,261140,+,627
87,WOLB.0323.00011,1,1011667,1012294,+,627
87,WOLB.0323.00035,1,294043,294670,+,627
87,WOLB.0323.00032,1,846824,847451,-,627
87,WOLB.0323.00012,1,294129,294745,+,616
87,WOLB.0323.00018,1,309564,310191,+,627
87,WOLB.0323.00010,1,278458,279074,+,616
87,WOLB.0323.00068,1,173597,174213,-,616
87,WOLB.0323.00128,1,274054,274681,+,627
87,WOLB.0323.00158,1,942341,942968,+,627
87,WOLB.0323.00017,1,260559,261175,+,616
87,WOLB.0323.00104,1,296443,297070,+,627
87,WOLB.0323.00007,1,1198265,1198803,-,538
87,WOLB.0323.00001,1,337537,338164,+,627
87,WOLB.0323.00100,1,294143,294759,+,616
87,WOLB.0323.00070,1,272569,273185,+,616
87,WOLB.0323.00006,1,322203,322830,-,627
87,WOLB.0323.00042,1,287386,288002,+,616
87,WOLB.0323.00119,1,834417,835044,-,627
87,WOLB.0323.00149,1,204064,204691,-,627
87,WOLB.0323.00014,1,333684,334300,+,616
87,WOLB.0323.00096,1,1007278,1007905,-,627
88,WOLB.0323.00090,1,267252,269968,+,2716
88,WOLB.0323.00002,1,350645,353367,+,2722
88,WOLB.0323.00138,1,337291,340013,-,2722
88,WOLB.0323.00132,1,218898,221620,+,2722
88,WOLB.0323.00143,1,1040872,1043588,-,2716
88,WOLB.0323.00106,1,1040875,1043591,-,2716
88,WOLB.0323.00121,1,337789,340511,+,2722
88,WOLB.0323.00135,1,61096,63812,-,2716
88,WOLB.0323.00103,1,338189,340911,+,2722
88,WOLB.0323.00107,1,338188,340910,+,2722
88,WOLB.0323.00019,1,829014,831737,-,2723
88,WOLB.0323.00060,1,1709932,1712648,+,2716
88,WOLB.0323.00074,1,661512,664234,+,2722
88,WOLB.0323.00120,1,647683,650405,+,2722
88,WOLB.0323.00039,1,544130,546853,-,2723
88,WOLB.0323.00041,1,966627,969349,-,2722
88,WOLB.0323.00031,1,1017249,1019965,+,2716
88,WOLB.0323.00056,1,303333,306049,+,2716
88,WOLB.0323.00142,1,262498,265220,+,2722
88,WOLB.0323.00023,1,1242267,1244946,+,2679
88,WOLB.0323.00153,1,270553,273269,+,2716
88,WOLB.0323.00093,1,431338,434011,-,2673
88,WOLB.0323.00088,1,369205,371927,+,2722
88,WOLB.0323.00008,1,983536,986258,+,2722
88,WOLB.0323.00024,1,740411,743129,+,2718
88,WOLB.0323.00064,1,24095,26817,+,2722
88,WOLB.0323.00030,1,1385510,1388232,-,2722
88,WOLB.0323.00105,1,338190,340912,+,2722
88,WOLB.0323.00133,1,590196,592907,-,2711
88,WOLB.0323.00084,1,431544,434266,-,2722
88,WOLB.0323.00021,1,278787,281509,-,2722
88,WOLB.0323.00043,1,274502,277224,+,2722
88,WOLB.0323.00020,1,338983,341705,+,2722
88,WOLB.0323.00122,1,352210,354932,+,2722
88,WOLB.0323.00118,1,274947,277669,+,2722
88,WOLB.0323.00004,1,261166,263888,+,2722
88,WOLB.0323.00011,1,1012320,1015042,+,2722
88,WOLB.0323.00035,1,294696,297418,+,2722
88,WOLB.0323.00032,1,844076,846798,-,2722
88,WOLB.0323.00012,1,370357,373079,+,2722
88,WOLB.0323.00018,1,310217,312939,+,2722
88,WOLB.0323.00025,1,606261,608978,-,2717
88,WOLB.0323.00010,1,1222398,1225120,-,2722
88,WOLB.0323.00068,1,504911,507633,-,2722
88,WOLB.0323.00128,1,274707,277429,+,2722
88,WOLB.0323.00158,1,942994,945716,+,2722
88,WOLB.0323.00017,1,336790,339512,+,2722
88,WOLB.0323.00104,1,297096,299818,+,2722
88,WOLB.0323.00007,1,1195517,1198233,-,2716
88,WOLB.0323.00001,1,338190,340912,+,2722
88,WOLB.0323.00100,1,445950,448672,+,2722
88,WOLB.0323.00070,1,340810,343532,+,2722
88,WOLB.0323.00006,1,319455,322171,-,2716
88,WOLB.0323.00042,1,366539,369260,+,2721
88,WOLB.0323.00119,1,831668,834391,-,2723
88,WOLB.0323.00149,1,201316,204038,-,2722
88,WOLB.0323.00014,1,369012,371734,+,2722
88,WOLB.0323.00096,1,1004530,1007252,-,2722
89,WOLB.0323.00090,1,269969,275700,+,5731
89,WOLB.0323.00002,1,353368,359099,+,5731
89,WOLB.0323.00138,1,331559,337289,-,5730
89,WOLB.0323.00132,1,221621,227352,+,5731
89,WOLB.0323.00143,1,1035140,1040870,-,5730
89,WOLB.0323.00106,1,1035143,1040873,-,5730
89,WOLB.0323.00121,1,340512,346243,+,5731
89,WOLB.0323.00135,1,55363,61094,-,5731
89,WOLB.0323.00103,1,340912,346643,+,5731
89,WOLB.0323.00107,1,340911,346642,+,5731
89,WOLB.0323.00019,1,823282,829012,-,5730
89,WOLB.0323.00060,1,1712649,1718380,+,5731
89,WOLB.0323.00074,1,664235,669966,+,5731
89,WOLB.0323.00120,1,650406,656137,+,5731
89,WOLB.0323.00039,1,538398,544128,-,5730
89,WOLB.0323.00041,1,960895,966625,-,5730
89,WOLB.0323.00031,1,1019966,1025697,+,5731
89,WOLB.0323.00056,1,306050,311781,+,5731
89,WOLB.0323.00142,1,265221,270952,+,5731
89,WOLB.0323.00023,1,1246385,1252131,+,5746
89,WOLB.0323.00153,1,273270,279001,+,5731
89,WOLB.0323.00093,1,425606,431336,-,5730
89,WOLB.0323.00088,1,371928,377659,+,5731
89,WOLB.0323.00008,1,986259,991990,+,5731
89,WOLB.0323.00024,1,743130,748861,+,5731
89,WOLB.0323.00064,1,26818,32549,+,5731
89,WOLB.0323.00030,1,1379778,1385508,-,5730
89,WOLB.0323.00105,1,340913,346644,+,5731
89,WOLB.0323.00133,1,584464,590194,-,5730
89,WOLB.0323.00084,1,425812,431542,-,5730
89,WOLB.0323.00021,1,273055,278785,-,5730
89,WOLB.0323.00043,1,277225,282956,+,5731
89,WOLB.0323.00020,1,341706,347437,+,5731
89,WOLB.0323.00122,1,354933,360664,+,5731
89,WOLB.0323.00118,1,277670,283401,+,5731
89,WOLB.0323.00004,1,263889,269620,+,5731
89,WOLB.0323.00011,1,1015043,1020774,+,5731
89,WOLB.0323.00035,1,297419,303150,+,5731
89,WOLB.0323.00032,1,838344,844074,-,5730
89,WOLB.0323.00012,1,373080,378811,+,5731
89,WOLB.0323.00018,1,312940,318671,+,5731
89,WOLB.0323.00025,1,600529,606259,-,5730
89,WOLB.0323.00010,1,1216666,1222396,-,5730
89,WOLB.0323.00068,1,499179,504909,-,5730
89,WOLB.0323.00128,1,277430,283161,+,5731
89,WOLB.0323.00158,1,945717,951448,+,5731
89,WOLB.0323.00017,1,339513,345244,+,5731
89,WOLB.0323.00104,1,299819,305550,+,5731
89,WOLB.0323.00007,1,1189785,1195515,-,5730
89,WOLB.0323.00001,1,340913,346644,+,5731
89,WOLB.0323.00100,1,448673,454404,+,5731
89,WOLB.0323.00070,1,343533,349264,+,5731
89,WOLB.0323.00006,1,313723,319453,-,5730
89,WOLB.0323.00042,1,369261,374992,+,5731
89,WOLB.0323.00119,1,825936,831666,-,5730
89,WOLB.0323.00149,1,195584,201314,-,5730
89,WOLB.0323.00014,1,371735,377455,+,5720
89,WOLB.0323.00096,1,998798,1004528,-,5730
90,WOLB.0323.00090,1,275988,276721,+,733
90,WOLB.0323.00002,1,359387,360136,+,749
90,WOLB.0323.00138,1,326997,327728,-,731
90,WOLB.0323.00132,1,227640,228373,+,733
90,WOLB.0323.00143,1,1034118,1034852,-,734
90,WOLB.0323.00106,1,1034121,1034855,-,734
90,WOLB.0323.00121,1,346531,347264,+,733
90,WOLB.0323.00135,1,54341,55075,-,734
90,WOLB.0323.00103,1,346930,347663,+,733
90,WOLB.0323.00107,1,346929,347662,+,733
90,WOLB.0323.00019,1,822260,822994,-,734
90,WOLB.0323.00060,1,1718668,1719401,+,733
90,WOLB.0323.00074,1,670254,670987,+,733
90,WOLB.0323.00120,1,656425,657158,+,733
90,WOLB.0323.00039,1,537376,538110,-,734
90,WOLB.0323.00041,1,959873,960607,-,734
90,WOLB.0323.00031,1,1025985,1026718,+,733
90,WOLB.0323.00056,1,314839,315570,+,731
90,WOLB.0323.00142,1,271240,271973,+,733
90,WOLB.0323.00023,1,1252419,1253152,+,733
90,WOLB.0323.00153,1,279289,280022,+,733
90,WOLB.0323.00093,1,424584,425318,-,734
90,WOLB.0323.00088,1,377947,378680,+,733
90,WOLB.0323.00008,1,992278,993011,+,733
90,WOLB.0323.00024,1,749149,749882,+,733
90,WOLB.0323.00064,1,32837,33570,+,733
90,WOLB.0323.00030,1,1378756,1379490,-,734
90,WOLB.0323.00105,1,346931,347664,+,733
90,WOLB.0323.00133,1,583158,583886,-,728
90,WOLB.0323.00084,1,422378,423109,-,731
90,WOLB.0323.00021,1,642045,642776,+,731
90,WOLB.0323.00043,1,283244,283977,+,733
90,WOLB.0323.00020,1,347725,348458,+,733
90,WOLB.0323.00122,1,360952,361685,+,733
90,WOLB.0323.00118,1,283689,284422,+,733
90,WOLB.0323.00004,1,269908,270641,+,733
90,WOLB.0323.00011,1,1021062,1021795,+,733
90,WOLB.0323.00035,1,303438,304171,+,733
90,WOLB.0323.00032,1,835670,836401,-,731
90,WOLB.0323.00012,1,379099,379832,+,733
90,WOLB.0323.00018,1,318959,319692,+,733
90,WOLB.0323.00025,1,599507,600241,-,734
90,WOLB.0323.00010,1,1215644,1216378,-,734
90,WOLB.0323.00068,1,494403,495134,-,731
90,WOLB.0323.00128,1,283449,284198,+,749
90,WOLB.0323.00158,1,951736,952469,+,733
90,WOLB.0323.00017,1,345532,346265,+,733
90,WOLB.0323.00104,1,305838,306571,+,733
90,WOLB.0323.00007,1,1188763,1189497,-,734
90,WOLB.0323.00001,1,346931,347664,+,733
90,WOLB.0323.00100,1,454692,455425,+,733
90,WOLB.0323.00070,1,349552,350285,+,733
90,WOLB.0323.00006,1,312701,313435,-,734
90,WOLB.0323.00042,1,375280,376013,+,733
90,WOLB.0323.00119,1,824914,825648,-,734
90,WOLB.0323.00149,1,194562,195296,-,734
90,WOLB.0323.00014,1,380066,380799,+,733
90,WOLB.0323.00096,1,997776,998510,-,734
91,WOLB.0323.00090,1,277306,278441,+,1135
91,WOLB.0323.00002,1,362079,363223,+,1144
91,WOLB.0323.00138,1,325283,326418,-,1135
91,WOLB.0323.00132,1,228956,230091,+,1135
91,WOLB.0323.00143,1,1032438,1033571,-,1133
91,WOLB.0323.00106,1,1032441,1033574,-,1133
91,WOLB.0323.00121,1,347849,348993,+,1144
91,WOLB.0323.00135,1,52615,53759,-,1144
91,WOLB.0323.00103,1,348242,349373,+,1131
91,WOLB.0323.00107,1,348241,349372,+,1131
91,WOLB.0323.00019,1,1079016,1080146,-,1130
91,WOLB.0323.00060,1,1719986,1721121,+,1135
91,WOLB.0323.00074,1,671570,672714,+,1144
91,WOLB.0323.00120,1,657741,658885,+,1144
91,WOLB.0323.00039,1,535735,536870,-,1135
91,WOLB.0323.00041,1,958147,959291,-,1144
91,WOLB.0323.00031,1,1027266,1028399,+,1133
91,WOLB.0323.00056,1,316155,317290,+,1135
91,WOLB.0323.00142,1,272558,273702,+,1144
91,WOLB.0323.00023,1,1253735,1254870,+,1135
91,WOLB.0323.00153,1,280607,281742,+,1135
91,WOLB.0323.00093,1,421423,422553,-,1130
91,WOLB.0323.00088,1,379265,380400,+,1135
91,WOLB.0323.00008,1,993589,994724,+,1135
91,WOLB.0323.00024,1,750466,751610,+,1144
91,WOLB.0323.00064,1,34153,35297,+,1144
91,WOLB.0323.00030,1,1377030,1378174,-,1144
91,WOLB.0323.00105,1,348243,349374,+,1131
91,WOLB.0323.00133,1,581438,582582,-,1144
91,WOLB.0323.00084,1,420664,421799,-,1135
91,WOLB.0323.00021,1,643356,644491,+,1135
91,WOLB.0323.00043,1,284559,285703,+,1144
91,WOLB.0323.00020,1,349043,350178,+,1135
91,WOLB.0323.00122,1,362268,363412,+,1144
91,WOLB.0323.00118,1,285008,286143,+,1135
91,WOLB.0323.00004,1,271226,272370,+,1144
91,WOLB.0323.00011,1,1022380,1023524,+,1144
91,WOLB.0323.00035,1,304756,305891,+,1135
91,WOLB.0323.00032,1,833956,835091,-,1135
91,WOLB.0323.00012,1,380417,381552,+,1135
91,WOLB.0323.00018,1,320275,321419,+,1144
91,WOLB.0323.00025,1,597827,598960,-,1133
91,WOLB.0323.00010,1,1213917,1215061,-,1144
91,WOLB.0323.00068,1,492689,493824,-,1135
91,WOLB.0323.00128,1,286141,287285,+,1144
91,WOLB.0323.00158,1,953054,954198,+,1144
91,WOLB.0323.00017,1,346850,347994,+,1144
91,WOLB.0323.00104,1,307156,308291,+,1135
91,WOLB.0323.00007,1,1187044,1188179,-,1135
91,WOLB.0323.00001,1,348243,349374,+,1131
91,WOLB.0323.00100,1,456010,457145,+,1135
91,WOLB.0323.00070,1,350867,352011,+,1144
91,WOLB.0323.00006,1,311021,312154,-,1133
91,WOLB.0323.00042,1,376596,377740,+,1144
91,WOLB.0323.00119,1,1083111,1084241,-,1130
91,WOLB.0323.00149,1,192834,193978,-,1144
91,WOLB.0323.00014,1,381381,382525,+,1144
91,WOLB.0323.00096,1,996050,997194,-,1144
92,WOLB.0323.00090,1,278444,281703,+,3259
92,WOLB.0323.00002,1,363226,366485,+,3259
92,WOLB.0323.00138,1,322020,325280,-,3260
92,WOLB.0323.00132,1,230094,233353,+,3259
92,WOLB.0323.00143,1,1029168,1032428,-,3260
92,WOLB.0323.00106,1,1029171,1032431,-,3260
92,WOLB.0323.00121,1,348996,352255,+,3259
92,WOLB.0323.00135,1,49352,52612,-,3260
92,WOLB.0323.00103,1,352255,355514,+,3259
92,WOLB.0323.00107,1,352254,355513,+,3259
92,WOLB.0323.00019,1,1075753,1079013,-,3260
92,WOLB.0323.00060,1,1721124,1724383,+,3259
92,WOLB.0323.00074,1,672717,675976,+,3259
92,WOLB.0323.00120,1,658888,662147,+,3259
92,WOLB.0323.00039,1,532472,535732,-,3260
92,WOLB.0323.00041,1,954884,958144,-,3260
92,WOLB.0323.00031,1,1028409,1031668,+,3259
92,WOLB.0323.00056,1,317293,320552,+,3259
92,WOLB.0323.00142,1,273705,276964,+,3259
92,WOLB.0323.00023,1,1254873,1258132,+,3259
92,WOLB.0323.00153,1,281745,285004,+,3259
92,WOLB.0323.00093,1,418159,421420,-,3261
92,WOLB.0323.00088,1,380403,383663,+,3260
92,WOLB.0323.00008,1,994727,997987,+,3260
92,WOLB.0323.00024,1,751613,754872,+,3259
92,WOLB.0323.00064,1,35300,38559,+,3259
92,WOLB.0323.00030,1,1373767,1377027,-,3260
92,WOLB.0323.00105,1,352256,355515,+,3259
92,WOLB.0323.00133,1,578183,581435,-,3252
92,WOLB.0323.00084,1,417401,420661,-,3260
92,WOLB.0323.00021,1,644494,647753,+,3259
92,WOLB.0323.00043,1,285706,288965,+,3259
92,WOLB.0323.00020,1,350181,353441,+,3260
92,WOLB.0323.00122,1,363415,366674,+,3259
92,WOLB.0323.00118,1,286146,289405,+,3259
92,WOLB.0323.00004,1,272373,275632,+,3259
92,WOLB.0323.00011,1,1023527,1026786,+,3259
92,WOLB.0323.00035,1,305894,309154,+,3260
92,WOLB.0323.00032,1,830693,833953,-,3260
92,WOLB.0323.00012,1,381555,384815,+,3260
92,WOLB.0323.00018,1,321422,324681,+,3259
92,WOLB.0323.00025,1,594558,597805,-,3247
92,WOLB.0323.00010,1,1210654,1213914,-,3260
92,WOLB.0323.00068,1,489426,492686,-,3260
92,WOLB.0323.00128,1,287288,290547,+,3259
92,WOLB.0323.00158,1,954201,957460,+,3259
92,WOLB.0323.00017,1,347997,351256,+,3259
92,WOLB.0323.00104,1,308294,311554,+,3260
92,WOLB.0323.00007,1,1183781,1187041,-,3260
92,WOLB.0323.00001,1,352256,355515,+,3259
92,WOLB.0323.00100,1,457148,460408,+,3260
92,WOLB.0323.00070,1,352014,355273,+,3259
92,WOLB.0323.00006,1,307751,311011,-,3260
92,WOLB.0323.00042,1,377743,381002,+,3259
92,WOLB.0323.00119,1,1079848,1083108,-,3260
92,WOLB.0323.00149,1,189571,192831,-,3260
92,WOLB.0323.00014,1,382528,385787,+,3259
92,WOLB.0323.00096,1,992787,996047,-,3260
93,WOLB.0323.00090,1,281815,282739,+,924
93,WOLB.0323.00090,1,926013,926936,-,923
93,WOLB.0323.00002,1,366597,367521,+,924
93,WOLB.0323.00002,1,1228041,1228964,-,923
93,WOLB.0323.00138,1,320985,321908,-,923
93,WOLB.0323.00138,1,920443,921367,+,924
93,WOLB.0323.00132,1,233465,234389,+,924
93,WOLB.0323.00132,1,906188,907111,-,923
93,WOLB.0323.00143,1,307823,308747,+,924
93,WOLB.0323.00143,1,1028133,1029056,-,923
93,WOLB.0323.00106,1,307825,308749,+,924
93,WOLB.0323.00106,1,1028136,1029059,-,923
93,WOLB.0323.00121,1,352367,353291,+,924
93,WOLB.0323.00121,1,1191048,1191971,-,923
93,WOLB.0323.00135,1,48317,49240,-,923
93,WOLB.0323.00135,1,708271,709195,+,924
93,WOLB.0323.00103,1,355626,356550,+,924
93,WOLB.0323.00103,1,1046193,1047116,-,923
93,WOLB.0323.00107,1,355625,356549,+,924
93,WOLB.0323.00107,1,1044760,1045683,-,923
93,WOLB.0323.00019,1,344373,345297,+,924
93,WOLB.0323.00019,1,1074718,1075641,-,923
93,WOLB.0323.00060,1,933028,933951,-,923
93,WOLB.0323.00060,1,1724495,1725419,+,924
93,WOLB.0323.00074,1,676088,677012,+,924
93,WOLB.0323.00074,1,1324819,1325743,+,924
93,WOLB.0323.00120,1,662259,663183,+,924
93,WOLB.0323.00120,1,1317094,1318018,+,924
93,WOLB.0323.00039,1,531437,532360,-,923
93,WOLB.0323.00039,1,1128108,1129032,+,924
93,WOLB.0323.00041,1,332450,333373,-,923
93,WOLB.0323.00041,1,953849,954772,-,923
93,WOLB.0323.00031,1,478564,479487,-,923
93,WOLB.0323.00031,1,1031780,1032704,+,924
93,WOLB.0323.00056,1,320664,321588,+,924
93,WOLB.0323.00056,1,978083,979006,-,923
93,WOLB.0323.00142,1,277076,278000,+,924
93,WOLB.0323.00142,1,1069992,1070915,-,923
93,WOLB.0323.00023,1,550578,551497,-,919
93,WOLB.0323.00023,1,1258244,1259164,+,920
93,WOLB.0323.00153,1,285116,286040,+,924
93,WOLB.0323.00153,1,999193,1000116,-,923
93,WOLB.0323.00093,1,417128,418047,-,919
93,WOLB.0323.00093,1,600389,601309,+,920
93,WOLB.0323.00088,1,383775,384699,+,924
93,WOLB.0323.00088,1,1017325,1018248,-,923
93,WOLB.0323.00008,1,323181,324101,+,920
93,WOLB.0323.00008,1,998099,999019,+,920
93,WOLB.0323.00024,1,754984,755908,+,924
93,WOLB.0323.00024,1,1198308,1199232,+,924
93,WOLB.0323.00064,1,38671,39595,+,924
93,WOLB.0323.00064,1,814961,815884,-,923
93,WOLB.0323.00030,1,1372732,1373655,-,923
93,WOLB.0323.00030,1,1429391,1430314,-,923
93,WOLB.0323.00105,1,355627,356551,+,924
93,WOLB.0323.00105,1,1046201,1047124,-,923
93,WOLB.0323.00084,1,416366,417289,-,923
93,WOLB.0323.00084,1,1015914,1016838,+,924
93,WOLB.0323.00021,1,647865,648789,+,924
93,WOLB.0323.00021,1,1347190,1348113,-,923
93,WOLB.0323.00043,1,289077,290001,+,924
93,WOLB.0323.00043,1,1307212,1308135,-,923
93,WOLB.0323.00020,1,353553,354477,+,924
93,WOLB.0323.00020,1,959386,960309,-,923
93,WOLB.0323.00122,1,366786,367710,+,924
93,WOLB.0323.00122,1,510328,511252,+,924
93,WOLB.0323.00118,1,289517,290441,+,924
93,WOLB.0323.00118,1,844479,845402,-,923
93,WOLB.0323.00004,1,275744,276668,+,924
93,WOLB.0323.00004,1,1066905,1067828,-,923
93,WOLB.0323.00011,1,435267,436190,-,923
93,WOLB.0323.00011,1,1026898,1027822,+,924
93,WOLB.0323.00035,1,309266,310190,+,924
93,WOLB.0323.00035,1,955067,955990,-,923
93,WOLB.0323.00032,1,525825,526748,-,923
93,WOLB.0323.00032,1,829658,830581,-,923
93,WOLB.0323.00012,1,384927,385851,+,924
93,WOLB.0323.00012,1,1021438,1022361,-,923
93,WOLB.0323.00018,1,324793,325717,+,924
93,WOLB.0323.00018,1,1070064,1070987,-,923
93,WOLB.0323.00010,1,1209619,1210542,-,923
93,WOLB.0323.00010,1,1357882,1358805,-,923
93,WOLB.0323.00068,1,488391,489314,-,923
93,WOLB.0323.00068,1,823939,824862,-,923
93,WOLB.0323.00128,1,290659,291583,+,924
93,WOLB.0323.00128,1,1214694,1215617,-,923
93,WOLB.0323.00158,1,340847,341763,-,916
93,WOLB.0323.00158,1,957572,958496,+,924
93,WOLB.0323.00017,1,351368,352292,+,924
93,WOLB.0323.00017,1,1055621,1056544,-,923
93,WOLB.0323.00104,1,311666,312590,+,924
93,WOLB.0323.00104,1,995162,996085,-,923
93,WOLB.0323.00007,1,304129,305053,+,924
93,WOLB.0323.00007,1,1182746,1183669,-,923
93,WOLB.0323.00001,1,355627,356551,+,924
93,WOLB.0323.00001,1,1046201,1047124,-,923
93,WOLB.0323.00100,1,460520,461444,+,924
93,WOLB.0323.00100,1,1339867,1340790,-,923
93,WOLB.0323.00070,1,355385,356309,+,924
93,WOLB.0323.00070,1,1546595,1547518,-,923
93,WOLB.0323.00006,1,306716,307639,-,923
93,WOLB.0323.00006,1,912324,913248,+,924
93,WOLB.0323.00042,1,381114,382038,+,924
93,WOLB.0323.00042,1,1022527,1023451,+,924
93,WOLB.0323.00119,1,344258,345182,+,924
93,WOLB.0323.00119,1,1078813,1079736,-,923
93,WOLB.0323.00149,1,188536,189459,-,923
93,WOLB.0323.00149,1,776936,777860,+,924
93,WOLB.0323.00014,1,385899,386823,+,924
93,WOLB.0323.00014,1,1559625,1560548,-,923
93,WOLB.0323.00096,1,344305,345228,-,923
93,WOLB.0323.00096,1,991752,992675,-,923
94,WOLB.0323.00090,1,282741,286099,+,3358
94,WOLB.0323.00002,1,367523,370881,+,3358
94,WOLB.0323.00138,1,317625,320983,-,3358
94,WOLB.0323.00132,1,234391,237749,+,3358
94,WOLB.0323.00143,1,1024773,1028131,-,3358
94,WOLB.0323.00106,1,1024776,1028134,-,3358
94,WOLB.0323.00121,1,353293,356651,+,3358
94,WOLB.0323.00135,1,44957,48315,-,3358
94,WOLB.0323.00103,1,356552,359908,+,3356
94,WOLB.0323.00107,1,356551,359907,+,3356
94,WOLB.0323.00019,1,1071358,1074716,-,3358
94,WOLB.0323.00060,1,1725421,1728764,+,3343
94,WOLB.0323.00074,1,677014,680370,+,3356
94,WOLB.0323.00120,1,663185,666541,+,3356
94,WOLB.0323.00039,1,528077,531435,-,3358
94,WOLB.0323.00041,1,950491,953847,-,3356
94,WOLB.0323.00031,1,1032706,1036064,+,3358
94,WOLB.0323.00056,1,321590,324948,+,3358
94,WOLB.0323.00142,1,278002,281360,+,3358
94,WOLB.0323.00023,1,1259170,1262528,+,3358
94,WOLB.0323.00153,1,286042,289400,+,3358
94,WOLB.0323.00093,1,413765,417122,-,3357
94,WOLB.0323.00088,1,384701,388059,+,3358
94,WOLB.0323.00008,1,999025,1002382,+,3357
94,WOLB.0323.00024,1,755910,759268,+,3358
94,WOLB.0323.00064,1,39597,42955,+,3358
94,WOLB.0323.00030,1,1369372,1372730,-,3358
94,WOLB.0323.00105,1,356553,359909,+,3356
94,WOLB.0323.00133,1,556496,559823,-,3327
94,WOLB.0323.00084,1,413006,416364,-,3358
94,WOLB.0323.00021,1,648791,652149,+,3358
94,WOLB.0323.00043,1,1303852,1307210,-,3358
94,WOLB.0323.00020,1,354479,357837,+,3358
94,WOLB.0323.00122,1,367712,371070,+,3358
94,WOLB.0323.00118,1,290443,293801,+,3358
94,WOLB.0323.00004,1,276670,280028,+,3358
94,WOLB.0323.00011,1,1027824,1031182,+,3358
94,WOLB.0323.00035,1,310192,313550,+,3358
94,WOLB.0323.00032,1,826298,829656,-,3358
94,WOLB.0323.00012,1,385853,389211,+,3358
94,WOLB.0323.00018,1,325719,329077,+,3358
94,WOLB.0323.00025,1,591052,594381,-,3329
94,WOLB.0323.00010,1,1206259,1209617,-,3358
94,WOLB.0323.00068,1,485031,488389,-,3358
94,WOLB.0323.00128,1,291585,294943,+,3358
94,WOLB.0323.00158,1,958498,961856,+,3358
94,WOLB.0323.00017,1,352294,355652,+,3358
94,WOLB.0323.00104,1,312592,315950,+,3358
94,WOLB.0323.00007,1,1179386,1182744,-,3358
94,WOLB.0323.00001,1,356553,359909,+,3356
94,WOLB.0323.00100,1,461446,464804,+,3358
94,WOLB.0323.00070,1,356311,359669,+,3358
94,WOLB.0323.00006,1,303356,306714,-,3358
94,WOLB.0323.00042,1,382040,385396,+,3356
94,WOLB.0323.00119,1,1075453,1078811,-,3358
94,WOLB.0323.00149,1,185176,188534,-,3358
94,WOLB.0323.00014,1,386825,390183,+,3358
94,WOLB.0323.00096,1,988394,991750,-,3356
95,WOLB.0323.00090,1,286100,290359,+,4259
95,WOLB.0323.00002,1,370882,375141,+,4259
95,WOLB.0323.00138,1,313364,317623,-,4259
95,WOLB.0323.00132,1,237750,242009,+,4259
95,WOLB.0323.00143,1,1020512,1024771,-,4259
95,WOLB.0323.00106,1,1020515,1024774,-,4259
95,WOLB.0323.00121,1,356652,360911,+,4259
95,WOLB.0323.00135,1,40696,44955,-,4259
95,WOLB.0323.00103,1,359909,364168,+,4259
95,WOLB.0323.00107,1,359908,364167,+,4259
95,WOLB.0323.00019,1,1067097,1071356,-,4259
95,WOLB.0323.00060,1,1,4275,+,4274
95,WOLB.0323.00074,1,680371,684630,+,4259
95,WOLB.0323.00120,1,666542,670801,+,4259
95,WOLB.0323.00039,1,523816,528075,-,4259
95,WOLB.0323.00041,1,946230,950489,-,4259
95,WOLB.0323.00031,1,1036065,1040324,+,4259
95,WOLB.0323.00056,1,324949,329208,+,4259
95,WOLB.0323.00142,1,281361,285620,+,4259
95,WOLB.0323.00023,1,1262529,1266788,+,4259
95,WOLB.0323.00153,1,289401,293660,+,4259
95,WOLB.0323.00093,1,409504,413763,-,4259
95,WOLB.0323.00088,1,388060,392319,+,4259
95,WOLB.0323.00008,1,1002383,1006642,+,4259
95,WOLB.0323.00024,1,759269,763525,+,4256
95,WOLB.0323.00064,1,42956,47215,+,4259
95,WOLB.0323.00030,1,1365111,1369370,-,4259
95,WOLB.0323.00105,1,359910,364169,+,4259
95,WOLB.0323.00133,1,552232,556494,-,4262
95,WOLB.0323.00084,1,408745,413004,-,4259
95,WOLB.0323.00021,1,652150,656409,+,4259
95,WOLB.0323.00043,1,1299591,1303850,-,4259
95,WOLB.0323.00020,1,357838,362097,+,4259
95,WOLB.0323.00122,1,371071,375330,+,4259
95,WOLB.0323.00118,1,293802,298061,+,4259
95,WOLB.0323.00004,1,280029,284288,+,4259
95,WOLB.0323.00011,1,1031183,1035442,+,4259
95,WOLB.0323.00035,1,313551,317810,+,4259
95,WOLB.0323.00032,1,822037,826296,-,4259
95,WOLB.0323.00012,1,389212,393471,+,4259
95,WOLB.0323.00018,1,329078,333337,+,4259
95,WOLB.0323.00025,1,586791,591050,-,4259
95,WOLB.0323.00010,1,1201998,1206257,-,4259
95,WOLB.0323.00068,1,480770,485029,-,4259
95,WOLB.0323.00128,1,294944,299203,+,4259
95,WOLB.0323.00158,1,961857,966116,+,4259
95,WOLB.0323.00017,1,355653,359912,+,4259
95,WOLB.0323.00104,1,315951,320210,+,4259
95,WOLB.0323.00007,1,1175125,1179384,-,4259
95,WOLB.0323.00001,1,359910,364169,+,4259
95,WOLB.0323.00100,1,464805,469064,+,4259
95,WOLB.0323.00070,1,359670,363929,+,4259
95,WOLB.0323.00006,1,299095,303354,-,4259
95,WOLB.0323.00042,1,385397,389656,+,4259
95,WOLB.0323.00119,1,1071192,1075451,-,4259
95,WOLB.0323.00149,1,180915,185174,-,4259
95,WOLB.0323.00014,1,390184,394443,+,4259
95,WOLB.0323.00096,1,984133,988392,-,4259
96,WOLB.0323.00090,1,290361,294546,+,4185
96,WOLB.0323.00002,1,375143,379328,+,4185
96,WOLB.0323.00138,1,309178,313363,-,4185
96,WOLB.0323.00132,1,242011,246196,+,4185
96,WOLB.0323.00143,1,1016326,1020511,-,4185
96,WOLB.0323.00106,1,1016329,1020514,-,4185
96,WOLB.0323.00121,1,360913,365098,+,4185
96,WOLB.0323.00135,1,36510,40695,-,4185
96,WOLB.0323.00103,1,364170,368355,+,4185
96,WOLB.0323.00107,1,364169,368354,+,4185
96,WOLB.0323.00019,1,1062911,1067096,-,4185
96,WOLB.0323.00060,1,4277,8462,+,4185
96,WOLB.0323.00074,1,684632,688817,+,4185
96,WOLB.0323.00074,1,692269,696428,-,4159
96,WOLB.0323.00120,1,670803,674988,+,4185
96,WOLB.0323.00039,1,519630,523815,-,4185
96,WOLB.0323.00041,1,942044,946229,-,4185
96,WOLB.0323.00031,1,1040326,1044511,+,4185
96,WOLB.0323.00056,1,329210,333395,+,4185
96,WOLB.0323.00142,1,285622,289807,+,4185
96,WOLB.0323.00023,1,1266790,1270975,+,4185
96,WOLB.0323.00153,1,293662,297847,+,4185
96,WOLB.0323.00093,1,405318,409503,-,4185
96,WOLB.0323.00088,1,392321,396506,+,4185
96,WOLB.0323.00008,1,1006644,1010829,+,4185
96,WOLB.0323.00024,1,763527,767692,+,4165
96,WOLB.0323.00064,1,47217,51402,+,4185
96,WOLB.0323.00030,1,1360925,1365110,-,4185
96,WOLB.0323.00105,1,364171,368356,+,4185
96,WOLB.0323.00133,1,548046,552231,-,4185
96,WOLB.0323.00084,1,404559,408744,-,4185
96,WOLB.0323.00021,1,656411,660596,+,4185
96,WOLB.0323.00043,1,1295405,1299590,-,4185
96,WOLB.0323.00020,1,362099,366284,+,4185
96,WOLB.0323.00122,1,375332,379517,+,4185
96,WOLB.0323.00118,1,298063,302248,+,4185
96,WOLB.0323.00004,1,284290,288475,+,4185
96,WOLB.0323.00011,1,1035444,1039629,+,4185
96,WOLB.0323.00035,1,317812,321997,+,4185
96,WOLB.0323.00032,1,817851,822036,-,4185
96,WOLB.0323.00012,1,393473,397658,+,4185
96,WOLB.0323.00018,1,333339,337524,+,4185
96,WOLB.0323.00025,1,582605,586790,-,4185
96,WOLB.0323.00010,1,1197812,1201997,-,4185
96,WOLB.0323.00068,1,476584,480769,-,4185
96,WOLB.0323.00128,1,299205,303390,+,4185
96,WOLB.0323.00158,1,966118,970303,+,4185
96,WOLB.0323.00017,1,359914,364099,+,4185
96,WOLB.0323.00104,1,320212,324397,+,4185
96,WOLB.0323.00007,1,1170939,1175124,-,4185
96,WOLB.0323.00001,1,364171,368356,+,4185
96,WOLB.0323.00100,1,469066,473251,+,4185
96,WOLB.0323.00070,1,363931,368116,+,4185
96,WOLB.0323.00006,1,294909,299094,-,4185
96,WOLB.0323.00042,1,389658,393843,+,4185
96,WOLB.0323.00119,1,1067006,1071191,-,4185
96,WOLB.0323.00149,1,176729,180914,-,4185
96,WOLB.0323.00014,1,394445,398630,+,4185
96,WOLB.0323.00096,1,979947,984132,-,4185
97,WOLB.0323.00090,1,294547,295509,+,962
97,WOLB.0323.00002,1,379329,380291,+,962
97,WOLB.0323.00138,1,308215,309176,-,961
97,WOLB.0323.00132,1,246197,247159,+,962
97,WOLB.0323.00143,1,1015363,1016324,-,961
97,WOLB.0323.00106,1,1015366,1016327,-,961
97,WOLB.0323.00121,1,365099,366061,+,962
97,WOLB.0323.00135,1,35547,36508,-,961
97,WOLB.0323.00103,1,368356,369318,+,962
97,WOLB.0323.00107,1,368355,369317,+,962
97,WOLB.0323.00019,1,1061948,1062909,-,961
97,WOLB.0323.00060,1,8463,9425,+,962
97,WOLB.0323.00074,1,688818,689780,+,962
97,WOLB.0323.00074,1,691304,692267,-,963
97,WOLB.0323.00120,1,674989,675951,+,962
97,WOLB.0323.00039,1,518667,519628,-,961
97,WOLB.0323.00041,1,941081,942042,-,961
97,WOLB.0323.00031,1,1044512,1045474,+,962
97,WOLB.0323.00056,1,333396,334358,+,962
97,WOLB.0323.00142,1,289808,290770,+,962
97,WOLB.0323.00023,1,1270976,1271938,+,962
97,WOLB.0323.00153,1,297848,298810,+,962
97,WOLB.0323.00093,1,404356,405316,-,960
97,WOLB.0323.00088,1,396507,397469,+,962
97,WOLB.0323.00008,1,1010830,1011792,+,962
97,WOLB.0323.00024,1,769180,770157,+,977
97,WOLB.0323.00064,1,51403,52365,+,962
97,WOLB.0323.00030,1,1359962,1360923,-,961
97,WOLB.0323.00105,1,368357,369319,+,962
97,WOLB.0323.00133,1,547083,548044,-,961
97,WOLB.0323.00084,1,403596,404557,-,961
97,WOLB.0323.00021,1,660597,661559,+,962
97,WOLB.0323.00043,1,1294442,1295403,-,961
97,WOLB.0323.00020,1,366285,367247,+,962
97,WOLB.0323.00122,1,379518,380480,+,962
97,WOLB.0323.00118,1,302249,303211,+,962
97,WOLB.0323.00004,1,288476,289438,+,962
97,WOLB.0323.00011,1,1039630,1040592,+,962
97,WOLB.0323.00035,1,321998,322960,+,962
97,WOLB.0323.00032,1,816888,817849,-,961
97,WOLB.0323.00012,1,397659,398621,+,962
97,WOLB.0323.00018,1,337525,338487,+,962
97,WOLB.0323.00025,1,581642,582603,-,961
97,WOLB.0323.00010,1,1196904,1197810,-,906
97,WOLB.0323.00068,1,475621,476582,-,961
97,WOLB.0323.00128,1,303391,304353,+,962
97,WOLB.0323.00158,1,970304,971266,+,962
97,WOLB.0323.00017,1,364100,365062,+,962
97,WOLB.0323.00104,1,324398,325360,+,962
97,WOLB.0323.00007,1,1169976,1170937,-,961
97,WOLB.0323.00001,1,368357,369319,+,962
97,WOLB.0323.00100,1,473252,474214,+,962
97,WOLB.0323.00070,1,368117,369079,+,962
97,WOLB.0323.00006,1,293946,294907,-,961
97,WOLB.0323.00042,1,393844,394806,+,962
97,WOLB.0323.00119,1,1066043,1067004,-,961
97,WOLB.0323.00149,1,175766,176727,-,961
97,WOLB.0323.00014,1,398631,399593,+,962
97,WOLB.0323.00096,1,978984,979945,-,961
98,WOLB.0323.00090,1,297633,299803,+,2170
98,WOLB.0323.00002,1,382221,384389,+,2168
98,WOLB.0323.00138,1,304081,306249,-,2168
98,WOLB.0323.00132,1,249278,251446,+,2168
98,WOLB.0323.00143,1,1011093,1013263,-,2170
98,WOLB.0323.00106,1,1011096,1013266,-,2170
98,WOLB.0323.00121,1,368027,370195,+,2168
98,WOLB.0323.00135,1,31412,33581,-,2169
98,WOLB.0323.00103,1,371243,373413,+,2170
98,WOLB.0323.00107,1,371242,373412,+,2170
98,WOLB.0323.00019,1,1057640,1059808,-,2168
98,WOLB.0323.00060,1,11391,13559,+,2168
98,WOLB.0323.00074,1,698552,700720,+,2168
98,WOLB.0323.00120,1,678079,680247,+,2168
98,WOLB.0323.00039,1,514359,516527,-,2168
98,WOLB.0323.00041,1,936785,938953,-,2168
98,WOLB.0323.00031,1,1047574,1049744,+,2170
98,WOLB.0323.00056,1,336324,338492,+,2168
98,WOLB.0323.00142,1,292736,294904,+,2168
98,WOLB.0323.00023,1,1274062,1276230,+,2168
98,WOLB.0323.00153,1,300934,303104,+,2170
98,WOLB.0323.00093,1,400049,402219,-,2170
98,WOLB.0323.00088,1,399399,401567,+,2168
98,WOLB.0323.00008,1,1013929,1016099,+,2170
98,WOLB.0323.00024,1,772285,774449,+,2164
98,WOLB.0323.00064,1,54489,56657,+,2168
98,WOLB.0323.00030,1,1355670,1357838,-,2168
98,WOLB.0323.00105,1,371244,373414,+,2170
98,WOLB.0323.00133,1,542815,544983,-,2168
98,WOLB.0323.00084,1,399462,401630,-,2168
98,WOLB.0323.00021,1,663525,665693,+,2168
98,WOLB.0323.00043,1,1290343,1292511,-,2168
98,WOLB.0323.00020,1,369177,371345,+,2168
98,WOLB.0323.00122,1,382446,384614,+,2168
98,WOLB.0323.00118,1,305344,307514,+,2170
98,WOLB.0323.00004,1,291404,293572,+,2168
98,WOLB.0323.00011,1,1042558,1044726,+,2168
98,WOLB.0323.00035,1,324890,327058,+,2168
98,WOLB.0323.00032,1,812754,814922,-,2168
98,WOLB.0323.00012,1,400551,402719,+,2168
98,WOLB.0323.00018,1,340543,342711,+,2168
98,WOLB.0323.00025,1,577315,579485,-,2170
98,WOLB.0323.00010,1,1190795,1192963,-,2168
98,WOLB.0323.00068,1,471487,473655,-,2168
98,WOLB.0323.00128,1,306283,308451,+,2168
98,WOLB.0323.00158,1,973232,975400,+,2168
98,WOLB.0323.00017,1,367028,369196,+,2168
98,WOLB.0323.00104,1,327290,329458,+,2168
98,WOLB.0323.00007,1,1165842,1168010,-,2168
98,WOLB.0323.00001,1,371244,373414,+,2170
98,WOLB.0323.00100,1,476144,478312,+,2168
98,WOLB.0323.00070,1,371010,373178,+,2168
98,WOLB.0323.00006,1,289676,291846,-,2170
98,WOLB.0323.00042,1,396736,398904,+,2168
98,WOLB.0323.00119,1,1061735,1063903,-,2168
98,WOLB.0323.00149,1,171632,173800,-,2168
98,WOLB.0323.00014,1,401523,403691,+,2168
98,WOLB.0323.00096,1,974688,976856,-,2168
99,WOLB.0323.00090,1,300714,301650,+,936
99,WOLB.0323.00002,1,385311,386245,+,934
99,WOLB.0323.00138,1,302234,303170,-,936
99,WOLB.0323.00132,1,252100,253029,+,929
99,WOLB.0323.00143,1,1009527,1010463,-,936
99,WOLB.0323.00106,1,1009530,1010466,-,936
99,WOLB.0323.00121,1,371103,372039,+,936
99,WOLB.0323.00135,1,29798,30734,-,936
99,WOLB.0323.00103,1,374207,375143,+,936
99,WOLB.0323.00107,1,374206,375142,+,936
99,WOLB.0323.00019,1,1055775,1056711,-,936
99,WOLB.0323.00060,1,14447,15383,+,936
99,WOLB.0323.00074,1,701925,702861,+,936
99,WOLB.0323.00120,1,681452,682388,+,936
99,WOLB.0323.00039,1,512494,513430,-,936
99,WOLB.0323.00041,1,934644,935580,-,936
99,WOLB.0323.00031,1,1050374,1051310,+,936
99,WOLB.0323.00056,1,339380,340316,+,936
99,WOLB.0323.00142,1,295812,296748,+,936
99,WOLB.0323.00023,1,1277117,1278047,+,930
99,WOLB.0323.00153,1,304015,304951,+,936
99,WOLB.0323.00093,1,397974,398908,-,934
99,WOLB.0323.00088,1,402478,403414,+,936
99,WOLB.0323.00008,1,1017072,1018000,+,928
99,WOLB.0323.00024,1,1646714,1647650,-,936
99,WOLB.0323.00064,1,57568,58498,+,930
99,WOLB.0323.00030,1,1353829,1354759,-,930
99,WOLB.0323.00105,1,374208,375144,+,936
99,WOLB.0323.00133,1,540968,541902,-,934
99,WOLB.0323.00084,1,396517,397453,-,936
99,WOLB.0323.00021,1,667702,668638,+,936
99,WOLB.0323.00043,1,1288487,1289421,-,934
99,WOLB.0323.00020,1,372256,373192,+,936
99,WOLB.0323.00122,1,385525,386461,+,936
99,WOLB.0323.00118,1,308331,309267,+,936
99,WOLB.0323.00004,1,294480,295416,+,936
99,WOLB.0323.00011,1,1045634,1046570,+,936
99,WOLB.0323.00035,1,327969,328905,+,936
99,WOLB.0323.00032,1,1263323,1264259,-,936
99,WOLB.0323.00012,1,403630,404566,+,936
99,WOLB.0323.00018,1,343365,344301,+,936
99,WOLB.0323.00025,1,575749,576685,-,936
99,WOLB.0323.00010,1,1188952,1189884,-,932
99,WOLB.0323.00068,1,468542,469478,-,936
99,WOLB.0323.00128,1,309373,310307,+,934
99,WOLB.0323.00158,1,976308,977244,+,936
99,WOLB.0323.00017,1,370104,371040,+,936
99,WOLB.0323.00104,1,330369,331305,+,936
99,WOLB.0323.00007,1,1164018,1164954,-,936
99,WOLB.0323.00001,1,374208,375144,+,936
99,WOLB.0323.00100,1,479223,480159,+,936
99,WOLB.0323.00070,1,374100,375034,+,934
99,WOLB.0323.00006,1,288110,289046,-,936
99,WOLB.0323.00042,1,399570,400506,+,936
99,WOLB.0323.00119,1,1059870,1060806,-,936
99,WOLB.0323.00149,1,169788,170724,-,936
99,WOLB.0323.00014,1,404613,405547,+,934
99,WOLB.0323.00096,1,972547,973483,-,936
100,WOLB.0323.00090,1,304695,305224,+,529
100,WOLB.0323.00138,1,298659,299188,-,529
100,WOLB.0323.00143,1,41483,41996,-,513
100,WOLB.0323.00106,1,41484,41997,-,513
100,WOLB.0323.00121,1,375084,375613,+,529
100,WOLB.0323.00019,1,1249126,1249656,+,530
100,WOLB.0323.00060,1,18428,18957,+,529
100,WOLB.0323.00039,1,466504,467034,+,530
100,WOLB.0323.00031,1,803953,804466,-,513
100,WOLB.0323.00056,1,343361,343890,+,529
100,WOLB.0323.00142,1,299793,300322,+,529
100,WOLB.0323.00153,1,307996,308525,+,529
100,WOLB.0323.00088,1,406459,406988,+,529
100,WOLB.0323.00133,1,438429,438966,-,537
100,WOLB.0323.00084,1,392942,393471,-,529
100,WOLB.0323.00021,1,671683,672212,+,529
100,WOLB.0323.00020,1,376237,376766,+,529
100,WOLB.0323.00122,1,390609,391137,+,528
100,WOLB.0323.00118,1,168037,168566,-,529
100,WOLB.0323.00118,1,312312,312841,+,529
100,WOLB.0323.00004,1,298461,298990,+,529
100,WOLB.0323.00011,1,1049615,1050144,+,529
100,WOLB.0323.00035,1,331950,332479,+,529
100,WOLB.0323.00032,1,1259748,1260277,-,529
100,WOLB.0323.00012,1,407611,408140,+,529
100,WOLB.0323.00068,1,464967,465496,-,529
100,WOLB.0323.00158,1,980289,980818,+,529
100,WOLB.0323.00017,1,374085,374614,+,529
100,WOLB.0323.00104,1,334350,334879,+,529
100,WOLB.0323.00007,1,1160443,1160972,-,529
100,WOLB.0323.00100,1,483204,483733,+,529
100,WOLB.0323.00006,1,657747,658286,+,539
100,WOLB.0323.00119,1,1240456,1240985,-,529
100,WOLB.0323.00149,1,166213,166742,-,529
101,WOLB.0323.00090,1,305671,307309,+,1638
101,WOLB.0323.00002,1,396415,398053,-,1638
101,WOLB.0323.00138,1,296575,298213,-,1638
101,WOLB.0323.00132,1,359563,361201,+,1638
101,WOLB.0323.00143,1,1004914,1006552,-,1638
101,WOLB.0323.00106,1,1004917,1006555,-,1638
101,WOLB.0323.00121,1,376060,377698,+,1638
101,WOLB.0323.00135,1,25322,26960,-,1638
101,WOLB.0323.00103,1,421249,422887,-,1638
101,WOLB.0323.00107,1,421247,422885,-,1638
101,WOLB.0323.00019,1,1250100,1251738,+,1638
101,WOLB.0323.00060,1,19404,21042,+,1638
101,WOLB.0323.00074,1,607331,608886,+,1555
101,WOLB.0323.00120,1,593502,595057,+,1555
101,WOLB.0323.00039,1,467478,469116,+,1638
101,WOLB.0323.00041,1,1021975,1023530,-,1555
101,WOLB.0323.00031,1,1054285,1055923,+,1638
101,WOLB.0323.00056,1,344337,345975,+,1638
101,WOLB.0323.00142,1,300769,302407,+,1638
101,WOLB.0323.00023,1,1313166,1314804,+,1638
101,WOLB.0323.00153,1,308972,310610,+,1638
101,WOLB.0323.00093,1,1077845,1079460,+,1615
101,WOLB.0323.00088,1,407435,409073,+,1638
101,WOLB.0323.00008,1,935083,936698,+,1615
101,WOLB.0323.00024,1,2003313,2004951,+,1638
101,WOLB.0323.00064,1,93583,95221,+,1638
101,WOLB.0323.00030,1,1245990,1247628,-,1638
101,WOLB.0323.00105,1,421250,422888,-,1638
101,WOLB.0323.00133,1,436354,437992,-,1638
101,WOLB.0323.00084,1,390858,392496,-,1638
101,WOLB.0323.00021,1,672659,674297,+,1638
101,WOLB.0323.00043,1,1276679,1278317,+,1638
101,WOLB.0323.00020,1,377213,378851,+,1638
101,WOLB.0323.00122,1,1256419,1258057,-,1638
101,WOLB.0323.00118,1,313288,314926,+,1638
101,WOLB.0323.00004,1,299437,301075,+,1638
101,WOLB.0323.00011,1,1050591,1052229,+,1638
101,WOLB.0323.00035,1,332926,334564,+,1638
101,WOLB.0323.00032,1,1257664,1259302,-,1638
101,WOLB.0323.00012,1,408587,410225,+,1638
101,WOLB.0323.00018,1,379571,381209,+,1638
101,WOLB.0323.00025,1,572816,574454,-,1638
101,WOLB.0323.00010,1,1152438,1154075,-,1637
101,WOLB.0323.00068,1,462883,464521,-,1638
101,WOLB.0323.00128,1,320477,322115,-,1638
101,WOLB.0323.00158,1,981265,982903,+,1638
101,WOLB.0323.00017,1,375061,376699,+,1638
101,WOLB.0323.00104,1,335326,336964,+,1638
101,WOLB.0323.00007,1,1158359,1159997,-,1638
101,WOLB.0323.00001,1,421250,422888,-,1638
101,WOLB.0323.00100,1,484180,485818,+,1638
101,WOLB.0323.00070,1,385204,386842,-,1638
101,WOLB.0323.00006,1,283497,285135,-,1638
101,WOLB.0323.00042,1,429581,431219,+,1638
101,WOLB.0323.00119,1,1238374,1240012,-,1638
101,WOLB.0323.00149,1,164129,165767,-,1638
101,WOLB.0323.00014,1,415718,417356,-,1638
101,WOLB.0323.00096,1,1059878,1061433,-,1555
102,WOLB.0323.00090,1,307480,310697,+,3217
102,WOLB.0323.00002,1,393031,396235,-,3204
102,WOLB.0323.00138,1,292089,295306,-,3217
102,WOLB.0323.00132,1,361359,364583,+,3224
102,WOLB.0323.00143,1,1001525,1004768,-,3243
102,WOLB.0323.00106,1,1001528,1004771,-,3243
102,WOLB.0323.00121,1,377869,381086,+,3217
102,WOLB.0323.00135,1,167760,170977,+,3217
102,WOLB.0323.00103,1,417859,421098,-,3239
102,WOLB.0323.00107,1,417857,421096,-,3239
102,WOLB.0323.00019,1,1251884,1255131,+,3247
102,WOLB.0323.00060,1,1465975,1469192,+,3217
102,WOLB.0323.00074,1,609208,612351,+,3143
102,WOLB.0323.00120,1,595379,598522,+,3143
102,WOLB.0323.00039,1,469262,472505,+,3243
102,WOLB.0323.00041,1,1018510,1021653,-,3143
102,WOLB.0323.00031,1,1056069,1059312,+,3243
102,WOLB.0323.00056,1,194864,198081,-,3217
102,WOLB.0323.00142,1,302578,305795,+,3217
102,WOLB.0323.00023,1,1314979,1318203,+,3224
102,WOLB.0323.00153,1,310781,313998,+,3217
102,WOLB.0323.00093,1,1079635,1082839,+,3204
102,WOLB.0323.00088,1,188441,191658,-,3217
102,WOLB.0323.00008,1,936873,940103,+,3230
102,WOLB.0323.00024,1,2005126,2008344,+,3218
102,WOLB.0323.00064,1,95396,98620,+,3224
102,WOLB.0323.00030,1,1242591,1245814,-,3223
102,WOLB.0323.00105,1,417860,421099,-,3239
102,WOLB.0323.00133,1,432960,436203,-,3243
102,WOLB.0323.00084,1,387470,390687,-,3217
102,WOLB.0323.00021,1,675566,678783,+,3217
102,WOLB.0323.00043,1,1278497,1281701,+,3204
102,WOLB.0323.00020,1,190784,194001,-,3217
102,WOLB.0323.00122,1,1253031,1256248,-,3217
102,WOLB.0323.00118,1,345201,348433,-,3232
102,WOLB.0323.00004,1,301246,304463,+,3217
102,WOLB.0323.00011,1,1052400,1055617,+,3217
102,WOLB.0323.00035,1,188340,191557,-,3217
102,WOLB.0323.00032,1,1253178,1256395,-,3217
102,WOLB.0323.00012,1,188426,191643,-,3217
102,WOLB.0323.00018,1,381380,384587,+,3207
102,WOLB.0323.00025,1,569427,572665,-,3238
102,WOLB.0323.00010,1,1149057,1152257,-,3200
102,WOLB.0323.00068,1,458397,461614,-,3217
102,WOLB.0323.00128,1,317093,320297,-,3204
102,WOLB.0323.00158,1,983074,986291,+,3217
102,WOLB.0323.00017,1,376870,380087,+,3217
102,WOLB.0323.00104,1,190740,193957,-,3217
102,WOLB.0323.00007,1,1303401,1306618,+,3217
102,WOLB.0323.00001,1,417860,421099,-,3239
102,WOLB.0323.00100,1,188440,191657,-,3217
102,WOLB.0323.00070,1,381820,385024,-,3204
102,WOLB.0323.00006,1,280108,283351,-,3243
102,WOLB.0323.00042,1,431394,434612,+,3218
102,WOLB.0323.00119,1,1234981,1238228,-,3247
102,WOLB.0323.00149,1,160741,163958,-,3217
102,WOLB.0323.00014,1,412334,415538,-,3204
102,WOLB.0323.00096,1,1056413,1059556,-,3143
103,WOLB.0323.00090,1,310901,311487,+,586
103,WOLB.0323.00002,1,392240,392827,-,587
103,WOLB.0323.00138,1,291298,291885,-,587
103,WOLB.0323.00132,1,364787,365373,+,586
103,WOLB.0323.00143,1,1000734,1001321,-,587
103,WOLB.0323.00106,1,1000737,1001324,-,587
103,WOLB.0323.00121,1,381290,381876,+,586
103,WOLB.0323.00135,1,171181,171767,+,586
103,WOLB.0323.00103,1,417068,417655,-,587
103,WOLB.0323.00107,1,417066,417653,-,587
103,WOLB.0323.00019,1,1014553,1015137,+,584
103,WOLB.0323.00060,1,1469396,1469982,+,586
103,WOLB.0323.00074,1,613525,614111,+,586
103,WOLB.0323.00120,1,599696,600282,+,586
103,WOLB.0323.00039,1,472708,473294,+,586
103,WOLB.0323.00041,1,1016749,1017336,-,587
103,WOLB.0323.00031,1,1059516,1060102,+,586
103,WOLB.0323.00056,1,194073,194660,-,587
103,WOLB.0323.00142,1,305999,306585,+,586
103,WOLB.0323.00023,1,1318407,1318993,+,586
103,WOLB.0323.00153,1,314202,314788,+,586
103,WOLB.0323.00093,1,1083097,1083683,+,586
103,WOLB.0323.00088,1,187650,188237,-,587
103,WOLB.0323.00008,1,940307,940893,+,586
103,WOLB.0323.00024,1,2008548,2009134,+,586
103,WOLB.0323.00064,1,98824,99410,+,586
103,WOLB.0323.00030,1,1241800,1242387,-,587
103,WOLB.0323.00105,1,417069,417656,-,587
103,WOLB.0323.00133,1,432169,432756,-,587
103,WOLB.0323.00084,1,386679,387266,-,587
103,WOLB.0323.00021,1,678987,679573,+,586
103,WOLB.0323.00043,1,1281905,1282491,+,586
103,WOLB.0323.00020,1,189993,190580,-,587
103,WOLB.0323.00122,1,1251137,1251696,-,559
103,WOLB.0323.00118,1,344410,344997,-,587
103,WOLB.0323.00004,1,304667,305253,+,586
103,WOLB.0323.00011,1,1055821,1056407,+,586
103,WOLB.0323.00035,1,187549,188136,-,587
103,WOLB.0323.00032,1,1252372,1252974,-,602
103,WOLB.0323.00012,1,187635,188222,-,587
103,WOLB.0323.00018,1,384791,385377,+,586
103,WOLB.0323.00025,1,568637,569220,-,583
103,WOLB.0323.00010,1,1148267,1148853,-,586
103,WOLB.0323.00068,1,457606,458193,-,587
103,WOLB.0323.00128,1,316302,316889,-,587
103,WOLB.0323.00158,1,986495,987081,+,586
103,WOLB.0323.00017,1,380291,380877,+,586
103,WOLB.0323.00104,1,189949,190536,-,587
103,WOLB.0323.00007,1,1306822,1307408,+,586
103,WOLB.0323.00001,1,417069,417656,-,587
103,WOLB.0323.00100,1,187649,188236,-,587
103,WOLB.0323.00070,1,381029,381616,-,587
103,WOLB.0323.00006,1,279317,279904,-,587
103,WOLB.0323.00042,1,434816,435401,+,585
103,WOLB.0323.00119,1,1018648,1019232,+,584
103,WOLB.0323.00149,1,159950,160537,-,587
103,WOLB.0323.00014,1,411543,412130,-,587
103,WOLB.0323.00096,1,1054652,1055239,-,587
104,WOLB.0323.00090,1,311489,314673,+,3184
104,WOLB.0323.00002,1,389112,392239,-,3127
104,WOLB.0323.00138,1,288113,291297,-,3184
104,WOLB.0323.00132,1,365375,368493,+,3118
104,WOLB.0323.00143,1,997606,1000733,-,3127
104,WOLB.0323.00106,1,997609,1000736,-,3127
104,WOLB.0323.00121,1,381878,385062,+,3184
104,WOLB.0323.00135,1,171769,174896,+,3127
104,WOLB.0323.00103,1,413883,417067,-,3184
104,WOLB.0323.00107,1,413881,417065,-,3184
104,WOLB.0323.00019,1,1015139,1018257,+,3118
104,WOLB.0323.00060,1,1469984,1473168,+,3184
104,WOLB.0323.00074,1,614113,617237,+,3124
104,WOLB.0323.00120,1,600284,603408,+,3124
104,WOLB.0323.00039,1,473296,476414,+,3118
104,WOLB.0323.00041,1,1013624,1016748,-,3124
104,WOLB.0323.00031,1,1060104,1063231,+,3127
104,WOLB.0323.00056,1,190888,194072,-,3184
104,WOLB.0323.00142,1,306587,309771,+,3184
104,WOLB.0323.00023,1,1318995,1322113,+,3118
104,WOLB.0323.00153,1,314790,317974,+,3184
104,WOLB.0323.00093,1,1083685,1086869,+,3184
104,WOLB.0323.00088,1,184522,187649,-,3127
104,WOLB.0323.00008,1,940895,944079,+,3184
104,WOLB.0323.00024,1,2009136,2012254,+,3118
104,WOLB.0323.00064,1,99412,102530,+,3118
104,WOLB.0323.00030,1,1238681,1241799,-,3118
104,WOLB.0323.00105,1,413884,417068,-,3184
104,WOLB.0323.00133,1,429050,432168,-,3118
104,WOLB.0323.00084,1,383494,386678,-,3184
104,WOLB.0323.00021,1,679575,682759,+,3184
104,WOLB.0323.00043,1,1282493,1285620,+,3127
104,WOLB.0323.00020,1,186865,189992,-,3127
104,WOLB.0323.00122,1,1247952,1251136,-,3184
104,WOLB.0323.00118,1,341225,344409,-,3184
104,WOLB.0323.00004,1,305255,308439,+,3184
104,WOLB.0323.00011,1,1056409,1059593,+,3184
104,WOLB.0323.00035,1,184421,187548,-,3127
104,WOLB.0323.00032,1,1247693,1250846,-,3153
104,WOLB.0323.00012,1,184507,187634,-,3127
104,WOLB.0323.00018,1,385379,388506,+,3127
104,WOLB.0323.00025,1,565511,568636,-,3125
104,WOLB.0323.00010,1,1145140,1148266,-,3126
104,WOLB.0323.00068,1,454421,457605,-,3184
104,WOLB.0323.00128,1,313174,316301,-,3127
104,WOLB.0323.00158,1,987083,990267,+,3184
104,WOLB.0323.00017,1,380879,384063,+,3184
104,WOLB.0323.00104,1,186821,189948,-,3127
104,WOLB.0323.00007,1,1307410,1310594,+,3184
104,WOLB.0323.00001,1,413884,417068,-,3184
104,WOLB.0323.00100,1,184521,187648,-,3127
104,WOLB.0323.00070,1,377901,381028,-,3127
104,WOLB.0323.00006,1,276189,279316,-,3127
104,WOLB.0323.00042,1,435403,438530,+,3127
104,WOLB.0323.00119,1,1019234,1022352,+,3118
104,WOLB.0323.00149,1,156765,159949,-,3184
104,WOLB.0323.00014,1,408414,411542,-,3128
104,WOLB.0323.00096,1,1051527,1054651,-,3124
105,WOLB.0323.00090,1,315128,317490,+,2362
105,WOLB.0323.00002,1,398663,401026,+,2363
105,WOLB.0323.00138,1,285296,287658,-,2362
105,WOLB.0323.00132,1,356594,358953,-,2359
105,WOLB.0323.00143,1,994790,997145,-,2355
105,WOLB.0323.00106,1,994793,997148,-,2355
105,WOLB.0323.00121,1,385517,387879,+,2362
105,WOLB.0323.00135,1,175351,177710,+,2359
105,WOLB.0323.00103,1,411061,413421,-,2360
105,WOLB.0323.00107,1,411060,413420,-,2360
105,WOLB.0323.00019,1,1018720,1021076,+,2356
105,WOLB.0323.00060,1,1473623,1475985,+,2362
105,WOLB.0323.00074,1,619156,621523,+,2367
105,WOLB.0323.00120,1,605327,607694,+,2367
105,WOLB.0323.00039,1,476877,479233,+,2356
105,WOLB.0323.00041,1,1009338,1011705,-,2367
105,WOLB.0323.00031,1,1063692,1066047,+,2355
105,WOLB.0323.00056,1,188071,190433,-,2362
105,WOLB.0323.00142,1,310226,312588,+,2362
105,WOLB.0323.00023,1,1310200,1312556,-,2356
105,WOLB.0323.00153,1,318429,320791,+,2362
105,WOLB.0323.00093,1,1087332,1089683,+,2351
105,WOLB.0323.00088,1,181704,184067,-,2363
105,WOLB.0323.00008,1,944542,946901,+,2359
105,WOLB.0323.00024,1,615947,618306,+,2359
105,WOLB.0323.00064,1,90617,92973,-,2356
105,WOLB.0323.00030,1,1248238,1250594,+,2356
105,WOLB.0323.00105,1,411062,413422,-,2360
105,WOLB.0323.00133,1,426228,428587,-,2359
105,WOLB.0323.00084,1,380677,383039,-,2362
105,WOLB.0323.00021,1,683214,685576,+,2362
105,WOLB.0323.00043,1,1273706,1276069,-,2363
105,WOLB.0323.00020,1,184047,186410,-,2363
105,WOLB.0323.00122,1,1245135,1247497,-,2362
105,WOLB.0323.00118,1,338408,340770,-,2362
105,WOLB.0323.00004,1,308894,311256,+,2362
105,WOLB.0323.00011,1,1060048,1062410,+,2362
105,WOLB.0323.00035,1,181603,183966,-,2363
105,WOLB.0323.00032,1,1244876,1247238,-,2362
105,WOLB.0323.00012,1,181689,184052,-,2363
105,WOLB.0323.00018,1,376598,378961,-,2363
105,WOLB.0323.00025,1,433667,436023,+,2356
105,WOLB.0323.00010,1,1154685,1157047,+,2362
105,WOLB.0323.00068,1,451604,453966,-,2362
105,WOLB.0323.00128,1,322725,325088,+,2363
105,WOLB.0323.00158,1,990722,993084,+,2362
105,WOLB.0323.00017,1,384518,386880,+,2362
105,WOLB.0323.00104,1,184003,186366,-,2363
105,WOLB.0323.00007,1,1311049,1313411,+,2362
105,WOLB.0323.00001,1,411062,413422,-,2360
105,WOLB.0323.00100,1,181703,184066,-,2363
105,WOLB.0323.00070,1,387452,389815,+,2363
105,WOLB.0323.00006,1,273450,275727,-,2277
105,WOLB.0323.00042,1,426609,428971,-,2362
105,WOLB.0323.00119,1,1022815,1025171,+,2356
105,WOLB.0323.00149,1,153948,156310,-,2362
105,WOLB.0323.00014,1,417966,420329,+,2363
105,WOLB.0323.00096,1,1047241,1049608,-,2367
106,WOLB.0323.00090,1,317491,318369,+,878
106,WOLB.0323.00002,1,401027,401901,+,874
106,WOLB.0323.00103,1,410176,411059,-,883
106,WOLB.0323.00107,1,410175,411058,-,883
106,WOLB.0323.00060,1,1475986,1476864,+,878
106,WOLB.0323.00074,1,621524,622418,+,894
106,WOLB.0323.00120,1,607695,608589,+,894
106,WOLB.0323.00041,1,1008443,1009336,-,893
106,WOLB.0323.00056,1,187192,188069,-,877
106,WOLB.0323.00023,1,1309319,1310198,-,879
106,WOLB.0323.00153,1,320792,321670,+,878
106,WOLB.0323.00088,1,180825,181702,-,877
106,WOLB.0323.00008,1,946902,947780,+,878
106,WOLB.0323.00064,1,89736,90615,-,879
106,WOLB.0323.00030,1,1250595,1251475,+,880
106,WOLB.0323.00105,1,410177,411060,-,883
106,WOLB.0323.00043,1,1272828,1273704,-,876
106,WOLB.0323.00020,1,183168,184045,-,877
106,WOLB.0323.00118,1,337529,338406,-,877
106,WOLB.0323.00035,1,180724,181601,-,877
106,WOLB.0323.00012,1,180810,181687,-,877
106,WOLB.0323.00018,1,375720,376596,-,876
106,WOLB.0323.00010,1,1157048,1157924,+,876
106,WOLB.0323.00128,1,325089,325963,+,874
106,WOLB.0323.00104,1,183124,184001,-,877
106,WOLB.0323.00007,1,1313412,1314290,+,878
106,WOLB.0323.00001,1,410177,411060,-,883
106,WOLB.0323.00100,1,180824,181701,-,877
106,WOLB.0323.00070,1,389816,390690,+,874
106,WOLB.0323.00042,1,425730,426607,-,877
106,WOLB.0323.00014,1,420330,421204,+,874
106,WOLB.0323.00096,1,1046346,1047239,-,893
107,WOLB.0323.00090,1,318437,320061,+,1624
107,WOLB.0323.00002,1,401972,403596,+,1624
107,WOLB.0323.00138,1,262794,264418,+,1624
107,WOLB.0323.00132,1,354413,356038,-,1625
107,WOLB.0323.00143,1,992530,994154,-,1624
107,WOLB.0323.00106,1,992533,994157,-,1624
107,WOLB.0323.00121,1,408782,410407,-,1625
107,WOLB.0323.00135,1,178062,179675,+,1613
107,WOLB.0323.00103,1,408474,410098,-,1624
107,WOLB.0323.00107,1,408473,410097,-,1624
107,WOLB.0323.00019,1,1021657,1023280,+,1623
107,WOLB.0323.00060,1,1476932,1478556,+,1624
107,WOLB.0323.00074,1,622486,624110,+,1624
107,WOLB.0323.00120,1,608657,610281,+,1624
107,WOLB.0323.00039,1,479814,481437,+,1623
107,WOLB.0323.00041,1,1006750,1008375,-,1625
107,WOLB.0323.00031,1,1066683,1068307,+,1624
107,WOLB.0323.00056,1,185499,187124,-,1625
107,WOLB.0323.00142,1,333494,335119,-,1625
107,WOLB.0323.00023,1,1307626,1309251,-,1625
107,WOLB.0323.00153,1,321738,323362,+,1624
107,WOLB.0323.00093,1,1091748,1093361,+,1613
107,WOLB.0323.00088,1,179132,180757,-,1625
107,WOLB.0323.00008,1,947848,949473,+,1625
107,WOLB.0323.00024,1,1491728,1493353,-,1625
107,WOLB.0323.00064,1,88043,89668,-,1625
107,WOLB.0323.00030,1,1251543,1253167,+,1624
107,WOLB.0323.00105,1,408475,410099,-,1624
107,WOLB.0323.00133,1,424202,425827,-,1625
107,WOLB.0323.00084,1,358172,359796,+,1624
107,WOLB.0323.00021,1,706456,708081,-,1625
107,WOLB.0323.00043,1,1271135,1272760,-,1625
107,WOLB.0323.00020,1,181475,183100,-,1625
107,WOLB.0323.00122,1,1220393,1222017,+,1624
107,WOLB.0323.00118,1,335836,337461,-,1625
107,WOLB.0323.00004,1,332162,333787,-,1625
107,WOLB.0323.00011,1,1083316,1084941,-,1625
107,WOLB.0323.00035,1,179031,180656,-,1625
107,WOLB.0323.00032,1,1222371,1223995,+,1624
107,WOLB.0323.00012,1,179117,180742,-,1625
107,WOLB.0323.00018,1,374027,375650,-,1623
107,WOLB.0323.00025,1,563242,564867,-,1625
107,WOLB.0323.00010,1,1157992,1159616,+,1624
107,WOLB.0323.00068,1,1338345,1339969,+,1624
107,WOLB.0323.00128,1,326034,327658,+,1624
107,WOLB.0323.00158,1,559801,561425,+,1624
107,WOLB.0323.00017,1,407786,409411,-,1625
107,WOLB.0323.00104,1,181431,183056,-,1625
107,WOLB.0323.00007,1,1314358,1315982,+,1624
107,WOLB.0323.00001,1,408475,410099,-,1624
107,WOLB.0323.00100,1,179131,180756,-,1625
107,WOLB.0323.00070,1,390761,392385,+,1624
107,WOLB.0323.00006,1,271189,272814,-,1625
107,WOLB.0323.00042,1,424037,425662,-,1625
107,WOLB.0323.00119,1,1025752,1027375,+,1623
107,WOLB.0323.00149,1,131417,133041,+,1624
107,WOLB.0323.00014,1,421275,422899,+,1624
107,WOLB.0323.00096,1,1044653,1046278,-,1625
108,WOLB.0323.00090,1,320749,321796,+,1047
108,WOLB.0323.00002,1,404284,405424,+,1140
108,WOLB.0323.00138,1,265106,266153,+,1047
108,WOLB.0323.00132,1,352564,353705,-,1141
108,WOLB.0323.00121,1,407006,408066,-,1060
108,WOLB.0323.00135,1,180363,181491,+,1128
108,WOLB.0323.00019,1,1023968,1025120,+,1152
108,WOLB.0323.00060,1,1479244,1480291,+,1047
108,WOLB.0323.00039,1,482125,483277,+,1152
108,WOLB.0323.00056,1,183764,184812,-,1048
108,WOLB.0323.00142,1,331718,332778,-,1060
108,WOLB.0323.00153,1,324050,325097,+,1047
108,WOLB.0323.00088,1,177283,178424,-,1141
108,WOLB.0323.00008,1,950188,951318,+,1130
108,WOLB.0323.00064,1,86296,87352,-,1056
108,WOLB.0323.00030,1,1253859,1254902,+,1043
108,WOLB.0323.00133,1,422345,423480,-,1135
108,WOLB.0323.00084,1,360484,361531,+,1047
108,WOLB.0323.00021,1,704721,705769,-,1048
108,WOLB.0323.00043,1,1269307,1270448,-,1141
108,WOLB.0323.00020,1,179626,180767,-,1141
108,WOLB.0323.00122,1,1222726,1223773,+,1047
108,WOLB.0323.00118,1,334072,335100,-,1028
108,WOLB.0323.00004,1,330386,331446,-,1060
108,WOLB.0323.00011,1,1081540,1082600,-,1060
108,WOLB.0323.00035,1,177182,178323,-,1141
108,WOLB.0323.00032,1,1224683,1225730,+,1047
108,WOLB.0323.00012,1,177268,178409,-,1141
108,WOLB.0323.00018,1,372178,373319,-,1141
108,WOLB.0323.00010,1,1160333,1161380,+,1047
108,WOLB.0323.00068,1,1340657,1341704,+,1047
108,WOLB.0323.00128,1,328346,329486,+,1140
108,WOLB.0323.00158,1,562142,563201,+,1059
108,WOLB.0323.00017,1,406010,407070,-,1060
108,WOLB.0323.00104,1,179582,180723,-,1141
108,WOLB.0323.00007,1,1316670,1317717,+,1047
108,WOLB.0323.00100,1,177282,178423,-,1141
108,WOLB.0323.00070,1,393073,394213,+,1140
108,WOLB.0323.00119,1,1028063,1029215,+,1152
108,WOLB.0323.00149,1,133758,134817,+,1059
108,WOLB.0323.00014,1,423587,424715,+,1128
109,WOLB.0323.00090,1,321798,323890,+,2092
109,WOLB.0323.00002,1,405426,407518,+,2092
109,WOLB.0323.00138,1,266155,268243,+,2088
109,WOLB.0323.00132,1,350471,352563,-,2092
109,WOLB.0323.00143,1,987126,989214,-,2088
109,WOLB.0323.00106,1,987129,989217,-,2088
109,WOLB.0323.00121,1,404917,407005,-,2088
109,WOLB.0323.00135,1,181493,183585,+,2092
109,WOLB.0323.00103,1,402810,404890,-,2080
109,WOLB.0323.00107,1,402809,404889,-,2080
109,WOLB.0323.00019,1,1025122,1027204,+,2082
109,WOLB.0323.00060,1,1480293,1482381,+,2088
109,WOLB.0323.00074,1,626140,628225,+,2085
109,WOLB.0323.00120,1,612311,614396,+,2085
109,WOLB.0323.00039,1,483279,485361,+,2082
109,WOLB.0323.00041,1,1002636,1004721,-,2085
109,WOLB.0323.00031,1,1071623,1073711,+,2088
109,WOLB.0323.00056,1,181675,183763,-,2088
109,WOLB.0323.00142,1,329629,331717,-,2088
109,WOLB.0323.00023,1,1303667,1305759,-,2092
109,WOLB.0323.00153,1,325099,327191,+,2092
109,WOLB.0323.00093,1,1095430,1097511,+,2081
109,WOLB.0323.00088,1,175190,177282,-,2092
109,WOLB.0323.00008,1,951330,953412,+,2082
109,WOLB.0323.00024,1,1487588,1489669,-,2081
109,WOLB.0323.00064,1,84203,86295,-,2092
109,WOLB.0323.00030,1,1254904,1256996,+,2092
109,WOLB.0323.00105,1,402811,404891,-,2080
109,WOLB.0323.00133,1,420256,422344,-,2088
109,WOLB.0323.00084,1,361533,363621,+,2088
109,WOLB.0323.00021,1,702632,704720,-,2088
109,WOLB.0323.00043,1,1267214,1269306,-,2092
109,WOLB.0323.00020,1,177533,179625,-,2092
109,WOLB.0323.00122,1,1223775,1225867,+,2092
109,WOLB.0323.00118,1,331979,334071,-,2092
109,WOLB.0323.00004,1,328297,330385,-,2088
109,WOLB.0323.00011,1,1079451,1081539,-,2088
109,WOLB.0323.00035,1,175089,177181,-,2092
109,WOLB.0323.00032,1,1225732,1227820,+,2088
109,WOLB.0323.00012,1,175175,177267,-,2092
109,WOLB.0323.00018,1,370085,372177,-,2092
109,WOLB.0323.00025,1,308971,311059,+,2088
109,WOLB.0323.00010,1,1161382,1163474,+,2092
109,WOLB.0323.00068,1,1341706,1343794,+,2088
109,WOLB.0323.00128,1,329488,331580,+,2092
109,WOLB.0323.00158,1,563203,565291,+,2088
109,WOLB.0323.00017,1,403921,406009,-,2088
109,WOLB.0323.00104,1,177489,179581,-,2092
109,WOLB.0323.00007,1,1317719,1319807,+,2088
109,WOLB.0323.00001,1,402811,404891,-,2080
109,WOLB.0323.00100,1,175189,177281,-,2092
109,WOLB.0323.00070,1,394215,396307,+,2092
109,WOLB.0323.00006,1,267085,269173,-,2088
109,WOLB.0323.00042,1,419946,422038,-,2092
109,WOLB.0323.00119,1,1029217,1031299,+,2082
109,WOLB.0323.00149,1,134819,136907,+,2088
109,WOLB.0323.00014,1,424717,426809,+,2092
109,WOLB.0323.00096,1,1040539,1042624,-,2085
110,WOLB.0323.00090,1,324193,325599,+,1406
110,WOLB.0323.00135,1,183906,185198,+,1292
110,WOLB.0323.00153,1,327494,328900,+,1406
110,WOLB.0323.00088,1,173476,174868,-,1392
110,WOLB.0323.00020,1,175819,177211,-,1392
110,WOLB.0323.00122,1,1226170,1227478,+,1308
110,WOLB.0323.00035,1,173474,174767,-,1293
110,WOLB.0323.00012,1,173461,174853,-,1392
110,WOLB.0323.00104,1,175775,177167,-,1392
110,WOLB.0323.00100,1,173475,174867,-,1392
111,WOLB.0323.00090,1,325601,330097,+,4496
111,WOLB.0323.00002,1,408019,412508,+,4489
111,WOLB.0323.00138,1,268731,273227,+,4496
111,WOLB.0323.00132,1,345474,349969,-,4495
111,WOLB.0323.00143,1,982055,986593,-,4538
111,WOLB.0323.00106,1,982058,986596,-,4538
111,WOLB.0323.00121,1,399931,404427,-,4496
111,WOLB.0323.00135,1,185200,189702,+,4502
111,WOLB.0323.00103,1,397775,402278,-,4503
111,WOLB.0323.00107,1,397774,402277,-,4503
111,WOLB.0323.00019,1,1027737,1032296,+,4559
111,WOLB.0323.00060,1,1482869,1487365,+,4496
111,WOLB.0323.00074,1,628473,632972,+,4499
111,WOLB.0323.00120,1,614644,619143,+,4499
111,WOLB.0323.00039,1,485894,490453,+,4559
111,WOLB.0323.00041,1,997889,1002388,-,4499
111,WOLB.0323.00031,1,1074244,1078782,+,4538
111,WOLB.0323.00056,1,176691,181187,-,4496
111,WOLB.0323.00142,1,324643,329139,-,4496
111,WOLB.0323.00023,1,1298671,1303166,-,4495
111,WOLB.0323.00153,1,328902,333398,+,4496
111,WOLB.0323.00093,1,1098005,1102506,+,4501
111,WOLB.0323.00088,1,168979,173475,-,4496
111,WOLB.0323.00008,1,953907,958408,+,4501
111,WOLB.0323.00024,1,1481040,1485535,-,4495
111,WOLB.0323.00064,1,79206,83701,-,4495
111,WOLB.0323.00030,1,1257498,1261993,+,4495
111,WOLB.0323.00105,1,397776,402279,-,4503
111,WOLB.0323.00133,1,415263,419726,-,4463
111,WOLB.0323.00084,1,364109,368605,+,4496
111,WOLB.0323.00021,1,697648,702144,-,4496
111,WOLB.0323.00043,1,1262224,1266713,-,4489
111,WOLB.0323.00020,1,171322,175818,-,4496
111,WOLB.0323.00122,1,1227480,1231976,+,4496
111,WOLB.0323.00118,1,326976,331477,-,4501
111,WOLB.0323.00004,1,323311,327807,-,4496
111,WOLB.0323.00011,1,1074465,1078961,-,4496
111,WOLB.0323.00035,1,168977,173473,-,4496
111,WOLB.0323.00032,1,1228308,1232804,+,4496
111,WOLB.0323.00012,1,168964,173460,-,4496
111,WOLB.0323.00018,1,365089,369584,-,4495
111,WOLB.0323.00025,1,311390,315931,+,4541
111,WOLB.0323.00010,1,1163975,1168470,+,4495
111,WOLB.0323.00068,1,1345380,1349876,+,4496
111,WOLB.0323.00128,1,333184,337673,+,4489
111,WOLB.0323.00158,1,565781,570277,+,4496
111,WOLB.0323.00017,1,398935,403431,-,4496
111,WOLB.0323.00104,1,171278,175774,-,4496
111,WOLB.0323.00007,1,1320295,1324791,+,4496
111,WOLB.0323.00001,1,397776,402279,-,4503
111,WOLB.0323.00100,1,168978,173474,-,4496
111,WOLB.0323.00070,1,396808,401297,+,4489
111,WOLB.0323.00006,1,262014,266552,-,4538
111,WOLB.0323.00042,1,414953,419445,-,4492
111,WOLB.0323.00119,1,1031832,1036391,+,4559
111,WOLB.0323.00149,1,137397,141893,+,4496
111,WOLB.0323.00014,1,427310,431799,+,4489
111,WOLB.0323.00096,1,1035792,1040291,-,4499
112,WOLB.0323.00090,1,330770,335799,+,5029
112,WOLB.0323.00002,1,413181,418201,+,5020
112,WOLB.0323.00138,1,273900,278929,+,5029
112,WOLB.0323.00132,1,339492,344501,-,5009
112,WOLB.0323.00143,1,975677,980773,-,5096
112,WOLB.0323.00106,1,975680,980776,-,5096
112,WOLB.0323.00121,1,394229,399258,-,5029
112,WOLB.0323.00135,1,190702,195719,+,5017
112,WOLB.0323.00103,1,391816,396802,-,4986
112,WOLB.0323.00107,1,391815,396801,-,4986
112,WOLB.0323.00019,1,1032996,1037994,+,4998
112,WOLB.0323.00060,1,1488038,1493067,+,5029
112,WOLB.0323.00074,1,633672,638718,+,5046
112,WOLB.0323.00120,1,619843,624889,+,5046
112,WOLB.0323.00039,1,491153,496153,+,5000
112,WOLB.0323.00041,1,992143,997189,-,5046
112,WOLB.0323.00031,1,1080064,1085160,+,5096
112,WOLB.0323.00056,1,170989,176018,-,5029
112,WOLB.0323.00142,1,318941,323970,-,5029
112,WOLB.0323.00023,1,1292689,1297698,-,5009
112,WOLB.0323.00153,1,334071,339100,+,5029
112,WOLB.0323.00093,1,1103482,1108503,+,5021
112,WOLB.0323.00088,1,163277,168306,-,5029
112,WOLB.0323.00008,1,959108,964111,+,5003
112,WOLB.0323.00024,1,1475355,1480367,-,5012
112,WOLB.0323.00064,1,73224,78233,-,5009
112,WOLB.0323.00030,1,1262966,1267975,+,5009
112,WOLB.0323.00105,1,391817,396803,-,4986
112,WOLB.0323.00133,1,409569,414564,-,4995
112,WOLB.0323.00084,1,369278,374307,+,5029
112,WOLB.0323.00021,1,691946,696975,-,5029
112,WOLB.0323.00043,1,1256531,1261551,-,5020
112,WOLB.0323.00020,1,165620,170649,-,5029
112,WOLB.0323.00122,1,1232649,1237678,+,5029
112,WOLB.0323.00118,1,321274,326303,-,5029
112,WOLB.0323.00004,1,317609,322638,-,5029
112,WOLB.0323.00011,1,1068763,1073792,-,5029
112,WOLB.0323.00035,1,163275,168304,-,5029
112,WOLB.0323.00032,1,1233477,1238506,+,5029
112,WOLB.0323.00012,1,163262,168291,-,5029
112,WOLB.0323.00018,1,359099,364116,-,5017
112,WOLB.0323.00025,1,316943,322068,+,5125
112,WOLB.0323.00010,1,1169443,1174451,+,5008
112,WOLB.0323.00068,1,1350549,1355578,+,5029
112,WOLB.0323.00128,1,338346,343366,+,5020
112,WOLB.0323.00158,1,570950,575979,+,5029
112,WOLB.0323.00017,1,393233,398262,-,5029
112,WOLB.0323.00104,1,165576,170605,-,5029
112,WOLB.0323.00007,1,1325464,1330493,+,5029
112,WOLB.0323.00001,1,391817,396803,-,4986
112,WOLB.0323.00100,1,163276,168305,-,5029
112,WOLB.0323.00070,1,401970,406990,+,5020
112,WOLB.0323.00006,1,255636,260732,-,5096
112,WOLB.0323.00042,1,408963,413980,-,5017
112,WOLB.0323.00119,1,1037091,1042089,+,4998
112,WOLB.0323.00149,1,142566,147595,+,5029
112,WOLB.0323.00014,1,432472,437492,+,5020
112,WOLB.0323.00096,1,1030046,1035092,-,5046
113,WOLB.0323.00090,1,337752,338707,+,955
113,WOLB.0323.00002,1,420221,421176,+,955
113,WOLB.0323.00138,1,280882,281837,+,955
113,WOLB.0323.00132,1,336576,337530,-,954
113,WOLB.0323.00143,1,972744,973694,-,950
113,WOLB.0323.00106,1,972747,973697,-,950
113,WOLB.0323.00121,1,391322,392276,-,954
113,WOLB.0323.00135,1,197664,198619,+,955
113,WOLB.0323.00103,1,383724,384678,-,954
113,WOLB.0323.00107,1,383723,384677,-,954
113,WOLB.0323.00019,1,1039970,1040925,+,955
113,WOLB.0323.00060,1,1496169,1497124,+,955
113,WOLB.0323.00074,1,603501,604456,+,955
113,WOLB.0323.00120,1,589672,590627,+,955
113,WOLB.0323.00039,1,498130,499085,+,955
113,WOLB.0323.00041,1,1026405,1027359,-,954
113,WOLB.0323.00031,1,1087142,1088093,+,951
113,WOLB.0323.00056,1,166932,167886,-,954
113,WOLB.0323.00142,1,316034,316988,-,954
113,WOLB.0323.00023,1,1289773,1290727,-,954
113,WOLB.0323.00153,1,341053,342008,+,955
113,WOLB.0323.00093,1,822140,823091,-,951
113,WOLB.0323.00088,1,160377,161331,-,954
113,WOLB.0323.00024,1,1032853,1033808,+,955
113,WOLB.0323.00064,1,70298,71252,-,954
113,WOLB.0323.00030,1,1269946,1270901,+,955
113,WOLB.0323.00105,1,383725,384679,-,954
113,WOLB.0323.00084,1,376260,377215,+,955
113,WOLB.0323.00021,1,689038,689992,-,954
113,WOLB.0323.00043,1,1253556,1254510,-,954
113,WOLB.0323.00020,1,162720,163674,-,954
113,WOLB.0323.00122,1,1240734,1241689,+,955
113,WOLB.0323.00118,1,318366,319320,-,954
113,WOLB.0323.00004,1,314702,315656,-,954
113,WOLB.0323.00011,1,1065856,1066810,-,954
113,WOLB.0323.00035,1,160375,161329,-,954
113,WOLB.0323.00032,1,1240459,1241414,+,955
113,WOLB.0323.00012,1,160362,161316,-,954
113,WOLB.0323.00018,1,356051,357005,-,954
113,WOLB.0323.00010,1,1176420,1177376,+,956
113,WOLB.0323.00068,1,447190,448145,+,955
113,WOLB.0323.00128,1,345386,346341,+,955
113,WOLB.0323.00158,1,577931,578886,+,955
113,WOLB.0323.00017,1,390326,391280,-,954
113,WOLB.0323.00104,1,162676,163630,-,954
113,WOLB.0323.00007,1,1333595,1334550,+,955
113,WOLB.0323.00001,1,383725,384679,-,954
113,WOLB.0323.00100,1,160376,161330,-,954
113,WOLB.0323.00070,1,409010,409965,+,955
113,WOLB.0323.00006,1,252703,253653,-,950
113,WOLB.0323.00042,1,406055,407009,-,954
113,WOLB.0323.00119,1,1044065,1045020,+,955
113,WOLB.0323.00149,1,149547,150502,+,955
113,WOLB.0323.00014,1,439512,440467,+,955
113,WOLB.0323.00096,1,1064308,1065262,-,954
114,WOLB.0323.00090,1,339628,341787,+,2159
114,WOLB.0323.00002,1,422098,424080,+,1982
114,WOLB.0323.00138,1,257264,259417,-,2153
114,WOLB.0323.00132,1,333487,335646,-,2159
114,WOLB.0323.00143,1,970068,972217,-,2149
114,WOLB.0323.00106,1,970071,972220,-,2149
114,WOLB.0323.00121,1,412670,414823,+,2153
114,WOLB.0323.00135,1,18644,20626,-,1982
114,WOLB.0323.00135,1,1373500,1375482,-,1982
114,WOLB.0323.00103,1,428697,430856,+,2159
114,WOLB.0323.00107,1,428695,430854,+,2159
114,WOLB.0323.00019,1,1041935,1044094,+,2159
114,WOLB.0323.00060,1,26603,28756,+,2153
114,WOLB.0323.00074,1,706064,708209,-,2145
114,WOLB.0323.00120,1,685591,687736,-,2145
114,WOLB.0323.00039,1,500080,502239,+,2159
114,WOLB.0323.00041,1,929296,931441,+,2145
114,WOLB.0323.00031,1,1088620,1090769,+,2149
114,WOLB.0323.00056,1,350670,352823,+,2153
114,WOLB.0323.00142,1,337382,339535,+,2153
114,WOLB.0323.00023,1,1286869,1288851,-,1982
114,WOLB.0323.00153,1,342929,345088,+,2159
114,WOLB.0323.00093,1,392795,394940,+,2145
114,WOLB.0323.00088,1,413753,415906,+,2153
114,WOLB.0323.00008,1,1022458,1024603,-,2145
114,WOLB.0323.00024,1,1034738,1036897,+,2159
114,WOLB.0323.00064,1,67386,69368,-,1982
114,WOLB.0323.00030,1,1271831,1273813,+,1982
114,WOLB.0323.00105,1,428698,430857,+,2159
114,WOLB.0323.00133,1,276213,278372,-,2159
114,WOLB.0323.00084,1,353740,355893,-,2153
114,WOLB.0323.00021,1,710360,712513,+,2153
114,WOLB.0323.00043,1,1250652,1252634,-,1982
114,WOLB.0323.00020,1,383531,385684,+,2153
114,WOLB.0323.00122,1,1214868,1217013,-,2145
114,WOLB.0323.00118,1,350300,352453,+,2153
114,WOLB.0323.00004,1,336050,338203,+,2153
114,WOLB.0323.00011,1,1087204,1089357,+,2153
114,WOLB.0323.00035,1,339244,341397,+,2153
114,WOLB.0323.00032,1,1217939,1220092,-,2153
114,WOLB.0323.00012,1,414905,417058,+,2153
114,WOLB.0323.00018,1,353147,355129,-,1982
114,WOLB.0323.00025,1,357879,360031,-,2152
114,WOLB.0323.00010,1,1178298,1180280,+,1982
114,WOLB.0323.00068,1,1333913,1336066,-,2153
114,WOLB.0323.00128,1,347263,349245,+,1982
114,WOLB.0323.00158,1,555385,557538,-,2153
114,WOLB.0323.00017,1,411674,413827,+,2153
114,WOLB.0323.00104,1,341644,343797,+,2153
114,WOLB.0323.00007,1,1151511,1153664,-,2153
114,WOLB.0323.00001,1,428698,430857,+,2159
114,WOLB.0323.00100,1,490498,492651,+,2153
114,WOLB.0323.00070,1,410887,412869,+,1982
114,WOLB.0323.00006,1,250027,252176,-,2149
114,WOLB.0323.00042,1,403150,405132,-,1982
114,WOLB.0323.00119,1,1046030,1048189,+,2159
114,WOLB.0323.00149,1,127001,129154,-,2153
114,WOLB.0323.00014,1,441389,443371,+,1982
114,WOLB.0323.00096,1,967199,969344,+,2145
115,WOLB.0323.00090,1,341846,342735,+,889
115,WOLB.0323.00002,1,424139,425028,+,889
115,WOLB.0323.00138,1,256310,257213,-,903
115,WOLB.0323.00132,1,260964,261853,-,889
115,WOLB.0323.00143,1,936726,937615,-,889
115,WOLB.0323.00106,1,936729,937618,-,889
115,WOLB.0323.00121,1,414874,415777,+,903
115,WOLB.0323.00135,1,1301072,1301961,-,889
115,WOLB.0323.00103,1,1213647,1214544,+,897
115,WOLB.0323.00107,1,1211910,1212807,+,897
115,WOLB.0323.00019,1,1044138,1045042,+,904
115,WOLB.0323.00060,1,28807,29710,+,903
115,WOLB.0323.00039,1,502283,503187,+,904
115,WOLB.0323.00041,1,1346656,1347517,+,861
115,WOLB.0323.00031,1,1123222,1124111,+,889
115,WOLB.0323.00056,1,352874,353777,+,903
115,WOLB.0323.00142,1,339586,340489,+,903
115,WOLB.0323.00023,1,1285921,1286825,-,904
115,WOLB.0323.00153,1,345147,346036,+,889
115,WOLB.0323.00093,1,896332,897203,+,871
115,WOLB.0323.00088,1,415957,416860,+,903
115,WOLB.0323.00008,1,860174,861045,-,871
115,WOLB.0323.00024,1,961024,961913,+,889
115,WOLB.0323.00064,1,66438,67327,-,889
115,WOLB.0323.00030,1,1345000,1345889,+,889
115,WOLB.0323.00105,1,1213655,1214552,+,897
115,WOLB.0323.00133,1,308257,309146,+,889
115,WOLB.0323.00084,1,352786,353689,-,903
115,WOLB.0323.00021,1,712564,713467,+,903
115,WOLB.0323.00043,1,1249704,1250593,-,889
115,WOLB.0323.00020,1,385735,386638,+,903
115,WOLB.0323.00122,1,1213920,1214809,-,889
115,WOLB.0323.00118,1,352504,353407,+,903
115,WOLB.0323.00004,1,338254,339157,+,903
115,WOLB.0323.00011,1,1089408,1090311,+,903
115,WOLB.0323.00035,1,341448,342351,+,903
115,WOLB.0323.00032,1,1284078,1284982,+,904
115,WOLB.0323.00012,1,417109,418012,+,903
115,WOLB.0323.00018,1,352199,353097,-,898
115,WOLB.0323.00025,1,356947,357829,-,882
115,WOLB.0323.00010,1,1180339,1181228,+,889
115,WOLB.0323.00068,1,1332959,1333862,-,903
115,WOLB.0323.00128,1,1065751,1066640,-,889
115,WOLB.0323.00158,1,554431,555334,-,903
115,WOLB.0323.00017,1,413878,414781,+,903
115,WOLB.0323.00104,1,343848,344751,+,903
115,WOLB.0323.00007,1,1076873,1077777,-,904
115,WOLB.0323.00001,1,1213655,1214552,+,897
115,WOLB.0323.00100,1,492702,493605,+,903
115,WOLB.0323.00070,1,412928,413817,+,889
115,WOLB.0323.00006,1,216698,217587,-,889
115,WOLB.0323.00042,1,1427855,1428753,-,898
115,WOLB.0323.00119,1,1048233,1049137,+,904
115,WOLB.0323.00149,1,126047,126950,-,903
115,WOLB.0323.00014,1,443430,444319,+,889
116,WOLB.0323.00090,1,342736,345148,+,2412
116,WOLB.0323.00002,1,425029,427431,+,2402
116,WOLB.0323.00138,1,253897,256308,-,2411
116,WOLB.0323.00132,1,258550,260962,-,2412
116,WOLB.0323.00143,1,934313,936724,-,2411
116,WOLB.0323.00106,1,934316,936727,-,2411
116,WOLB.0323.00121,1,415778,418190,+,2412
116,WOLB.0323.00135,1,1298659,1301070,-,2411
116,WOLB.0323.00103,1,1214545,1216957,+,2412
116,WOLB.0323.00107,1,1212808,1215220,+,2412
116,WOLB.0323.00019,1,1045043,1047437,+,2394
116,WOLB.0323.00060,1,29711,32123,+,2412
116,WOLB.0323.00039,1,503188,505600,+,2412
116,WOLB.0323.00041,1,1347518,1349930,+,2412
116,WOLB.0323.00031,1,1124112,1126524,+,2412
116,WOLB.0323.00056,1,353778,356190,+,2412
116,WOLB.0323.00142,1,340490,342902,+,2412
116,WOLB.0323.00023,1,1283508,1285919,-,2411
116,WOLB.0323.00153,1,346037,348449,+,2412
116,WOLB.0323.00093,1,897204,899616,+,2412
116,WOLB.0323.00088,1,416861,419273,+,2412
116,WOLB.0323.00008,1,857761,860172,-,2411
116,WOLB.0323.00024,1,961914,964326,+,2412
116,WOLB.0323.00064,1,64025,66436,-,2411
116,WOLB.0323.00030,1,1345890,1348302,+,2412
116,WOLB.0323.00105,1,1214553,1216965,+,2412
116,WOLB.0323.00133,1,309147,311560,+,2413
116,WOLB.0323.00084,1,350373,352784,-,2411
116,WOLB.0323.00021,1,713468,715880,+,2412
116,WOLB.0323.00043,1,1247301,1249702,-,2401
116,WOLB.0323.00020,1,386639,389051,+,2412
116,WOLB.0323.00122,1,1211507,1213918,-,2411
116,WOLB.0323.00118,1,353408,355820,+,2412
116,WOLB.0323.00004,1,339158,341570,+,2412
116,WOLB.0323.00011,1,1090312,1092724,+,2412
116,WOLB.0323.00035,1,342352,344764,+,2412
116,WOLB.0323.00032,1,1284983,1287395,+,2412
116,WOLB.0323.00012,1,418013,420425,+,2412
116,WOLB.0323.00018,1,349786,352197,-,2411
116,WOLB.0323.00025,1,529694,532119,+,2425
116,WOLB.0323.00010,1,1181229,1183641,+,2412
116,WOLB.0323.00068,1,1330546,1332957,-,2411
116,WOLB.0323.00128,1,1063348,1065749,-,2401
116,WOLB.0323.00158,1,552018,554429,-,2411
116,WOLB.0323.00017,1,414782,417194,+,2412
116,WOLB.0323.00104,1,344752,347164,+,2412
116,WOLB.0323.00007,1,1074460,1076871,-,2411
116,WOLB.0323.00001,1,1214553,1216965,+,2412
116,WOLB.0323.00100,1,493606,496018,+,2412
116,WOLB.0323.00070,1,413818,416220,+,2402
116,WOLB.0323.00006,1,214285,216696,-,2411
116,WOLB.0323.00042,1,1425442,1427853,-,2411
116,WOLB.0323.00119,1,1049138,1051532,+,2394
116,WOLB.0323.00149,1,123634,126045,-,2411
116,WOLB.0323.00014,1,444320,446722,+,2402
117,WOLB.0323.00090,1,345344,347679,+,2335
117,WOLB.0323.00002,1,427640,429975,+,2335
117,WOLB.0323.00138,1,251372,253707,-,2335
117,WOLB.0323.00132,1,256019,258354,-,2335
117,WOLB.0323.00143,1,931780,934110,-,2330
117,WOLB.0323.00106,1,931783,934113,-,2330
117,WOLB.0323.00121,1,418386,420721,+,2335
117,WOLB.0323.00135,1,1296128,1298463,-,2335
117,WOLB.0323.00103,1,1217153,1219497,+,2344
117,WOLB.0323.00107,1,1215416,1217760,+,2344
117,WOLB.0323.00019,1,1049084,1051419,+,2335
117,WOLB.0323.00060,1,32319,34654,+,2335
117,WOLB.0323.00039,1,505803,508138,+,2335
117,WOLB.0323.00041,1,1350126,1352470,+,2344
117,WOLB.0323.00031,1,1126727,1129057,+,2330
117,WOLB.0323.00056,1,356386,358721,+,2335
117,WOLB.0323.00142,1,343098,345433,+,2335
117,WOLB.0323.00023,1,1281036,1283371,-,2335
117,WOLB.0323.00153,1,348645,350980,+,2335
117,WOLB.0323.00093,1,899638,901956,+,2318
117,WOLB.0323.00088,1,419469,421804,+,2335
117,WOLB.0323.00008,1,855421,857739,-,2318
117,WOLB.0323.00024,1,996546,998881,+,2335
117,WOLB.0323.00064,1,61487,63822,-,2335
117,WOLB.0323.00030,1,1348505,1350840,+,2335
117,WOLB.0323.00105,1,1217161,1219505,+,2344
117,WOLB.0323.00133,1,311763,314098,+,2335
117,WOLB.0323.00084,1,347848,350183,-,2335
117,WOLB.0323.00021,1,716070,718405,+,2335
117,WOLB.0323.00043,1,1244757,1247092,-,2335
117,WOLB.0323.00020,1,389247,391582,+,2335
117,WOLB.0323.00122,1,1208976,1211311,-,2335
117,WOLB.0323.00118,1,356016,358351,+,2335
117,WOLB.0323.00004,1,341766,344101,+,2335
117,WOLB.0323.00011,1,1092920,1095255,+,2335
117,WOLB.0323.00035,1,344960,347295,+,2335
117,WOLB.0323.00032,1,1287585,1289920,+,2335
117,WOLB.0323.00012,1,420621,422956,+,2335
117,WOLB.0323.00018,1,347254,349589,-,2335
117,WOLB.0323.00025,1,532322,534652,+,2330
117,WOLB.0323.00010,1,1183663,1185995,+,2332
117,WOLB.0323.00068,1,1328021,1330356,-,2335
117,WOLB.0323.00128,1,1060804,1063139,-,2335
117,WOLB.0323.00158,1,549487,551822,-,2335
117,WOLB.0323.00017,1,417390,419725,+,2335
117,WOLB.0323.00104,1,347360,349695,+,2335
117,WOLB.0323.00007,1,1071929,1074264,-,2335
117,WOLB.0323.00001,1,1217161,1219505,+,2344
117,WOLB.0323.00100,1,496214,498549,+,2335
117,WOLB.0323.00070,1,416429,418764,+,2335
117,WOLB.0323.00006,1,211752,214082,-,2330
117,WOLB.0323.00042,1,1422911,1425246,-,2335
117,WOLB.0323.00119,1,1053179,1055514,+,2335
117,WOLB.0323.00149,1,121103,123438,-,2335
117,WOLB.0323.00014,1,446931,449266,+,2335
118,WOLB.0323.00090,1,348517,353668,+,5151
118,WOLB.0323.00002,1,430806,435952,+,5146
118,WOLB.0323.00138,1,245374,250525,-,5151
118,WOLB.0323.00132,1,370728,375879,+,5151
118,WOLB.0323.00143,1,925784,930937,-,5153
118,WOLB.0323.00106,1,925787,930940,-,5153
118,WOLB.0323.00121,1,421559,426710,+,5151
118,WOLB.0323.00135,1,1290199,1295349,-,5150
118,WOLB.0323.00103,1,1219503,1224649,+,5146
118,WOLB.0323.00107,1,1217766,1222912,+,5146
118,WOLB.0323.00019,1,1101016,1106167,-,5151
118,WOLB.0323.00060,1,35492,40642,+,5150
118,WOLB.0323.00039,1,458993,464144,-,5151
118,WOLB.0323.00041,1,1352476,1357627,+,5151
118,WOLB.0323.00031,1,1129900,1135053,+,5153
118,WOLB.0323.00056,1,359559,364709,+,5150
118,WOLB.0323.00142,1,346271,351422,+,5151
118,WOLB.0323.00023,1,1324344,1329495,+,5151
118,WOLB.0323.00153,1,351818,356969,+,5151
118,WOLB.0323.00093,1,901975,907123,+,5148
118,WOLB.0323.00088,1,422642,427793,+,5151
118,WOLB.0323.00008,1,850254,855402,-,5148
118,WOLB.0323.00024,1,1790816,1795967,+,5151
118,WOLB.0323.00064,1,104769,109920,+,5151
118,WOLB.0323.00030,1,1231291,1236442,-,5151
118,WOLB.0323.00105,1,1219511,1224657,+,5146
118,WOLB.0323.00133,1,441335,446493,+,5158
118,WOLB.0323.00084,1,341850,347001,-,5151
118,WOLB.0323.00021,1,719252,724403,+,5151
118,WOLB.0323.00043,1,1238775,1243926,-,5151
118,WOLB.0323.00020,1,392420,397571,+,5151
118,WOLB.0323.00122,1,1202987,1208138,-,5151
118,WOLB.0323.00118,1,359189,364339,+,5150
118,WOLB.0323.00004,1,344939,350090,+,5151
118,WOLB.0323.00011,1,1096093,1101244,+,5151
118,WOLB.0323.00035,1,348133,353284,+,5151
118,WOLB.0323.00032,1,1290767,1295918,+,5151
118,WOLB.0323.00012,1,423794,428945,+,5151
118,WOLB.0323.00018,1,390735,395886,+,5151
118,WOLB.0323.00025,1,517394,522546,-,5152
118,WOLB.0323.00010,1,1137775,1142926,-,5151
118,WOLB.0323.00068,1,1322023,1327174,-,5151
118,WOLB.0323.00128,1,1054822,1059973,-,5151
118,WOLB.0323.00158,1,543498,548649,-,5151
118,WOLB.0323.00017,1,420563,425714,+,5151
118,WOLB.0323.00104,1,350533,355684,+,5151
118,WOLB.0323.00007,1,1065075,1070225,-,5150
118,WOLB.0323.00001,1,1219511,1224657,+,5146
118,WOLB.0323.00100,1,499387,504538,+,5151
118,WOLB.0323.00070,1,419595,424746,+,5151
118,WOLB.0323.00006,1,205757,210909,-,5152
118,WOLB.0323.00042,1,440761,445912,+,5151
118,WOLB.0323.00119,1,1105111,1110262,-,5151
118,WOLB.0323.00149,1,115114,120265,-,5151
118,WOLB.0323.00014,1,450097,455248,+,5151
119,WOLB.0323.00090,1,355522,357944,+,2422
119,WOLB.0323.00002,1,437804,440226,+,2422
119,WOLB.0323.00138,1,241098,243520,-,2422
119,WOLB.0323.00132,1,377740,380161,+,2421
119,WOLB.0323.00143,1,921500,923922,-,2422
119,WOLB.0323.00106,1,921503,923925,-,2422
119,WOLB.0323.00121,1,428564,430986,+,2422
119,WOLB.0323.00135,1,1285923,1288345,-,2422
119,WOLB.0323.00103,1,1229582,1232004,+,2422
119,WOLB.0323.00107,1,1227845,1230267,+,2422
119,WOLB.0323.00019,1,1096732,1099153,-,2421
119,WOLB.0323.00060,1,42496,44918,+,2422
119,WOLB.0323.00074,1,600122,602544,-,2422
119,WOLB.0323.00120,1,586293,588715,-,2422
119,WOLB.0323.00039,1,454709,457130,-,2421
119,WOLB.0323.00041,1,1028317,1030739,+,2422
119,WOLB.0323.00031,1,1136915,1139337,+,2422
119,WOLB.0323.00056,1,366563,368985,+,2422
119,WOLB.0323.00142,1,353276,355698,+,2422
119,WOLB.0323.00023,1,1331343,1333764,+,2421
119,WOLB.0323.00153,1,358823,361245,+,2422
119,WOLB.0323.00093,1,825056,827478,+,2422
119,WOLB.0323.00088,1,429647,432069,+,2422
119,WOLB.0323.00008,1,928969,931391,+,2422
119,WOLB.0323.00024,1,1797826,1800248,+,2422
119,WOLB.0323.00064,1,111780,114201,+,2421
119,WOLB.0323.00030,1,1227009,1229430,-,2421
119,WOLB.0323.00105,1,1229590,1232012,+,2422
119,WOLB.0323.00133,1,399169,401589,-,2420
119,WOLB.0323.00084,1,337574,339996,-,2422
119,WOLB.0323.00021,1,726257,728679,+,2422
119,WOLB.0323.00043,1,1234506,1236928,-,2422
119,WOLB.0323.00020,1,399425,401847,+,2422
119,WOLB.0323.00122,1,1198711,1201133,-,2422
119,WOLB.0323.00118,1,366199,368620,+,2421
119,WOLB.0323.00004,1,351944,354366,+,2422
119,WOLB.0323.00011,1,1103098,1105520,+,2422
119,WOLB.0323.00035,1,355138,357560,+,2422
119,WOLB.0323.00032,1,1297772,1300194,+,2422
119,WOLB.0323.00012,1,430799,433221,+,2422
119,WOLB.0323.00018,1,397724,400145,+,2421
119,WOLB.0323.00025,1,487459,489881,-,2422
119,WOLB.0323.00010,1,1133498,1135920,-,2422
119,WOLB.0323.00068,1,1317747,1320169,-,2422
119,WOLB.0323.00128,1,1050553,1052975,-,2422
119,WOLB.0323.00158,1,539222,541644,-,2422
119,WOLB.0323.00017,1,427568,429990,+,2422
119,WOLB.0323.00104,1,357538,359960,+,2422
119,WOLB.0323.00007,1,1060799,1063221,-,2422
119,WOLB.0323.00001,1,1229590,1232012,+,2422
119,WOLB.0323.00100,1,506392,508814,+,2422
119,WOLB.0323.00070,1,426593,429015,+,2422
119,WOLB.0323.00006,1,201472,203894,-,2422
119,WOLB.0323.00042,1,447766,450187,+,2421
119,WOLB.0323.00119,1,1100827,1103248,-,2421
119,WOLB.0323.00149,1,110838,113260,-,2422
119,WOLB.0323.00014,1,457095,459517,+,2422
119,WOLB.0323.00096,1,1066220,1068642,+,2422
120,WOLB.0323.00090,1,360968,361757,+,789
120,WOLB.0323.00002,1,443235,444024,+,789
120,WOLB.0323.00138,1,237286,238075,-,789
120,WOLB.0323.00132,1,383098,383887,+,789
120,WOLB.0323.00143,1,916935,917712,-,777
120,WOLB.0323.00106,1,916938,917715,-,777
120,WOLB.0323.00121,1,434394,435183,+,789
120,WOLB.0323.00135,1,1282110,1282899,-,789
120,WOLB.0323.00103,1,1235425,1236201,+,776
120,WOLB.0323.00107,1,1233688,1234464,+,776
120,WOLB.0323.00019,1,1086646,1087417,+,771
120,WOLB.0323.00060,1,47957,48746,+,789
120,WOLB.0323.00074,1,596377,597128,-,751
120,WOLB.0323.00120,1,582548,583299,-,751
120,WOLB.0323.00039,1,450876,451646,-,770
120,WOLB.0323.00041,1,1033733,1034484,+,751
120,WOLB.0323.00031,1,1143125,1143902,+,777
120,WOLB.0323.00056,1,372024,372813,+,789
120,WOLB.0323.00142,1,359106,359895,+,789
120,WOLB.0323.00023,1,1336822,1337613,+,791
120,WOLB.0323.00153,1,364269,365058,+,789
120,WOLB.0323.00093,1,831935,832718,+,783
120,WOLB.0323.00088,1,435468,436257,+,789
120,WOLB.0323.00008,1,922575,923366,-,791
120,WOLB.0323.00024,1,1807500,1808278,+,778
120,WOLB.0323.00064,1,117147,117936,+,789
120,WOLB.0323.00030,1,1223274,1224063,-,789
120,WOLB.0323.00105,1,1235433,1236209,+,776
120,WOLB.0323.00133,1,393779,394568,-,789
120,WOLB.0323.00084,1,333762,334551,-,789
120,WOLB.0323.00021,1,731702,732491,+,789
120,WOLB.0323.00043,1,1230699,1231488,-,789
120,WOLB.0323.00020,1,405246,406035,+,789
120,WOLB.0323.00122,1,1194889,1195678,-,789
120,WOLB.0323.00118,1,371267,372056,+,789
120,WOLB.0323.00004,1,357774,358563,+,789
120,WOLB.0323.00011,1,1108919,1109708,+,789
120,WOLB.0323.00035,1,360959,361748,+,789
120,WOLB.0323.00032,1,1303216,1304005,+,789
120,WOLB.0323.00012,1,436620,437409,+,789
120,WOLB.0323.00018,1,403488,404274,+,786
120,WOLB.0323.00025,1,370546,371328,-,782
120,WOLB.0323.00010,1,1129331,1130120,-,789
120,WOLB.0323.00068,1,1313935,1314724,-,789
120,WOLB.0323.00128,1,1046746,1047535,-,789
120,WOLB.0323.00158,1,535025,535814,-,789
120,WOLB.0323.00017,1,433425,434214,+,789
120,WOLB.0323.00104,1,363359,364148,+,789
120,WOLB.0323.00007,1,1056986,1057775,-,789
120,WOLB.0323.00001,1,1235433,1236209,+,776
120,WOLB.0323.00100,1,512213,513002,+,789
120,WOLB.0323.00070,1,432033,432822,+,789
120,WOLB.0323.00006,1,196907,197684,-,777
120,WOLB.0323.00042,1,456217,457006,+,789
120,WOLB.0323.00119,1,1090741,1091512,+,771
120,WOLB.0323.00149,1,106641,107430,-,789
120,WOLB.0323.00014,1,462535,463324,+,789
120,WOLB.0323.00096,1,1071636,1072387,+,751
121,WOLB.0323.00090,1,362282,364045,+,1763
121,WOLB.0323.00002,1,444600,446363,+,1763
121,WOLB.0323.00138,1,234998,236761,-,1763
121,WOLB.0323.00132,1,384412,386175,+,1763
121,WOLB.0323.00143,1,913103,914866,-,1763
121,WOLB.0323.00106,1,913106,914869,-,1763
121,WOLB.0323.00121,1,435708,437471,+,1763
121,WOLB.0323.00135,1,1279822,1281585,-,1763
121,WOLB.0323.00103,1,1236726,1238489,+,1763
121,WOLB.0323.00107,1,1234989,1236752,+,1763
121,WOLB.0323.00019,1,1087981,1089744,+,1763
121,WOLB.0323.00060,1,49271,51034,+,1763
121,WOLB.0323.00074,1,594034,595797,-,1763
121,WOLB.0323.00120,1,580205,581968,-,1763
121,WOLB.0323.00039,1,448549,450312,-,1763
121,WOLB.0323.00041,1,1035064,1036827,+,1763
121,WOLB.0323.00031,1,1145971,1147734,+,1763
121,WOLB.0323.00056,1,373338,375101,+,1763
121,WOLB.0323.00142,1,360420,362183,+,1763
121,WOLB.0323.00023,1,1338191,1339954,+,1763
121,WOLB.0323.00153,1,365583,367346,+,1763
121,WOLB.0323.00093,1,833298,835061,+,1763
121,WOLB.0323.00088,1,436782,438545,+,1763
121,WOLB.0323.00008,1,920234,921997,-,1763
121,WOLB.0323.00024,1,1808791,1810554,+,1763
121,WOLB.0323.00064,1,118516,120279,+,1763
121,WOLB.0323.00030,1,1220931,1222694,-,1763
121,WOLB.0323.00105,1,1236734,1238497,+,1763
121,WOLB.0323.00133,1,391492,393255,-,1763
121,WOLB.0323.00084,1,331474,333237,-,1763
121,WOLB.0323.00021,1,733016,734779,+,1763
121,WOLB.0323.00043,1,1228360,1230123,-,1763
121,WOLB.0323.00020,1,406560,408323,+,1763
121,WOLB.0323.00122,1,1192601,1194364,-,1763
121,WOLB.0323.00118,1,372636,374399,+,1763
121,WOLB.0323.00004,1,359088,360851,+,1763
121,WOLB.0323.00011,1,1110233,1111996,+,1763
121,WOLB.0323.00035,1,362273,364036,+,1763
121,WOLB.0323.00032,1,1304530,1306293,+,1763
121,WOLB.0323.00012,1,437934,439697,+,1763
121,WOLB.0323.00018,1,404852,406615,+,1763
121,WOLB.0323.00025,1,368211,369966,-,1755
121,WOLB.0323.00010,1,1127043,1128806,-,1763
121,WOLB.0323.00068,1,1311647,1313410,-,1763
121,WOLB.0323.00128,1,1044407,1046170,-,1763
121,WOLB.0323.00158,1,532737,534500,-,1763
121,WOLB.0323.00017,1,434739,436502,+,1763
121,WOLB.0323.00104,1,364673,366436,+,1763
121,WOLB.0323.00007,1,1054698,1056461,-,1763
121,WOLB.0323.00001,1,1236734,1238497,+,1763
121,WOLB.0323.00100,1,513527,515290,+,1763
121,WOLB.0323.00070,1,433398,435161,+,1763
121,WOLB.0323.00006,1,193075,194838,-,1763
121,WOLB.0323.00042,1,457584,459347,+,1763
121,WOLB.0323.00119,1,1092076,1093839,+,1763
121,WOLB.0323.00149,1,104353,106116,-,1763
121,WOLB.0323.00014,1,463900,465663,+,1763
121,WOLB.0323.00096,1,1072967,1074730,+,1763
122,WOLB.0323.00090,1,364339,365627,+,1288
122,WOLB.0323.00002,1,446657,447945,+,1288
122,WOLB.0323.00138,1,233416,234704,-,1288
122,WOLB.0323.00132,1,386469,387760,+,1291
122,WOLB.0323.00143,1,911521,912800,-,1279
122,WOLB.0323.00106,1,911524,912803,-,1279
122,WOLB.0323.00121,1,437765,439053,+,1288
122,WOLB.0323.00135,1,1278240,1279528,-,1288
122,WOLB.0323.00103,1,1238783,1240071,+,1288
122,WOLB.0323.00107,1,1237046,1238334,+,1288
122,WOLB.0323.00019,1,1090038,1091326,+,1288
122,WOLB.0323.00060,1,51328,52616,+,1288
122,WOLB.0323.00074,1,592452,593740,-,1288
122,WOLB.0323.00120,1,578623,579911,-,1288
122,WOLB.0323.00039,1,446967,448255,-,1288
122,WOLB.0323.00041,1,1037121,1038409,+,1288
122,WOLB.0323.00031,1,1148037,1149316,+,1279
122,WOLB.0323.00056,1,375395,376683,+,1288
122,WOLB.0323.00142,1,362477,363765,+,1288
122,WOLB.0323.00023,1,1340248,1341536,+,1288
122,WOLB.0323.00153,1,367640,368928,+,1288
122,WOLB.0323.00093,1,835355,836643,+,1288
122,WOLB.0323.00088,1,438839,440127,+,1288
122,WOLB.0323.00008,1,918652,919940,-,1288
122,WOLB.0323.00024,1,1810848,1812139,+,1291
122,WOLB.0323.00064,1,120573,121861,+,1288
122,WOLB.0323.00030,1,1219349,1220637,-,1288
122,WOLB.0323.00105,1,1238791,1240079,+,1288
122,WOLB.0323.00133,1,389910,391198,-,1288
122,WOLB.0323.00084,1,329892,331180,-,1288
122,WOLB.0323.00021,1,735073,736361,+,1288
122,WOLB.0323.00043,1,1226778,1228066,-,1288
122,WOLB.0323.00020,1,408617,409905,+,1288
122,WOLB.0323.00122,1,1191019,1192307,-,1288
122,WOLB.0323.00118,1,374693,375981,+,1288
122,WOLB.0323.00004,1,361145,362433,+,1288
122,WOLB.0323.00011,1,1112290,1113578,+,1288
122,WOLB.0323.00035,1,364330,365618,+,1288
122,WOLB.0323.00032,1,1306587,1307875,+,1288
122,WOLB.0323.00012,1,439991,441279,+,1288
122,WOLB.0323.00018,1,406909,408197,+,1288
122,WOLB.0323.00025,1,468294,469582,-,1288
122,WOLB.0323.00010,1,1125461,1126749,-,1288
122,WOLB.0323.00068,1,1310065,1311353,-,1288
122,WOLB.0323.00128,1,1042825,1044113,-,1288
122,WOLB.0323.00158,1,531155,532443,-,1288
122,WOLB.0323.00017,1,436796,438084,+,1288
122,WOLB.0323.00104,1,366730,368018,+,1288
122,WOLB.0323.00007,1,1053116,1054404,-,1288
122,WOLB.0323.00001,1,1238791,1240079,+,1288
122,WOLB.0323.00100,1,515584,516872,+,1288
122,WOLB.0323.00070,1,435455,436743,+,1288
122,WOLB.0323.00006,1,191493,192772,-,1279
122,WOLB.0323.00042,1,459641,460929,+,1288
122,WOLB.0323.00119,1,1094133,1095421,+,1288
122,WOLB.0323.00149,1,102771,104059,-,1288
122,WOLB.0323.00014,1,465957,467245,+,1288
122,WOLB.0323.00096,1,1075024,1076312,+,1288
123,WOLB.0323.00090,1,365939,366609,+,670
123,WOLB.0323.00002,1,448257,448927,+,670
123,WOLB.0323.00138,1,232434,233104,-,670
123,WOLB.0323.00132,1,388072,388742,+,670
123,WOLB.0323.00143,1,910550,911209,-,659
123,WOLB.0323.00106,1,910553,911212,-,659
123,WOLB.0323.00121,1,439365,440035,+,670
123,WOLB.0323.00135,1,1277258,1277928,-,670
123,WOLB.0323.00103,1,1240383,1241035,+,652
123,WOLB.0323.00107,1,1238646,1239298,+,652
123,WOLB.0323.00019,1,1081845,1082515,+,670
123,WOLB.0323.00060,1,52928,53598,+,670
123,WOLB.0323.00074,1,591470,592140,-,670
123,WOLB.0323.00120,1,577641,578311,-,670
123,WOLB.0323.00039,1,445985,446655,-,670
123,WOLB.0323.00041,1,1038721,1039391,+,670
123,WOLB.0323.00031,1,1149628,1150287,+,659
123,WOLB.0323.00056,1,376995,377665,+,670
123,WOLB.0323.00142,1,364077,364747,+,670
123,WOLB.0323.00023,1,1341848,1342518,+,670
123,WOLB.0323.00153,1,369240,369910,+,670
123,WOLB.0323.00093,1,836955,837625,+,670
123,WOLB.0323.00088,1,440439,441109,+,670
123,WOLB.0323.00008,1,917670,918340,-,670
123,WOLB.0323.00024,1,1812451,1813120,+,669
123,WOLB.0323.00064,1,122173,122843,+,670
123,WOLB.0323.00030,1,1216519,1217136,-,617
123,WOLB.0323.00105,1,1240391,1241043,+,652
123,WOLB.0323.00133,1,388933,389596,-,663
123,WOLB.0323.00084,1,328910,329580,-,670
123,WOLB.0323.00021,1,736673,737343,+,670
123,WOLB.0323.00043,1,1225796,1226466,-,670
123,WOLB.0323.00020,1,410217,410887,+,670
123,WOLB.0323.00122,1,1190037,1190707,-,670
123,WOLB.0323.00118,1,376293,376963,+,670
123,WOLB.0323.00004,1,362745,363415,+,670
123,WOLB.0323.00011,1,1113890,1114560,+,670
123,WOLB.0323.00035,1,365930,366600,+,670
123,WOLB.0323.00032,1,1308187,1308857,+,670
123,WOLB.0323.00012,1,441591,442261,+,670
123,WOLB.0323.00018,1,408509,409179,+,670
123,WOLB.0323.00025,1,467312,467964,-,652
123,WOLB.0323.00010,1,1124479,1125149,-,670
123,WOLB.0323.00068,1,1309083,1309753,-,670
123,WOLB.0323.00128,1,1041843,1042513,-,670
123,WOLB.0323.00158,1,530173,530843,-,670
123,WOLB.0323.00017,1,438396,439066,+,670
123,WOLB.0323.00104,1,368330,369000,+,670
123,WOLB.0323.00007,1,1052134,1052804,-,670
123,WOLB.0323.00001,1,1240391,1241043,+,652
123,WOLB.0323.00100,1,517184,517854,+,670
123,WOLB.0323.00070,1,437055,437725,+,670
123,WOLB.0323.00006,1,190522,191181,-,659
123,WOLB.0323.00042,1,461241,461911,+,670
123,WOLB.0323.00119,1,1085940,1086610,+,670
123,WOLB.0323.00149,1,101789,102459,-,670
123,WOLB.0323.00014,1,467557,468227,+,670
123,WOLB.0323.00096,1,1076624,1077294,+,670
124,WOLB.0323.00090,1,367015,368365,+,1350
124,WOLB.0323.00002,1,449334,450683,+,1349
124,WOLB.0323.00138,1,230678,232028,-,1350
124,WOLB.0323.00132,1,389149,390498,+,1349
124,WOLB.0323.00143,1,908794,910144,-,1350
124,WOLB.0323.00106,1,908797,910147,-,1350
124,WOLB.0323.00121,1,440441,441791,+,1350
124,WOLB.0323.00135,1,1275502,1276852,-,1350
124,WOLB.0323.00103,1,1244921,1246271,+,1350
124,WOLB.0323.00107,1,1243184,1244534,+,1350
124,WOLB.0323.00019,1,1082921,1084271,+,1350
124,WOLB.0323.00060,1,54004,55354,+,1350
124,WOLB.0323.00074,1,589714,591064,-,1350
124,WOLB.0323.00120,1,575885,577235,-,1350
124,WOLB.0323.00039,1,444229,445579,-,1350
124,WOLB.0323.00041,1,1039797,1041147,+,1350
124,WOLB.0323.00031,1,1150693,1152043,+,1350
124,WOLB.0323.00056,1,378070,379420,+,1350
124,WOLB.0323.00142,1,365153,366503,+,1350
124,WOLB.0323.00023,1,1342925,1344274,+,1349
124,WOLB.0323.00153,1,370316,371666,+,1350
124,WOLB.0323.00093,1,838031,839381,+,1350
124,WOLB.0323.00088,1,441515,442865,+,1350
124,WOLB.0323.00008,1,915914,917264,-,1350
124,WOLB.0323.00024,1,1513290,1514639,-,1349
124,WOLB.0323.00064,1,123250,124599,+,1349
124,WOLB.0323.00030,1,1214763,1216112,-,1349
124,WOLB.0323.00105,1,1244929,1246279,+,1350
124,WOLB.0323.00133,1,387170,388520,-,1350
124,WOLB.0323.00084,1,327154,328504,-,1350
124,WOLB.0323.00021,1,737749,739099,+,1350
124,WOLB.0323.00043,1,1224040,1225389,-,1349
124,WOLB.0323.00020,1,411293,412643,+,1350
124,WOLB.0323.00122,1,1188281,1189631,-,1350
124,WOLB.0323.00118,1,377369,378719,+,1350
124,WOLB.0323.00004,1,363821,365171,+,1350
124,WOLB.0323.00011,1,1114966,1116316,+,1350
124,WOLB.0323.00035,1,367006,368356,+,1350
124,WOLB.0323.00032,1,1309263,1310613,+,1350
124,WOLB.0323.00012,1,442667,444017,+,1350
124,WOLB.0323.00018,1,409585,410935,+,1350
124,WOLB.0323.00025,1,465563,466906,-,1343
124,WOLB.0323.00010,1,1122723,1124072,-,1349
124,WOLB.0323.00068,1,1307327,1308677,-,1350
124,WOLB.0323.00128,1,1040087,1041436,-,1349
124,WOLB.0323.00158,1,528417,529767,-,1350
124,WOLB.0323.00017,1,439472,440822,+,1350
124,WOLB.0323.00104,1,369406,370756,+,1350
124,WOLB.0323.00007,1,1050378,1051728,-,1350
124,WOLB.0323.00001,1,1244929,1246279,+,1350
124,WOLB.0323.00100,1,518260,519610,+,1350
124,WOLB.0323.00070,1,438132,439481,+,1349
124,WOLB.0323.00006,1,188766,190116,-,1350
124,WOLB.0323.00042,1,462317,463667,+,1350
124,WOLB.0323.00119,1,1087016,1088366,+,1350
124,WOLB.0323.00149,1,100033,101383,-,1350
124,WOLB.0323.00014,1,468634,469983,+,1349
124,WOLB.0323.00096,1,1077700,1079050,+,1350
125,WOLB.0323.00090,1,369036,371046,+,2010
125,WOLB.0323.00002,1,451063,453073,+,2010
125,WOLB.0323.00138,1,227997,230007,-,2010
125,WOLB.0323.00132,1,391169,393179,+,2010
125,WOLB.0323.00143,1,906116,908123,-,2007
125,WOLB.0323.00106,1,906119,908126,-,2007
125,WOLB.0323.00121,1,442462,444472,+,2010
125,WOLB.0323.00135,1,1270857,1272867,-,2010
125,WOLB.0323.00103,1,1246942,1248952,+,2010
125,WOLB.0323.00107,1,1245205,1247215,+,2010
125,WOLB.0323.00019,1,1210275,1212277,-,2002
125,WOLB.0323.00060,1,56025,58035,+,2010
125,WOLB.0323.00074,1,587036,589043,-,2007
125,WOLB.0323.00120,1,573207,575214,-,2007
125,WOLB.0323.00039,1,441548,443558,-,2010
125,WOLB.0323.00041,1,1041818,1043825,+,2007
125,WOLB.0323.00031,1,1152714,1154721,+,2007
125,WOLB.0323.00056,1,380091,382101,+,2010
125,WOLB.0323.00142,1,367174,369184,+,2010
125,WOLB.0323.00023,1,1344945,1346955,+,2010
125,WOLB.0323.00153,1,372337,374347,+,2010
125,WOLB.0323.00093,1,840052,842060,+,2008
125,WOLB.0323.00088,1,443536,445546,+,2010
125,WOLB.0323.00008,1,913235,915243,-,2008
125,WOLB.0323.00024,1,1510609,1512619,-,2010
125,WOLB.0323.00064,1,125274,127284,+,2010
125,WOLB.0323.00030,1,1212078,1214088,-,2010
125,WOLB.0323.00105,1,1246950,1248960,+,2010
125,WOLB.0323.00133,1,384514,386524,-,2010
125,WOLB.0323.00084,1,324473,326483,-,2010
125,WOLB.0323.00021,1,739770,741780,+,2010
125,WOLB.0323.00043,1,1221650,1223660,-,2010
125,WOLB.0323.00020,1,413314,415324,+,2010
125,WOLB.0323.00122,1,1185600,1187610,-,2010
125,WOLB.0323.00118,1,379389,381399,+,2010
125,WOLB.0323.00004,1,365842,367852,+,2010
125,WOLB.0323.00011,1,1116987,1118997,+,2010
125,WOLB.0323.00035,1,369027,371037,+,2010
125,WOLB.0323.00032,1,1311284,1313294,+,2010
125,WOLB.0323.00012,1,444688,446698,+,2010
125,WOLB.0323.00018,1,411315,413325,+,2010
125,WOLB.0323.00025,1,462876,464886,-,2010
125,WOLB.0323.00010,1,1120046,1122056,-,2010
125,WOLB.0323.00068,1,1304646,1306656,-,2010
125,WOLB.0323.00128,1,1037697,1039707,-,2010
125,WOLB.0323.00158,1,525736,527746,-,2010
125,WOLB.0323.00017,1,441493,443503,+,2010
125,WOLB.0323.00104,1,371427,373437,+,2010
125,WOLB.0323.00007,1,1047697,1049707,-,2010
125,WOLB.0323.00001,1,1246950,1248960,+,2010
125,WOLB.0323.00100,1,520281,522291,+,2010
125,WOLB.0323.00070,1,439861,441871,+,2010
125,WOLB.0323.00006,1,186088,188095,-,2007
125,WOLB.0323.00042,1,465282,467292,+,2010
125,WOLB.0323.00119,1,1283404,1285406,-,2002
125,WOLB.0323.00149,1,97352,99362,-,2010
125,WOLB.0323.00014,1,470363,472373,+,2010
125,WOLB.0323.00096,1,1079721,1081728,+,2007
126,WOLB.0323.00090,1,371704,372593,+,889
126,WOLB.0323.00002,1,453731,454629,+,898
126,WOLB.0323.00138,1,226449,227339,-,890
126,WOLB.0323.00132,1,393837,394726,+,889
126,WOLB.0323.00143,1,903638,904531,-,893
126,WOLB.0323.00106,1,903641,904534,-,893
126,WOLB.0323.00121,1,445130,446019,+,889
126,WOLB.0323.00135,1,1269309,1270199,-,890
126,WOLB.0323.00103,1,1249610,1250502,+,892
126,WOLB.0323.00107,1,1247873,1248765,+,892
126,WOLB.0323.00019,1,1208709,1209617,-,908
126,WOLB.0323.00060,1,58693,59582,+,889
126,WOLB.0323.00074,1,582281,583174,-,893
126,WOLB.0323.00120,1,568452,569345,-,893
126,WOLB.0323.00039,1,439997,440890,-,893
126,WOLB.0323.00041,1,1047656,1048548,+,892
126,WOLB.0323.00031,1,1156306,1157198,+,892
126,WOLB.0323.00056,1,382759,383648,+,889
126,WOLB.0323.00142,1,370990,371834,+,844
126,WOLB.0323.00023,1,1347626,1348502,+,876
126,WOLB.0323.00153,1,375005,375894,+,889
126,WOLB.0323.00093,1,843643,844532,+,889
126,WOLB.0323.00088,1,446204,447093,+,889
126,WOLB.0323.00008,1,910763,911653,-,890
126,WOLB.0323.00024,1,1505979,1506873,-,894
126,WOLB.0323.00064,1,127942,128831,+,889
126,WOLB.0323.00030,1,1210530,1211420,-,890
126,WOLB.0323.00105,1,1249618,1250510,+,892
126,WOLB.0323.00133,1,382963,383856,-,893
126,WOLB.0323.00084,1,322925,323815,-,890
126,WOLB.0323.00021,1,742438,743327,+,889
126,WOLB.0323.00043,1,1220102,1220992,-,890
126,WOLB.0323.00020,1,415982,416871,+,889
126,WOLB.0323.00122,1,1184052,1184942,-,890
126,WOLB.0323.00118,1,382057,382946,+,889
126,WOLB.0323.00004,1,368510,369399,+,889
126,WOLB.0323.00011,1,1119655,1120544,+,889
126,WOLB.0323.00035,1,371695,372584,+,889
126,WOLB.0323.00032,1,1313952,1314841,+,889
126,WOLB.0323.00012,1,447356,448245,+,889
126,WOLB.0323.00018,1,413983,414875,+,892
126,WOLB.0323.00025,1,461325,462218,-,893
126,WOLB.0323.00010,1,1118489,1119383,-,894
126,WOLB.0323.00068,1,1303098,1303988,-,890
126,WOLB.0323.00128,1,1036149,1037039,-,890
126,WOLB.0323.00158,1,524188,525078,-,890
126,WOLB.0323.00017,1,444161,445050,+,889
126,WOLB.0323.00104,1,374095,374984,+,889
126,WOLB.0323.00007,1,1046149,1047039,-,890
126,WOLB.0323.00001,1,1249618,1250510,+,892
126,WOLB.0323.00100,1,522949,523838,+,889
126,WOLB.0323.00070,1,442529,443418,+,889
126,WOLB.0323.00006,1,183610,184503,-,893
126,WOLB.0323.00042,1,467950,468842,+,892
126,WOLB.0323.00119,1,1281838,1282746,-,908
126,WOLB.0323.00149,1,95804,96694,-,890
126,WOLB.0323.00014,1,473031,473920,+,889
126,WOLB.0323.00096,1,1085590,1086482,+,892
127,WOLB.0323.00090,1,372595,373525,+,930
127,WOLB.0323.00002,1,454631,455552,+,921
127,WOLB.0323.00138,1,225518,226448,-,930
127,WOLB.0323.00132,1,394728,395658,+,930
127,WOLB.0323.00143,1,902707,903637,-,930
127,WOLB.0323.00106,1,902710,903640,-,930
127,WOLB.0323.00121,1,446021,446951,+,930
127,WOLB.0323.00135,1,1268378,1269308,-,930
127,WOLB.0323.00103,1,1250504,1251434,+,930
127,WOLB.0323.00107,1,1248767,1249697,+,930
127,WOLB.0323.00019,1,1276228,1277142,+,914
127,WOLB.0323.00060,1,59584,60514,+,930
127,WOLB.0323.00074,1,581350,582280,-,930
127,WOLB.0323.00120,1,567521,568451,-,930
127,WOLB.0323.00039,1,439066,439996,-,930
127,WOLB.0323.00041,1,1048550,1049480,+,930
127,WOLB.0323.00031,1,1157200,1158130,+,930
127,WOLB.0323.00056,1,383650,384580,+,930
127,WOLB.0323.00142,1,371836,372766,+,930
127,WOLB.0323.00023,1,1348504,1349434,+,930
127,WOLB.0323.00153,1,375896,376826,+,930
127,WOLB.0323.00093,1,844534,845464,+,930
127,WOLB.0323.00088,1,447095,448025,+,930
127,WOLB.0323.00008,1,909832,910762,-,930
127,WOLB.0323.00024,1,1505048,1505978,-,930
127,WOLB.0323.00064,1,128833,129763,+,930
127,WOLB.0323.00030,1,1209599,1210529,-,930
127,WOLB.0323.00105,1,1250512,1251442,+,930
127,WOLB.0323.00133,1,382032,382962,-,930
127,WOLB.0323.00084,1,321994,322924,-,930
127,WOLB.0323.00021,1,743329,744259,+,930
127,WOLB.0323.00043,1,1219171,1220101,-,930
127,WOLB.0323.00020,1,416873,417803,+,930
127,WOLB.0323.00122,1,1183121,1184051,-,930
127,WOLB.0323.00118,1,382948,383878,+,930
127,WOLB.0323.00004,1,369401,370331,+,930
127,WOLB.0323.00011,1,1120546,1121476,+,930
127,WOLB.0323.00035,1,372586,373516,+,930
127,WOLB.0323.00032,1,1314843,1315773,+,930
127,WOLB.0323.00012,1,448247,449177,+,930
127,WOLB.0323.00018,1,414877,415807,+,930
127,WOLB.0323.00025,1,460394,461324,-,930
127,WOLB.0323.00010,1,1117561,1118488,-,927
127,WOLB.0323.00068,1,1302167,1303097,-,930
127,WOLB.0323.00128,1,1035218,1036148,-,930
127,WOLB.0323.00158,1,523257,524187,-,930
127,WOLB.0323.00017,1,445052,445982,+,930
127,WOLB.0323.00104,1,374986,375916,+,930
127,WOLB.0323.00007,1,1045218,1046148,-,930
127,WOLB.0323.00001,1,1250512,1251442,+,930
127,WOLB.0323.00100,1,523840,524770,+,930
127,WOLB.0323.00070,1,443420,444350,+,930
127,WOLB.0323.00006,1,182679,183609,-,930
127,WOLB.0323.00042,1,468844,469774,+,930
127,WOLB.0323.00119,1,1212970,1213884,-,914
127,WOLB.0323.00149,1,94873,95803,-,930
127,WOLB.0323.00014,1,473922,474852,+,930
127,WOLB.0323.00096,1,1086484,1087414,+,930
258,WOLB.0323.00090,1,754222,760378,+,6156
258,WOLB.0323.00002,1,512098,518239,-,6141
258,WOLB.0323.00138,1,1285247,1291403,-,6156
258,WOLB.0323.00132,1,455442,461598,-,6156
258,WOLB.0323.00143,1,533601,539756,-,6155
258,WOLB.0323.00106,1,533604,539759,-,6155
258,WOLB.0323.00121,1,1014839,1020995,+,6156
258,WOLB.0323.00135,1,918555,924711,+,6156
258,WOLB.0323.00103,1,715771,721927,+,6156
258,WOLB.0323.00107,1,714355,720511,+,6156
258,WOLB.0323.00019,1,547329,553485,+,6156
258,WOLB.0323.00060,1,580082,586238,-,6156
258,WOLB.0323.00074,1,115553,121712,+,6159
258,WOLB.0323.00120,1,114783,120942,+,6159
258,WOLB.0323.00039,1,1294006,1300162,-,6156
258,WOLB.0323.00041,1,108799,114958,+,6159
258,WOLB.0323.00031,1,247553,253708,+,6155
258,WOLB.0323.00056,1,800631,806787,+,6156
258,WOLB.0323.00142,1,889592,895748,+,6156
258,WOLB.0323.00023,1,1434572,1440746,-,6174
258,WOLB.0323.00153,1,825902,832058,+,6156
258,WOLB.0323.00093,1,943307,949460,+,6153
258,WOLB.0323.00088,1,846309,852465,+,6156
258,WOLB.0323.00008,1,460266,466403,+,6137
258,WOLB.0323.00024,1,47454,53556,+,6102
258,WOLB.0323.00064,1,189862,196018,-,6156
258,WOLB.0323.00030,1,1001845,1008001,+,6156
258,WOLB.0323.00105,1,715782,721938,+,6156
258,WOLB.0323.00133,1,187823,193990,-,6167
258,WOLB.0323.00084,1,1185259,1191415,-,6156
258,WOLB.0323.00021,1,1051667,1057823,+,6156
258,WOLB.0323.00043,1,891916,898058,+,6142
258,WOLB.0323.00020,1,787205,793361,+,6156
258,WOLB.0323.00122,1,699064,705220,+,6156
258,WOLB.0323.00118,1,677523,683680,+,6157
258,WOLB.0323.00004,1,889593,895749,+,6156
258,WOLB.0323.00011,1,259058,265214,+,6156
258,WOLB.0323.00035,1,784210,790366,+,6156
258,WOLB.0323.00032,1,346570,352726,+,6156
258,WOLB.0323.00012,1,850411,856567,+,6156
258,WOLB.0323.00018,1,875346,881506,+,6160
258,WOLB.0323.00025,1,1075693,1081845,-,6152
258,WOLB.0323.00010,1,392160,398315,-,6155
258,WOLB.0323.00068,1,1021652,1027823,+,6171
258,WOLB.0323.00128,1,502573,508714,-,6141
258,WOLB.0323.00158,1,162443,168599,+,6156
258,WOLB.0323.00017,1,878300,884456,+,6156
258,WOLB.0323.00104,1,821830,827986,+,6156
258,WOLB.0323.00007,1,535684,541840,-,6156
258,WOLB.0323.00001,1,715782,721938,+,6156
258,WOLB.0323.00100,1,1168859,1175015,+,6156
258,WOLB.0323.00070,1,1342031,1348173,+,6142
258,WOLB.0323.00006,1,1066060,1072215,-,6155
258,WOLB.0323.00042,1,833565,839700,-,6135
258,WOLB.0323.00119,1,626538,632694,-,6156
258,WOLB.0323.00149,1,947913,954069,-,6156
258,WOLB.0323.00014,1,1204243,1210385,+,6142
258,WOLB.0323.00096,1,122608,128767,+,6159
259,WOLB.0323.00090,1,760924,762765,+,1841
259,WOLB.0323.00002,1,564269,566110,-,1841
259,WOLB.0323.00138,1,1282860,1284701,-,1841
259,WOLB.0323.00132,1,453055,454896,-,1841
259,WOLB.0323.00143,1,531214,533055,-,1841
259,WOLB.0323.00106,1,531217,533058,-,1841
259,WOLB.0323.00121,1,1021541,1023382,+,1841
259,WOLB.0323.00135,1,925257,927098,+,1841
259,WOLB.0323.00103,1,727349,729152,+,1803
259,WOLB.0323.00107,1,725933,727736,+,1803
259,WOLB.0323.00019,1,554031,555872,+,1841
259,WOLB.0323.00060,1,577683,579536,-,1853
259,WOLB.0323.00074,1,122258,124099,+,1841
259,WOLB.0323.00120,1,121488,123329,+,1841
259,WOLB.0323.00039,1,1291619,1293460,-,1841
259,WOLB.0323.00041,1,115504,117345,+,1841
259,WOLB.0323.00031,1,254254,256095,+,1841
259,WOLB.0323.00056,1,807333,809174,+,1841
259,WOLB.0323.00142,1,896294,898135,+,1841
259,WOLB.0323.00023,1,1432185,1434026,-,1841
259,WOLB.0323.00153,1,832604,834445,+,1841
259,WOLB.0323.00093,1,916677,918517,-,1840
259,WOLB.0323.00088,1,853011,854852,+,1841
259,WOLB.0323.00008,1,472708,474549,+,1841
259,WOLB.0323.00024,1,54099,55940,+,1841
259,WOLB.0323.00064,1,187475,189316,-,1841
259,WOLB.0323.00030,1,1008547,1010388,+,1841
259,WOLB.0323.00105,1,727360,729163,+,1803
259,WOLB.0323.00133,1,185436,187277,-,1841
259,WOLB.0323.00084,1,1182872,1184713,-,1841
259,WOLB.0323.00021,1,1058369,1060210,+,1841
259,WOLB.0323.00043,1,879683,881524,-,1841
259,WOLB.0323.00020,1,793907,795748,+,1841
259,WOLB.0323.00122,1,705766,707607,+,1841
259,WOLB.0323.00118,1,684226,686067,+,1841
259,WOLB.0323.00004,1,896295,898136,+,1841
259,WOLB.0323.00011,1,265760,267601,+,1841
259,WOLB.0323.00035,1,790912,792753,+,1841
259,WOLB.0323.00032,1,353272,355113,+,1841
259,WOLB.0323.00012,1,857113,858954,+,1841
259,WOLB.0323.00018,1,863351,865192,-,1841
259,WOLB.0323.00025,1,1073141,1074962,-,1821
259,WOLB.0323.00010,1,408619,410460,+,1841
259,WOLB.0323.00068,1,1028369,1030210,+,1841
259,WOLB.0323.00128,1,519107,520948,+,1841
259,WOLB.0323.00158,1,169145,170986,+,1841
259,WOLB.0323.00017,1,885002,886843,+,1841
259,WOLB.0323.00104,1,828532,830373,+,1841
259,WOLB.0323.00007,1,533297,535138,-,1841
259,WOLB.0323.00001,1,727360,729163,+,1803
259,WOLB.0323.00100,1,1175561,1177402,+,1841
259,WOLB.0323.00070,1,1329798,1331639,-,1841
259,WOLB.0323.00006,1,1063673,1065514,-,1841
259,WOLB.0323.00042,1,1077115,1078956,+,1841
259,WOLB.0323.00119,1,624151,625992,-,1841
259,WOLB.0323.00149,1,945526,947367,-,1841
259,WOLB.0323.00014,1,1192010,1193851,-,1841
259,WOLB.0323.00096,1,129313,131154,+,1841
260,WOLB.0323.00090,1,764851,771093,+,6242
260,WOLB.0323.00002,1,554586,560829,-,6243
260,WOLB.0323.00138,1,1274531,1280774,-,6243
260,WOLB.0323.00132,1,444725,450968,-,6243
260,WOLB.0323.00143,1,522743,529005,-,6262
260,WOLB.0323.00106,1,522746,529008,-,6262
260,WOLB.0323.00121,1,1025468,1031710,+,6242
260,WOLB.0323.00135,1,929184,935426,+,6242
260,WOLB.0323.00103,1,731230,737472,+,6242
260,WOLB.0323.00107,1,729814,736056,+,6242
260,WOLB.0323.00019,1,556190,562421,+,6231
260,WOLB.0323.00060,1,569354,575597,-,6243
260,WOLB.0323.00074,1,126784,133043,+,6259
260,WOLB.0323.00120,1,126014,132273,+,6259
260,WOLB.0323.00039,1,1285069,1291301,-,6232
260,WOLB.0323.00041,1,120030,126289,+,6259
260,WOLB.0323.00031,1,258304,264566,+,6262
260,WOLB.0323.00056,1,812548,818790,+,6242
260,WOLB.0323.00142,1,900221,906463,+,6242
260,WOLB.0323.00023,1,1425643,1431886,-,6243
260,WOLB.0323.00153,1,836531,842773,+,6242
260,WOLB.0323.00093,1,1172936,1179178,+,6242
260,WOLB.0323.00088,1,856938,863180,+,6242
260,WOLB.0323.00008,1,477205,483447,+,6242
260,WOLB.0323.00024,1,56247,62504,+,6257
260,WOLB.0323.00064,1,179145,185388,-,6243
260,WOLB.0323.00030,1,1012482,1018724,+,6242
260,WOLB.0323.00105,1,731241,737483,+,6242
260,WOLB.0323.00133,1,178894,185137,-,6243
260,WOLB.0323.00084,1,1174543,1180786,-,6243
260,WOLB.0323.00021,1,1062296,1068538,+,6242
260,WOLB.0323.00043,1,871345,877588,-,6243
260,WOLB.0323.00020,1,797834,804076,+,6242
260,WOLB.0323.00122,1,709693,715935,+,6242
260,WOLB.0323.00118,1,686366,692608,+,6242
260,WOLB.0323.00004,1,900222,906464,+,6242
260,WOLB.0323.00011,1,269687,275929,+,6242
260,WOLB.0323.00035,1,794839,801081,+,6242
260,WOLB.0323.00032,1,357199,363441,+,6242
260,WOLB.0323.00012,1,861040,867282,+,6242
260,WOLB.0323.00018,1,855024,861267,-,6243
260,WOLB.0323.00025,1,1066579,1072834,-,6255
260,WOLB.0323.00010,1,412555,418797,+,6242
260,WOLB.0323.00068,1,1032296,1038538,+,6242
260,WOLB.0323.00128,1,523043,529285,+,6242
260,WOLB.0323.00158,1,173072,179314,+,6242
260,WOLB.0323.00017,1,888929,895171,+,6242
260,WOLB.0323.00104,1,832459,838701,+,6242
260,WOLB.0323.00007,1,524968,531211,-,6243
260,WOLB.0323.00001,1,731241,737483,+,6242
260,WOLB.0323.00100,1,1179488,1185730,+,6242
260,WOLB.0323.00070,1,1321460,1327703,-,6243
260,WOLB.0323.00006,1,1055202,1061464,-,6262
260,WOLB.0323.00042,1,1079255,1085513,+,6258
260,WOLB.0323.00119,1,617601,623833,-,6232
260,WOLB.0323.00149,1,937197,943440,-,6243
260,WOLB.0323.00014,1,1183672,1189915,-,6243
260,WOLB.0323.00096,1,133839,140098,+,6259
261,WOLB.0323.00090,1,772169,772698,+,529
261,WOLB.0323.00002,1,552982,553511,-,529
261,WOLB.0323.00138,1,1270627,1271156,-,529
261,WOLB.0323.00132,1,443121,443650,-,529
261,WOLB.0323.00143,1,521143,521672,-,529
261,WOLB.0323.00106,1,521146,521675,-,529
261,WOLB.0323.00121,1,1032786,1033315,+,529
261,WOLB.0323.00135,1,1150917,1151446,+,529
261,WOLB.0323.00103,1,739391,739916,+,525
261,WOLB.0323.00107,1,737975,738500,+,525
261,WOLB.0323.00019,1,563485,564014,+,529
261,WOLB.0323.00060,1,567750,568279,-,529
261,WOLB.0323.00074,1,134123,134648,+,525
261,WOLB.0323.00120,1,133353,133878,+,525
261,WOLB.0323.00039,1,1283478,1284007,-,529
261,WOLB.0323.00041,1,127369,127894,+,525
261,WOLB.0323.00031,1,265637,266166,+,529
261,WOLB.0323.00056,1,819866,820395,+,529
261,WOLB.0323.00142,1,907539,908068,+,529
261,WOLB.0323.00023,1,1424045,1424568,-,523
261,WOLB.0323.00153,1,843849,844378,+,529
261,WOLB.0323.00093,1,1180254,1180783,+,529
261,WOLB.0323.00088,1,864256,864785,+,529
261,WOLB.0323.00008,1,484516,485045,+,529
261,WOLB.0323.00024,1,189130,189659,+,529
261,WOLB.0323.00064,1,177541,178070,-,529
261,WOLB.0323.00030,1,1019800,1020329,+,529
261,WOLB.0323.00105,1,739402,739927,+,525
261,WOLB.0323.00133,1,177290,177819,-,529
261,WOLB.0323.00084,1,1170639,1171168,-,529
261,WOLB.0323.00021,1,1071914,1072443,+,529
261,WOLB.0323.00043,1,869741,870270,-,529
261,WOLB.0323.00020,1,805152,805681,+,529
261,WOLB.0323.00122,1,717011,717540,+,529
261,WOLB.0323.00118,1,693684,694213,+,529
261,WOLB.0323.00004,1,907540,908069,+,529
261,WOLB.0323.00011,1,277005,277534,+,529
261,WOLB.0323.00035,1,802157,802686,+,529
261,WOLB.0323.00032,1,366817,367346,+,529
261,WOLB.0323.00012,1,868358,868887,+,529
261,WOLB.0323.00018,1,853420,853949,-,529
261,WOLB.0323.00025,1,1064975,1065504,-,529
261,WOLB.0323.00010,1,419874,420402,+,528
261,WOLB.0323.00068,1,661442,661971,+,529
261,WOLB.0323.00128,1,530361,530890,+,529
261,WOLB.0323.00158,1,180390,180919,+,529
261,WOLB.0323.00017,1,896247,896776,+,529
261,WOLB.0323.00104,1,839777,840306,+,529
261,WOLB.0323.00007,1,521064,521593,-,529
261,WOLB.0323.00001,1,739402,739927,+,525
261,WOLB.0323.00100,1,1186806,1187335,+,529
261,WOLB.0323.00070,1,1319856,1320385,-,529
261,WOLB.0323.00006,1,1053602,1054131,-,529
261,WOLB.0323.00042,1,602367,602896,+,529
261,WOLB.0323.00119,1,616009,616538,-,529
261,WOLB.0323.00149,1,935593,936122,-,529
261,WOLB.0323.00014,1,1182068,1182597,-,529
261,WOLB.0323.00096,1,141178,141703,+,525
262,WOLB.0323.00090,1,773699,774856,+,1157
262,WOLB.0323.00002,1,551734,552894,-,1160
262,WOLB.0323.00138,1,1268469,1269626,-,1157
262,WOLB.0323.00132,1,440960,442120,-,1160
262,WOLB.0323.00143,1,519892,521055,-,1163
262,WOLB.0323.00106,1,519895,521058,-,1163
262,WOLB.0323.00121,1,1034315,1035472,+,1157
262,WOLB.0323.00135,1,1152446,1153603,+,1157
262,WOLB.0323.00103,1,739996,741160,+,1164
262,WOLB.0323.00107,1,738580,739744,+,1164
262,WOLB.0323.00019,1,564102,565260,+,1158
262,WOLB.0323.00060,1,565593,566750,-,1157
262,WOLB.0323.00074,1,134735,135853,+,1118
262,WOLB.0323.00120,1,133965,135083,+,1118
262,WOLB.0323.00039,1,1282232,1283390,-,1158
262,WOLB.0323.00041,1,127981,129099,+,1118
262,WOLB.0323.00031,1,266254,267417,+,1163
262,WOLB.0323.00056,1,821395,822552,+,1157
262,WOLB.0323.00142,1,909068,910225,+,1157
262,WOLB.0323.00023,1,1421878,1423038,-,1160
262,WOLB.0323.00153,1,845379,846536,+,1157
262,WOLB.0323.00093,1,1180863,1182021,+,1158
262,WOLB.0323.00088,1,865785,866942,+,1157
262,WOLB.0323.00008,1,491134,492298,-,1164
262,WOLB.0323.00024,1,190668,191827,+,1159
262,WOLB.0323.00064,1,175380,176540,-,1160
262,WOLB.0323.00030,1,1021328,1022487,+,1159
262,WOLB.0323.00105,1,740007,741171,+,1164
262,WOLB.0323.00133,1,176039,177202,-,1163
262,WOLB.0323.00084,1,1168481,1169638,-,1157
262,WOLB.0323.00021,1,1073444,1074601,+,1157
262,WOLB.0323.00043,1,868493,869653,-,1160
262,WOLB.0323.00020,1,806681,807838,+,1157
262,WOLB.0323.00122,1,718541,719698,+,1157
262,WOLB.0323.00118,1,695214,696371,+,1157
262,WOLB.0323.00004,1,909069,910226,+,1157
262,WOLB.0323.00011,1,278534,279691,+,1157
262,WOLB.0323.00035,1,803686,804843,+,1157
262,WOLB.0323.00032,1,368347,369504,+,1157
262,WOLB.0323.00012,1,869887,871044,+,1157
262,WOLB.0323.00018,1,852165,853340,-,1175
262,WOLB.0323.00025,1,1063724,1064887,-,1163
262,WOLB.0323.00010,1,420490,421648,+,1158
262,WOLB.0323.00068,1,662972,664129,+,1157
262,WOLB.0323.00128,1,530978,532137,+,1159
262,WOLB.0323.00158,1,181919,183076,+,1157
262,WOLB.0323.00017,1,897776,898933,+,1157
262,WOLB.0323.00104,1,841306,842463,+,1157
262,WOLB.0323.00007,1,518907,520064,-,1157
262,WOLB.0323.00001,1,740007,741171,+,1164
262,WOLB.0323.00100,1,1188335,1189492,+,1157
262,WOLB.0323.00070,1,1318608,1319768,-,1160
262,WOLB.0323.00006,1,1052351,1053514,-,1163
262,WOLB.0323.00042,1,602976,604156,+,1180
262,WOLB.0323.00119,1,614763,615921,-,1158
262,WOLB.0323.00149,1,933436,934593,-,1157
262,WOLB.0323.00014,1,1180820,1181980,-,1160
262,WOLB.0323.00096,1,141790,142908,+,1118
263,WOLB.0323.00090,1,776849,778918,+,2069
263,WOLB.0323.00002,1,752296,754356,+,2060
263,WOLB.0323.00138,1,1264464,1266533,-,2069
263,WOLB.0323.00132,1,515754,517829,-,2075
263,WOLB.0323.00143,1,514286,516364,-,2078
263,WOLB.0323.00106,1,514289,516367,-,2078
263,WOLB.0323.00121,1,1037432,1039498,+,2066
263,WOLB.0323.00135,1,1155539,1157608,+,2069
263,WOLB.0323.00103,1,862099,864165,-,2066
263,WOLB.0323.00107,1,860673,862739,-,2066
263,WOLB.0323.00019,1,567160,569226,+,2066
263,WOLB.0323.00060,1,561622,563691,-,2069
263,WOLB.0323.00074,1,138934,141018,+,2084
263,WOLB.0323.00120,1,138164,140248,+,2084
263,WOLB.0323.00039,1,1278265,1280331,-,2066
263,WOLB.0323.00041,1,132180,134264,+,2084
263,WOLB.0323.00031,1,270945,273023,+,2078
263,WOLB.0323.00056,1,824452,826521,+,2069
263,WOLB.0323.00142,1,914170,916236,+,2066
263,WOLB.0323.00023,1,1848390,1850456,-,2066
263,WOLB.0323.00153,1,848529,850598,+,2069
263,WOLB.0323.00093,1,1184796,1186871,+,2075
263,WOLB.0323.00088,1,868842,870911,+,2069
263,WOLB.0323.00008,1,487132,489198,-,2066
263,WOLB.0323.00024,1,1583021,1585096,+,2075
263,WOLB.0323.00064,1,649908,651974,+,2066
263,WOLB.0323.00030,1,854497,856563,-,2066
263,WOLB.0323.00105,1,862109,864175,-,2066
263,WOLB.0323.00133,1,1173857,1175923,-,2066
263,WOLB.0323.00084,1,1164476,1166545,-,2069
263,WOLB.0323.00021,1,1076537,1078606,+,2069
263,WOLB.0323.00043,1,1030275,1032335,+,2060
263,WOLB.0323.00020,1,809738,811807,+,2069
263,WOLB.0323.00122,1,721691,723732,+,2041
263,WOLB.0323.00118,1,698222,700300,+,2078
263,WOLB.0323.00004,1,912186,914252,+,2066
263,WOLB.0323.00011,1,281651,283717,+,2066
263,WOLB.0323.00035,1,806743,808812,+,2069
263,WOLB.0323.00032,1,371440,373509,+,2069
263,WOLB.0323.00012,1,872944,875013,+,2069
263,WOLB.0323.00018,1,997248,999314,+,2066
263,WOLB.0323.00025,1,1025713,1027791,-,2078
263,WOLB.0323.00010,1,341398,343458,-,2060
263,WOLB.0323.00068,1,666063,668132,+,2069
263,WOLB.0323.00128,1,702580,704640,-,2060
263,WOLB.0323.00158,1,185036,187102,+,2066
263,WOLB.0323.00017,1,900893,902959,+,2066
263,WOLB.0323.00104,1,844363,846432,+,2069
263,WOLB.0323.00007,1,514938,517007,-,2069
263,WOLB.0323.00001,1,862109,864175,-,2066
263,WOLB.0323.00100,1,1191392,1193461,+,2069
263,WOLB.0323.00070,1,673977,676037,+,2060
263,WOLB.0323.00006,1,1046727,1048805,-,2078
263,WOLB.0323.00042,1,1455914,1457989,-,2075
263,WOLB.0323.00119,1,610797,612863,-,2066
263,WOLB.0323.00149,1,929410,931476,-,2066
263,WOLB.0323.00014,1,915558,917618,+,2060
263,WOLB.0323.00096,1,145989,148073,+,2084
264,WOLB.0323.00090,1,779626,782000,+,2374
264,WOLB.0323.00002,1,755013,757395,+,2382
264,WOLB.0323.00138,1,1261382,1263756,-,2374
264,WOLB.0323.00132,1,512720,515097,-,2377
264,WOLB.0323.00143,1,511187,513581,-,2394
264,WOLB.0323.00106,1,511190,513584,-,2394
264,WOLB.0323.00121,1,1040206,1042580,+,2374
264,WOLB.0323.00135,1,1158316,1160690,+,2374
264,WOLB.0323.00103,1,869094,871491,+,2397
264,WOLB.0323.00107,1,867668,870065,+,2397
264,WOLB.0323.00019,1,569883,572257,+,2374
264,WOLB.0323.00060,1,558540,560914,-,2374
264,WOLB.0323.00074,1,141726,144123,+,2397
264,WOLB.0323.00120,1,140956,143353,+,2397
264,WOLB.0323.00039,1,1275297,1277671,-,2374
264,WOLB.0323.00041,1,134972,137369,+,2397
264,WOLB.0323.00031,1,273728,276122,+,2394
264,WOLB.0323.00056,1,827229,829603,+,2374
264,WOLB.0323.00142,1,916944,919318,+,2374
264,WOLB.0323.00023,1,1845354,1847736,-,2382
264,WOLB.0323.00153,1,851306,853680,+,2374
264,WOLB.0323.00093,1,1187528,1189905,+,2377
264,WOLB.0323.00088,1,871619,873993,+,2374
264,WOLB.0323.00008,1,493622,495980,+,2358
264,WOLB.0323.00024,1,1585826,1588200,+,2374
264,WOLB.0323.00064,1,652628,655010,+,2382
264,WOLB.0323.00030,1,851461,853843,-,2382
264,WOLB.0323.00105,1,869104,871501,+,2397
264,WOLB.0323.00133,1,1170808,1173203,-,2395
264,WOLB.0323.00084,1,1161394,1163768,-,2374
264,WOLB.0323.00021,1,1079314,1081688,+,2374
264,WOLB.0323.00043,1,1032992,1035374,+,2382
264,WOLB.0323.00020,1,812515,814889,+,2374
264,WOLB.0323.00122,1,725813,728187,+,2374
264,WOLB.0323.00118,1,701008,703382,+,2374
264,WOLB.0323.00004,1,914960,917334,+,2374
264,WOLB.0323.00011,1,284425,286799,+,2374
264,WOLB.0323.00035,1,809520,811894,+,2374
264,WOLB.0323.00032,1,374217,376591,+,2374
264,WOLB.0323.00012,1,875721,878095,+,2374
264,WOLB.0323.00018,1,1000022,1002417,+,2395
264,WOLB.0323.00025,1,1022610,1025004,-,2394
264,WOLB.0323.00010,1,338295,340690,-,2395
264,WOLB.0323.00068,1,668840,671214,+,2374
264,WOLB.0323.00128,1,699541,701923,-,2382
264,WOLB.0323.00158,1,187810,190184,+,2374
264,WOLB.0323.00017,1,903667,906041,+,2374
264,WOLB.0323.00104,1,847140,849514,+,2374
264,WOLB.0323.00007,1,511856,514230,-,2374
264,WOLB.0323.00001,1,869104,871501,+,2397
264,WOLB.0323.00100,1,1194169,1196543,+,2374
264,WOLB.0323.00070,1,676694,679076,+,2382
264,WOLB.0323.00006,1,1043628,1046022,-,2394
264,WOLB.0323.00042,1,1452883,1455257,-,2374
264,WOLB.0323.00119,1,607766,610140,-,2374
264,WOLB.0323.00149,1,926328,928702,-,2374
264,WOLB.0323.00014,1,918275,920657,+,2382
264,WOLB.0323.00096,1,148781,151178,+,2397
265,WOLB.0323.00090,1,784848,787152,+,2304
265,WOLB.0323.00002,1,851018,853313,-,2295
265,WOLB.0323.00138,1,1257289,1259584,-,2295
265,WOLB.0323.00132,1,568448,570743,-,2295
265,WOLB.0323.00143,1,506468,508763,-,2295
265,WOLB.0323.00106,1,506471,508766,-,2295
265,WOLB.0323.00121,1,1045465,1047760,+,2295
265,WOLB.0323.00135,1,849919,852214,-,2295
265,WOLB.0323.00103,1,876068,878357,+,2289
265,WOLB.0323.00107,1,874642,876931,+,2289
265,WOLB.0323.00019,1,575298,577593,+,2295
265,WOLB.0323.00060,1,714471,716766,-,2295
265,WOLB.0323.00074,1,146953,149248,+,2295
265,WOLB.0323.00120,1,146183,148478,+,2295
265,WOLB.0323.00039,1,1269974,1272269,-,2295
265,WOLB.0323.00041,1,140199,142494,+,2295
265,WOLB.0323.00031,1,278546,280841,+,2295
265,WOLB.0323.00056,1,832496,834791,+,2295
265,WOLB.0323.00142,1,922203,924498,+,2295
265,WOLB.0323.00023,1,1409838,1412133,-,2295
265,WOLB.0323.00153,1,856528,858832,+,2304
265,WOLB.0323.00093,1,1193961,1196265,+,2304
265,WOLB.0323.00088,1,876878,879173,+,2295
265,WOLB.0323.00008,1,501334,503638,+,2304
265,WOLB.0323.00024,1,1524289,1526584,+,2295
265,WOLB.0323.00064,1,595638,597933,+,2295
265,WOLB.0323.00030,1,716708,719003,-,2295
265,WOLB.0323.00105,1,876078,878367,+,2289
265,WOLB.0323.00133,1,1165756,1168013,-,2257
265,WOLB.0323.00084,1,1157301,1159596,-,2295
265,WOLB.0323.00021,1,1083486,1085781,+,2295
265,WOLB.0323.00043,1,697843,700138,-,2295
265,WOLB.0323.00020,1,817774,820069,+,2295
265,WOLB.0323.00122,1,731072,733367,+,2295
265,WOLB.0323.00118,1,707327,709631,+,2304
265,WOLB.0323.00004,1,920219,922514,+,2295
265,WOLB.0323.00011,1,289684,291979,+,2295
265,WOLB.0323.00035,1,814779,817074,+,2295
265,WOLB.0323.00032,1,378389,380684,+,2295
265,WOLB.0323.00012,1,880980,883275,+,2295
265,WOLB.0323.00018,1,1028642,1030946,-,2304
265,WOLB.0323.00025,1,1016264,1018559,-,2295
265,WOLB.0323.00010,1,631506,633801,-,2295
265,WOLB.0323.00068,1,673012,675307,+,2295
265,WOLB.0323.00128,1,943476,945771,+,2295
265,WOLB.0323.00158,1,193069,195364,+,2295
265,WOLB.0323.00017,1,908926,911221,+,2295
265,WOLB.0323.00104,1,852399,854694,+,2295
265,WOLB.0323.00007,1,506668,508963,-,2295
265,WOLB.0323.00001,1,876078,878367,+,2289
265,WOLB.0323.00100,1,1199428,1201723,+,2295
265,WOLB.0323.00070,1,1162304,1164599,-,2295
265,WOLB.0323.00006,1,1038909,1041204,-,2295
265,WOLB.0323.00042,1,1678388,1680692,-,2304
265,WOLB.0323.00119,1,600991,603286,-,2295
265,WOLB.0323.00149,1,921148,923443,-,2295
265,WOLB.0323.00014,1,601935,604230,-,2295
265,WOLB.0323.00096,1,154008,156303,+,2295
266,WOLB.0323.00090,1,787390,790723,+,3333
266,WOLB.0323.00002,1,847430,850765,-,3335
266,WOLB.0323.00138,1,1253703,1257036,-,3333
266,WOLB.0323.00132,1,564862,568195,-,3333
266,WOLB.0323.00143,1,502897,506230,-,3333
266,WOLB.0323.00106,1,502900,506233,-,3333
266,WOLB.0323.00121,1,1047998,1051331,+,3333
266,WOLB.0323.00135,1,846348,849681,-,3333
266,WOLB.0323.00103,1,878607,881937,+,3330
266,WOLB.0323.00107,1,877181,880511,+,3330
266,WOLB.0323.00019,1,577854,581179,+,3325
266,WOLB.0323.00060,1,710900,714233,-,3333
266,WOLB.0323.00074,1,149486,152819,+,3333
266,WOLB.0323.00120,1,148716,152049,+,3333
266,WOLB.0323.00039,1,1266388,1269702,-,3314
266,WOLB.0323.00041,1,142732,146065,+,3333
266,WOLB.0323.00031,1,281079,284412,+,3333
266,WOLB.0323.00056,1,835029,838362,+,3333
266,WOLB.0323.00142,1,924736,928069,+,3333
266,WOLB.0323.00023,1,1406267,1409600,-,3333
266,WOLB.0323.00153,1,859070,862403,+,3333
266,WOLB.0323.00093,1,1196522,1199851,+,3329
266,WOLB.0323.00088,1,879411,882744,+,3333
266,WOLB.0323.00008,1,503891,507224,+,3333
266,WOLB.0323.00024,1,1526837,1530170,+,3333
266,WOLB.0323.00064,1,598171,601504,+,3333
266,WOLB.0323.00030,1,713137,716470,-,3333
266,WOLB.0323.00105,1,878617,881947,+,3330
266,WOLB.0323.00133,1,1162466,1165718,-,3252
266,WOLB.0323.00084,1,1153715,1157048,-,3333
266,WOLB.0323.00021,1,1086034,1089367,+,3333
266,WOLB.0323.00043,1,694256,697591,-,3335
266,WOLB.0323.00020,1,820307,823640,+,3333
266,WOLB.0323.00122,1,733605,736938,+,3333
266,WOLB.0323.00118,1,710982,714315,+,3333
266,WOLB.0323.00004,1,922752,926085,+,3333
266,WOLB.0323.00011,1,292217,295550,+,3333
266,WOLB.0323.00035,1,817312,820645,+,3333
266,WOLB.0323.00032,1,382035,385368,+,3333
266,WOLB.0323.00012,1,883513,886846,+,3333
266,WOLB.0323.00018,1,1025071,1028400,-,3329
266,WOLB.0323.00025,1,1012693,1016026,-,3333
266,WOLB.0323.00010,1,627920,631253,-,3333
266,WOLB.0323.00068,1,676651,679984,+,3333
266,WOLB.0323.00128,1,946024,949359,+,3335
266,WOLB.0323.00158,1,195602,198935,+,3333
266,WOLB.0323.00017,1,911459,914792,+,3333
266,WOLB.0323.00104,1,854932,858265,+,3333
266,WOLB.0323.00007,1,503097,506430,-,3333
266,WOLB.0323.00001,1,878617,881947,+,3330
266,WOLB.0323.00100,1,1201961,1205294,+,3333
266,WOLB.0323.00070,1,1158716,1162051,-,3335
266,WOLB.0323.00006,1,1035338,1038671,-,3333
266,WOLB.0323.00042,1,1674817,1678146,-,3329
266,WOLB.0323.00119,1,597405,600719,-,3314
266,WOLB.0323.00149,1,917577,920910,-,3333
266,WOLB.0323.00014,1,598347,601682,-,3335
266,WOLB.0323.00096,1,156541,159874,+,3333
267,WOLB.0323.00090,1,794342,795895,+,1553
267,WOLB.0323.00002,1,709733,711283,-,1550
267,WOLB.0323.00138,1,1248515,1250068,-,1553
267,WOLB.0323.00132,1,633205,634756,+,1551
267,WOLB.0323.00143,1,497181,498733,-,1552
267,WOLB.0323.00106,1,497184,498736,-,1552
267,WOLB.0323.00121,1,1054950,1056503,+,1553
267,WOLB.0323.00135,1,841272,842825,-,1553
267,WOLB.0323.00103,1,886501,888053,+,1552
267,WOLB.0323.00107,1,885075,886627,+,1552
267,WOLB.0323.00019,1,584195,585747,+,1552
267,WOLB.0323.00060,1,705720,707273,-,1553
267,WOLB.0323.00074,1,157145,158698,+,1553
267,WOLB.0323.00120,1,156375,157928,+,1553
267,WOLB.0323.00039,1,1261821,1263373,-,1552
267,WOLB.0323.00041,1,150391,151944,+,1553
267,WOLB.0323.00031,1,288576,290128,+,1552
267,WOLB.0323.00056,1,841989,843542,+,1553
267,WOLB.0323.00142,1,931688,933241,+,1553
267,WOLB.0323.00023,1,1747515,1749062,-,1547
267,WOLB.0323.00153,1,867437,868990,+,1553
267,WOLB.0323.00093,1,1202411,1203960,+,1549
267,WOLB.0323.00088,1,885198,886751,+,1553
267,WOLB.0323.00008,1,510708,512262,+,1554
267,WOLB.0323.00024,1,1426765,1428315,-,1550
267,WOLB.0323.00064,1,319534,321084,-,1550
267,WOLB.0323.00030,1,912174,913725,+,1551
267,WOLB.0323.00105,1,886511,888063,+,1552
267,WOLB.0323.00133,1,1158460,1159991,-,1531
267,WOLB.0323.00084,1,1148543,1150096,-,1553
267,WOLB.0323.00021,1,1093002,1094555,+,1553
267,WOLB.0323.00043,1,797614,799164,-,1550
267,WOLB.0323.00020,1,826094,827647,+,1553
267,WOLB.0323.00122,1,740557,742110,+,1553
267,WOLB.0323.00118,1,716767,718320,+,1553
267,WOLB.0323.00004,1,929704,931257,+,1553
267,WOLB.0323.00011,1,299169,300722,+,1553
267,WOLB.0323.00035,1,823099,824652,+,1553
267,WOLB.0323.00032,1,389003,390556,+,1553
267,WOLB.0323.00012,1,889300,890853,+,1553
267,WOLB.0323.00018,1,661077,662624,-,1547
267,WOLB.0323.00025,1,515141,516665,-,1524
267,WOLB.0323.00010,1,600695,602245,-,1550
267,WOLB.0323.00068,1,683619,685172,+,1553
267,WOLB.0323.00128,1,864210,865761,+,1551
267,WOLB.0323.00158,1,202554,204107,+,1553
267,WOLB.0323.00017,1,918411,919964,+,1553
267,WOLB.0323.00104,1,860719,862272,+,1553
267,WOLB.0323.00007,1,498064,499617,-,1553
267,WOLB.0323.00001,1,886511,888063,+,1552
267,WOLB.0323.00100,1,1207748,1209301,+,1553
267,WOLB.0323.00070,1,965262,966813,+,1551
267,WOLB.0323.00006,1,1265361,1266914,-,1553
267,WOLB.0323.00042,1,875546,877083,+,1537
267,WOLB.0323.00119,1,592837,594389,-,1552
267,WOLB.0323.00149,1,912405,913958,-,1553
267,WOLB.0323.00014,1,748799,750349,-,1550
267,WOLB.0323.00096,1,163237,164792,-,1555
267,WOLB.0323.00096,1,171157,172710,+,1553
268,WOLB.0323.00090,1,797485,803560,+,6075
268,WOLB.0323.00002,1,701927,708149,-,6222
268,WOLB.0323.00138,1,1240300,1246375,-,6075
268,WOLB.0323.00132,1,636347,642569,+,6222
268,WOLB.0323.00143,1,489378,495591,-,6213
268,WOLB.0323.00106,1,489381,495594,-,6213
268,WOLB.0323.00121,1,1058093,1064168,+,6075
268,WOLB.0323.00135,1,833608,839683,-,6075
268,WOLB.0323.00103,1,889643,895708,+,6065
268,WOLB.0323.00107,1,888217,894282,+,6065
268,WOLB.0323.00019,1,587340,593562,+,6222
268,WOLB.0323.00060,1,698055,704130,-,6075
268,WOLB.0323.00074,1,160288,166429,+,6141
268,WOLB.0323.00120,1,159518,165659,+,6141
268,WOLB.0323.00039,1,1254006,1260228,-,6222
268,WOLB.0323.00041,1,153534,159675,+,6141
268,WOLB.0323.00031,1,291718,297931,+,6213
268,WOLB.0323.00056,1,845132,851207,+,6075
268,WOLB.0323.00142,1,934831,940906,+,6075
268,WOLB.0323.00023,1,1738224,1744437,-,6213
268,WOLB.0323.00153,1,870580,876655,+,6075
268,WOLB.0323.00093,1,1205555,1211621,+,6066
268,WOLB.0323.00088,1,888341,894416,+,6075
268,WOLB.0323.00008,1,513851,519908,+,6057
268,WOLB.0323.00024,1,1418953,1425175,-,6222
268,WOLB.0323.00064,1,311721,317943,-,6222
268,WOLB.0323.00030,1,915316,921538,+,6222
268,WOLB.0323.00105,1,889653,895718,+,6065
268,WOLB.0323.00133,1,1150647,1156869,-,6222
268,WOLB.0323.00084,1,1140328,1146403,-,6075
268,WOLB.0323.00021,1,1098653,1104728,+,6075
268,WOLB.0323.00043,1,789804,796025,-,6221
268,WOLB.0323.00020,1,829237,835312,+,6075
268,WOLB.0323.00122,1,743700,749775,+,6075
268,WOLB.0323.00118,1,719911,725986,+,6075
268,WOLB.0323.00004,1,932847,938922,+,6075
268,WOLB.0323.00011,1,302312,308387,+,6075
268,WOLB.0323.00035,1,826242,832317,+,6075
268,WOLB.0323.00032,1,392696,398772,+,6076
268,WOLB.0323.00012,1,892443,898518,+,6075
268,WOLB.0323.00018,1,653265,659487,-,6222
268,WOLB.0323.00025,1,246866,253079,-,6213
268,WOLB.0323.00010,1,592884,599106,-,6222
268,WOLB.0323.00068,1,687312,693387,+,6075
268,WOLB.0323.00128,1,867350,873572,+,6222
268,WOLB.0323.00158,1,205697,211771,+,6074
268,WOLB.0323.00017,1,921554,927629,+,6075
268,WOLB.0323.00104,1,863862,869937,+,6075
268,WOLB.0323.00007,1,490399,496474,-,6075
268,WOLB.0323.00001,1,889653,895718,+,6065
268,WOLB.0323.00100,1,1210891,1216966,+,6075
268,WOLB.0323.00070,1,968402,974624,+,6222
268,WOLB.0323.00006,1,1257559,1263772,-,6213
268,WOLB.0323.00042,1,878673,884886,+,6213
268,WOLB.0323.00119,1,585022,591244,-,6222
268,WOLB.0323.00149,1,904740,910815,-,6075
268,WOLB.0323.00014,1,740988,747210,-,6222
268,WOLB.0323.00096,1,174300,180441,+,6141
269,WOLB.0323.00090,1,803934,807450,+,3516
269,WOLB.0323.00002,1,698042,701553,-,3511
269,WOLB.0323.00138,1,1236411,1239926,-,3515
269,WOLB.0323.00132,1,642943,646459,+,3516
269,WOLB.0323.00143,1,485493,489004,-,3511
269,WOLB.0323.00106,1,485496,489007,-,3511
269,WOLB.0323.00121,1,1064542,1068058,+,3516
269,WOLB.0323.00135,1,829718,833234,-,3516
269,WOLB.0323.00103,1,897285,900800,+,3515
269,WOLB.0323.00107,1,895859,899374,+,3515
269,WOLB.0323.00019,1,593936,597283,+,3347
269,WOLB.0323.00060,1,694165,697681,-,3516
269,WOLB.0323.00074,1,166803,170311,+,3508
269,WOLB.0323.00120,1,166033,169541,+,3508
269,WOLB.0323.00039,1,1250116,1253632,-,3516
269,WOLB.0323.00041,1,160049,163557,+,3508
269,WOLB.0323.00031,1,298305,301816,+,3511
269,WOLB.0323.00056,1,851581,855097,+,3516
269,WOLB.0323.00142,1,941280,944796,+,3516
269,WOLB.0323.00023,1,1734334,1737850,-,3516
269,WOLB.0323.00153,1,877029,880545,+,3516
269,WOLB.0323.00093,1,1211995,1215506,+,3511
269,WOLB.0323.00088,1,894790,898306,+,3516
269,WOLB.0323.00008,1,520282,523793,+,3511
269,WOLB.0323.00024,1,1729357,1732873,+,3516
269,WOLB.0323.00064,1,307831,311347,-,3516
269,WOLB.0323.00030,1,921912,925428,+,3516
269,WOLB.0323.00105,1,897295,900810,+,3515
269,WOLB.0323.00133,1,1146762,1150273,-,3511
269,WOLB.0323.00084,1,1136439,1139954,-,3515
269,WOLB.0323.00021,1,1105102,1108617,+,3515
269,WOLB.0323.00043,1,785919,789430,-,3511
269,WOLB.0323.00020,1,835686,839202,+,3516
269,WOLB.0323.00122,1,750149,753665,+,3516
269,WOLB.0323.00118,1,726360,729875,+,3515
269,WOLB.0323.00004,1,939296,942812,+,3516
269,WOLB.0323.00011,1,308761,312277,+,3516
269,WOLB.0323.00035,1,832691,836207,+,3516
269,WOLB.0323.00032,1,399146,402661,+,3515
269,WOLB.0323.00012,1,898892,902408,+,3516
269,WOLB.0323.00018,1,649375,652891,-,3516
269,WOLB.0323.00025,1,243294,246741,-,3447
269,WOLB.0323.00010,1,588995,592510,-,3515
269,WOLB.0323.00068,1,693761,697276,+,3515
269,WOLB.0323.00128,1,873946,877457,+,3511
269,WOLB.0323.00158,1,212145,215661,+,3516
269,WOLB.0323.00017,1,928003,931519,+,3516
269,WOLB.0323.00104,1,870311,873827,+,3516
269,WOLB.0323.00007,1,486509,490025,-,3516
269,WOLB.0323.00001,1,897295,900810,+,3515
269,WOLB.0323.00100,1,1217340,1220856,+,3516
269,WOLB.0323.00070,1,974998,978509,+,3511
269,WOLB.0323.00006,1,1253674,1257185,-,3511
269,WOLB.0323.00042,1,885260,888776,+,3516
269,WOLB.0323.00119,1,581301,584648,-,3347
269,WOLB.0323.00149,1,900850,904366,-,3516
269,WOLB.0323.00014,1,737103,740614,-,3511
269,WOLB.0323.00096,1,180815,184323,+,3508
270,WOLB.0323.00090,1,807985,810500,+,2515
270,WOLB.0323.00002,1,695424,697939,-,2515
270,WOLB.0323.00138,1,1232263,1234778,-,2515
270,WOLB.0323.00132,1,646994,649509,+,2515
270,WOLB.0323.00143,1,482426,484941,-,2515
270,WOLB.0323.00106,1,482429,484944,-,2515
270,WOLB.0323.00121,1,1068593,1071108,+,2515
270,WOLB.0323.00135,1,826668,829183,-,2515
270,WOLB.0323.00103,1,901335,903850,+,2515
270,WOLB.0323.00107,1,899909,902424,+,2515
270,WOLB.0323.00019,1,597818,600333,+,2515
270,WOLB.0323.00060,1,691115,693630,-,2515
270,WOLB.0323.00074,1,170846,173361,+,2515
270,WOLB.0323.00120,1,170076,172591,+,2515
270,WOLB.0323.00039,1,1247066,1249581,-,2515
270,WOLB.0323.00041,1,164092,166607,+,2515
270,WOLB.0323.00031,1,302368,304883,+,2515
270,WOLB.0323.00056,1,855632,858147,+,2515
270,WOLB.0323.00142,1,945331,947846,+,2515
270,WOLB.0323.00023,1,1731284,1733799,-,2515
270,WOLB.0323.00153,1,881080,883595,+,2515
270,WOLB.0323.00093,1,1216046,1218561,+,2515
270,WOLB.0323.00088,1,898841,901356,+,2515
270,WOLB.0323.00008,1,524333,526848,+,2515
270,WOLB.0323.00024,1,555801,558316,+,2515
270,WOLB.0323.00064,1,304781,307296,-,2515
270,WOLB.0323.00030,1,925963,928478,+,2515
270,WOLB.0323.00105,1,901345,903860,+,2515
270,WOLB.0323.00133,1,1143707,1146222,-,2515
270,WOLB.0323.00084,1,1132291,1134806,-,2515
270,WOLB.0323.00021,1,1110250,1112765,+,2515
270,WOLB.0323.00043,1,783301,785816,-,2515
270,WOLB.0323.00020,1,839737,842252,+,2515
270,WOLB.0323.00122,1,754200,756715,+,2515
270,WOLB.0323.00118,1,730285,732800,+,2515
270,WOLB.0323.00004,1,943347,945862,+,2515
270,WOLB.0323.00011,1,312812,315327,+,2515
270,WOLB.0323.00035,1,836742,839257,+,2515
270,WOLB.0323.00032,1,403196,405711,+,2515
270,WOLB.0323.00012,1,902943,905458,+,2515
270,WOLB.0323.00018,1,646762,649277,-,2515
270,WOLB.0323.00025,1,240264,242754,-,2490
270,WOLB.0323.00010,1,585945,588460,-,2515
270,WOLB.0323.00068,1,698909,701424,+,2515
270,WOLB.0323.00128,1,877560,880075,+,2515
270,WOLB.0323.00158,1,216196,218711,+,2515
270,WOLB.0323.00017,1,932054,934569,+,2515
270,WOLB.0323.00104,1,874362,876877,+,2515
270,WOLB.0323.00007,1,483459,485974,-,2515
270,WOLB.0323.00001,1,901345,903860,+,2515
270,WOLB.0323.00100,1,1221391,1223906,+,2515
270,WOLB.0323.00070,1,978612,981127,+,2515
270,WOLB.0323.00006,1,1250607,1253122,-,2515
270,WOLB.0323.00042,1,889311,891826,+,2515
270,WOLB.0323.00119,1,578251,580766,-,2515
270,WOLB.0323.00149,1,897800,900315,-,2515
270,WOLB.0323.00014,1,734485,737000,-,2515
270,WOLB.0323.00096,1,184858,187373,+,2515
271,WOLB.0323.00090,1,810654,813690,+,3036
271,WOLB.0323.00002,1,689734,692770,-,3036
271,WOLB.0323.00138,1,1229073,1232109,-,3036
271,WOLB.0323.00132,1,652178,655214,+,3036
271,WOLB.0323.00143,1,479235,482271,-,3036
271,WOLB.0323.00106,1,479238,482274,-,3036
271,WOLB.0323.00121,1,1073826,1076862,+,3036
271,WOLB.0323.00135,1,820908,823944,-,3036
271,WOLB.0323.00103,1,904003,907039,+,3036
271,WOLB.0323.00107,1,902577,905613,+,3036
271,WOLB.0323.00019,1,604224,607255,+,3031
271,WOLB.0323.00060,1,811187,814223,+,3036
271,WOLB.0323.00074,1,1444691,1447727,-,3036
271,WOLB.0323.00120,1,1425033,1428069,-,3036
271,WOLB.0323.00039,1,1240153,1243184,-,3031
271,WOLB.0323.00041,1,223882,226918,+,3036
271,WOLB.0323.00031,1,305038,308074,+,3036
271,WOLB.0323.00056,1,858301,861337,+,3036
271,WOLB.0323.00142,1,951667,954703,+,3036
271,WOLB.0323.00023,1,1725609,1728645,-,3036
271,WOLB.0323.00153,1,883749,886785,+,3036
271,WOLB.0323.00093,1,1037383,1040414,+,3031
271,WOLB.0323.00088,1,901510,904546,+,3036
271,WOLB.0323.00008,1,527002,530033,+,3031
271,WOLB.0323.00024,1,883391,886427,-,3036
271,WOLB.0323.00064,1,299103,302139,-,3036
271,WOLB.0323.00030,1,931042,934078,+,3036
271,WOLB.0323.00105,1,904013,907049,+,3036
271,WOLB.0323.00133,1,1140524,1143554,-,3030
271,WOLB.0323.00084,1,1129101,1132137,-,3036
271,WOLB.0323.00021,1,1112919,1115955,+,3036
271,WOLB.0323.00043,1,777533,780569,-,3036
271,WOLB.0323.00020,1,842406,845442,+,3036
271,WOLB.0323.00122,1,760457,763493,+,3036
271,WOLB.0323.00118,1,732954,735990,+,3036
271,WOLB.0323.00004,1,949683,952719,+,3036
271,WOLB.0323.00011,1,318045,321081,+,3036
271,WOLB.0323.00035,1,839411,842447,+,3036
271,WOLB.0323.00032,1,405865,408901,+,3036
271,WOLB.0323.00012,1,905612,908648,+,3036
271,WOLB.0323.00018,1,643572,646608,-,3036
271,WOLB.0323.00025,1,1082249,1085261,-,3012
271,WOLB.0323.00010,1,582755,585791,-,3036
271,WOLB.0323.00068,1,701578,704614,+,3036
271,WOLB.0323.00128,1,883922,886958,+,3036
271,WOLB.0323.00158,1,222532,225568,+,3036
271,WOLB.0323.00017,1,937287,940323,+,3036
271,WOLB.0323.00104,1,877031,880067,+,3036
271,WOLB.0323.00007,1,420959,423995,-,3036
271,WOLB.0323.00001,1,904013,907049,+,3036
271,WOLB.0323.00100,1,1224060,1227096,+,3036
271,WOLB.0323.00070,1,983859,986895,+,3036
271,WOLB.0323.00006,1,1247416,1250452,-,3036
271,WOLB.0323.00042,1,891979,895015,+,3036
271,WOLB.0323.00119,1,571329,574360,-,3031
271,WOLB.0323.00149,1,892046,895082,-,3036
271,WOLB.0323.00014,1,728807,731843,-,3036
271,WOLB.0323.00096,1,234753,237789,+,3036
272,WOLB.0323.00090,1,813911,815411,+,1500
272,WOLB.0323.00002,1,688013,689513,-,1500
272,WOLB.0323.00138,1,1227355,1228852,-,1497
272,WOLB.0323.00132,1,655862,657398,+,1536
272,WOLB.0323.00143,1,477535,479035,-,1500
272,WOLB.0323.00106,1,477538,479038,-,1500
272,WOLB.0323.00121,1,1077083,1078583,+,1500
272,WOLB.0323.00135,1,819190,820687,-,1497
272,WOLB.0323.00103,1,907260,908760,+,1500
272,WOLB.0323.00107,1,905834,907334,+,1500
272,WOLB.0323.00019,1,607476,608976,+,1500
272,WOLB.0323.00060,1,814444,815941,+,1497
272,WOLB.0323.00074,1,1442970,1444470,-,1500
272,WOLB.0323.00120,1,1423312,1424812,-,1500
272,WOLB.0323.00039,1,1238432,1239932,-,1500
272,WOLB.0323.00041,1,227139,228639,+,1500
272,WOLB.0323.00031,1,308274,309774,+,1500
272,WOLB.0323.00056,1,861558,863055,+,1497
272,WOLB.0323.00142,1,954924,956424,+,1500
272,WOLB.0323.00023,1,1723891,1725388,-,1497
272,WOLB.0323.00153,1,887006,888506,+,1500
272,WOLB.0323.00093,1,1040635,1042135,+,1500
272,WOLB.0323.00088,1,904746,906246,+,1500
272,WOLB.0323.00008,1,530254,531754,+,1500
272,WOLB.0323.00024,1,881670,883170,-,1500
272,WOLB.0323.00064,1,297385,298882,-,1497
272,WOLB.0323.00030,1,934299,935796,+,1497
272,WOLB.0323.00105,1,907270,908770,+,1500
272,WOLB.0323.00133,1,1138803,1140303,-,1500
272,WOLB.0323.00084,1,1127383,1128880,-,1497
272,WOLB.0323.00021,1,1116176,1117673,+,1497
272,WOLB.0323.00043,1,775812,777312,-,1500
272,WOLB.0323.00020,1,845642,847142,+,1500
272,WOLB.0323.00122,1,767374,768910,+,1536
272,WOLB.0323.00118,1,736211,737711,+,1500
272,WOLB.0323.00004,1,952940,954440,+,1500
272,WOLB.0323.00011,1,321302,322802,+,1500
272,WOLB.0323.00035,1,842647,844147,+,1500
272,WOLB.0323.00032,1,409122,410619,+,1497
272,WOLB.0323.00012,1,908848,910348,+,1500
272,WOLB.0323.00018,1,641467,642964,-,1497
272,WOLB.0323.00025,1,116631,118131,+,1500
272,WOLB.0323.00010,1,581034,582534,-,1500
272,WOLB.0323.00068,1,704835,706332,+,1497
272,WOLB.0323.00128,1,887179,888679,+,1500
272,WOLB.0323.00158,1,225789,227289,+,1500
272,WOLB.0323.00017,1,940544,942044,+,1500
272,WOLB.0323.00104,1,880267,881767,+,1500
272,WOLB.0323.00007,1,419241,420738,-,1497
272,WOLB.0323.00001,1,907270,908770,+,1500
272,WOLB.0323.00100,1,1227296,1228796,+,1500
272,WOLB.0323.00070,1,987116,988616,+,1500
272,WOLB.0323.00006,1,1245716,1247216,-,1500
272,WOLB.0323.00042,1,895236,896733,+,1497
272,WOLB.0323.00119,1,569608,571108,-,1500
272,WOLB.0323.00149,1,890325,891825,-,1500
272,WOLB.0323.00014,1,727086,728586,-,1500
272,WOLB.0323.00096,1,238010,239510,+,1500
273,WOLB.0323.00090,1,822078,824068,+,1990
273,WOLB.0323.00002,1,898111,900102,-,1991
273,WOLB.0323.00138,1,1216837,1218828,-,1991
273,WOLB.0323.00132,1,663713,665703,+,1990
273,WOLB.0323.00143,1,466972,468963,-,1991
273,WOLB.0323.00106,1,466975,468966,-,1991
273,WOLB.0323.00121,1,1084134,1086124,+,1990
273,WOLB.0323.00135,1,808972,810962,-,1990
273,WOLB.0323.00019,1,614598,616604,+,2006
273,WOLB.0323.00060,1,823571,825561,+,1990
273,WOLB.0323.00074,1,1426496,1428490,+,1994
273,WOLB.0323.00074,1,1433936,1435927,-,1991
273,WOLB.0323.00120,1,1414278,1416269,-,1991
273,WOLB.0323.00039,1,1232374,1234379,-,2005
273,WOLB.0323.00041,1,235682,237672,+,1990
273,WOLB.0323.00031,1,318346,320336,+,1990
273,WOLB.0323.00056,1,870685,872675,+,1990
273,WOLB.0323.00142,1,961975,963965,+,1990
273,WOLB.0323.00023,1,1717470,1719461,-,1991
273,WOLB.0323.00153,1,895173,897163,+,1990
273,WOLB.0323.00088,1,912942,914932,+,1990
273,WOLB.0323.00024,1,1785406,1787397,+,1991
273,WOLB.0323.00064,1,289639,291630,-,1991
273,WOLB.0323.00030,1,943419,945409,+,1990
273,WOLB.0323.00133,1,1133554,1135546,-,1992
273,WOLB.0323.00084,1,1118635,1120626,-,1991
273,WOLB.0323.00021,1,1124430,1126420,+,1990
273,WOLB.0323.00043,1,767285,769276,-,1991
273,WOLB.0323.00020,1,853838,855828,+,1990
273,WOLB.0323.00122,1,774467,776457,+,1990
273,WOLB.0323.00004,1,959991,961981,+,1990
273,WOLB.0323.00011,1,328353,330343,+,1990
273,WOLB.0323.00035,1,850843,852833,+,1990
273,WOLB.0323.00032,1,418885,420875,+,1990
273,WOLB.0323.00012,1,917044,919034,+,1990
273,WOLB.0323.00018,1,632587,634578,-,1991
273,WOLB.0323.00010,1,571642,573632,-,1990
273,WOLB.0323.00068,1,713089,715079,+,1990
273,WOLB.0323.00128,1,895216,897206,+,1990
273,WOLB.0323.00158,1,232840,234830,+,1990
273,WOLB.0323.00017,1,947595,949585,+,1990
273,WOLB.0323.00104,1,888463,890453,+,1990
273,WOLB.0323.00007,1,409620,411611,-,1991
273,WOLB.0323.00100,1,1235492,1237482,+,1990
273,WOLB.0323.00070,1,995153,997143,+,1990
273,WOLB.0323.00006,1,1235154,1237144,-,1990
273,WOLB.0323.00042,1,901172,903163,+,1991
273,WOLB.0323.00119,1,561980,563986,-,2006
273,WOLB.0323.00149,1,882783,884774,-,1991
273,WOLB.0323.00014,1,718560,720551,-,1991
273,WOLB.0323.00096,1,246553,248543,+,1990
274,WOLB.0323.00090,1,829432,830093,+,661
274,WOLB.0323.00002,1,892297,892959,-,662
274,WOLB.0323.00138,1,1021737,1022399,-,662
274,WOLB.0323.00132,1,671212,671873,+,661
274,WOLB.0323.00143,1,461073,461729,-,656
274,WOLB.0323.00106,1,461076,461732,-,656
274,WOLB.0323.00121,1,1099046,1099708,-,662
274,WOLB.0323.00135,1,802803,803465,-,662
274,WOLB.0323.00103,1,923790,924451,+,661
274,WOLB.0323.00107,1,922364,923025,+,661
274,WOLB.0323.00019,1,445627,446289,-,662
274,WOLB.0323.00060,1,832157,832818,+,661
274,WOLB.0323.00074,1,1421139,1421801,-,662
274,WOLB.0323.00120,1,1408227,1408889,-,662
274,WOLB.0323.00039,1,1224313,1224975,-,662
274,WOLB.0323.00041,1,243062,243723,+,661
274,WOLB.0323.00031,1,325580,326235,+,655
274,WOLB.0323.00056,1,879271,879932,+,661
274,WOLB.0323.00142,1,976887,977549,-,662
274,WOLB.0323.00023,1,259872,260533,+,661
274,WOLB.0323.00153,1,902527,903188,+,661
274,WOLB.0323.00093,1,1050420,1051081,+,661
274,WOLB.0323.00088,1,920408,921069,+,661
274,WOLB.0323.00008,1,542357,543018,+,661
274,WOLB.0323.00024,1,1655719,1656380,+,661
274,WOLB.0323.00064,1,283470,284132,-,662
274,WOLB.0323.00030,1,950701,951362,+,661
274,WOLB.0323.00105,1,923800,924461,+,661
274,WOLB.0323.00133,1,1022645,1023307,-,662
274,WOLB.0323.00084,1,1111370,1112032,-,662
274,WOLB.0323.00021,1,1250352,1251013,+,661
274,WOLB.0323.00043,1,761503,762165,-,662
274,WOLB.0323.00020,1,861315,861976,+,661
274,WOLB.0323.00122,1,789384,790046,-,662
274,WOLB.0323.00118,1,748862,749523,+,661
274,WOLB.0323.00004,1,974903,975565,-,662
274,WOLB.0323.00011,1,343265,343927,-,662
274,WOLB.0323.00035,1,858320,858981,+,661
274,WOLB.0323.00032,1,427479,428140,+,661
274,WOLB.0323.00012,1,924521,925182,+,661
274,WOLB.0323.00018,1,626810,627472,-,662
274,WOLB.0323.00025,1,92622,93278,-,656
274,WOLB.0323.00010,1,565840,566502,-,662
274,WOLB.0323.00068,1,723049,723710,+,661
274,WOLB.0323.00128,1,902347,903008,+,661
274,WOLB.0323.00158,1,247752,248414,-,662
274,WOLB.0323.00017,1,962507,963169,-,662
274,WOLB.0323.00104,1,898240,898901,+,661
274,WOLB.0323.00007,1,402363,403025,-,662
274,WOLB.0323.00001,1,923800,924461,+,661
274,WOLB.0323.00100,1,1242969,1243630,+,661
274,WOLB.0323.00070,1,1002157,1002818,+,661
274,WOLB.0323.00006,1,1229255,1229911,-,656
274,WOLB.0323.00042,1,907784,908445,+,661
274,WOLB.0323.00119,1,735173,735834,+,661
274,WOLB.0323.00149,1,869200,869861,+,661
274,WOLB.0323.00014,1,712758,713420,-,662
274,WOLB.0323.00096,1,253933,254594,+,661
275,WOLB.0323.00090,1,830095,830753,+,658
275,WOLB.0323.00002,1,891638,892296,-,658
275,WOLB.0323.00138,1,1021078,1021736,-,658
275,WOLB.0323.00132,1,671875,672533,+,658
275,WOLB.0323.00143,1,460414,461072,-,658
275,WOLB.0323.00106,1,460417,461075,-,658
275,WOLB.0323.00121,1,1098387,1099045,-,658
275,WOLB.0323.00135,1,802144,802802,-,658
275,WOLB.0323.00103,1,924453,925111,+,658
275,WOLB.0323.00107,1,923027,923685,+,658
275,WOLB.0323.00019,1,444968,445626,-,658
275,WOLB.0323.00060,1,832820,833478,+,658
275,WOLB.0323.00074,1,1413810,1414447,-,637
275,WOLB.0323.00074,1,1420480,1421138,-,658
275,WOLB.0323.00120,1,1407568,1408226,-,658
275,WOLB.0323.00039,1,1223654,1224312,-,658
275,WOLB.0323.00041,1,243725,244383,+,658
275,WOLB.0323.00031,1,326237,326895,+,658
275,WOLB.0323.00056,1,879934,880592,+,658
275,WOLB.0323.00142,1,976228,976886,-,658
275,WOLB.0323.00023,1,260535,261193,+,658
275,WOLB.0323.00153,1,903190,903848,+,658
275,WOLB.0323.00093,1,1051083,1051741,+,658
275,WOLB.0323.00088,1,921071,921729,+,658
275,WOLB.0323.00008,1,543020,543678,+,658
275,WOLB.0323.00024,1,1656382,1657040,+,658
275,WOLB.0323.00064,1,282811,283469,-,658
275,WOLB.0323.00030,1,951364,952022,+,658
275,WOLB.0323.00105,1,924463,925121,+,658
275,WOLB.0323.00133,1,1021986,1022644,-,658
275,WOLB.0323.00084,1,1110711,1111369,-,658
275,WOLB.0323.00021,1,1251015,1251673,+,658
275,WOLB.0323.00043,1,760844,761502,-,658
275,WOLB.0323.00020,1,861978,862636,+,658
275,WOLB.0323.00122,1,788725,789383,-,658
275,WOLB.0323.00118,1,749525,750183,+,658
275,WOLB.0323.00004,1,974244,974902,-,658
275,WOLB.0323.00011,1,342606,343264,-,658
275,WOLB.0323.00035,1,858983,859641,+,658
275,WOLB.0323.00032,1,428142,428800,+,658
275,WOLB.0323.00012,1,925184,925842,+,658
275,WOLB.0323.00018,1,626151,626809,-,658
275,WOLB.0323.00025,1,91976,92621,-,645
275,WOLB.0323.00010,1,565181,565839,-,658
275,WOLB.0323.00068,1,723712,724370,+,658
275,WOLB.0323.00128,1,903010,903668,+,658
275,WOLB.0323.00158,1,247093,247751,-,658
275,WOLB.0323.00017,1,961848,962506,-,658
275,WOLB.0323.00104,1,898903,899561,+,658
275,WOLB.0323.00007,1,401704,402362,-,658
275,WOLB.0323.00001,1,924463,925121,+,658
275,WOLB.0323.00100,1,1243632,1244290,+,658
275,WOLB.0323.00070,1,1002820,1003478,+,658
275,WOLB.0323.00006,1,1228596,1229254,-,658
275,WOLB.0323.00042,1,908447,909105,+,658
275,WOLB.0323.00119,1,735836,736494,+,658
275,WOLB.0323.00149,1,869863,870521,+,658
275,WOLB.0323.00014,1,712099,712757,-,658
275,WOLB.0323.00096,1,254596,255254,+,658
276,WOLB.0323.00090,1,830776,832387,+,1611
276,WOLB.0323.00002,1,890004,891615,-,1611
276,WOLB.0323.00138,1,1019444,1021055,-,1611
276,WOLB.0323.00132,1,672556,674167,+,1611
276,WOLB.0323.00143,1,458793,460391,-,1598
276,WOLB.0323.00106,1,458796,460394,-,1598
276,WOLB.0323.00121,1,1096753,1098364,-,1611
276,WOLB.0323.00135,1,800510,802121,-,1611
276,WOLB.0323.00103,1,925134,926745,+,1611
276,WOLB.0323.00107,1,923708,925318,+,1610
276,WOLB.0323.00019,1,443347,444945,-,1598
276,WOLB.0323.00060,1,833501,835112,+,1611
276,WOLB.0323.00074,1,1412176,1413787,-,1611
276,WOLB.0323.00074,1,1414499,1416110,+,1611
276,WOLB.0323.00120,1,1405934,1407545,-,1611
276,WOLB.0323.00039,1,1222033,1223631,-,1598
276,WOLB.0323.00041,1,244406,246017,+,1611
276,WOLB.0323.00031,1,326918,328516,+,1598
276,WOLB.0323.00056,1,880615,882226,+,1611
276,WOLB.0323.00142,1,974594,976205,-,1611
276,WOLB.0323.00023,1,261216,262827,+,1611
276,WOLB.0323.00153,1,903871,905482,+,1611
276,WOLB.0323.00093,1,1051770,1053363,+,1593
276,WOLB.0323.00088,1,921752,923363,+,1611
276,WOLB.0323.00008,1,543701,545312,+,1611
276,WOLB.0323.00024,1,1657063,1658674,+,1611
276,WOLB.0323.00064,1,281177,282788,-,1611
276,WOLB.0323.00030,1,952045,953656,+,1611
276,WOLB.0323.00105,1,925144,926755,+,1611
276,WOLB.0323.00133,1,1020352,1021963,-,1611
276,WOLB.0323.00084,1,1109077,1110688,-,1611
276,WOLB.0323.00021,1,1251696,1253307,+,1611
276,WOLB.0323.00043,1,759210,760821,-,1611
276,WOLB.0323.00020,1,862659,864270,+,1611
276,WOLB.0323.00122,1,787091,788702,-,1611
276,WOLB.0323.00118,1,750206,751817,+,1611
276,WOLB.0323.00004,1,972610,974221,-,1611
276,WOLB.0323.00011,1,340972,342583,-,1611
276,WOLB.0323.00035,1,859664,861275,+,1611
276,WOLB.0323.00032,1,428823,430434,+,1611
276,WOLB.0323.00012,1,925865,927476,+,1611
276,WOLB.0323.00018,1,624517,626128,-,1611
276,WOLB.0323.00025,1,90377,91940,-,1563
276,WOLB.0323.00010,1,563548,565158,-,1610
276,WOLB.0323.00068,1,724393,726004,+,1611
276,WOLB.0323.00128,1,903691,905298,+,1607
276,WOLB.0323.00158,1,245459,247070,-,1611
276,WOLB.0323.00017,1,960214,961825,-,1611
276,WOLB.0323.00104,1,899584,901195,+,1611
276,WOLB.0323.00007,1,400070,401681,-,1611
276,WOLB.0323.00001,1,925144,926755,+,1611
276,WOLB.0323.00100,1,1244313,1245924,+,1611
276,WOLB.0323.00070,1,1003501,1005112,+,1611
276,WOLB.0323.00006,1,1226974,1228573,-,1599
276,WOLB.0323.00042,1,909128,910739,+,1611
276,WOLB.0323.00119,1,736517,738115,+,1598
276,WOLB.0323.00149,1,870544,872155,+,1611
276,WOLB.0323.00014,1,710465,712076,-,1611
276,WOLB.0323.00096,1,255277,256888,+,1611
277,WOLB.0323.00090,1,833693,834999,+,1306
277,WOLB.0323.00002,1,887362,888668,-,1306
277,WOLB.0323.00138,1,1015150,1016456,-,1306
277,WOLB.0323.00132,1,675503,676809,+,1306
277,WOLB.0323.00143,1,456004,457310,-,1306
277,WOLB.0323.00106,1,456007,457313,-,1306
277,WOLB.0323.00121,1,1094141,1095447,-,1306
277,WOLB.0323.00135,1,797427,798733,-,1306
277,WOLB.0323.00103,1,928075,929381,+,1306
277,WOLB.0323.00107,1,926648,927954,+,1306
277,WOLB.0323.00019,1,440686,441992,-,1306
277,WOLB.0323.00060,1,836889,838195,+,1306
277,WOLB.0323.00074,1,1408571,1409878,-,1307
277,WOLB.0323.00074,1,1418408,1419715,+,1307
277,WOLB.0323.00120,1,1402329,1403636,-,1307
277,WOLB.0323.00039,1,1219372,1220678,-,1306
277,WOLB.0323.00041,1,248315,249622,+,1307
277,WOLB.0323.00031,1,329999,331305,+,1306
277,WOLB.0323.00056,1,884003,885309,+,1306
277,WOLB.0323.00142,1,971982,973288,-,1306
277,WOLB.0323.00023,1,264154,265460,+,1306
277,WOLB.0323.00153,1,906788,908094,+,1306
277,WOLB.0323.00093,1,1054699,1056005,+,1306
277,WOLB.0323.00088,1,925140,926446,+,1306
277,WOLB.0323.00008,1,546497,547803,+,1306
277,WOLB.0323.00024,1,1660009,1661315,+,1306
277,WOLB.0323.00064,1,278535,279841,-,1306
277,WOLB.0323.00030,1,954992,956298,+,1306
277,WOLB.0323.00105,1,928085,929391,+,1306
277,WOLB.0323.00133,1,324243,325549,-,1306
277,WOLB.0323.00084,1,1106435,1107741,-,1306
277,WOLB.0323.00021,1,1254643,1255949,+,1306
277,WOLB.0323.00043,1,756568,757874,-,1306
277,WOLB.0323.00020,1,866047,867353,+,1306
277,WOLB.0323.00122,1,784479,785785,-,1306
277,WOLB.0323.00118,1,753153,754458,+,1305
277,WOLB.0323.00004,1,969998,971304,-,1306
277,WOLB.0323.00011,1,338360,339666,-,1306
277,WOLB.0323.00035,1,863052,864358,+,1306
277,WOLB.0323.00032,1,431770,433076,+,1306
277,WOLB.0323.00012,1,929253,930559,+,1306
277,WOLB.0323.00018,1,621905,623211,-,1306
277,WOLB.0323.00025,1,983090,984365,-,1275
277,WOLB.0323.00010,1,560937,562242,-,1305
277,WOLB.0323.00068,1,727340,728646,+,1306
277,WOLB.0323.00128,1,906634,907940,+,1306
277,WOLB.0323.00158,1,242847,244153,-,1306
277,WOLB.0323.00017,1,957602,958908,-,1306
277,WOLB.0323.00104,1,902972,904278,+,1306
277,WOLB.0323.00007,1,396987,398293,-,1306
277,WOLB.0323.00001,1,928085,929391,+,1306
277,WOLB.0323.00100,1,1247701,1249007,+,1306
277,WOLB.0323.00070,1,1006448,1007754,+,1306
277,WOLB.0323.00006,1,1224185,1225491,-,1306
277,WOLB.0323.00042,1,912075,913381,+,1306
277,WOLB.0323.00119,1,739470,740776,+,1306
277,WOLB.0323.00149,1,873461,874767,+,1306
277,WOLB.0323.00014,1,707823,709129,-,1306
277,WOLB.0323.00096,1,259186,260493,+,1307
278,WOLB.0323.00090,1,835685,837137,+,1452
278,WOLB.0323.00002,1,885224,886675,-,1451
278,WOLB.0323.00138,1,1013012,1014463,-,1451
278,WOLB.0323.00132,1,677495,678947,+,1452
278,WOLB.0323.00143,1,453865,455316,-,1451
278,WOLB.0323.00106,1,453868,455319,-,1451
278,WOLB.0323.00121,1,1092003,1093454,-,1451
278,WOLB.0323.00135,1,795289,796740,-,1451
278,WOLB.0323.00103,1,930067,931516,+,1449
278,WOLB.0323.00107,1,928640,930089,+,1449
278,WOLB.0323.00019,1,436250,437701,-,1451
278,WOLB.0323.00060,1,838881,840333,+,1452
278,WOLB.0323.00074,1,1406436,1407871,-,1435
278,WOLB.0323.00120,1,1400194,1401629,-,1435
278,WOLB.0323.00039,1,1217235,1218686,-,1451
278,WOLB.0323.00041,1,250322,251757,+,1435
278,WOLB.0323.00031,1,331992,333444,+,1452
278,WOLB.0323.00056,1,888294,889746,+,1452
278,WOLB.0323.00142,1,969844,971295,-,1451
278,WOLB.0323.00023,1,266146,267598,+,1452
278,WOLB.0323.00153,1,908780,910232,+,1452
278,WOLB.0323.00093,1,1056694,1058146,+,1452
278,WOLB.0323.00088,1,927132,928584,+,1452
278,WOLB.0323.00008,1,548506,549941,+,1435
278,WOLB.0323.00024,1,1144884,1146335,-,1451
278,WOLB.0323.00064,1,276397,277848,-,1451
278,WOLB.0323.00030,1,956984,958436,+,1452
278,WOLB.0323.00105,1,930077,931526,+,1449
278,WOLB.0323.00133,1,322106,323557,-,1451
278,WOLB.0323.00084,1,1104297,1105748,-,1451
278,WOLB.0323.00021,1,1256635,1258087,+,1452
278,WOLB.0323.00043,1,754430,755881,-,1451
278,WOLB.0323.00020,1,868039,869491,+,1452
278,WOLB.0323.00122,1,782341,783792,-,1451
278,WOLB.0323.00118,1,755140,756592,+,1452
278,WOLB.0323.00004,1,967860,969311,-,1451
278,WOLB.0323.00011,1,336222,337673,-,1451
278,WOLB.0323.00035,1,865044,866496,+,1452
278,WOLB.0323.00032,1,433762,435214,+,1452
278,WOLB.0323.00012,1,931245,932697,+,1452
278,WOLB.0323.00018,1,619767,621218,-,1451
278,WOLB.0323.00025,1,980951,982402,-,1451
278,WOLB.0323.00010,1,558800,560250,-,1450
278,WOLB.0323.00068,1,729332,730784,+,1452
278,WOLB.0323.00128,1,908626,910078,+,1452
278,WOLB.0323.00158,1,240709,242160,-,1451
278,WOLB.0323.00017,1,955464,956915,-,1451
278,WOLB.0323.00104,1,904964,906416,+,1452
278,WOLB.0323.00007,1,394849,396300,-,1451
278,WOLB.0323.00001,1,930077,931526,+,1449
278,WOLB.0323.00100,1,1249693,1251145,+,1452
278,WOLB.0323.00070,1,1008440,1009892,+,1452
278,WOLB.0323.00006,1,1222046,1223497,-,1451
278,WOLB.0323.00042,1,914067,915519,+,1452
278,WOLB.0323.00119,1,743760,745212,+,1452
278,WOLB.0323.00149,1,875453,876905,+,1452
278,WOLB.0323.00014,1,705685,707136,-,1451
278,WOLB.0323.00096,1,261193,262628,+,1435
279,WOLB.0323.00090,1,837446,840495,+,3049
279,WOLB.0323.00002,1,881868,884918,-,3050
279,WOLB.0323.00138,1,1009654,1012703,-,3049
279,WOLB.0323.00132,1,679247,682297,+,3050
279,WOLB.0323.00143,1,450471,453517,-,3046
279,WOLB.0323.00106,1,450474,453520,-,3046
279,WOLB.0323.00121,1,1088648,1091694,-,3046
279,WOLB.0323.00135,1,791995,794980,-,2985
279,WOLB.0323.00103,1,931702,934749,+,3047
279,WOLB.0323.00107,1,930275,933322,+,3047
279,WOLB.0323.00019,1,432889,435935,-,3046
279,WOLB.0323.00060,1,840633,843680,+,3047
279,WOLB.0323.00074,1,1403203,1406250,-,3047
279,WOLB.0323.00120,1,1396961,1400008,-,3047
279,WOLB.0323.00039,1,1213874,1216920,-,3046
279,WOLB.0323.00041,1,251943,254990,+,3047
279,WOLB.0323.00031,1,333792,336838,+,3046
279,WOLB.0323.00056,1,890046,893093,+,3047
279,WOLB.0323.00142,1,966489,969535,-,3046
279,WOLB.0323.00023,1,267913,270963,+,3050
279,WOLB.0323.00153,1,910541,913590,+,3049
279,WOLB.0323.00093,1,1058461,1061508,+,3047
279,WOLB.0323.00088,1,928884,931934,+,3050
279,WOLB.0323.00008,1,550250,553297,+,3047
279,WOLB.0323.00024,1,1141521,1144569,-,3048
279,WOLB.0323.00064,1,273032,276082,-,3050
279,WOLB.0323.00030,1,958751,961801,+,3050
279,WOLB.0323.00105,1,931712,934759,+,3047
279,WOLB.0323.00133,1,318744,321791,-,3047
279,WOLB.0323.00084,1,1100939,1103988,-,3049
279,WOLB.0323.00021,1,1258396,1261445,+,3049
279,WOLB.0323.00043,1,751074,754124,-,3050
279,WOLB.0323.00020,1,869791,872841,+,3050
279,WOLB.0323.00122,1,778985,782032,-,3047
279,WOLB.0323.00118,1,756901,759950,+,3049
279,WOLB.0323.00004,1,964505,967551,-,3046
279,WOLB.0323.00011,1,332867,335913,-,3046
279,WOLB.0323.00035,1,866796,869846,+,3050
279,WOLB.0323.00032,1,435523,438572,+,3049
279,WOLB.0323.00012,1,932997,936047,+,3050
279,WOLB.0323.00018,1,616416,619467,-,3051
279,WOLB.0323.00025,1,977452,980663,-,3211
279,WOLB.0323.00010,1,555444,558494,-,3050
279,WOLB.0323.00068,1,731093,734142,+,3049
279,WOLB.0323.00128,1,910384,913434,+,3050
279,WOLB.0323.00158,1,237354,240400,-,3046
279,WOLB.0323.00017,1,952109,955155,-,3046
279,WOLB.0323.00104,1,906716,909766,+,3050
279,WOLB.0323.00007,1,391502,394549,-,3047
279,WOLB.0323.00001,1,931712,934759,+,3047
279,WOLB.0323.00100,1,1251445,1254495,+,3050
279,WOLB.0323.00070,1,1010198,1013248,+,3050
279,WOLB.0323.00006,1,1218652,1221698,-,3046
279,WOLB.0323.00042,1,915834,918883,+,3049
279,WOLB.0323.00119,1,745527,748573,+,3046
279,WOLB.0323.00149,1,877214,880260,+,3046
279,WOLB.0323.00014,1,702329,705379,-,3050
279,WOLB.0323.00096,1,262814,265861,+,3047
280,WOLB.0323.00090,1,841122,844074,+,2952
280,WOLB.0323.00002,1,878092,881044,-,2952
280,WOLB.0323.00138,1,1006075,1009027,-,2952
280,WOLB.0323.00132,1,682957,685915,+,2958
280,WOLB.0323.00143,1,446620,449571,-,2951
280,WOLB.0323.00106,1,446623,449574,-,2951
280,WOLB.0323.00121,1,1107736,1110680,+,2944
280,WOLB.0323.00135,1,788346,791298,-,2952
280,WOLB.0323.00103,1,945481,948440,+,2959
280,WOLB.0323.00107,1,944054,947013,+,2959
280,WOLB.0323.00019,1,428972,431931,-,2959
280,WOLB.0323.00060,1,844330,847282,+,2952
280,WOLB.0323.00074,1,1399684,1402554,-,2870
280,WOLB.0323.00120,1,1393442,1396312,-,2870
280,WOLB.0323.00039,1,1209957,1212916,-,2959
280,WOLB.0323.00041,1,255639,258509,+,2870
280,WOLB.0323.00031,1,337738,340689,+,2951
280,WOLB.0323.00056,1,893743,896695,+,2952
280,WOLB.0323.00142,1,985577,988521,+,2944
280,WOLB.0323.00023,1,271900,274852,+,2952
280,WOLB.0323.00153,1,914217,917169,+,2952
280,WOLB.0323.00093,1,1063616,1066575,+,2959
280,WOLB.0323.00088,1,932831,935783,+,2952
280,WOLB.0323.00008,1,554204,557163,+,2959
280,WOLB.0323.00024,1,1137900,1140859,-,2959
280,WOLB.0323.00064,1,269413,272372,-,2959
280,WOLB.0323.00030,1,962461,965420,+,2959
280,WOLB.0323.00105,1,945490,948449,+,2959
280,WOLB.0323.00133,1,314816,317751,-,2935
280,WOLB.0323.00084,1,1097360,1100312,-,2952
280,WOLB.0323.00021,1,1262072,1265024,+,2952
280,WOLB.0323.00043,1,747298,750250,-,2952
280,WOLB.0323.00020,1,873738,876690,+,2952
280,WOLB.0323.00122,1,799880,802824,+,2944
280,WOLB.0323.00118,1,760830,763774,+,2944
280,WOLB.0323.00004,1,983593,986537,+,2944
280,WOLB.0323.00011,1,351955,354899,+,2944
280,WOLB.0323.00035,1,870743,873695,+,2952
280,WOLB.0323.00032,1,439199,442151,+,2952
280,WOLB.0323.00012,1,936944,939896,+,2952
280,WOLB.0323.00018,1,612634,615586,-,2952
280,WOLB.0323.00025,1,511461,514387,-,2926
280,WOLB.0323.00010,1,551669,554621,-,2952
280,WOLB.0323.00068,1,734769,737721,+,2952
280,WOLB.0323.00128,1,914258,917210,+,2952
280,WOLB.0323.00158,1,257545,260489,+,2944
280,WOLB.0323.00017,1,971197,974141,+,2944
280,WOLB.0323.00104,1,910663,913615,+,2952
280,WOLB.0323.00007,1,387900,390852,-,2952
280,WOLB.0323.00001,1,945490,948449,+,2959
280,WOLB.0323.00100,1,1255392,1258344,+,2952
280,WOLB.0323.00070,1,1014072,1017024,+,2952
280,WOLB.0323.00006,1,1214801,1217752,-,2951
280,WOLB.0323.00042,1,919705,922663,+,2958
280,WOLB.0323.00119,1,749531,752490,+,2959
280,WOLB.0323.00149,1,858228,861172,-,2944
280,WOLB.0323.00014,1,698553,701505,-,2952
280,WOLB.0323.00096,1,266510,269380,+,2870
281,WOLB.0323.00090,1,844443,847028,+,2585
281,WOLB.0323.00002,1,875129,877721,-,2592
281,WOLB.0323.00138,1,1003114,1005706,-,2592
281,WOLB.0323.00132,1,686287,688879,+,2592
281,WOLB.0323.00143,1,443578,446170,-,2592
281,WOLB.0323.00106,1,443581,446173,-,2592
281,WOLB.0323.00121,1,1111049,1113641,+,2592
281,WOLB.0323.00135,1,785392,787977,-,2585
281,WOLB.0323.00103,1,948888,951480,+,2592
281,WOLB.0323.00107,1,947461,950053,+,2592
281,WOLB.0323.00019,1,425932,428524,-,2592
281,WOLB.0323.00060,1,847651,850236,+,2585
281,WOLB.0323.00074,1,1396736,1399328,-,2592
281,WOLB.0323.00120,1,1390494,1393086,-,2592
281,WOLB.0323.00039,1,1206917,1209509,-,2592
281,WOLB.0323.00041,1,258865,261457,+,2592
281,WOLB.0323.00031,1,341139,343731,+,2592
281,WOLB.0323.00056,1,897064,899649,+,2585
281,WOLB.0323.00142,1,988890,991482,+,2592
281,WOLB.0323.00023,1,275223,277815,+,2592
281,WOLB.0323.00153,1,917538,920123,+,2585
281,WOLB.0323.00093,1,818958,821543,-,2585
281,WOLB.0323.00088,1,936152,938737,+,2585
281,WOLB.0323.00008,1,557612,560189,+,2577
281,WOLB.0323.00024,1,208877,211469,-,2592
281,WOLB.0323.00064,1,266372,268964,-,2592
281,WOLB.0323.00030,1,965869,968461,+,2592
281,WOLB.0323.00105,1,948897,951489,+,2592
281,WOLB.0323.00133,1,1228507,1231099,-,2592
281,WOLB.0323.00084,1,1094399,1096991,-,2592
281,WOLB.0323.00021,1,1265393,1267985,+,2592
281,WOLB.0323.00043,1,720577,723169,-,2592
281,WOLB.0323.00020,1,877059,879644,+,2585
281,WOLB.0323.00122,1,837613,840198,+,2585
281,WOLB.0323.00118,1,764143,766728,+,2585
281,WOLB.0323.00004,1,986906,989498,+,2592
281,WOLB.0323.00011,1,355268,357860,+,2592
281,WOLB.0323.00035,1,874064,876649,+,2585
281,WOLB.0323.00032,1,442520,445112,+,2592
281,WOLB.0323.00012,1,940265,942850,+,2585
281,WOLB.0323.00018,1,609671,612263,-,2592
281,WOLB.0323.00025,1,29374,31930,-,2556
281,WOLB.0323.00010,1,761872,764464,+,2592
281,WOLB.0323.00068,1,738090,740682,+,2592
281,WOLB.0323.00128,1,917581,920173,+,2592
281,WOLB.0323.00158,1,260858,263450,+,2592
281,WOLB.0323.00017,1,974510,977102,+,2592
281,WOLB.0323.00104,1,913984,916569,+,2585
281,WOLB.0323.00007,1,384946,387531,-,2585
281,WOLB.0323.00001,1,948897,951489,+,2592
281,WOLB.0323.00100,1,1258713,1261298,+,2585
281,WOLB.0323.00070,1,1017395,1019987,+,2592
281,WOLB.0323.00006,1,1211759,1214351,-,2592
281,WOLB.0323.00042,1,1491253,1493845,-,2592
281,WOLB.0323.00119,1,752938,755530,+,2592
281,WOLB.0323.00149,1,855267,857859,-,2592
281,WOLB.0323.00014,1,695590,698182,-,2592
281,WOLB.0323.00096,1,269736,272328,+,2592
282,WOLB.0323.00090,1,847409,851318,+,3909
282,WOLB.0323.00002,1,870916,874797,-,3881
282,WOLB.0323.00138,1,998835,1002744,-,3909
282,WOLB.0323.00132,1,689259,693168,+,3909
282,WOLB.0323.00143,1,439364,443245,-,3881
282,WOLB.0323.00106,1,439367,443248,-,3881
282,WOLB.0323.00121,1,1114011,1117920,+,3909
282,WOLB.0323.00135,1,781102,785011,-,3909
282,WOLB.0323.00103,1,953005,956984,+,3979
282,WOLB.0323.00107,1,951578,955557,+,3979
282,WOLB.0323.00019,1,421643,425552,-,3909
282,WOLB.0323.00060,1,850617,854526,+,3909
282,WOLB.0323.00074,1,1392556,1396414,-,3858
282,WOLB.0323.00120,1,1386314,1390172,-,3858
282,WOLB.0323.00039,1,1202628,1206537,-,3909
282,WOLB.0323.00041,1,261779,265637,+,3858
282,WOLB.0323.00031,1,344064,347945,+,3881
282,WOLB.0323.00056,1,900030,903939,+,3909
282,WOLB.0323.00142,1,991852,995761,+,3909
282,WOLB.0323.00023,1,278196,282105,+,3909
282,WOLB.0323.00153,1,920504,924407,+,3903
282,WOLB.0323.00093,1,814740,818625,-,3885
282,WOLB.0323.00088,1,939118,943024,+,3906
282,WOLB.0323.00008,1,561725,565610,+,3885
282,WOLB.0323.00024,1,204587,208496,-,3909
282,WOLB.0323.00064,1,262082,265991,-,3909
282,WOLB.0323.00030,1,831538,835447,-,3909
282,WOLB.0323.00105,1,953014,956993,+,3979
282,WOLB.0323.00133,1,1224334,1228195,-,3861
282,WOLB.0323.00084,1,1090120,1094029,-,3909
282,WOLB.0323.00021,1,1268355,1272264,+,3909
282,WOLB.0323.00043,1,716364,720245,-,3881
282,WOLB.0323.00020,1,881198,885104,+,3906
282,WOLB.0323.00122,1,840531,844416,+,3885
282,WOLB.0323.00118,1,767109,771018,+,3909
282,WOLB.0323.00004,1,989868,993777,+,3909
282,WOLB.0323.00011,1,358230,362139,+,3909
282,WOLB.0323.00035,1,877030,880936,+,3906
282,WOLB.0323.00032,1,445482,449391,+,3909
282,WOLB.0323.00012,1,943231,947137,+,3906
282,WOLB.0323.00018,1,605457,609338,-,3881
282,WOLB.0323.00025,1,34611,38454,+,3843
282,WOLB.0323.00010,1,764796,768677,+,3881
282,WOLB.0323.00068,1,741052,744961,+,3909
282,WOLB.0323.00128,1,920505,924386,+,3881
282,WOLB.0323.00158,1,263820,267729,+,3909
282,WOLB.0323.00017,1,978575,982484,+,3909
282,WOLB.0323.00104,1,916950,920856,+,3906
282,WOLB.0323.00007,1,380656,384565,-,3909
282,WOLB.0323.00001,1,953014,956993,+,3979
282,WOLB.0323.00100,1,1261679,1265585,+,3906
282,WOLB.0323.00070,1,1020319,1024200,+,3881
282,WOLB.0323.00006,1,1207563,1211426,-,3863
282,WOLB.0323.00042,1,1486975,1490884,-,3909
282,WOLB.0323.00119,1,755910,759819,+,3909
282,WOLB.0323.00149,1,850988,854897,-,3909
282,WOLB.0323.00014,1,691377,695258,-,3881
282,WOLB.0323.00096,1,272650,276508,+,3858
283,WOLB.0323.00090,1,851767,856863,+,5096
283,WOLB.0323.00002,1,865370,870466,-,5096
283,WOLB.0323.00138,1,993290,998386,-,5096
283,WOLB.0323.00132,1,693617,698713,+,5096
283,WOLB.0323.00143,1,433812,438914,-,5102
283,WOLB.0323.00106,1,433815,438917,-,5102
283,WOLB.0323.00121,1,1118369,1123465,+,5096
283,WOLB.0323.00135,1,775557,780653,-,5096
283,WOLB.0323.00103,1,957433,962530,+,5097
283,WOLB.0323.00107,1,956006,961103,+,5097
283,WOLB.0323.00019,1,416098,421194,-,5096
283,WOLB.0323.00060,1,854975,860071,+,5096
283,WOLB.0323.00074,1,1387062,1392158,-,5096
283,WOLB.0323.00120,1,1380820,1385916,-,5096
283,WOLB.0323.00039,1,1197083,1202179,-,5096
283,WOLB.0323.00041,1,266035,271131,+,5096
283,WOLB.0323.00031,1,348395,353497,+,5102
283,WOLB.0323.00056,1,904388,909484,+,5096
283,WOLB.0323.00142,1,996210,1001306,+,5096
283,WOLB.0323.00023,1,282554,287650,+,5096
283,WOLB.0323.00153,1,924856,929952,+,5096
283,WOLB.0323.00093,1,809195,814291,-,5096
283,WOLB.0323.00088,1,943473,948569,+,5096
283,WOLB.0323.00008,1,566059,571155,+,5096
283,WOLB.0323.00024,1,199042,204138,-,5096
283,WOLB.0323.00064,1,256537,261633,-,5096
283,WOLB.0323.00030,1,825993,831089,-,5096
283,WOLB.0323.00105,1,957442,962539,+,5097
283,WOLB.0323.00133,1,1218789,1223885,-,5096
283,WOLB.0323.00084,1,1084575,1089671,-,5096
283,WOLB.0323.00021,1,1272713,1277809,+,5096
283,WOLB.0323.00043,1,710818,715914,-,5096
283,WOLB.0323.00020,1,885553,890649,+,5096
283,WOLB.0323.00122,1,844865,849961,+,5096
283,WOLB.0323.00118,1,771467,776563,+,5096
283,WOLB.0323.00004,1,994226,999322,+,5096
283,WOLB.0323.00011,1,362588,367684,+,5096
283,WOLB.0323.00035,1,881385,886481,+,5096
283,WOLB.0323.00032,1,449840,454936,+,5096
283,WOLB.0323.00012,1,947586,952682,+,5096
283,WOLB.0323.00018,1,599911,605007,-,5096
283,WOLB.0323.00025,1,38900,43996,+,5096
283,WOLB.0323.00010,1,769127,774223,+,5096
283,WOLB.0323.00068,1,745410,750506,+,5096
283,WOLB.0323.00128,1,924836,929932,+,5096
283,WOLB.0323.00158,1,268178,273274,+,5096
283,WOLB.0323.00017,1,982933,988029,+,5096
283,WOLB.0323.00104,1,921305,926401,+,5096
283,WOLB.0323.00007,1,375111,380207,-,5096
283,WOLB.0323.00001,1,957442,962539,+,5097
283,WOLB.0323.00100,1,1266034,1271130,+,5096
283,WOLB.0323.00070,1,1024650,1029746,+,5096
283,WOLB.0323.00006,1,1202011,1207113,-,5102
283,WOLB.0323.00042,1,1481430,1486526,-,5096
283,WOLB.0323.00119,1,760268,765364,+,5096
283,WOLB.0323.00149,1,845443,850539,-,5096
283,WOLB.0323.00014,1,685831,690927,-,5096
283,WOLB.0323.00096,1,276906,282002,+,5096
284,WOLB.0323.00090,1,857999,858655,+,656
284,WOLB.0323.00002,1,863101,863757,-,656
284,WOLB.0323.00138,1,989728,990384,-,656
284,WOLB.0323.00132,1,699208,699864,+,656
284,WOLB.0323.00143,1,374398,375054,-,656
284,WOLB.0323.00106,1,374401,375057,-,656
284,WOLB.0323.00121,1,1124601,1125257,+,656
284,WOLB.0323.00135,1,773765,774421,-,656
284,WOLB.0323.00103,1,964147,964803,+,656
284,WOLB.0323.00107,1,962720,963376,+,656
284,WOLB.0323.00019,1,413829,414485,-,656
284,WOLB.0323.00060,1,861207,861863,+,656
284,WOLB.0323.00074,1,1385911,1386567,-,656
284,WOLB.0323.00120,1,1379669,1380325,-,656
284,WOLB.0323.00039,1,1194814,1195470,-,656
284,WOLB.0323.00041,1,271626,272282,+,656
284,WOLB.0323.00031,1,412256,412912,+,656
284,WOLB.0323.00056,1,910620,911276,+,656
284,WOLB.0323.00142,1,1002442,1003098,+,656
284,WOLB.0323.00023,1,288145,288801,+,656
284,WOLB.0323.00153,1,931088,931744,+,656
284,WOLB.0323.00093,1,808236,808877,-,641
284,WOLB.0323.00088,1,949705,950361,+,656
284,WOLB.0323.00008,1,571473,572114,+,641
284,WOLB.0323.00024,1,196799,197423,-,624
284,WOLB.0323.00064,1,255386,256042,-,656
284,WOLB.0323.00030,1,824842,825498,-,656
284,WOLB.0323.00105,1,964156,964812,+,656
284,WOLB.0323.00133,1,1116600,1117256,-,656
284,WOLB.0323.00084,1,1082783,1083439,-,656
284,WOLB.0323.00021,1,1280715,1281371,+,656
284,WOLB.0323.00043,1,708549,709205,-,656
284,WOLB.0323.00020,1,891785,892441,+,656
284,WOLB.0323.00122,1,851097,851753,+,656
284,WOLB.0323.00118,1,777058,777714,+,656
284,WOLB.0323.00004,1,1000458,1001114,+,656
284,WOLB.0323.00011,1,368820,369476,+,656
284,WOLB.0323.00035,1,887617,888273,+,656
284,WOLB.0323.00032,1,457724,458380,+,656
284,WOLB.0323.00012,1,953818,954474,+,656
284,WOLB.0323.00018,1,598119,598775,-,656
284,WOLB.0323.00025,1,1057781,1058437,-,656
284,WOLB.0323.00010,1,775836,776492,+,656
284,WOLB.0323.00068,1,755721,756377,+,656
284,WOLB.0323.00128,1,931545,932201,+,656
284,WOLB.0323.00158,1,274410,275066,+,656
284,WOLB.0323.00017,1,989165,989821,+,656
284,WOLB.0323.00104,1,927537,928193,+,656
284,WOLB.0323.00007,1,373319,373975,-,656
284,WOLB.0323.00001,1,964156,964812,+,656
284,WOLB.0323.00100,1,1272266,1272922,+,656
284,WOLB.0323.00070,1,1031359,1032015,+,656
284,WOLB.0323.00006,1,978872,979528,-,656
284,WOLB.0323.00042,1,1480279,1480935,-,656
284,WOLB.0323.00119,1,766977,767633,+,656
284,WOLB.0323.00149,1,843651,844307,-,656
284,WOLB.0323.00014,1,683562,684218,-,656
284,WOLB.0323.00096,1,282497,283153,+,656
285,WOLB.0323.00090,1,859118,860059,+,941
285,WOLB.0323.00002,1,861697,862638,-,941
285,WOLB.0323.00138,1,988324,989265,-,941
285,WOLB.0323.00132,1,700327,701264,+,937
285,WOLB.0323.00143,1,372994,373935,-,941
285,WOLB.0323.00106,1,372997,373938,-,941
285,WOLB.0323.00121,1,1125720,1126661,+,941
285,WOLB.0323.00135,1,772361,773302,-,941
285,WOLB.0323.00103,1,965266,966207,+,941
285,WOLB.0323.00107,1,963839,964780,+,941
285,WOLB.0323.00019,1,412425,413366,-,941
285,WOLB.0323.00060,1,862326,863267,+,941
285,WOLB.0323.00074,1,1384507,1385448,-,941
285,WOLB.0323.00120,1,1378265,1379206,-,941
285,WOLB.0323.00039,1,1193410,1194351,-,941
285,WOLB.0323.00041,1,272745,273686,+,941
285,WOLB.0323.00031,1,413375,414316,+,941
285,WOLB.0323.00056,1,911739,912680,+,941
285,WOLB.0323.00142,1,1003561,1004502,+,941
285,WOLB.0323.00023,1,289264,290205,+,941
285,WOLB.0323.00153,1,932207,933148,+,941
285,WOLB.0323.00093,1,806836,807773,-,937
285,WOLB.0323.00088,1,950824,951766,+,942
285,WOLB.0323.00008,1,572577,573518,+,941
285,WOLB.0323.00024,1,194243,195184,-,941
285,WOLB.0323.00064,1,253986,254923,-,937
285,WOLB.0323.00030,1,823442,824379,-,937
285,WOLB.0323.00105,1,965275,966216,+,941
285,WOLB.0323.00133,1,1115187,1116128,-,941
285,WOLB.0323.00084,1,1081379,1082320,-,941
285,WOLB.0323.00021,1,1281834,1282775,+,941
285,WOLB.0323.00043,1,707145,708086,-,941
285,WOLB.0323.00020,1,892904,893845,+,941
285,WOLB.0323.00122,1,852216,853157,+,941
285,WOLB.0323.00118,1,778177,779118,+,941
285,WOLB.0323.00004,1,1001577,1002518,+,941
285,WOLB.0323.00011,1,369939,370880,+,941
285,WOLB.0323.00035,1,888736,889677,+,941
285,WOLB.0323.00032,1,458843,459784,+,941
285,WOLB.0323.00012,1,954937,955878,+,941
285,WOLB.0323.00018,1,596715,597656,-,941
285,WOLB.0323.00025,1,1056407,1057317,-,910
285,WOLB.0323.00010,1,776955,777896,+,941
285,WOLB.0323.00068,1,756840,757781,+,941
285,WOLB.0323.00128,1,932664,933605,+,941
285,WOLB.0323.00158,1,275529,276470,+,941
285,WOLB.0323.00017,1,990284,991225,+,941
285,WOLB.0323.00104,1,928656,929597,+,941
285,WOLB.0323.00007,1,371915,372856,-,941
285,WOLB.0323.00001,1,965275,966216,+,941
285,WOLB.0323.00100,1,1273385,1274326,+,941
285,WOLB.0323.00070,1,1032478,1033419,+,941
285,WOLB.0323.00006,1,977468,978409,-,941
285,WOLB.0323.00042,1,1477931,1478849,-,918
285,WOLB.0323.00119,1,768096,769037,+,941
285,WOLB.0323.00149,1,842247,843188,-,941
285,WOLB.0323.00014,1,682158,683099,-,941
285,WOLB.0323.00096,1,283616,284557,+,941
286,WOLB.0323.00090,1,861431,862499,+,1068
286,WOLB.0323.00002,1,1109320,1110388,+,1068
286,WOLB.0323.00138,1,985884,986952,-,1068
286,WOLB.0323.00132,1,427028,428096,+,1068
286,WOLB.0323.00143,1,370188,371256,-,1068
286,WOLB.0323.00106,1,370191,371259,-,1068
286,WOLB.0323.00121,1,1128033,1129101,+,1068
286,WOLB.0323.00135,1,769921,770989,-,1068
286,WOLB.0323.00103,1,967579,968647,+,1068
286,WOLB.0323.00107,1,966152,967220,+,1068
286,WOLB.0323.00019,1,409967,411034,-,1067
286,WOLB.0323.00060,1,864639,865707,+,1068
286,WOLB.0323.00074,1,1381741,1382809,-,1068
286,WOLB.0323.00120,1,1375499,1376567,-,1068
286,WOLB.0323.00039,1,1190952,1192019,-,1067
286,WOLB.0323.00041,1,275384,276452,+,1068
286,WOLB.0323.00031,1,416054,417122,+,1068
286,WOLB.0323.00056,1,914052,915120,+,1068
286,WOLB.0323.00142,1,1005874,1006942,+,1068
286,WOLB.0323.00023,1,1383839,1384907,+,1068
286,WOLB.0323.00153,1,934520,935588,+,1068
286,WOLB.0323.00093,1,804065,805133,-,1068
286,WOLB.0323.00088,1,953138,954206,+,1068
286,WOLB.0323.00008,1,575217,576284,+,1067
286,WOLB.0323.00024,1,663603,664671,-,1068
286,WOLB.0323.00064,1,161458,162526,+,1068
286,WOLB.0323.00030,1,778778,779846,+,1068
286,WOLB.0323.00105,1,967588,968656,+,1068
286,WOLB.0323.00133,1,1112753,1113820,-,1067
286,WOLB.0323.00084,1,1078939,1080007,-,1068
286,WOLB.0323.00021,1,1284147,1285215,+,1068
286,WOLB.0323.00043,1,570673,571741,-,1068
286,WOLB.0323.00020,1,895217,896285,+,1068
286,WOLB.0323.00122,1,854529,855597,+,1068
286,WOLB.0323.00118,1,780478,781546,+,1068
286,WOLB.0323.00004,1,1003890,1004958,+,1068
286,WOLB.0323.00011,1,372252,373320,+,1068
286,WOLB.0323.00035,1,891049,892117,+,1068
286,WOLB.0323.00032,1,461156,462224,+,1068
286,WOLB.0323.00012,1,957250,958318,+,1068
286,WOLB.0323.00018,1,593041,594109,-,1068
286,WOLB.0323.00025,1,268081,269120,-,1039
286,WOLB.0323.00010,1,1291434,1292502,+,1068
286,WOLB.0323.00068,1,759153,760221,+,1068
286,WOLB.0323.00128,1,982027,983095,-,1068
286,WOLB.0323.00158,1,277842,278910,+,1068
286,WOLB.0323.00017,1,992597,993665,+,1068
286,WOLB.0323.00104,1,930969,932037,+,1068
286,WOLB.0323.00007,1,369475,370543,-,1068
286,WOLB.0323.00001,1,967588,968656,+,1068
286,WOLB.0323.00100,1,1275698,1276766,+,1068
286,WOLB.0323.00070,1,1125274,1126342,+,1068
286,WOLB.0323.00006,1,974662,975730,-,1068
286,WOLB.0323.00042,1,1475491,1476559,-,1068
286,WOLB.0323.00119,1,770428,771495,+,1067
286,WOLB.0323.00149,1,839807,840875,-,1068
286,WOLB.0323.00014,1,562630,563698,-,1068
286,WOLB.0323.00096,1,286255,287266,+,1011
286,WOLB.0323.00096,1,287271,288307,+,1036
287,WOLB.0323.00090,1,862500,868304,+,5804
287,WOLB.0323.00002,1,1110389,1116193,+,5804
287,WOLB.0323.00138,1,980079,985882,-,5803
287,WOLB.0323.00132,1,428097,433901,+,5804
287,WOLB.0323.00143,1,364392,370186,-,5794
287,WOLB.0323.00106,1,364395,370189,-,5794
287,WOLB.0323.00121,1,1129102,1134906,+,5804
287,WOLB.0323.00135,1,764116,769919,-,5803
287,WOLB.0323.00103,1,968648,974443,+,5795
287,WOLB.0323.00107,1,967221,973017,+,5796
287,WOLB.0323.00019,1,404163,409965,-,5802
287,WOLB.0323.00060,1,865708,871512,+,5804
287,WOLB.0323.00074,1,1375956,1381739,-,5783
287,WOLB.0323.00120,1,1369714,1375497,-,5783
287,WOLB.0323.00039,1,1185148,1190950,-,5802
287,WOLB.0323.00041,1,276453,282237,+,5784
287,WOLB.0323.00031,1,417123,422918,+,5795
287,WOLB.0323.00056,1,915121,920925,+,5804
287,WOLB.0323.00142,1,1006943,1012747,+,5804
287,WOLB.0323.00023,1,1384908,1390712,+,5804
287,WOLB.0323.00153,1,935589,941393,+,5804
287,WOLB.0323.00093,1,798266,804063,-,5797
287,WOLB.0323.00088,1,954207,960011,+,5804
287,WOLB.0323.00008,1,576285,582080,+,5795
287,WOLB.0323.00024,1,657798,663601,-,5803
287,WOLB.0323.00064,1,162527,168322,+,5795
287,WOLB.0323.00030,1,779847,785642,+,5795
287,WOLB.0323.00105,1,968657,974452,+,5795
287,WOLB.0323.00133,1,1106948,1112751,-,5803
287,WOLB.0323.00084,1,1073134,1078937,-,5803
287,WOLB.0323.00021,1,1285216,1291020,+,5804
287,WOLB.0323.00043,1,564868,570671,-,5803
287,WOLB.0323.00020,1,896286,902090,+,5804
287,WOLB.0323.00122,1,855598,861402,+,5804
287,WOLB.0323.00118,1,781547,787351,+,5804
287,WOLB.0323.00004,1,1004959,1010763,+,5804
287,WOLB.0323.00011,1,373321,379125,+,5804
287,WOLB.0323.00035,1,892118,897922,+,5804
287,WOLB.0323.00032,1,462225,468029,+,5804
287,WOLB.0323.00012,1,958319,964123,+,5804
287,WOLB.0323.00018,1,587245,593039,-,5794
287,WOLB.0323.00025,1,262277,268079,-,5802
287,WOLB.0323.00010,1,1292503,1298306,+,5803
287,WOLB.0323.00068,1,760222,766026,+,5804
287,WOLB.0323.00128,1,976222,982025,-,5803
287,WOLB.0323.00158,1,278911,284715,+,5804
287,WOLB.0323.00017,1,993666,999470,+,5804
287,WOLB.0323.00104,1,932038,937842,+,5804
287,WOLB.0323.00007,1,363670,369473,-,5803
287,WOLB.0323.00001,1,968657,974452,+,5795
287,WOLB.0323.00100,1,1276767,1282571,+,5804
287,WOLB.0323.00070,1,1126343,1132147,+,5804
287,WOLB.0323.00006,1,968866,974660,-,5794
287,WOLB.0323.00042,1,1469727,1475489,-,5762
287,WOLB.0323.00119,1,771496,777299,+,5803
287,WOLB.0323.00149,1,834002,839805,-,5803
287,WOLB.0323.00014,1,556825,562628,-,5803
287,WOLB.0323.00096,1,288308,294092,+,5784
288,WOLB.0323.00090,1,870563,873922,+,3359
288,WOLB.0323.00002,1,1117919,1121252,+,3333
288,WOLB.0323.00138,1,975021,978352,-,3331
288,WOLB.0323.00132,1,435633,438966,+,3333
288,WOLB.0323.00143,1,359340,362688,-,3348
288,WOLB.0323.00106,1,359343,362691,-,3348
288,WOLB.0323.00121,1,1136632,1139973,+,3341
288,WOLB.0323.00135,1,759049,762389,-,3340
288,WOLB.0323.00103,1,976172,979532,+,3360
288,WOLB.0323.00107,1,974746,978106,+,3360
288,WOLB.0323.00019,1,399080,402430,-,3350
288,WOLB.0323.00060,1,873238,876570,+,3332
288,WOLB.0323.00074,1,1370858,1374217,-,3359
288,WOLB.0323.00120,1,1364616,1367975,-,3359
288,WOLB.0323.00039,1,1180087,1183417,-,3330
288,WOLB.0323.00041,1,283975,287335,+,3360
288,WOLB.0323.00031,1,424621,427970,+,3349
288,WOLB.0323.00056,1,922651,926010,+,3359
288,WOLB.0323.00142,1,1014473,1017814,+,3341
288,WOLB.0323.00023,1,1392444,1395777,+,3333
288,WOLB.0323.00153,1,943652,947011,+,3359
288,WOLB.0323.00093,1,793197,796544,-,3347
288,WOLB.0323.00088,1,961737,965078,+,3341
288,WOLB.0323.00008,1,583808,587165,+,3357
288,WOLB.0323.00024,1,649032,652380,-,3348
288,WOLB.0323.00064,1,170053,173386,+,3333
288,WOLB.0323.00030,1,787373,790706,+,3333
288,WOLB.0323.00105,1,976181,979541,+,3360
288,WOLB.0323.00133,1,1101935,1105228,-,3293
288,WOLB.0323.00084,1,1068076,1071407,-,3331
288,WOLB.0323.00021,1,1292746,1296078,+,3332
288,WOLB.0323.00043,1,559809,563141,-,3332
288,WOLB.0323.00020,1,903816,907157,+,3341
288,WOLB.0323.00122,1,864231,867563,+,3332
288,WOLB.0323.00118,1,789626,792968,+,3342
288,WOLB.0323.00004,1,1012489,1015830,+,3341
288,WOLB.0323.00011,1,380851,384192,+,3341
288,WOLB.0323.00035,1,899648,902988,+,3340
288,WOLB.0323.00032,1,471264,474596,+,3332
288,WOLB.0323.00012,1,965849,969190,+,3341
288,WOLB.0323.00018,1,582192,585524,-,3332
288,WOLB.0323.00025,1,25344,28703,-,3359
288,WOLB.0323.00010,1,1300031,1303363,+,3332
288,WOLB.0323.00068,1,767752,771084,+,3332
288,WOLB.0323.00128,1,971163,974495,-,3332
288,WOLB.0323.00158,1,286441,289782,+,3341
288,WOLB.0323.00017,1,1001196,1004537,+,3341
288,WOLB.0323.00104,1,939568,942909,+,3341
288,WOLB.0323.00007,1,358585,361943,-,3358
288,WOLB.0323.00001,1,976181,979541,+,3360
288,WOLB.0323.00100,1,1284297,1287638,+,3341
288,WOLB.0323.00070,1,1133873,1137206,+,3333
288,WOLB.0323.00006,1,963802,967150,-,3348
288,WOLB.0323.00042,1,1463693,1467034,-,3341
288,WOLB.0323.00119,1,779031,782382,+,3351
288,WOLB.0323.00149,1,828935,832275,-,3340
288,WOLB.0323.00014,1,551766,555098,-,3332
288,WOLB.0323.00096,1,295830,299190,+,3360
289,WOLB.0323.00090,1,878078,878638,+,560
289,WOLB.0323.00002,1,1124396,1124956,+,560
289,WOLB.0323.00138,1,969120,969680,-,560
289,WOLB.0323.00132,1,707655,708215,+,560
289,WOLB.0323.00143,1,355072,355632,-,560
289,WOLB.0323.00106,1,355075,355635,-,560
289,WOLB.0323.00121,1,1144055,1144615,+,560
289,WOLB.0323.00135,1,754222,754782,-,560
289,WOLB.0323.00135,1,1116764,1117324,+,560
289,WOLB.0323.00103,1,980924,981484,+,560
289,WOLB.0323.00107,1,979498,980058,+,560
289,WOLB.0323.00019,1,394839,395399,-,560
289,WOLB.0323.00060,1,882072,882632,+,560
289,WOLB.0323.00074,1,1368703,1369263,-,560
289,WOLB.0323.00120,1,1362461,1363021,-,560
289,WOLB.0323.00039,1,1175846,1176406,-,560
289,WOLB.0323.00041,1,288930,289490,+,560
289,WOLB.0323.00031,1,431678,432238,+,560
289,WOLB.0323.00056,1,930145,930705,+,560
289,WOLB.0323.00142,1,1021896,1022456,+,560
289,WOLB.0323.00023,1,300023,300583,+,560
289,WOLB.0323.00153,1,951167,951727,+,560
289,WOLB.0323.00093,1,1365374,1365927,-,553
289,WOLB.0323.00088,1,969228,969788,+,560
289,WOLB.0323.00008,1,800290,800850,-,560
289,WOLB.0323.00024,1,1981422,1981976,-,554
289,WOLB.0323.00064,1,247085,247645,-,560
289,WOLB.0323.00030,1,816661,817221,-,560
289,WOLB.0323.00105,1,980933,981493,+,560
289,WOLB.0323.00133,1,1097729,1098289,-,560
289,WOLB.0323.00084,1,1063222,1063782,-,560
289,WOLB.0323.00021,1,1300246,1300806,+,560
289,WOLB.0323.00043,1,556105,556665,-,560
289,WOLB.0323.00020,1,911307,911867,+,560
289,WOLB.0323.00122,1,872786,873346,+,560
289,WOLB.0323.00118,1,796601,797161,+,560
289,WOLB.0323.00004,1,1019912,1020472,+,560
289,WOLB.0323.00011,1,388274,388834,+,560
289,WOLB.0323.00035,1,906970,907530,+,560
289,WOLB.0323.00032,1,478881,479441,+,560
289,WOLB.0323.00012,1,973340,973900,+,560
289,WOLB.0323.00018,1,983074,983634,+,560
289,WOLB.0323.00025,1,1053062,1053622,-,560
289,WOLB.0323.00010,1,1307497,1308057,+,560
289,WOLB.0323.00068,1,775327,775887,+,560
289,WOLB.0323.00128,1,967459,968019,-,560
289,WOLB.0323.00158,1,293854,294414,+,560
289,WOLB.0323.00017,1,1008628,1009188,+,560
289,WOLB.0323.00104,1,947066,947626,+,560
289,WOLB.0323.00007,1,353899,354459,-,560
289,WOLB.0323.00001,1,980933,981493,+,560
289,WOLB.0323.00100,1,1291788,1292348,+,560
289,WOLB.0323.00070,1,1140350,1140910,+,560
289,WOLB.0323.00006,1,959534,960094,-,560
289,WOLB.0323.00042,1,1072144,1072704,-,560
289,WOLB.0323.00119,1,786063,786623,+,560
289,WOLB.0323.00149,1,824293,824853,-,560
289,WOLB.0323.00014,1,548062,548622,-,560
289,WOLB.0323.00096,1,300785,301345,+,560
290,WOLB.0323.00090,1,878762,880286,+,1524
290,WOLB.0323.00002,1,1125083,1126610,+,1527
290,WOLB.0323.00138,1,967472,968996,-,1524
290,WOLB.0323.00132,1,708339,709837,+,1498
290,WOLB.0323.00143,1,353465,354995,-,1530
290,WOLB.0323.00106,1,353468,354998,-,1530
290,WOLB.0323.00121,1,1144739,1146263,+,1524
290,WOLB.0323.00135,1,752621,754145,-,1524
290,WOLB.0323.00135,1,1117448,1118946,+,1498
290,WOLB.0323.00103,1,981608,983132,+,1524
290,WOLB.0323.00107,1,980182,981706,+,1524
290,WOLB.0323.00019,1,393232,394762,-,1530
290,WOLB.0323.00060,1,882756,884280,+,1524
290,WOLB.0323.00074,1,1367049,1368579,-,1530
290,WOLB.0323.00120,1,1360807,1362337,-,1530
290,WOLB.0323.00039,1,1174239,1175769,-,1530
290,WOLB.0323.00041,1,289614,291144,+,1530
290,WOLB.0323.00031,1,432315,433845,+,1530
290,WOLB.0323.00056,1,930829,932353,+,1524
290,WOLB.0323.00142,1,1022580,1024104,+,1524
290,WOLB.0323.00023,1,300707,302232,+,1525
290,WOLB.0323.00153,1,951851,953375,+,1524
290,WOLB.0323.00093,1,1370086,1371607,+,1521
290,WOLB.0323.00088,1,969912,971437,+,1525
290,WOLB.0323.00008,1,444071,445592,+,1521
290,WOLB.0323.00024,1,698859,700357,-,1498
290,WOLB.0323.00064,1,245463,246961,-,1498
290,WOLB.0323.00030,1,815039,816537,-,1498
290,WOLB.0323.00105,1,981617,983141,+,1524
290,WOLB.0323.00133,1,1096122,1097652,-,1530
290,WOLB.0323.00084,1,1061574,1063098,-,1524
290,WOLB.0323.00021,1,1300930,1302454,+,1524
290,WOLB.0323.00043,1,554451,555978,-,1527
290,WOLB.0323.00020,1,911991,913516,+,1525
290,WOLB.0323.00122,1,873470,874994,+,1524
290,WOLB.0323.00118,1,797241,798762,+,1521
290,WOLB.0323.00004,1,1020596,1022120,+,1524
290,WOLB.0323.00011,1,388958,390482,+,1524
290,WOLB.0323.00035,1,907654,909179,+,1525
290,WOLB.0323.00032,1,479565,481089,+,1524
290,WOLB.0323.00012,1,974024,975549,+,1525
290,WOLB.0323.00018,1,983758,985283,+,1525
290,WOLB.0323.00025,1,1051461,1052985,-,1524
290,WOLB.0323.00010,1,1308181,1309679,+,1498
290,WOLB.0323.00068,1,776011,777535,+,1524
290,WOLB.0323.00128,1,965805,967332,-,1527
290,WOLB.0323.00158,1,294538,296062,+,1524
290,WOLB.0323.00017,1,1009312,1010836,+,1524
290,WOLB.0323.00104,1,947750,949275,+,1525
290,WOLB.0323.00007,1,352251,353775,-,1524
290,WOLB.0323.00001,1,981617,983141,+,1524
290,WOLB.0323.00100,1,1292472,1293997,+,1525
290,WOLB.0323.00070,1,1141037,1142564,+,1527
290,WOLB.0323.00006,1,957927,959457,-,1530
290,WOLB.0323.00042,1,1070522,1072020,-,1498
290,WOLB.0323.00119,1,786700,788230,+,1530
290,WOLB.0323.00149,1,822645,824169,-,1524
290,WOLB.0323.00014,1,546408,547935,-,1527
290,WOLB.0323.00096,1,301469,302999,+,1530
291,WOLB.0323.00090,1,881135,882147,+,1012
291,WOLB.0323.00153,1,954314,955326,+,1012
292,WOLB.0323.00090,1,883274,886508,+,3234
292,WOLB.0323.00002,1,1022265,1025491,+,3226
292,WOLB.0323.00138,1,962253,965486,-,3233
292,WOLB.0323.00132,1,713877,717140,+,3263
292,WOLB.0323.00143,1,346722,349970,-,3248
292,WOLB.0323.00106,1,346725,349973,-,3248
292,WOLB.0323.00121,1,1148233,1151467,+,3234
292,WOLB.0323.00135,1,747402,750635,-,3233
292,WOLB.0323.00103,1,985102,988330,+,3228
292,WOLB.0323.00107,1,983676,986904,+,3228
292,WOLB.0323.00019,1,385310,388539,-,3229
292,WOLB.0323.00060,1,887174,890408,+,3234
292,WOLB.0323.00074,1,1362522,1365762,-,3240
292,WOLB.0323.00120,1,1356280,1359520,-,3240
292,WOLB.0323.00039,1,1166167,1169396,-,3229
292,WOLB.0323.00041,1,292430,295671,+,3241
292,WOLB.0323.00031,1,437339,440588,+,3249
292,WOLB.0323.00056,1,935247,938481,+,3234
292,WOLB.0323.00142,1,1026074,1029308,+,3234
292,WOLB.0323.00023,1,305540,308790,+,3250
292,WOLB.0323.00153,1,956453,959687,+,3234
292,WOLB.0323.00093,1,933713,936952,+,3239
292,WOLB.0323.00088,1,974499,977733,+,3234
292,WOLB.0323.00008,1,450885,454124,+,3239
292,WOLB.0323.00024,1,474745,478001,-,3256
292,WOLB.0323.00064,1,238775,242037,-,3262
292,WOLB.0323.00030,1,808283,811541,-,3258
292,WOLB.0323.00105,1,985111,988339,+,3228
292,WOLB.0323.00133,1,1089716,1092954,-,3238
292,WOLB.0323.00084,1,1056355,1059588,-,3233
292,WOLB.0323.00021,1,1304439,1307673,+,3234
292,WOLB.0323.00043,1,547115,550340,-,3225
292,WOLB.0323.00020,1,916560,919794,+,3234
292,WOLB.0323.00122,1,876964,880198,+,3234
292,WOLB.0323.00118,1,801582,804828,+,3246
292,WOLB.0323.00004,1,1024090,1027324,+,3234
292,WOLB.0323.00011,1,392452,395686,+,3234
292,WOLB.0323.00035,1,912241,915475,+,3234
292,WOLB.0323.00032,1,483074,486308,+,3234
292,WOLB.0323.00012,1,978611,981845,+,3234
292,WOLB.0323.00018,1,988666,991921,+,3255
292,WOLB.0323.00025,1,1044641,1047824,-,3183
292,WOLB.0323.00010,1,1312578,1315835,+,3257
292,WOLB.0323.00068,1,779520,782754,+,3234
292,WOLB.0323.00128,1,958433,961658,-,3225
292,WOLB.0323.00158,1,298032,301266,+,3234
292,WOLB.0323.00017,1,1012806,1016040,+,3234
292,WOLB.0323.00104,1,952337,955571,+,3234
292,WOLB.0323.00007,1,346162,349395,-,3233
292,WOLB.0323.00001,1,985111,988339,+,3228
292,WOLB.0323.00100,1,1297041,1300275,+,3234
292,WOLB.0323.00070,1,1146770,1149996,+,3226
292,WOLB.0323.00006,1,951166,954414,-,3248
292,WOLB.0323.00042,1,1063556,1066817,-,3261
292,WOLB.0323.00119,1,792922,796152,+,3230
292,WOLB.0323.00149,1,817441,820674,-,3233
292,WOLB.0323.00014,1,586401,589627,+,3226
292,WOLB.0323.00096,1,304285,307526,+,3241
293,WOLB.0323.00090,1,887002,887876,+,874
293,WOLB.0323.00002,1,1025985,1026859,+,874
293,WOLB.0323.00138,1,960885,961758,-,873
293,WOLB.0323.00132,1,717634,718508,+,874
293,WOLB.0323.00121,1,1151961,1152835,+,874
293,WOLB.0323.00135,1,746034,746907,-,873
293,WOLB.0323.00060,1,890902,891776,+,874
293,WOLB.0323.00056,1,938975,939849,+,874
293,WOLB.0323.00142,1,1029802,1030676,+,874
293,WOLB.0323.00153,1,960181,961055,+,874
293,WOLB.0323.00088,1,978227,979098,+,871
293,WOLB.0323.00064,1,237407,238280,-,873
293,WOLB.0323.00030,1,806912,807784,-,872
293,WOLB.0323.00084,1,1054987,1055860,-,873
293,WOLB.0323.00021,1,1308167,1309041,+,874
293,WOLB.0323.00043,1,545747,546620,-,873
293,WOLB.0323.00020,1,920288,921162,+,874
293,WOLB.0323.00122,1,880707,881581,+,874
293,WOLB.0323.00004,1,1027818,1028692,+,874
293,WOLB.0323.00011,1,396180,397054,+,874
293,WOLB.0323.00035,1,915969,916843,+,874
293,WOLB.0323.00032,1,486802,487676,+,874
293,WOLB.0323.00012,1,982339,983213,+,874
293,WOLB.0323.00018,1,992415,993289,+,874
293,WOLB.0323.00010,1,1316329,1317202,+,873
293,WOLB.0323.00068,1,783248,784122,+,874
293,WOLB.0323.00128,1,957065,957938,-,873
293,WOLB.0323.00158,1,301760,302634,+,874
293,WOLB.0323.00017,1,1016534,1017408,+,874
293,WOLB.0323.00104,1,956065,956939,+,874
293,WOLB.0323.00007,1,344794,345667,-,873
293,WOLB.0323.00100,1,1300769,1301643,+,874
293,WOLB.0323.00070,1,1150490,1151364,+,874
293,WOLB.0323.00042,1,1062188,1063061,-,873
293,WOLB.0323.00149,1,816073,816946,-,873
293,WOLB.0323.00014,1,590121,590995,+,874
294,WOLB.0323.00090,1,889549,891871,+,2322
294,WOLB.0323.00002,1,1194559,1196890,+,2331
294,WOLB.0323.00138,1,956890,959212,-,2322
294,WOLB.0323.00132,1,720190,722530,+,2340
294,WOLB.0323.00143,1,341699,344032,-,2333
294,WOLB.0323.00106,1,341702,344035,-,2333
294,WOLB.0323.00121,1,1154500,1156841,+,2341
294,WOLB.0323.00135,1,742020,744361,-,2341
294,WOLB.0323.00103,1,998925,1001265,-,2340
294,WOLB.0323.00107,1,997492,999832,-,2340
294,WOLB.0323.00019,1,378747,381078,-,2331
294,WOLB.0323.00060,1,893449,895790,+,2341
294,WOLB.0323.00074,1,1357480,1359886,-,2406
294,WOLB.0323.00120,1,1351238,1353644,-,2406
294,WOLB.0323.00039,1,1161044,1163375,-,2331
294,WOLB.0323.00041,1,298307,300713,+,2406
294,WOLB.0323.00031,1,443278,445611,+,2333
294,WOLB.0323.00056,1,941522,943863,+,2341
294,WOLB.0323.00142,1,1032341,1034682,+,2341
294,WOLB.0323.00023,1,311670,314010,+,2340
294,WOLB.0323.00153,1,962728,965050,+,2322
294,WOLB.0323.00093,1,633086,635417,-,2331
294,WOLB.0323.00088,1,980774,983096,+,2322
294,WOLB.0323.00008,1,357045,359309,-,2264
294,WOLB.0323.00024,1,466127,468437,-,2310
294,WOLB.0323.00064,1,233321,235661,-,2340
294,WOLB.0323.00030,1,802826,805166,-,2340
294,WOLB.0323.00105,1,998934,1001274,-,2340
294,WOLB.0323.00133,1,1085063,1087394,-,2331
294,WOLB.0323.00084,1,1050992,1053314,-,2322
294,WOLB.0323.00021,1,1310714,1313036,+,2322
294,WOLB.0323.00043,1,321152,323483,-,2331
294,WOLB.0323.00020,1,922835,925157,+,2322
294,WOLB.0323.00122,1,545468,547799,-,2331
294,WOLB.0323.00118,1,809142,811482,+,2340
294,WOLB.0323.00004,1,1030357,1032698,+,2341
294,WOLB.0323.00011,1,398719,401060,+,2341
294,WOLB.0323.00035,1,918516,920838,+,2322
294,WOLB.0323.00032,1,489349,491671,+,2322
294,WOLB.0323.00012,1,984886,987208,+,2322
294,WOLB.0323.00018,1,1036557,1038897,+,2340
294,WOLB.0323.00025,1,16443,18775,-,2332
294,WOLB.0323.00010,1,1320838,1323178,+,2340
294,WOLB.0323.00068,1,785795,788117,+,2322
294,WOLB.0323.00128,1,1181211,1183542,+,2331
294,WOLB.0323.00158,1,304299,306640,+,2341
294,WOLB.0323.00017,1,1019073,1021414,+,2341
294,WOLB.0323.00104,1,958612,960934,+,2322
294,WOLB.0323.00007,1,340780,343121,-,2341
294,WOLB.0323.00001,1,998934,1001274,-,2340
294,WOLB.0323.00100,1,1303316,1305638,+,2322
294,WOLB.0323.00070,1,1513113,1515444,+,2331
294,WOLB.0323.00006,1,946143,948476,-,2333
294,WOLB.0323.00042,1,1057235,1059571,-,2336
294,WOLB.0323.00119,1,800384,802715,+,2331
294,WOLB.0323.00149,1,812067,814408,-,2341
294,WOLB.0323.00014,1,1526143,1528474,+,2331
294,WOLB.0323.00096,1,310162,312568,+,2406
295,WOLB.0323.00090,1,892238,894400,+,2162
295,WOLB.0323.00002,1,1197329,1199482,+,2153
295,WOLB.0323.00138,1,954361,956523,-,2162
295,WOLB.0323.00132,1,722897,725059,+,2162
295,WOLB.0323.00143,1,339170,341332,-,2162
295,WOLB.0323.00106,1,339173,341335,-,2162
295,WOLB.0323.00121,1,1157190,1159352,+,2162
295,WOLB.0323.00135,1,739509,741671,-,2162
295,WOLB.0323.00103,1,996405,998558,-,2153
295,WOLB.0323.00107,1,994972,997125,-,2153
295,WOLB.0323.00019,1,376233,378371,-,2138
295,WOLB.0323.00060,1,896139,898301,+,2162
295,WOLB.0323.00074,1,1355064,1357226,-,2162
295,WOLB.0323.00120,1,1348822,1350984,-,2162
295,WOLB.0323.00039,1,1158530,1160668,-,2138
295,WOLB.0323.00041,1,300967,303129,+,2162
295,WOLB.0323.00031,1,445978,448140,+,2162
295,WOLB.0323.00056,1,944212,946374,+,2162
295,WOLB.0323.00142,1,1035031,1037193,+,2162
295,WOLB.0323.00023,1,314377,316539,+,2162
295,WOLB.0323.00153,1,965417,967579,+,2162
295,WOLB.0323.00093,1,630584,632728,-,2144
295,WOLB.0323.00088,1,983463,985625,+,2162
295,WOLB.0323.00008,1,354543,356678,-,2135
295,WOLB.0323.00024,1,463607,465760,-,2153
295,WOLB.0323.00064,1,230792,232954,-,2162
295,WOLB.0323.00030,1,800297,802459,-,2162
295,WOLB.0323.00105,1,996414,998567,-,2153
295,WOLB.0323.00133,1,1082534,1084696,-,2162
295,WOLB.0323.00084,1,1048463,1050625,-,2162
295,WOLB.0323.00021,1,1313403,1315565,+,2162
295,WOLB.0323.00043,1,318560,320713,-,2153
295,WOLB.0323.00020,1,925524,927686,+,2162
295,WOLB.0323.00122,1,542948,545110,-,2162
295,WOLB.0323.00118,1,811831,813993,+,2162
295,WOLB.0323.00004,1,1033047,1035209,+,2162
295,WOLB.0323.00011,1,401409,403571,+,2162
295,WOLB.0323.00035,1,921205,923367,+,2162
295,WOLB.0323.00032,1,492038,494200,+,2162
295,WOLB.0323.00012,1,987575,989737,+,2162
295,WOLB.0323.00018,1,1039327,1041480,+,2153
295,WOLB.0323.00025,1,13905,16067,-,2162
295,WOLB.0323.00010,1,1323528,1325690,+,2162
295,WOLB.0323.00068,1,788484,790646,+,2162
295,WOLB.0323.00128,1,1183981,1186134,+,2153
295,WOLB.0323.00158,1,306989,309151,+,2162
295,WOLB.0323.00017,1,1021763,1023925,+,2162
295,WOLB.0323.00104,1,961300,963462,+,2162
295,WOLB.0323.00007,1,338269,340431,-,2162
295,WOLB.0323.00001,1,996414,998567,-,2153
295,WOLB.0323.00100,1,1306005,1308167,+,2162
295,WOLB.0323.00070,1,1515883,1518036,+,2153
295,WOLB.0323.00006,1,943614,945776,-,2162
295,WOLB.0323.00042,1,1054742,1056886,-,2144
295,WOLB.0323.00119,1,803091,805229,+,2138
295,WOLB.0323.00149,1,809556,811718,-,2162
295,WOLB.0323.00014,1,1528913,1531066,+,2153
295,WOLB.0323.00096,1,312822,314984,+,2162
296,WOLB.0323.00090,1,894458,896267,+,1809
296,WOLB.0323.00002,1,1199570,1201384,+,1814
296,WOLB.0323.00138,1,951125,952934,-,1809
296,WOLB.0323.00132,1,725117,726926,+,1809
296,WOLB.0323.00143,1,337263,339082,-,1819
296,WOLB.0323.00106,1,337265,339085,-,1820
296,WOLB.0323.00121,1,1159410,1161219,+,1809
296,WOLB.0323.00135,1,737645,739451,-,1806
296,WOLB.0323.00103,1,994540,996347,-,1807
296,WOLB.0323.00107,1,993107,994914,-,1807
296,WOLB.0323.00019,1,374325,376145,-,1820
296,WOLB.0323.00060,1,898359,900168,+,1809
296,WOLB.0323.00074,1,1353197,1355006,-,1809
296,WOLB.0323.00120,1,1346955,1348764,-,1809
296,WOLB.0323.00039,1,1156622,1158442,-,1820
296,WOLB.0323.00041,1,303187,304996,+,1809
296,WOLB.0323.00031,1,448228,450048,+,1820
296,WOLB.0323.00056,1,946432,948242,+,1810
296,WOLB.0323.00142,1,1037251,1039060,+,1809
296,WOLB.0323.00023,1,316597,318406,+,1809
296,WOLB.0323.00153,1,967637,969446,+,1809
296,WOLB.0323.00093,1,628719,630526,-,1807
296,WOLB.0323.00088,1,985683,987492,+,1809
296,WOLB.0323.00008,1,352678,354485,-,1807
296,WOLB.0323.00024,1,461697,463519,-,1822
296,WOLB.0323.00064,1,228925,230734,-,1809
296,WOLB.0323.00030,1,798430,800239,-,1809
296,WOLB.0323.00105,1,994549,996356,-,1807
296,WOLB.0323.00133,1,1080669,1082476,-,1807
296,WOLB.0323.00084,1,1046596,1048405,-,1809
296,WOLB.0323.00021,1,1315623,1317432,+,1809
296,WOLB.0323.00043,1,316658,318472,-,1814
296,WOLB.0323.00020,1,927744,929553,+,1809
296,WOLB.0323.00122,1,541081,542890,-,1809
296,WOLB.0323.00118,1,814051,815860,+,1809
296,WOLB.0323.00004,1,1035267,1037076,+,1809
296,WOLB.0323.00011,1,403629,405438,+,1809
296,WOLB.0323.00035,1,923425,925234,+,1809
296,WOLB.0323.00032,1,494258,496067,+,1809
296,WOLB.0323.00012,1,989795,991604,+,1809
296,WOLB.0323.00018,1,1041538,1043354,+,1816
296,WOLB.0323.00025,1,102817,104637,-,1820
296,WOLB.0323.00010,1,1325748,1327562,+,1814
296,WOLB.0323.00068,1,792073,793882,+,1809
296,WOLB.0323.00128,1,1186222,1188036,+,1814
296,WOLB.0323.00158,1,309209,311018,+,1809
296,WOLB.0323.00017,1,1023983,1025792,+,1809
296,WOLB.0323.00104,1,963520,965329,+,1809
296,WOLB.0323.00007,1,336402,338211,-,1809
296,WOLB.0323.00001,1,994549,996356,-,1807
296,WOLB.0323.00100,1,1308225,1310034,+,1809
296,WOLB.0323.00070,1,1518124,1519938,+,1814
296,WOLB.0323.00006,1,941706,943526,-,1820
296,WOLB.0323.00042,1,1052808,1054636,-,1828
296,WOLB.0323.00119,1,805317,807137,+,1820
296,WOLB.0323.00149,1,807689,809498,-,1809
296,WOLB.0323.00014,1,1531154,1532968,+,1814
296,WOLB.0323.00096,1,315042,316851,+,1809
297,WOLB.0323.00090,1,896596,897171,+,575
297,WOLB.0323.00138,1,950220,950796,-,576
297,WOLB.0323.00121,1,1161548,1162123,+,575
297,WOLB.0323.00060,1,900497,901072,+,575
297,WOLB.0323.00056,1,948571,949146,+,575
297,WOLB.0323.00142,1,1039389,1039964,+,575
297,WOLB.0323.00153,1,969775,970350,+,575
297,WOLB.0323.00088,1,987821,988396,+,575
297,WOLB.0323.00084,1,1045691,1046267,-,576
297,WOLB.0323.00021,1,1317761,1318336,+,575
297,WOLB.0323.00020,1,929882,930457,+,575
297,WOLB.0323.00122,1,540176,540752,-,576
297,WOLB.0323.00118,1,816189,816764,+,575
297,WOLB.0323.00004,1,1037405,1037980,+,575
297,WOLB.0323.00011,1,405767,406342,+,575
297,WOLB.0323.00035,1,925563,926138,+,575
297,WOLB.0323.00032,1,496396,496971,+,575
297,WOLB.0323.00012,1,991933,992508,+,575
297,WOLB.0323.00068,1,794211,794786,+,575
297,WOLB.0323.00158,1,311347,311922,+,575
297,WOLB.0323.00017,1,1026121,1026696,+,575
297,WOLB.0323.00104,1,965658,966233,+,575
297,WOLB.0323.00007,1,335497,336073,-,576
297,WOLB.0323.00100,1,1310363,1310938,+,575
297,WOLB.0323.00149,1,806784,807360,-,576
298,WOLB.0323.00090,1,898208,899110,+,902
298,WOLB.0323.00138,1,948281,949183,-,902
298,WOLB.0323.00121,1,1163160,1164062,+,902
298,WOLB.0323.00060,1,902109,903024,+,915
298,WOLB.0323.00056,1,950183,951085,+,902
298,WOLB.0323.00142,1,1041001,1041903,+,902
298,WOLB.0323.00153,1,971387,972289,+,902
298,WOLB.0323.00088,1,989433,990335,+,902
298,WOLB.0323.00084,1,1043752,1044654,-,902
298,WOLB.0323.00021,1,1319373,1320275,+,902
298,WOLB.0323.00020,1,931494,932396,+,902
298,WOLB.0323.00122,1,538237,539139,-,902
298,WOLB.0323.00118,1,817801,818703,+,902
298,WOLB.0323.00004,1,1039017,1039919,+,902
298,WOLB.0323.00011,1,407379,408281,+,902
298,WOLB.0323.00035,1,927175,928077,+,902
298,WOLB.0323.00032,1,498008,498910,+,902
298,WOLB.0323.00012,1,993545,994447,+,902
298,WOLB.0323.00068,1,796122,797024,+,902
298,WOLB.0323.00158,1,312959,313861,+,902
298,WOLB.0323.00017,1,1027733,1028635,+,902
298,WOLB.0323.00104,1,967270,968172,+,902
298,WOLB.0323.00007,1,333558,334460,-,902
298,WOLB.0323.00100,1,1311975,1312877,+,902
298,WOLB.0323.00149,1,804845,805747,-,902
299,WOLB.0323.00090,1,899373,900456,+,1083
299,WOLB.0323.00002,1,1202512,1203595,+,1083
299,WOLB.0323.00138,1,946936,948019,-,1083
299,WOLB.0323.00132,1,880665,881743,+,1078
299,WOLB.0323.00143,1,335058,336121,-,1063
299,WOLB.0323.00106,1,335060,336123,-,1063
299,WOLB.0323.00121,1,1164325,1165408,+,1083
299,WOLB.0323.00135,1,735453,736532,-,1079
299,WOLB.0323.00019,1,372072,373155,-,1083
299,WOLB.0323.00060,1,904783,905867,+,1084
299,WOLB.0323.00074,1,1351005,1352084,-,1079
299,WOLB.0323.00120,1,1344763,1345842,-,1079
299,WOLB.0323.00039,1,1154369,1155452,-,1083
299,WOLB.0323.00041,1,306109,307188,+,1079
299,WOLB.0323.00031,1,451190,452253,+,1063
299,WOLB.0323.00056,1,951348,952431,+,1083
299,WOLB.0323.00142,1,1042166,1043249,+,1083
299,WOLB.0323.00023,1,525052,526130,+,1078
299,WOLB.0323.00153,1,972552,973635,+,1083
299,WOLB.0323.00093,1,626388,627455,-,1067
299,WOLB.0323.00088,1,990598,991681,+,1083
299,WOLB.0323.00008,1,350347,351414,-,1067
299,WOLB.0323.00024,1,1229647,1230725,-,1078
299,WOLB.0323.00064,1,789448,790526,+,1078
299,WOLB.0323.00030,1,1403881,1404959,+,1078
299,WOLB.0323.00133,1,1078331,1079413,-,1082
299,WOLB.0323.00084,1,1042407,1043490,-,1083
299,WOLB.0323.00021,1,1320538,1321621,+,1083
299,WOLB.0323.00043,1,314447,315530,-,1083
299,WOLB.0323.00020,1,932659,933742,+,1083
299,WOLB.0323.00122,1,536892,537975,-,1083
299,WOLB.0323.00118,1,818966,820049,+,1083
299,WOLB.0323.00004,1,1040182,1041265,+,1083
299,WOLB.0323.00011,1,408544,409627,+,1083
299,WOLB.0323.00035,1,928340,929423,+,1083
299,WOLB.0323.00032,1,499173,500256,+,1083
299,WOLB.0323.00012,1,994710,995793,+,1083
299,WOLB.0323.00018,1,1044601,1045684,+,1083
299,WOLB.0323.00025,1,100612,101695,-,1083
299,WOLB.0323.00010,1,1332230,1333313,+,1083
299,WOLB.0323.00068,1,797287,798370,+,1083
299,WOLB.0323.00128,1,1189164,1190247,+,1083
299,WOLB.0323.00158,1,314124,315207,+,1083
299,WOLB.0323.00017,1,1028898,1029981,+,1083
299,WOLB.0323.00104,1,968435,969518,+,1083
299,WOLB.0323.00007,1,332213,333296,-,1083
299,WOLB.0323.00100,1,1313140,1314223,+,1083
299,WOLB.0323.00070,1,1521066,1522149,+,1083
299,WOLB.0323.00006,1,939501,940564,-,1063
299,WOLB.0323.00042,1,1047793,1048876,-,1083
299,WOLB.0323.00119,1,808307,809390,+,1083
299,WOLB.0323.00149,1,803500,804583,-,1083
299,WOLB.0323.00014,1,1534096,1535179,+,1083
299,WOLB.0323.00096,1,317964,319043,+,1079
300,WOLB.0323.00090,1,902031,904916,+,2885
300,WOLB.0323.00002,1,1205274,1208173,+,2899
300,WOLB.0323.00138,1,942389,945274,-,2885
300,WOLB.0323.00132,1,883406,886311,+,2905
300,WOLB.0323.00143,1,329856,332746,-,2890
300,WOLB.0323.00106,1,329858,332748,-,2890
300,WOLB.0323.00121,1,1167066,1169951,+,2885
300,WOLB.0323.00135,1,730292,733177,-,2885
300,WOLB.0323.00103,1,1004854,1007746,+,2892
300,WOLB.0323.00107,1,1003421,1006313,+,2892
300,WOLB.0323.00019,1,365316,368194,-,2878
300,WOLB.0323.00060,1,909038,911923,+,2885
300,WOLB.0323.00074,1,1345767,1348646,-,2879
300,WOLB.0323.00120,1,1339525,1342404,-,2879
300,WOLB.0323.00039,1,1149052,1151930,-,2878
300,WOLB.0323.00041,1,309547,312426,+,2879
300,WOLB.0323.00031,1,454565,457455,+,2890
300,WOLB.0323.00056,1,954093,956978,+,2885
300,WOLB.0323.00142,1,1046010,1048895,+,2885
300,WOLB.0323.00023,1,527793,530698,+,2905
300,WOLB.0323.00153,1,975211,978096,+,2885
300,WOLB.0323.00093,1,621335,624204,-,2869
300,WOLB.0323.00088,1,993343,996228,+,2885
300,WOLB.0323.00008,1,344131,347009,-,2878
300,WOLB.0323.00024,1,1220594,1223499,-,2905
300,WOLB.0323.00064,1,792188,795085,+,2897
300,WOLB.0323.00030,1,1406621,1409518,+,2897
300,WOLB.0323.00105,1,1004863,1007755,+,2892
300,WOLB.0323.00133,1,77019,79852,+,2833
300,WOLB.0323.00084,1,1037860,1040745,-,2885
300,WOLB.0323.00021,1,1323283,1326168,+,2885
300,WOLB.0323.00043,1,309869,312768,-,2899
300,WOLB.0323.00020,1,935404,938289,+,2885
300,WOLB.0323.00122,1,532349,535234,-,2885
300,WOLB.0323.00118,1,821708,824613,+,2905
300,WOLB.0323.00004,1,1042923,1045808,+,2885
300,WOLB.0323.00011,1,411285,414170,+,2885
300,WOLB.0323.00035,1,931085,933970,+,2885
300,WOLB.0323.00032,1,501918,504803,+,2885
300,WOLB.0323.00012,1,997455,1000340,+,2885
300,WOLB.0323.00018,1,1047306,1050197,+,2891
300,WOLB.0323.00025,1,986893,989783,+,2890
300,WOLB.0323.00010,1,1334989,1337867,+,2878
300,WOLB.0323.00068,1,800032,802917,+,2885
300,WOLB.0323.00128,1,1191927,1194826,+,2899
300,WOLB.0323.00158,1,316865,319750,+,2885
300,WOLB.0323.00017,1,1031639,1034524,+,2885
300,WOLB.0323.00104,1,971180,974065,+,2885
300,WOLB.0323.00007,1,326158,329043,-,2885
300,WOLB.0323.00001,1,1004863,1007755,+,2892
300,WOLB.0323.00100,1,1315885,1318770,+,2885
300,WOLB.0323.00070,1,1523828,1526727,+,2899
300,WOLB.0323.00006,1,934357,937247,-,2890
300,WOLB.0323.00042,1,1043319,1046210,-,2891
300,WOLB.0323.00119,1,365201,368079,-,2878
300,WOLB.0323.00149,1,798957,801842,-,2885
300,WOLB.0323.00014,1,1536858,1539757,+,2899
300,WOLB.0323.00096,1,321402,324281,+,2879
301,WOLB.0323.00090,1,906410,908105,+,1695
301,WOLB.0323.00002,1,1208423,1210133,+,1710
301,WOLB.0323.00138,1,939274,940985,-,1711
301,WOLB.0323.00132,1,886569,888280,+,1711
301,WOLB.0323.00143,1,326667,328387,-,1720
301,WOLB.0323.00106,1,326669,328389,-,1720
301,WOLB.0323.00121,1,1171445,1173140,+,1695
301,WOLB.0323.00135,1,727102,728813,-,1711
301,WOLB.0323.00103,1,1026555,1028274,+,1719
301,WOLB.0323.00107,1,1025122,1026841,+,1719
301,WOLB.0323.00019,1,363210,364927,-,1717
301,WOLB.0323.00060,1,913410,915120,+,1710
301,WOLB.0323.00074,1,1343653,1345373,-,1720
301,WOLB.0323.00120,1,1337411,1339131,-,1720
301,WOLB.0323.00039,1,1146946,1148663,-,1717
301,WOLB.0323.00041,1,312820,314539,+,1719
301,WOLB.0323.00031,1,458924,460643,+,1719
301,WOLB.0323.00056,1,958465,960175,+,1710
301,WOLB.0323.00142,1,1050389,1052084,+,1695
301,WOLB.0323.00023,1,530955,532666,+,1711
301,WOLB.0323.00153,1,979590,981285,+,1695
301,WOLB.0323.00093,1,619220,620941,-,1721
301,WOLB.0323.00088,1,997707,999417,+,1710
301,WOLB.0323.00008,1,342015,343736,-,1721
301,WOLB.0323.00024,1,1218610,1220337,-,1727
301,WOLB.0323.00064,1,795342,797053,+,1711
301,WOLB.0323.00030,1,1409775,1411486,+,1711
301,WOLB.0323.00105,1,1026563,1028282,+,1719
301,WOLB.0323.00133,1,335817,337535,+,1718
301,WOLB.0323.00084,1,1034745,1036456,-,1711
301,WOLB.0323.00021,1,1327572,1329282,+,1710
301,WOLB.0323.00043,1,307908,309619,-,1711
301,WOLB.0323.00020,1,939768,941478,+,1710
301,WOLB.0323.00122,1,529159,530855,-,1696
301,WOLB.0323.00118,1,824862,826571,+,1709
301,WOLB.0323.00004,1,1047302,1048997,+,1695
301,WOLB.0323.00011,1,415664,417359,+,1695
301,WOLB.0323.00035,1,935449,937159,+,1710
301,WOLB.0323.00032,1,506207,507917,+,1710
301,WOLB.0323.00012,1,1001819,1003530,+,1711
301,WOLB.0323.00018,1,1050446,1052156,+,1710
301,WOLB.0323.00025,1,990170,991885,+,1715
301,WOLB.0323.00010,1,1338269,1339979,+,1710
301,WOLB.0323.00068,1,804321,806031,+,1710
301,WOLB.0323.00128,1,1195076,1196786,+,1710
301,WOLB.0323.00158,1,321244,322939,+,1695
301,WOLB.0323.00017,1,1036018,1037713,+,1695
301,WOLB.0323.00104,1,975544,977254,+,1710
301,WOLB.0323.00007,1,322960,324671,-,1711
301,WOLB.0323.00001,1,1026563,1028282,+,1719
301,WOLB.0323.00100,1,1320249,1321959,+,1710
301,WOLB.0323.00070,1,1526977,1528687,+,1710
301,WOLB.0323.00006,1,931168,932888,-,1720
301,WOLB.0323.00042,1,1041358,1043070,-,1712
301,WOLB.0323.00119,1,363095,364812,-,1717
301,WOLB.0323.00149,1,795767,797463,-,1696
301,WOLB.0323.00014,1,1540007,1541717,+,1710
301,WOLB.0323.00096,1,324675,326394,+,1719
302,WOLB.0323.00090,1,908107,919285,+,11178
302,WOLB.0323.00002,1,1210135,1221313,+,11178
302,WOLB.0323.00138,1,928094,939273,-,11179
302,WOLB.0323.00132,1,888282,899460,+,11178
302,WOLB.0323.00143,1,315475,326666,-,11191
302,WOLB.0323.00106,1,315477,326668,-,11191
302,WOLB.0323.00121,1,1173142,1184320,+,11178
302,WOLB.0323.00135,1,715922,727101,-,11179
302,WOLB.0323.00103,1,1028276,1039466,+,11190
302,WOLB.0323.00107,1,1026843,1038033,+,11190
302,WOLB.0323.00019,1,352024,363209,-,11185
302,WOLB.0323.00060,1,915122,926300,+,11178
302,WOLB.0323.00074,1,1332470,1343652,-,11182
302,WOLB.0323.00120,1,1326228,1337410,-,11182
302,WOLB.0323.00039,1,1135759,1146945,-,11186
302,WOLB.0323.00041,1,314541,325722,+,11181
302,WOLB.0323.00031,1,460645,471835,+,11190
302,WOLB.0323.00056,1,960177,971355,+,11178
302,WOLB.0323.00142,1,1052086,1063264,+,11178
302,WOLB.0323.00023,1,532668,543846,+,11178
302,WOLB.0323.00153,1,981287,992465,+,11178
302,WOLB.0323.00093,1,608040,619219,-,11179
302,WOLB.0323.00088,1,999419,1010597,+,11178
302,WOLB.0323.00008,1,330832,342014,-,11182
302,WOLB.0323.00024,1,1205960,1217114,-,11154
302,WOLB.0323.00064,1,797055,808233,+,11178
302,WOLB.0323.00030,1,1411488,1422666,+,11178
302,WOLB.0323.00105,1,1028284,1039474,+,11190
302,WOLB.0323.00133,1,337537,348716,+,11179
302,WOLB.0323.00084,1,1023565,1034744,-,11179
302,WOLB.0323.00021,1,1329284,1340462,+,11178
302,WOLB.0323.00043,1,296728,307907,-,11179
302,WOLB.0323.00020,1,941480,952658,+,11178
302,WOLB.0323.00122,1,517979,529158,-,11179
302,WOLB.0323.00118,1,826573,837751,+,11178
302,WOLB.0323.00004,1,1048999,1060177,+,11178
302,WOLB.0323.00011,1,417361,428539,+,11178
302,WOLB.0323.00035,1,937161,948339,+,11178
302,WOLB.0323.00032,1,507919,519097,+,11178
302,WOLB.0323.00012,1,1003532,1014710,+,11178
302,WOLB.0323.00018,1,1052158,1063336,+,11178
302,WOLB.0323.00025,1,991887,1003077,+,11190
302,WOLB.0323.00010,1,1339981,1351159,+,11178
302,WOLB.0323.00068,1,806033,817211,+,11178
302,WOLB.0323.00128,1,1196788,1207966,+,11178
302,WOLB.0323.00158,1,322941,334119,+,11178
302,WOLB.0323.00017,1,1037715,1048893,+,11178
302,WOLB.0323.00104,1,977256,988434,+,11178
302,WOLB.0323.00007,1,311780,322959,-,11179
302,WOLB.0323.00001,1,1028284,1039474,+,11190
302,WOLB.0323.00100,1,1321961,1333139,+,11178
302,WOLB.0323.00070,1,1528689,1539867,+,11178
302,WOLB.0323.00006,1,919976,931167,-,11191
302,WOLB.0323.00042,1,1030178,1041357,-,11179
302,WOLB.0323.00119,1,351909,363094,-,11185
302,WOLB.0323.00149,1,784587,795766,-,11179
302,WOLB.0323.00014,1,1541719,1552897,+,11178
302,WOLB.0323.00096,1,326396,337577,+,11181
303,WOLB.0323.00090,1,919287,920749,+,1462
303,WOLB.0323.00002,1,1221315,1222777,+,1462
303,WOLB.0323.00138,1,926631,928093,-,1462
303,WOLB.0323.00132,1,899462,900924,+,1462
303,WOLB.0323.00143,1,314009,315474,-,1465
303,WOLB.0323.00106,1,314011,315476,-,1465
303,WOLB.0323.00121,1,1184322,1185784,+,1462
303,WOLB.0323.00135,1,714459,715921,-,1462
303,WOLB.0323.00103,1,1039468,1040930,+,1462
303,WOLB.0323.00107,1,1038035,1039497,+,1462
303,WOLB.0323.00019,1,350561,352023,-,1462
303,WOLB.0323.00060,1,926302,927764,+,1462
303,WOLB.0323.00074,1,1331007,1332469,-,1462
303,WOLB.0323.00120,1,1323282,1324714,-,1432
303,WOLB.0323.00120,1,1324762,1326227,-,1465
303,WOLB.0323.00039,1,1134296,1135758,-,1462
303,WOLB.0323.00041,1,325724,327186,+,1462
303,WOLB.0323.00031,1,471837,473302,+,1465
303,WOLB.0323.00056,1,971357,972819,+,1462
303,WOLB.0323.00142,1,1063266,1064728,+,1462
303,WOLB.0323.00023,1,543848,545310,+,1462
303,WOLB.0323.00153,1,992467,993929,+,1462
303,WOLB.0323.00093,1,606577,608039,-,1462
303,WOLB.0323.00088,1,1010599,1012061,+,1462
303,WOLB.0323.00008,1,329369,330831,-,1462
303,WOLB.0323.00024,1,1204497,1205959,-,1462
303,WOLB.0323.00064,1,808235,809697,+,1462
303,WOLB.0323.00030,1,1422668,1424127,+,1459
303,WOLB.0323.00105,1,1039476,1040938,+,1462
303,WOLB.0323.00133,1,348718,350177,+,1459
303,WOLB.0323.00084,1,1022102,1023564,-,1462
303,WOLB.0323.00021,1,1340464,1341926,+,1462
303,WOLB.0323.00043,1,295265,296727,-,1462
303,WOLB.0323.00020,1,952660,954122,+,1462
303,WOLB.0323.00122,1,516516,517978,-,1462
303,WOLB.0323.00118,1,837753,839215,+,1462
303,WOLB.0323.00004,1,1060179,1061641,+,1462
303,WOLB.0323.00011,1,428541,430003,+,1462
303,WOLB.0323.00035,1,948341,949803,+,1462
303,WOLB.0323.00032,1,519099,520561,+,1462
303,WOLB.0323.00012,1,1014712,1016174,+,1462
303,WOLB.0323.00018,1,1063338,1064800,+,1462
303,WOLB.0323.00025,1,1003079,1004544,+,1465
303,WOLB.0323.00010,1,1351161,1352617,+,1456
303,WOLB.0323.00068,1,817213,818675,+,1462
303,WOLB.0323.00128,1,1207968,1209430,+,1462
303,WOLB.0323.00158,1,334121,335583,+,1462
303,WOLB.0323.00017,1,1048895,1050357,+,1462
303,WOLB.0323.00104,1,988436,989898,+,1462
303,WOLB.0323.00007,1,310317,311779,-,1462
303,WOLB.0323.00001,1,1039476,1040938,+,1462
303,WOLB.0323.00100,1,1333141,1334603,+,1462
303,WOLB.0323.00070,1,1539869,1541331,+,1462
303,WOLB.0323.00006,1,918510,919975,-,1465
303,WOLB.0323.00042,1,1028715,1030177,-,1462
303,WOLB.0323.00119,1,350446,351908,-,1462
303,WOLB.0323.00149,1,783124,784586,-,1462
303,WOLB.0323.00014,1,1552899,1554361,+,1462
303,WOLB.0323.00096,1,337579,339041,+,1462
304,WOLB.0323.00090,1,920750,925982,+,5232
304,WOLB.0323.00002,1,1222778,1228010,+,5232
304,WOLB.0323.00138,1,921398,926629,-,5231
304,WOLB.0323.00132,1,900925,906157,+,5232
304,WOLB.0323.00143,1,308778,314007,-,5229
304,WOLB.0323.00106,1,308780,314009,-,5229
304,WOLB.0323.00121,1,1185785,1191017,+,5232
304,WOLB.0323.00135,1,709226,714457,-,5231
304,WOLB.0323.00103,1,1040931,1046162,+,5231
304,WOLB.0323.00107,1,1039498,1044729,+,5231
304,WOLB.0323.00019,1,345328,350559,-,5231
304,WOLB.0323.00060,1,927765,932997,+,5232
304,WOLB.0323.00074,1,1325774,1331005,-,5231
304,WOLB.0323.00120,1,1318049,1323280,-,5231
304,WOLB.0323.00039,1,1129063,1134294,-,5231
304,WOLB.0323.00041,1,327187,332419,+,5232
304,WOLB.0323.00031,1,473303,478533,+,5230
304,WOLB.0323.00056,1,972820,978052,+,5232
304,WOLB.0323.00142,1,1064729,1069961,+,5232
304,WOLB.0323.00023,1,545311,550528,+,5217
304,WOLB.0323.00153,1,993930,999162,+,5232
304,WOLB.0323.00093,1,601359,606575,-,5216
304,WOLB.0323.00088,1,1012062,1017294,+,5232
304,WOLB.0323.00008,1,324136,329367,-,5231
304,WOLB.0323.00024,1,1199263,1204495,-,5232
304,WOLB.0323.00064,1,809698,814930,+,5232
304,WOLB.0323.00030,1,1424128,1429360,+,5232
304,WOLB.0323.00105,1,1040939,1046170,+,5231
304,WOLB.0323.00133,1,350178,355410,+,5232
304,WOLB.0323.00084,1,1016869,1022100,-,5231
304,WOLB.0323.00021,1,1341927,1347159,+,5232
304,WOLB.0323.00043,1,290032,295263,-,5231
304,WOLB.0323.00020,1,954123,959355,+,5232
304,WOLB.0323.00122,1,511283,516514,-,5231
304,WOLB.0323.00118,1,839216,844448,+,5232
304,WOLB.0323.00004,1,1061642,1066874,+,5232
304,WOLB.0323.00011,1,430004,435236,+,5232
304,WOLB.0323.00035,1,949804,955036,+,5232
304,WOLB.0323.00032,1,520562,525794,+,5232
304,WOLB.0323.00012,1,1016175,1021407,+,5232
304,WOLB.0323.00018,1,1064801,1070033,+,5232
304,WOLB.0323.00025,1,1004545,1009775,+,5230
304,WOLB.0323.00010,1,1352618,1357851,+,5233
304,WOLB.0323.00068,1,818676,823908,+,5232
304,WOLB.0323.00128,1,1209431,1214663,+,5232
304,WOLB.0323.00158,1,335584,340816,+,5232
304,WOLB.0323.00017,1,1050358,1055590,+,5232
304,WOLB.0323.00104,1,989899,995131,+,5232
304,WOLB.0323.00007,1,305084,310315,-,5231
304,WOLB.0323.00001,1,1040939,1046170,+,5231
304,WOLB.0323.00100,1,1334604,1339836,+,5232
304,WOLB.0323.00070,1,1541332,1546564,+,5232
304,WOLB.0323.00006,1,913279,918508,-,5229
304,WOLB.0323.00042,1,1023482,1028713,-,5231
304,WOLB.0323.00119,1,345213,350444,-,5231
304,WOLB.0323.00149,1,777891,783122,-,5231
304,WOLB.0323.00014,1,1554362,1559594,+,5232
304,WOLB.0323.00096,1,339042,344274,+,5232
305,WOLB.0323.00090,1,927067,928510,+,1443
305,WOLB.0323.00002,1,1229095,1230537,+,1442
305,WOLB.0323.00138,1,918870,920313,-,1443
305,WOLB.0323.00132,1,907242,908684,+,1442
305,WOLB.0323.00143,1,306251,307693,-,1442
305,WOLB.0323.00106,1,306253,307695,-,1442
305,WOLB.0323.00121,1,1192102,1193545,+,1443
305,WOLB.0323.00135,1,706697,708141,-,1444
305,WOLB.0323.00103,1,1047247,1048684,+,1437
305,WOLB.0323.00107,1,1045814,1047251,+,1437
305,WOLB.0323.00019,1,342801,344243,-,1442
305,WOLB.0323.00060,1,934082,935525,+,1443
305,WOLB.0323.00074,1,1323245,1324689,-,1444
305,WOLB.0323.00120,1,1315520,1316964,-,1444
305,WOLB.0323.00039,1,1126536,1127978,-,1442
305,WOLB.0323.00041,1,333504,334948,+,1444
305,WOLB.0323.00031,1,479618,481060,+,1442
305,WOLB.0323.00056,1,979137,980580,+,1443
305,WOLB.0323.00142,1,1071046,1072489,+,1443
305,WOLB.0323.00023,1,551628,553070,+,1442
305,WOLB.0323.00153,1,1000247,1001690,+,1443
305,WOLB.0323.00093,1,598815,600259,-,1444
305,WOLB.0323.00088,1,1018379,1019822,+,1443
305,WOLB.0323.00008,1,321607,323051,-,1444
305,WOLB.0323.00024,1,1196736,1198178,-,1442
305,WOLB.0323.00064,1,816015,817458,+,1443
305,WOLB.0323.00030,1,1430445,1431888,+,1443
305,WOLB.0323.00105,1,1047255,1048692,+,1437
305,WOLB.0323.00133,1,1076575,1078017,-,1442
305,WOLB.0323.00084,1,1014341,1015784,-,1443
305,WOLB.0323.00021,1,1348244,1349687,+,1443
305,WOLB.0323.00043,1,1308266,1309708,+,1442
305,WOLB.0323.00020,1,960440,961883,+,1443
305,WOLB.0323.00122,1,508755,510198,-,1443
305,WOLB.0323.00118,1,845533,846977,+,1444
305,WOLB.0323.00004,1,1067959,1069402,+,1443
305,WOLB.0323.00011,1,436321,437764,+,1443
305,WOLB.0323.00035,1,956121,957564,+,1443
305,WOLB.0323.00032,1,526879,528322,+,1443
305,WOLB.0323.00012,1,1022492,1023935,+,1443
305,WOLB.0323.00018,1,1071118,1072561,+,1443
305,WOLB.0323.00025,1,816757,818198,-,1441
305,WOLB.0323.00010,1,1358936,1360378,+,1442
305,WOLB.0323.00068,1,824993,826436,+,1443
305,WOLB.0323.00128,1,1215748,1217190,+,1442
305,WOLB.0323.00158,1,341894,343337,+,1443
305,WOLB.0323.00017,1,1056675,1058118,+,1443
305,WOLB.0323.00104,1,996216,997659,+,1443
305,WOLB.0323.00007,1,302556,303999,-,1443
305,WOLB.0323.00001,1,1047255,1048692,+,1437
305,WOLB.0323.00100,1,1340921,1342364,+,1443
305,WOLB.0323.00070,1,1547649,1549091,+,1442
305,WOLB.0323.00006,1,910752,912194,-,1442
305,WOLB.0323.00042,1,1020955,1022397,-,1442
305,WOLB.0323.00119,1,342686,344128,-,1442
305,WOLB.0323.00149,1,775363,776806,-,1443
305,WOLB.0323.00014,1,1560679,1562121,+,1442
305,WOLB.0323.00096,1,345359,346803,+,1444
306,WOLB.0323.00090,1,930711,931553,+,842
306,WOLB.0323.00002,1,1232517,1233348,+,831
306,WOLB.0323.00138,1,915827,916669,-,842
306,WOLB.0323.00132,1,910885,911727,+,842
306,WOLB.0323.00143,1,304110,304936,-,826
306,WOLB.0323.00106,1,304112,304938,-,826
306,WOLB.0323.00121,1,1195746,1196588,+,842
306,WOLB.0323.00135,1,704567,705397,-,830
306,WOLB.0323.00103,1,1049757,1050582,+,825
306,WOLB.0323.00107,1,1048324,1049149,+,825
306,WOLB.0323.00019,1,339773,340598,-,825
306,WOLB.0323.00060,1,937726,938568,+,842
306,WOLB.0323.00074,1,1321338,1322180,-,842
306,WOLB.0323.00120,1,1313613,1314455,-,842
306,WOLB.0323.00039,1,1123505,1124330,-,825
306,WOLB.0323.00041,1,336013,336855,+,842
306,WOLB.0323.00031,1,482375,483201,+,826
306,WOLB.0323.00056,1,982781,983623,+,842
306,WOLB.0323.00142,1,1074690,1075532,+,842
306,WOLB.0323.00023,1,555271,556113,+,842
306,WOLB.0323.00153,1,1003891,1004733,+,842
306,WOLB.0323.00093,1,596912,597749,-,837
306,WOLB.0323.00088,1,1022023,1022865,+,842
306,WOLB.0323.00008,1,319719,320540,-,821
306,WOLB.0323.00024,1,1192154,1192996,-,842
306,WOLB.0323.00064,1,819659,820501,+,842
306,WOLB.0323.00030,1,1434089,1434931,+,842
306,WOLB.0323.00105,1,1049765,1050590,+,825
306,WOLB.0323.00133,1,1073538,1074357,-,819
306,WOLB.0323.00084,1,1011298,1012140,-,842
306,WOLB.0323.00021,1,1351888,1352730,+,842
306,WOLB.0323.00043,1,1311688,1312530,+,842
306,WOLB.0323.00020,1,964084,964926,+,842
306,WOLB.0323.00122,1,505712,506554,-,842
306,WOLB.0323.00118,1,849178,850020,+,842
306,WOLB.0323.00004,1,1071603,1072445,+,842
306,WOLB.0323.00011,1,439965,440807,+,842
306,WOLB.0323.00035,1,959765,960607,+,842
306,WOLB.0323.00032,1,530523,531365,+,842
306,WOLB.0323.00012,1,1026136,1026978,+,842
306,WOLB.0323.00018,1,1074762,1075604,+,842
306,WOLB.0323.00025,1,366416,367249,+,833
306,WOLB.0323.00010,1,1362358,1363200,+,842
306,WOLB.0323.00068,1,829735,830577,+,842
306,WOLB.0323.00128,1,1219170,1220012,+,842
306,WOLB.0323.00158,1,345538,346380,+,842
306,WOLB.0323.00017,1,1060319,1061161,+,842
306,WOLB.0323.00104,1,999860,1000702,+,842
306,WOLB.0323.00007,1,299513,300355,-,842
306,WOLB.0323.00001,1,1049765,1050590,+,825
306,WOLB.0323.00100,1,1344565,1345407,+,842
306,WOLB.0323.00070,1,1551071,1551913,+,842
306,WOLB.0323.00006,1,908611,909437,-,826
306,WOLB.0323.00042,1,1018133,1018975,-,842
306,WOLB.0323.00119,1,339658,340483,-,825
306,WOLB.0323.00149,1,772320,773162,-,842
306,WOLB.0323.00014,1,1564101,1564943,+,842
306,WOLB.0323.00096,1,347868,348710,+,842
307,WOLB.0323.00090,1,931930,932486,+,556
307,WOLB.0323.00002,1,1233731,1234287,+,556
307,WOLB.0323.00138,1,914893,915449,-,556
307,WOLB.0323.00132,1,912104,912660,+,556
307,WOLB.0323.00143,1,303162,303718,-,556
307,WOLB.0323.00106,1,303164,303720,-,556
307,WOLB.0323.00121,1,1196965,1197521,+,556
307,WOLB.0323.00135,1,703605,704161,-,556
307,WOLB.0323.00103,1,1050967,1051532,+,565
307,WOLB.0323.00107,1,1049534,1050099,+,565
307,WOLB.0323.00019,1,338822,339378,-,556
307,WOLB.0323.00060,1,938945,939501,+,556
307,WOLB.0323.00074,1,1320404,1320960,-,556
307,WOLB.0323.00120,1,1312679,1313235,-,556
307,WOLB.0323.00039,1,1122554,1123110,-,556
307,WOLB.0323.00041,1,337232,337788,+,556
307,WOLB.0323.00031,1,483592,484148,+,556
307,WOLB.0323.00056,1,984000,984556,+,556
307,WOLB.0323.00142,1,1075909,1076465,+,556
307,WOLB.0323.00023,1,556489,557045,+,556
307,WOLB.0323.00153,1,1005110,1005666,+,556
307,WOLB.0323.00093,1,595971,596527,-,556
307,WOLB.0323.00088,1,1023242,1023798,+,556
307,WOLB.0323.00008,1,318772,319337,-,565
307,WOLB.0323.00024,1,1191219,1191775,-,556
307,WOLB.0323.00064,1,820878,821434,+,556
307,WOLB.0323.00030,1,1435308,1435864,+,556
307,WOLB.0323.00105,1,1050975,1051540,+,565
307,WOLB.0323.00133,1,1072594,1073150,-,556
307,WOLB.0323.00084,1,1010364,1010920,-,556
307,WOLB.0323.00021,1,1353107,1353663,+,556
307,WOLB.0323.00043,1,1312907,1313463,+,556
307,WOLB.0323.00020,1,965303,965859,+,556
307,WOLB.0323.00122,1,504778,505334,-,556
307,WOLB.0323.00118,1,850397,850953,+,556
307,WOLB.0323.00004,1,1072822,1073378,+,556
307,WOLB.0323.00011,1,441184,441740,+,556
307,WOLB.0323.00035,1,960984,961540,+,556
307,WOLB.0323.00032,1,531742,532298,+,556
307,WOLB.0323.00012,1,1027355,1027911,+,556
307,WOLB.0323.00018,1,1075981,1076537,+,556
307,WOLB.0323.00025,1,421289,421998,-,709
307,WOLB.0323.00010,1,1364466,1365037,+,571
307,WOLB.0323.00068,1,830954,831510,+,556
307,WOLB.0323.00128,1,1220389,1220945,+,556
307,WOLB.0323.00158,1,346757,347329,+,572
307,WOLB.0323.00017,1,1061538,1062094,+,556
307,WOLB.0323.00104,1,1001079,1001635,+,556
307,WOLB.0323.00007,1,298579,299135,-,556
307,WOLB.0323.00001,1,1050975,1051540,+,565
307,WOLB.0323.00100,1,1345784,1346340,+,556
307,WOLB.0323.00070,1,1552290,1552846,+,556
307,WOLB.0323.00006,1,907663,908219,-,556
307,WOLB.0323.00042,1,1017200,1017756,-,556
307,WOLB.0323.00119,1,338707,339263,-,556
307,WOLB.0323.00149,1,771386,771942,-,556
307,WOLB.0323.00014,1,1565320,1565876,+,556
307,WOLB.0323.00096,1,349087,349643,+,556
308,WOLB.0323.00090,1,933241,933984,+,743
308,WOLB.0323.00132,1,913283,914026,+,743
308,WOLB.0323.00019,1,337136,337878,-,742
308,WOLB.0323.00039,1,1120868,1121610,-,742
308,WOLB.0323.00023,1,557668,558411,+,743
308,WOLB.0323.00153,1,1006421,1007164,+,743
308,WOLB.0323.00064,1,822057,822800,+,743
308,WOLB.0323.00030,1,1436487,1437230,+,743
308,WOLB.0323.00133,1,1071229,1071972,-,743
308,WOLB.0323.00122,1,503281,504023,-,742
308,WOLB.0323.00042,1,1015835,1016577,-,742
308,WOLB.0323.00119,1,337021,337763,-,742
309,WOLB.0323.00090,1,934444,937333,+,2889
309,WOLB.0323.00002,1,1236231,1239119,+,2888
309,WOLB.0323.00138,1,908960,911850,-,2890
309,WOLB.0323.00132,1,914718,917605,+,2887
309,WOLB.0323.00143,1,297809,300699,-,2890
309,WOLB.0323.00106,1,297811,300701,-,2890
309,WOLB.0323.00121,1,1200570,1203459,+,2889
309,WOLB.0323.00135,1,698450,701340,-,2890
309,WOLB.0323.00103,1,1074280,1077170,-,2890
309,WOLB.0323.00107,1,1072847,1075737,-,2890
309,WOLB.0323.00019,1,333629,336519,-,2890
309,WOLB.0323.00060,1,942514,945403,+,2889
309,WOLB.0323.00074,1,1314500,1317390,-,2890
309,WOLB.0323.00120,1,1306775,1309665,-,2890
309,WOLB.0323.00039,1,1117361,1120251,-,2890
309,WOLB.0323.00041,1,340803,343692,+,2889
309,WOLB.0323.00031,1,486612,489501,+,2889
309,WOLB.0323.00056,1,987568,990457,+,2889
309,WOLB.0323.00142,1,1079514,1082403,+,2889
309,WOLB.0323.00023,1,559079,561966,+,2887
309,WOLB.0323.00153,1,1007624,1010513,+,2889
309,WOLB.0323.00093,1,590972,593862,-,2890
309,WOLB.0323.00088,1,1026811,1029700,+,2889
309,WOLB.0323.00008,1,313773,316663,-,2890
309,WOLB.0323.00024,1,1816561,1819448,+,2887
309,WOLB.0323.00064,1,823492,826379,+,2887
309,WOLB.0323.00030,1,1437922,1440809,+,2887
309,WOLB.0323.00105,1,1074287,1077177,-,2890
309,WOLB.0323.00133,1,1067722,1070612,-,2890
309,WOLB.0323.00084,1,1004426,1007316,-,2890
309,WOLB.0323.00021,1,1356707,1359596,+,2889
309,WOLB.0323.00043,1,1315407,1318295,+,2888
309,WOLB.0323.00020,1,968872,971761,+,2889
309,WOLB.0323.00122,1,499931,502821,-,2890
309,WOLB.0323.00118,1,854005,856894,+,2889
309,WOLB.0323.00004,1,1076427,1079316,+,2889
309,WOLB.0323.00011,1,444789,447678,+,2889
309,WOLB.0323.00035,1,964553,967442,+,2889
309,WOLB.0323.00032,1,535342,538231,+,2889
309,WOLB.0323.00012,1,1030922,1033811,+,2889
309,WOLB.0323.00018,1,1078465,1081356,+,2891
309,WOLB.0323.00025,1,1041371,1044261,-,2890
309,WOLB.0323.00010,1,1366676,1369564,+,2888
309,WOLB.0323.00068,1,834554,837459,+,2905
309,WOLB.0323.00128,1,1222889,1225777,+,2888
309,WOLB.0323.00158,1,351465,354354,+,2889
309,WOLB.0323.00017,1,1065143,1068032,+,2889
309,WOLB.0323.00104,1,1004648,1007537,+,2889
309,WOLB.0323.00007,1,292677,295567,-,2890
309,WOLB.0323.00001,1,1074287,1077177,-,2890
309,WOLB.0323.00100,1,1349353,1352242,+,2889
309,WOLB.0323.00070,1,1554790,1557692,+,2902
309,WOLB.0323.00006,1,902310,905200,-,2890
309,WOLB.0323.00042,1,1011305,1014193,-,2888
309,WOLB.0323.00119,1,333514,336404,-,2890
309,WOLB.0323.00149,1,765448,768338,-,2890
309,WOLB.0323.00014,1,1567820,1570708,+,2888
309,WOLB.0323.00096,1,352658,355547,+,2889
310,WOLB.0323.00090,1,937335,938388,+,1053
310,WOLB.0323.00002,1,1239121,1240181,+,1060
310,WOLB.0323.00138,1,907906,908959,-,1053
310,WOLB.0323.00132,1,917607,918667,+,1060
310,WOLB.0323.00143,1,296748,297808,-,1060
310,WOLB.0323.00106,1,296750,297810,-,1060
310,WOLB.0323.00121,1,1203461,1204514,+,1053
310,WOLB.0323.00135,1,697396,698449,-,1053
310,WOLB.0323.00103,1,1073244,1074279,-,1035
310,WOLB.0323.00107,1,1071811,1072846,-,1035
310,WOLB.0323.00019,1,332575,333628,-,1053
310,WOLB.0323.00060,1,945405,946458,+,1053
310,WOLB.0323.00074,1,1313439,1314499,-,1060
310,WOLB.0323.00120,1,1305714,1306774,-,1060
310,WOLB.0323.00039,1,1116307,1117360,-,1053
310,WOLB.0323.00041,1,343694,344754,+,1060
310,WOLB.0323.00031,1,489503,490563,+,1060
310,WOLB.0323.00056,1,990459,991512,+,1053
310,WOLB.0323.00142,1,1082405,1083458,+,1053
310,WOLB.0323.00023,1,561968,563028,+,1060
310,WOLB.0323.00153,1,1010515,1011568,+,1053
310,WOLB.0323.00093,1,589924,590971,-,1047
310,WOLB.0323.00088,1,1029702,1030755,+,1053
310,WOLB.0323.00008,1,312725,313772,-,1047
310,WOLB.0323.00024,1,1819450,1820510,+,1060
310,WOLB.0323.00064,1,826381,827441,+,1060
310,WOLB.0323.00030,1,1440811,1441871,+,1060
310,WOLB.0323.00105,1,1073251,1074286,-,1035
310,WOLB.0323.00133,1,1066668,1067721,-,1053
310,WOLB.0323.00084,1,1003372,1004425,-,1053
310,WOLB.0323.00021,1,1359598,1360651,+,1053
310,WOLB.0323.00043,1,1318297,1319357,+,1060
310,WOLB.0323.00020,1,971763,972816,+,1053
310,WOLB.0323.00122,1,498877,499930,-,1053
310,WOLB.0323.00118,1,856896,857949,+,1053
310,WOLB.0323.00004,1,1079318,1080371,+,1053
310,WOLB.0323.00011,1,447680,448733,+,1053
310,WOLB.0323.00035,1,967444,968497,+,1053
310,WOLB.0323.00032,1,538233,539286,+,1053
310,WOLB.0323.00012,1,1033813,1034866,+,1053
310,WOLB.0323.00018,1,1081358,1082415,+,1057
310,WOLB.0323.00025,1,1040310,1041370,-,1060
310,WOLB.0323.00010,1,1369566,1370626,+,1060
310,WOLB.0323.00068,1,839280,840304,+,1024
310,WOLB.0323.00128,1,1225779,1226839,+,1060
310,WOLB.0323.00158,1,354356,355409,+,1053
310,WOLB.0323.00017,1,1068034,1069087,+,1053
310,WOLB.0323.00104,1,1007539,1008592,+,1053
310,WOLB.0323.00007,1,291623,292676,-,1053
310,WOLB.0323.00001,1,1073251,1074286,-,1035
310,WOLB.0323.00100,1,1352244,1353297,+,1053
310,WOLB.0323.00070,1,1557694,1558734,+,1040
310,WOLB.0323.00006,1,901249,902309,-,1060
310,WOLB.0323.00042,1,1010244,1011304,-,1060
310,WOLB.0323.00119,1,332460,333513,-,1053
310,WOLB.0323.00149,1,764394,765447,-,1053
310,WOLB.0323.00014,1,1570710,1571770,+,1060
310,WOLB.0323.00096,1,355549,356609,+,1060
311,WOLB.0323.00090,1,939100,945963,+,6863
311,WOLB.0323.00002,1,1240896,1247759,+,6863
311,WOLB.0323.00138,1,900336,907193,-,6857
311,WOLB.0323.00132,1,919381,926236,+,6855
311,WOLB.0323.00143,1,289413,296285,-,6872
311,WOLB.0323.00106,1,289415,296287,-,6872
311,WOLB.0323.00121,1,1205227,1212090,+,6863
311,WOLB.0323.00135,1,689820,696683,-,6863
311,WOLB.0323.00103,1,1062417,1069289,-,6872
311,WOLB.0323.00107,1,1060983,1067856,-,6873
311,WOLB.0323.00019,1,324998,331861,-,6863
311,WOLB.0323.00060,1,947171,954034,+,6863
311,WOLB.0323.00074,1,1305788,1312649,-,6861
311,WOLB.0323.00120,1,1298063,1304924,-,6861
311,WOLB.0323.00039,1,1108729,1115593,-,6864
311,WOLB.0323.00041,1,345544,352405,+,6861
311,WOLB.0323.00031,1,491026,497898,+,6872
311,WOLB.0323.00056,1,992225,999088,+,6863
311,WOLB.0323.00142,1,1084171,1091034,+,6863
311,WOLB.0323.00023,1,563742,570597,+,6855
311,WOLB.0323.00153,1,1012280,1019143,+,6863
311,WOLB.0323.00093,1,582597,589407,-,6810
311,WOLB.0323.00088,1,1031468,1038331,+,6863
311,WOLB.0323.00008,1,305392,312209,-,6817
311,WOLB.0323.00024,1,1823984,1831139,+,7155
311,WOLB.0323.00064,1,828155,835010,+,6855
311,WOLB.0323.00030,1,1442585,1449440,+,6855
311,WOLB.0323.00105,1,1062424,1069296,-,6872
311,WOLB.0323.00133,1,1059091,1065953,-,6862
311,WOLB.0323.00084,1,995796,1002659,-,6863
311,WOLB.0323.00021,1,1361364,1368227,+,6863
311,WOLB.0323.00043,1,1320072,1326935,+,6863
311,WOLB.0323.00020,1,973529,980392,+,6863
311,WOLB.0323.00122,1,491307,498164,-,6857
311,WOLB.0323.00118,1,858662,865524,+,6862
311,WOLB.0323.00004,1,1081084,1087947,+,6863
311,WOLB.0323.00011,1,449446,456309,+,6863
311,WOLB.0323.00035,1,969210,976073,+,6863
311,WOLB.0323.00032,1,539999,546862,+,6863
311,WOLB.0323.00012,1,1035579,1042442,+,6863
311,WOLB.0323.00018,1,1083129,1089985,+,6856
311,WOLB.0323.00025,1,447475,454331,+,6856
311,WOLB.0323.00010,1,1371340,1378203,+,6863
311,WOLB.0323.00068,1,841017,847880,+,6863
311,WOLB.0323.00128,1,1227554,1234417,+,6863
311,WOLB.0323.00158,1,356122,362985,+,6863
311,WOLB.0323.00017,1,1069800,1076663,+,6863
311,WOLB.0323.00104,1,1009305,1016168,+,6863
311,WOLB.0323.00007,1,284047,290910,-,6863
311,WOLB.0323.00001,1,1062424,1069296,-,6872
311,WOLB.0323.00100,1,1354010,1360873,+,6863
311,WOLB.0323.00070,1,1559469,1566332,+,6863
311,WOLB.0323.00006,1,893767,900639,-,6872
311,WOLB.0323.00042,1,1002667,1009530,-,6863
311,WOLB.0323.00119,1,324883,331746,-,6863
311,WOLB.0323.00149,1,756818,763681,-,6863
311,WOLB.0323.00014,1,1572485,1579348,+,6863
311,WOLB.0323.00096,1,357399,364260,+,6861
312,WOLB.0323.00090,1,945982,947611,+,1629
312,WOLB.0323.00002,1,1249366,1250951,+,1585
312,WOLB.0323.00138,1,898688,900317,-,1629
312,WOLB.0323.00132,1,926263,927875,+,1612
312,WOLB.0323.00143,1,287764,289394,-,1630
312,WOLB.0323.00106,1,287766,289396,-,1630
312,WOLB.0323.00121,1,1212109,1213738,+,1629
312,WOLB.0323.00135,1,688172,689801,-,1629
312,WOLB.0323.00103,1,1060769,1062398,-,1629
312,WOLB.0323.00107,1,1059335,1060964,-,1629
312,WOLB.0323.00019,1,323350,324979,-,1629
312,WOLB.0323.00060,1,954053,955682,+,1629
312,WOLB.0323.00074,1,1304153,1305760,-,1607
312,WOLB.0323.00120,1,1296428,1298035,-,1607
312,WOLB.0323.00039,1,1107081,1108710,-,1629
312,WOLB.0323.00041,1,352433,354040,+,1607
312,WOLB.0323.00031,1,497917,499547,+,1630
312,WOLB.0323.00056,1,999107,1000736,+,1629
312,WOLB.0323.00142,1,1091053,1092682,+,1629
312,WOLB.0323.00023,1,570624,572236,+,1612
312,WOLB.0323.00153,1,1019162,1020791,+,1629
312,WOLB.0323.00093,1,580942,582570,-,1628
312,WOLB.0323.00088,1,1038350,1039979,+,1629
312,WOLB.0323.00008,1,303744,305373,-,1629
312,WOLB.0323.00024,1,1831158,1832788,+,1630
312,WOLB.0323.00064,1,835037,836663,+,1626
312,WOLB.0323.00030,1,1449467,1451093,+,1626
312,WOLB.0323.00105,1,1060776,1062405,-,1629
312,WOLB.0323.00133,1,1057465,1059072,-,1607
312,WOLB.0323.00084,1,994148,995777,-,1629
312,WOLB.0323.00021,1,1368246,1369875,+,1629
312,WOLB.0323.00043,1,1328542,1330127,+,1585
312,WOLB.0323.00020,1,980411,982040,+,1629
312,WOLB.0323.00122,1,489659,491288,-,1629
312,WOLB.0323.00118,1,865543,867172,+,1629
312,WOLB.0323.00004,1,1087966,1089595,+,1629
312,WOLB.0323.00011,1,456328,457957,+,1629
312,WOLB.0323.00035,1,976092,977721,+,1629
312,WOLB.0323.00032,1,546881,548510,+,1629
312,WOLB.0323.00012,1,1042461,1044090,+,1629
312,WOLB.0323.00018,1,1090012,1091640,+,1628
312,WOLB.0323.00025,1,1038138,1039710,-,1572
312,WOLB.0323.00010,1,1381767,1383352,+,1585
312,WOLB.0323.00068,1,847899,849528,+,1629
312,WOLB.0323.00128,1,1236025,1237610,+,1585
312,WOLB.0323.00158,1,363004,364633,+,1629
312,WOLB.0323.00017,1,1076682,1078311,+,1629
312,WOLB.0323.00104,1,1016187,1017816,+,1629
312,WOLB.0323.00007,1,282399,284028,-,1629
312,WOLB.0323.00001,1,1060776,1062405,-,1629
312,WOLB.0323.00100,1,1360892,1362521,+,1629
312,WOLB.0323.00070,1,1567939,1569524,+,1585
312,WOLB.0323.00006,1,892118,893748,-,1630
312,WOLB.0323.00042,1,1000075,1001703,-,1628
312,WOLB.0323.00119,1,323235,324864,-,1629
312,WOLB.0323.00149,1,755170,756799,-,1629
312,WOLB.0323.00014,1,1580955,1582540,+,1585
312,WOLB.0323.00096,1,364288,365895,+,1607
313,WOLB.0323.00090,1,947612,948148,+,536
313,WOLB.0323.00002,1,1250952,1251488,+,536
313,WOLB.0323.00138,1,898151,898686,-,535
313,WOLB.0323.00143,1,287227,287762,-,535
313,WOLB.0323.00106,1,287229,287764,-,535
313,WOLB.0323.00121,1,1213739,1214275,+,536
313,WOLB.0323.00135,1,687635,688170,-,535
313,WOLB.0323.00103,1,1060232,1060767,-,535
313,WOLB.0323.00107,1,1058798,1059333,-,535
313,WOLB.0323.00019,1,322813,323348,-,535
313,WOLB.0323.00060,1,955683,956219,+,536
313,WOLB.0323.00074,1,1303616,1304151,-,535
313,WOLB.0323.00120,1,1295891,1296426,-,535
313,WOLB.0323.00039,1,1106544,1107079,-,535
313,WOLB.0323.00041,1,354041,354577,+,536
313,WOLB.0323.00031,1,499548,500084,+,536
313,WOLB.0323.00056,1,1000737,1001273,+,536
313,WOLB.0323.00142,1,1092683,1093219,+,536
313,WOLB.0323.00153,1,1020792,1021328,+,536
313,WOLB.0323.00093,1,580405,580940,-,535
313,WOLB.0323.00088,1,1039980,1040516,+,536
313,WOLB.0323.00008,1,303207,303742,-,535
313,WOLB.0323.00024,1,1832789,1833325,+,536
313,WOLB.0323.00064,1,836664,837200,+,536
313,WOLB.0323.00030,1,1451094,1451630,+,536
313,WOLB.0323.00105,1,1060239,1060774,-,535
313,WOLB.0323.00133,1,1056905,1057450,-,545
313,WOLB.0323.00084,1,993611,994146,-,535
313,WOLB.0323.00021,1,1369876,1370412,+,536
313,WOLB.0323.00043,1,1330128,1330664,+,536
313,WOLB.0323.00020,1,982041,982577,+,536
313,WOLB.0323.00122,1,489122,489657,-,535
313,WOLB.0323.00118,1,867173,867709,+,536
313,WOLB.0323.00004,1,1089596,1090132,+,536
313,WOLB.0323.00011,1,457958,458494,+,536
313,WOLB.0323.00035,1,977722,978258,+,536
313,WOLB.0323.00032,1,548511,549047,+,536
313,WOLB.0323.00012,1,1044091,1044627,+,536
313,WOLB.0323.00018,1,1091641,1092177,+,536
313,WOLB.0323.00025,1,1037601,1038136,-,535
313,WOLB.0323.00010,1,1383353,1383889,+,536
313,WOLB.0323.00068,1,849529,850065,+,536
313,WOLB.0323.00128,1,1237611,1238147,+,536
313,WOLB.0323.00158,1,364634,365170,+,536
313,WOLB.0323.00017,1,1078312,1078848,+,536
313,WOLB.0323.00104,1,1017817,1018353,+,536
313,WOLB.0323.00007,1,281862,282397,-,535
313,WOLB.0323.00001,1,1060239,1060774,-,535
313,WOLB.0323.00100,1,1362522,1363058,+,536
313,WOLB.0323.00070,1,1569525,1570061,+,536
313,WOLB.0323.00006,1,891581,892116,-,535
313,WOLB.0323.00042,1,999538,1000073,-,535
313,WOLB.0323.00119,1,322698,323233,-,535
313,WOLB.0323.00149,1,754633,755168,-,535
313,WOLB.0323.00014,1,1582541,1583077,+,536
313,WOLB.0323.00096,1,365896,366432,+,536
314,WOLB.0323.00090,1,948560,949379,+,819
314,WOLB.0323.00002,1,1251900,1252719,+,819
314,WOLB.0323.00138,1,896919,897739,-,820
314,WOLB.0323.00132,1,928852,929672,+,820
314,WOLB.0323.00143,1,285996,286815,-,819
314,WOLB.0323.00106,1,285998,286817,-,819
314,WOLB.0323.00121,1,1214687,1215506,+,819
314,WOLB.0323.00135,1,686404,687223,-,819
314,WOLB.0323.00103,1,1059011,1059820,-,809
314,WOLB.0323.00107,1,1057577,1058386,-,809
314,WOLB.0323.00019,1,321582,322401,-,819
314,WOLB.0323.00060,1,956631,957450,+,819
314,WOLB.0323.00074,1,1302417,1303204,-,787
314,WOLB.0323.00120,1,1294692,1295479,-,787
314,WOLB.0323.00039,1,1105313,1106132,-,819
314,WOLB.0323.00041,1,354989,355776,+,787
314,WOLB.0323.00031,1,500496,501315,+,819
314,WOLB.0323.00056,1,1001685,1002504,+,819
314,WOLB.0323.00142,1,1093631,1094450,+,819
314,WOLB.0323.00023,1,573213,573995,+,782
314,WOLB.0323.00153,1,1021740,1022559,+,819
314,WOLB.0323.00093,1,579173,579993,-,820
314,WOLB.0323.00088,1,1040928,1041747,+,819
314,WOLB.0323.00008,1,301976,302795,-,819
314,WOLB.0323.00024,1,1833736,1834552,+,816
314,WOLB.0323.00064,1,837612,838431,+,819
314,WOLB.0323.00030,1,1452042,1452861,+,819
314,WOLB.0323.00105,1,1059018,1059814,-,796
314,WOLB.0323.00133,1,1055673,1056493,-,820
314,WOLB.0323.00084,1,992379,993199,-,820
314,WOLB.0323.00021,1,1370824,1371644,+,820
314,WOLB.0323.00043,1,1331076,1331895,+,819
314,WOLB.0323.00020,1,982989,983808,+,819
314,WOLB.0323.00122,1,487891,488710,-,819
314,WOLB.0323.00118,1,868121,868940,+,819
314,WOLB.0323.00004,1,1090544,1091363,+,819
314,WOLB.0323.00011,1,458906,459725,+,819
314,WOLB.0323.00035,1,978670,979489,+,819
314,WOLB.0323.00032,1,549459,550279,+,820
314,WOLB.0323.00012,1,1045039,1045858,+,819
314,WOLB.0323.00018,1,1092589,1093409,+,820
314,WOLB.0323.00025,1,1036219,1037189,-,970
314,WOLB.0323.00010,1,1384301,1385121,+,820
314,WOLB.0323.00068,1,850477,851297,+,820
314,WOLB.0323.00128,1,1238559,1239378,+,819
314,WOLB.0323.00158,1,365582,366401,+,819
314,WOLB.0323.00017,1,1079260,1080079,+,819
314,WOLB.0323.00104,1,1018765,1019584,+,819
314,WOLB.0323.00007,1,280631,281450,-,819
314,WOLB.0323.00001,1,1059018,1059814,-,796
314,WOLB.0323.00100,1,1363470,1364289,+,819
314,WOLB.0323.00070,1,1570473,1571292,+,819
314,WOLB.0323.00006,1,890350,891169,-,819
314,WOLB.0323.00042,1,998307,999126,-,819
314,WOLB.0323.00119,1,321467,322286,-,819
314,WOLB.0323.00149,1,753402,754221,-,819
314,WOLB.0323.00014,1,1583489,1584308,+,819
314,WOLB.0323.00096,1,366844,367631,+,787
315,WOLB.0323.00090,1,949667,950816,+,1149
315,WOLB.0323.00002,1,1253007,1254156,+,1149
315,WOLB.0323.00138,1,895482,896631,-,1149
315,WOLB.0323.00132,1,929960,931109,+,1149
315,WOLB.0323.00143,1,284559,285708,-,1149
315,WOLB.0323.00106,1,284561,285710,-,1149
315,WOLB.0323.00121,1,1215794,1216943,+,1149
315,WOLB.0323.00135,1,684967,686116,-,1149
315,WOLB.0323.00103,1,1057574,1058723,-,1149
315,WOLB.0323.00107,1,1056140,1057289,-,1149
315,WOLB.0323.00019,1,320145,321294,-,1149
315,WOLB.0323.00060,1,957738,958887,+,1149
315,WOLB.0323.00074,1,1300988,1302129,-,1141
315,WOLB.0323.00120,1,1293263,1294404,-,1141
315,WOLB.0323.00039,1,1103876,1105025,-,1149
315,WOLB.0323.00041,1,356064,357205,+,1141
315,WOLB.0323.00031,1,501603,502752,+,1149
315,WOLB.0323.00056,1,1002792,1003941,+,1149
315,WOLB.0323.00142,1,1094738,1095887,+,1149
315,WOLB.0323.00023,1,575736,576885,+,1149
315,WOLB.0323.00153,1,1022847,1023996,+,1149
315,WOLB.0323.00093,1,576151,577279,-,1128
315,WOLB.0323.00088,1,1042035,1043184,+,1149
315,WOLB.0323.00008,1,300539,301688,-,1149
315,WOLB.0323.00024,1,1834840,1835989,+,1149
315,WOLB.0323.00064,1,838719,839868,+,1149
315,WOLB.0323.00030,1,1453149,1454298,+,1149
315,WOLB.0323.00105,1,1057581,1058730,-,1149
315,WOLB.0323.00133,1,1054236,1055385,-,1149
315,WOLB.0323.00084,1,990942,992091,-,1149
315,WOLB.0323.00021,1,1371932,1373081,+,1149
315,WOLB.0323.00043,1,1332183,1333332,+,1149
315,WOLB.0323.00020,1,984096,985245,+,1149
315,WOLB.0323.00122,1,486454,487603,-,1149
315,WOLB.0323.00118,1,869228,870377,+,1149
315,WOLB.0323.00004,1,1091651,1092800,+,1149
315,WOLB.0323.00011,1,460013,461162,+,1149
315,WOLB.0323.00035,1,979777,980926,+,1149
315,WOLB.0323.00032,1,550567,551716,+,1149
315,WOLB.0323.00012,1,1046146,1047295,+,1149
315,WOLB.0323.00018,1,1093697,1094846,+,1149
315,WOLB.0323.00025,1,1034806,1035931,-,1125
315,WOLB.0323.00010,1,1385409,1386558,+,1149
315,WOLB.0323.00068,1,851585,852734,+,1149
315,WOLB.0323.00128,1,1239666,1240815,+,1149
315,WOLB.0323.00158,1,366689,367838,+,1149
315,WOLB.0323.00017,1,1080367,1081516,+,1149
315,WOLB.0323.00104,1,1019872,1021021,+,1149
315,WOLB.0323.00007,1,279194,280343,-,1149
315,WOLB.0323.00001,1,1057581,1058730,-,1149
315,WOLB.0323.00100,1,1364577,1365726,+,1149
315,WOLB.0323.00070,1,1571580,1572729,+,1149
315,WOLB.0323.00006,1,888913,890062,-,1149
315,WOLB.0323.00042,1,996870,998019,-,1149
315,WOLB.0323.00119,1,320030,321179,-,1149
315,WOLB.0323.00149,1,751965,753114,-,1149
315,WOLB.0323.00014,1,1584596,1585745,+,1149
315,WOLB.0323.00096,1,367919,369060,+,1141
316,WOLB.0323.00090,1,952260,954505,+,2245
316,WOLB.0323.00002,1,1256373,1258631,+,2258
316,WOLB.0323.00138,1,891784,894028,-,2244
316,WOLB.0323.00132,1,933431,935678,+,2247
316,WOLB.0323.00143,1,280864,283108,-,2244
316,WOLB.0323.00106,1,280866,283110,-,2244
316,WOLB.0323.00121,1,1219159,1221397,+,2238
316,WOLB.0323.00135,1,681294,683522,-,2228
316,WOLB.0323.00103,1,1082648,1084895,+,2247
316,WOLB.0323.00107,1,1081214,1083461,+,2247
316,WOLB.0323.00019,1,314248,316494,-,2246
316,WOLB.0323.00060,1,961103,963350,+,2247
316,WOLB.0323.00074,1,1296516,1298729,-,2213
316,WOLB.0323.00120,1,1288791,1291004,-,2213
316,WOLB.0323.00039,1,1099419,1101665,-,2246
316,WOLB.0323.00041,1,359464,361677,+,2213
316,WOLB.0323.00031,1,504202,506447,+,2245
316,WOLB.0323.00056,1,1006157,1008404,+,2247
316,WOLB.0323.00142,1,1098103,1100341,+,2238
316,WOLB.0323.00023,1,579086,581333,+,2247
316,WOLB.0323.00153,1,1025440,1027685,+,2245
316,WOLB.0323.00093,1,571777,574023,-,2246
316,WOLB.0323.00088,1,1044628,1046873,+,2245
316,WOLB.0323.00008,1,296063,298309,-,2246
316,WOLB.0323.00024,1,1838186,1840433,+,2247
316,WOLB.0323.00064,1,842086,844333,+,2247
316,WOLB.0323.00030,1,1455721,1457968,+,2247
316,WOLB.0323.00105,1,1082655,1084902,+,2247
316,WOLB.0323.00133,1,1051264,1053508,-,2244
316,WOLB.0323.00084,1,987244,989488,-,2244
316,WOLB.0323.00021,1,1374534,1376779,+,2245
316,WOLB.0323.00043,1,1335532,1337790,+,2258
316,WOLB.0323.00020,1,986689,988934,+,2245
316,WOLB.0323.00122,1,480897,483134,-,2237
316,WOLB.0323.00118,1,871820,874065,+,2245
316,WOLB.0323.00004,1,1095016,1097254,+,2238
316,WOLB.0323.00011,1,463378,465616,+,2238
316,WOLB.0323.00035,1,982370,984615,+,2245
316,WOLB.0323.00032,1,553169,555414,+,2245
316,WOLB.0323.00012,1,1048739,1050984,+,2245
316,WOLB.0323.00018,1,1097047,1099294,+,2247
316,WOLB.0323.00025,1,1029715,1031959,-,2244
316,WOLB.0323.00010,1,1388066,1390324,+,2258
316,WOLB.0323.00068,1,854187,856432,+,2245
316,WOLB.0323.00128,1,1243032,1245290,+,2258
316,WOLB.0323.00158,1,370054,372292,+,2238
316,WOLB.0323.00017,1,1083732,1085970,+,2238
316,WOLB.0323.00104,1,1022465,1024710,+,2245
316,WOLB.0323.00007,1,275585,277831,-,2246
316,WOLB.0323.00001,1,1082655,1084902,+,2247
316,WOLB.0323.00100,1,1367170,1369415,+,2245
316,WOLB.0323.00070,1,1574982,1577204,+,2222
316,WOLB.0323.00006,1,885218,887462,-,2244
316,WOLB.0323.00042,1,992404,994650,-,2246
316,WOLB.0323.00119,1,314133,316379,-,2246
316,WOLB.0323.00149,1,747511,749748,-,2237
316,WOLB.0323.00014,1,1587962,1590220,+,2258
316,WOLB.0323.00096,1,371319,373532,+,2213
317,WOLB.0323.00090,1,956318,956945,+,627
317,WOLB.0323.00002,1,1259821,1260417,+,596
317,WOLB.0323.00138,1,889345,889972,-,627
317,WOLB.0323.00132,1,937229,937843,+,614
317,WOLB.0323.00143,1,278350,278968,-,618
317,WOLB.0323.00106,1,278352,278970,-,618
317,WOLB.0323.00121,1,1222860,1223487,+,627
317,WOLB.0323.00135,1,679109,679727,-,618
317,WOLB.0323.00103,1,1086883,1087496,+,613
317,WOLB.0323.00107,1,1085448,1086061,+,613
317,WOLB.0323.00019,1,311987,312605,-,618
317,WOLB.0323.00060,1,964901,965528,+,627
317,WOLB.0323.00074,1,1294710,1295313,-,603
317,WOLB.0323.00120,1,1286985,1287588,-,603
317,WOLB.0323.00039,1,1097386,1098004,-,618
317,WOLB.0323.00041,1,362880,363483,+,603
317,WOLB.0323.00031,1,508343,508961,+,618
317,WOLB.0323.00056,1,1009955,1010582,+,627
317,WOLB.0323.00142,1,1101804,1102431,+,627
317,WOLB.0323.00023,1,582880,583507,+,627
317,WOLB.0323.00153,1,1029498,1030125,+,627
317,WOLB.0323.00093,1,570065,570683,-,618
317,WOLB.0323.00088,1,1048424,1049051,+,627
317,WOLB.0323.00008,1,289713,290327,-,614
317,WOLB.0323.00024,1,393187,393813,+,626
317,WOLB.0323.00064,1,845880,846498,+,618
317,WOLB.0323.00030,1,1459515,1460133,+,618
317,WOLB.0323.00105,1,1086890,1087503,+,613
317,WOLB.0323.00133,1,1049896,1050515,-,619
317,WOLB.0323.00084,1,984806,985433,-,627
317,WOLB.0323.00021,1,1378591,1379218,+,627
317,WOLB.0323.00043,1,1338980,1339576,+,596
317,WOLB.0323.00020,1,990485,991112,+,627
317,WOLB.0323.00122,1,478810,479437,-,627
317,WOLB.0323.00118,1,876884,877511,+,627
317,WOLB.0323.00004,1,1098717,1099344,+,627
317,WOLB.0323.00011,1,467079,467706,+,627
317,WOLB.0323.00035,1,986166,986793,+,627
317,WOLB.0323.00032,1,558325,558952,+,627
317,WOLB.0323.00012,1,1052535,1053162,+,627
317,WOLB.0323.00018,1,1100488,1101106,+,618
317,WOLB.0323.00010,1,1391506,1392124,+,618
317,WOLB.0323.00068,1,858245,858872,+,627
317,WOLB.0323.00128,1,1246480,1247076,+,596
317,WOLB.0323.00158,1,373755,374382,+,627
317,WOLB.0323.00017,1,1087433,1088060,+,627
317,WOLB.0323.00104,1,1026261,1026888,+,627
317,WOLB.0323.00007,1,273451,274078,-,627
317,WOLB.0323.00001,1,1086890,1087503,+,613
317,WOLB.0323.00100,1,1370966,1371593,+,627
317,WOLB.0323.00070,1,1578394,1578990,+,596
317,WOLB.0323.00006,1,882704,883322,-,618
317,WOLB.0323.00042,1,1420729,1421275,-,546
317,WOLB.0323.00119,1,311872,312490,-,618
317,WOLB.0323.00149,1,745421,746048,-,627
317,WOLB.0323.00014,1,1591410,1592006,+,596
317,WOLB.0323.00096,1,374735,375338,+,603
318,WOLB.0323.00090,1,957148,958477,+,1329
318,WOLB.0323.00002,1,1260620,1261956,+,1336
318,WOLB.0323.00138,1,887813,889142,-,1329
318,WOLB.0323.00132,1,938039,939375,+,1336
318,WOLB.0323.00143,1,276827,278115,-,1288
318,WOLB.0323.00106,1,276829,278117,-,1288
318,WOLB.0323.00121,1,1223690,1225019,+,1329
318,WOLB.0323.00135,1,677577,678913,-,1336
318,WOLB.0323.00103,1,1087692,1089028,+,1336
318,WOLB.0323.00107,1,1086257,1087593,+,1336
318,WOLB.0323.00019,1,310455,311791,-,1336
318,WOLB.0323.00060,1,965731,967060,+,1329
318,WOLB.0323.00074,1,1293185,1294492,-,1307
318,WOLB.0323.00120,1,1285460,1286767,-,1307
318,WOLB.0323.00039,1,1095854,1097190,-,1336
318,WOLB.0323.00041,1,363701,365008,+,1307
318,WOLB.0323.00031,1,509196,510484,+,1288
318,WOLB.0323.00056,1,1010785,1012114,+,1329
318,WOLB.0323.00142,1,1102634,1103963,+,1329
318,WOLB.0323.00023,1,583703,585039,+,1336
318,WOLB.0323.00153,1,1030328,1031657,+,1329
318,WOLB.0323.00093,1,568533,569869,-,1336
318,WOLB.0323.00088,1,1049254,1050583,+,1329
318,WOLB.0323.00008,1,288181,289517,-,1336
318,WOLB.0323.00024,1,394009,395345,+,1336
318,WOLB.0323.00064,1,846694,848030,+,1336
318,WOLB.0323.00030,1,1460329,1461665,+,1336
318,WOLB.0323.00105,1,1087699,1089035,+,1336
318,WOLB.0323.00133,1,1048388,1049701,-,1313
318,WOLB.0323.00084,1,983274,984603,-,1329
318,WOLB.0323.00021,1,1379421,1380750,+,1329
318,WOLB.0323.00043,1,1339779,1341115,+,1336
318,WOLB.0323.00020,1,991315,992644,+,1329
318,WOLB.0323.00122,1,477278,478607,-,1329
318,WOLB.0323.00118,1,877714,879043,+,1329
318,WOLB.0323.00004,1,1099547,1100876,+,1329
318,WOLB.0323.00011,1,467909,469238,+,1329
318,WOLB.0323.00035,1,986996,988325,+,1329
318,WOLB.0323.00032,1,559155,560484,+,1329
318,WOLB.0323.00012,1,1053365,1054694,+,1329
318,WOLB.0323.00018,1,1101302,1102638,+,1336
318,WOLB.0323.00025,1,745291,746598,+,1307
318,WOLB.0323.00010,1,1392320,1393656,+,1336
318,WOLB.0323.00068,1,859075,860404,+,1329
318,WOLB.0323.00128,1,1247279,1248615,+,1336
318,WOLB.0323.00158,1,375688,377017,+,1329
318,WOLB.0323.00017,1,1088263,1089592,+,1329
318,WOLB.0323.00104,1,1027091,1028420,+,1329
318,WOLB.0323.00007,1,271919,273248,-,1329
318,WOLB.0323.00001,1,1087699,1089035,+,1336
318,WOLB.0323.00100,1,1371796,1373125,+,1329
318,WOLB.0323.00070,1,1579193,1580529,+,1336
318,WOLB.0323.00006,1,881181,882469,-,1288
318,WOLB.0323.00042,1,1419197,1420533,-,1336
318,WOLB.0323.00119,1,310340,311676,-,1336
318,WOLB.0323.00149,1,743889,745218,-,1329
318,WOLB.0323.00014,1,1592209,1593545,+,1336
318,WOLB.0323.00096,1,375556,376863,+,1307
319,WOLB.0323.00090,1,958478,959993,+,1515
319,WOLB.0323.00002,1,1261957,1263472,+,1515
319,WOLB.0323.00138,1,886297,887811,-,1514
319,WOLB.0323.00132,1,939376,940891,+,1515
319,WOLB.0323.00143,1,275311,276825,-,1514
319,WOLB.0323.00106,1,275313,276827,-,1514
319,WOLB.0323.00121,1,1225020,1226535,+,1515
319,WOLB.0323.00135,1,676076,677575,-,1499
319,WOLB.0323.00103,1,1089029,1090545,+,1516
319,WOLB.0323.00107,1,1087594,1089110,+,1516
319,WOLB.0323.00019,1,308939,310453,-,1514
319,WOLB.0323.00060,1,967061,968576,+,1515
319,WOLB.0323.00074,1,1291668,1293183,-,1515
319,WOLB.0323.00120,1,1283943,1285458,-,1515
319,WOLB.0323.00039,1,1094338,1095852,-,1514
319,WOLB.0323.00041,1,365009,366525,+,1516
319,WOLB.0323.00031,1,510485,512000,+,1515
319,WOLB.0323.00056,1,1012115,1013630,+,1515
319,WOLB.0323.00142,1,1103964,1105479,+,1515
319,WOLB.0323.00023,1,585040,586555,+,1515
319,WOLB.0323.00153,1,1031658,1033173,+,1515
319,WOLB.0323.00093,1,567017,568531,-,1514
319,WOLB.0323.00088,1,1050584,1052099,+,1515
319,WOLB.0323.00008,1,286664,288179,-,1515
319,WOLB.0323.00024,1,398497,400008,+,1511
319,WOLB.0323.00064,1,848031,849546,+,1515
319,WOLB.0323.00030,1,1461666,1463181,+,1515
319,WOLB.0323.00105,1,1089036,1090552,+,1516
319,WOLB.0323.00133,1,1046849,1048381,-,1532
319,WOLB.0323.00084,1,981758,983272,-,1514
319,WOLB.0323.00021,1,1380751,1382266,+,1515
319,WOLB.0323.00043,1,1341116,1342631,+,1515
319,WOLB.0323.00020,1,992645,994160,+,1515
319,WOLB.0323.00122,1,475762,477276,-,1514
319,WOLB.0323.00118,1,879044,880559,+,1515
319,WOLB.0323.00004,1,1100877,1102392,+,1515
319,WOLB.0323.00011,1,469239,470754,+,1515
319,WOLB.0323.00035,1,988326,989841,+,1515
319,WOLB.0323.00032,1,560485,562000,+,1515
319,WOLB.0323.00012,1,1054695,1056210,+,1515
319,WOLB.0323.00018,1,1102639,1104172,+,1533
319,WOLB.0323.00025,1,746599,748113,+,1514
319,WOLB.0323.00010,1,1393657,1395172,+,1515
319,WOLB.0323.00068,1,860405,861920,+,1515
319,WOLB.0323.00128,1,1248616,1250131,+,1515
319,WOLB.0323.00158,1,377018,378533,+,1515
319,WOLB.0323.00017,1,1089593,1091108,+,1515
319,WOLB.0323.00104,1,1028421,1029936,+,1515
319,WOLB.0323.00007,1,270403,271917,-,1514
319,WOLB.0323.00001,1,1089036,1090552,+,1516
319,WOLB.0323.00100,1,1373126,1374641,+,1515
319,WOLB.0323.00070,1,1580530,1582045,+,1515
319,WOLB.0323.00006,1,879665,881179,-,1514
319,WOLB.0323.00042,1,1417681,1419195,-,1514
319,WOLB.0323.00119,1,308824,310338,-,1514
319,WOLB.0323.00149,1,742373,743887,-,1514
319,WOLB.0323.00014,1,1593546,1595061,+,1515
319,WOLB.0323.00096,1,376864,378380,+,1516
320,WOLB.0323.00090,1,962891,963431,+,540
320,WOLB.0323.00002,1,1266037,1266577,+,540
320,WOLB.0323.00138,1,883138,883677,-,539
320,WOLB.0323.00132,1,943295,943835,+,540
320,WOLB.0323.00121,1,1229154,1229694,+,540
320,WOLB.0323.00135,1,672868,673407,-,539
320,WOLB.0323.00103,1,1093153,1093688,+,535
320,WOLB.0323.00107,1,1091718,1092253,+,535
320,WOLB.0323.00060,1,971197,971737,+,540
320,WOLB.0323.00074,1,1288458,1288997,-,539
320,WOLB.0323.00120,1,1280733,1281272,-,539
320,WOLB.0323.00041,1,369195,369735,+,540
320,WOLB.0323.00056,1,1016249,1016789,+,540
320,WOLB.0323.00142,1,1108098,1108638,+,540
320,WOLB.0323.00023,1,588967,589507,+,540
320,WOLB.0323.00153,1,1036070,1036610,+,540
320,WOLB.0323.00093,1,562744,563283,-,539
320,WOLB.0323.00088,1,1054740,1055280,+,540
320,WOLB.0323.00008,1,283521,284060,-,539
320,WOLB.0323.00024,1,402412,402952,+,540
320,WOLB.0323.00064,1,852187,852727,+,540
320,WOLB.0323.00030,1,1465823,1466363,+,540
320,WOLB.0323.00105,1,1093160,1093695,+,535
320,WOLB.0323.00084,1,978599,979138,-,539
320,WOLB.0323.00021,1,1384885,1385425,+,540
320,WOLB.0323.00043,1,1345196,1345736,+,540
320,WOLB.0323.00020,1,996801,997341,+,540
320,WOLB.0323.00122,1,471404,471943,-,539
320,WOLB.0323.00004,1,1105011,1105551,+,540
320,WOLB.0323.00011,1,473373,473913,+,540
320,WOLB.0323.00035,1,992482,993022,+,540
320,WOLB.0323.00032,1,564619,565159,+,540
320,WOLB.0323.00012,1,1058851,1059391,+,540
320,WOLB.0323.00018,1,1106945,1107485,+,540
320,WOLB.0323.00010,1,1397965,1398505,+,540
320,WOLB.0323.00068,1,864539,865079,+,540
320,WOLB.0323.00128,1,1252696,1253236,+,540
320,WOLB.0323.00158,1,1171076,1171615,-,539
320,WOLB.0323.00017,1,1093727,1094267,+,540
320,WOLB.0323.00104,1,1032577,1033117,+,540
320,WOLB.0323.00007,1,267244,267783,-,539
320,WOLB.0323.00001,1,1093160,1093695,+,535
320,WOLB.0323.00100,1,1377282,1377822,+,540
320,WOLB.0323.00070,1,1584610,1585150,+,540
320,WOLB.0323.00042,1,1414524,1415063,-,539
320,WOLB.0323.00149,1,739214,739753,-,539
320,WOLB.0323.00014,1,1597626,1598166,+,540
320,WOLB.0323.00096,1,381050,381590,+,540
321,WOLB.0323.00090,1,964220,966438,+,2218
321,WOLB.0323.00002,1,1267343,1269547,+,2204
321,WOLB.0323.00138,1,880139,882372,-,2233
321,WOLB.0323.00132,1,944601,946813,+,2212
321,WOLB.0323.00143,1,269039,271245,-,2206
321,WOLB.0323.00106,1,269041,271247,-,2206
321,WOLB.0323.00121,1,1230465,1232695,+,2230
321,WOLB.0323.00135,1,669867,672085,-,2218
321,WOLB.0323.00103,1,1094533,1096740,+,2207
321,WOLB.0323.00107,1,1093098,1095305,+,2207
321,WOLB.0323.00019,1,302838,305040,-,2202
321,WOLB.0323.00060,1,972520,974738,+,2218
321,WOLB.0323.00074,1,1285444,1287646,-,2202
321,WOLB.0323.00120,1,1277719,1279921,-,2202
321,WOLB.0323.00039,1,1088238,1090440,-,2202
321,WOLB.0323.00041,1,370547,372749,+,2202
321,WOLB.0323.00031,1,516066,518272,+,2206
321,WOLB.0323.00056,1,1017572,1019790,+,2218
321,WOLB.0323.00142,1,1109409,1111639,+,2230
321,WOLB.0323.00023,1,590273,592508,+,2235
321,WOLB.0323.00153,1,1037399,1039617,+,2218
321,WOLB.0323.00093,1,559766,561978,-,2212
321,WOLB.0323.00088,1,1056063,1058281,+,2218
321,WOLB.0323.00008,1,280550,282714,-,2164
321,WOLB.0323.00024,1,403718,405930,+,2212
321,WOLB.0323.00064,1,853493,855705,+,2212
321,WOLB.0323.00030,1,1467129,1469341,+,2212
321,WOLB.0323.00105,1,1094540,1096747,+,2207
321,WOLB.0323.00133,1,1040781,1042991,-,2210
321,WOLB.0323.00084,1,975600,977833,-,2233
321,WOLB.0323.00021,1,1386191,1388424,+,2233
321,WOLB.0323.00043,1,1346502,1348706,+,2204
321,WOLB.0323.00020,1,998124,1000342,+,2218
321,WOLB.0323.00122,1,468397,470615,-,2218
321,WOLB.0323.00118,1,884573,886791,+,2218
321,WOLB.0323.00004,1,1106322,1108552,+,2230
321,WOLB.0323.00011,1,474684,476914,+,2230
321,WOLB.0323.00035,1,993805,996023,+,2218
321,WOLB.0323.00032,1,565925,568158,+,2233
321,WOLB.0323.00012,1,1060174,1062392,+,2218
321,WOLB.0323.00018,1,1108258,1110464,+,2206
321,WOLB.0323.00025,1,444685,446891,-,2206
321,WOLB.0323.00010,1,1399275,1401478,+,2203
321,WOLB.0323.00068,1,865845,868078,+,2233
321,WOLB.0323.00128,1,1254002,1256206,+,2204
321,WOLB.0323.00158,1,1168075,1170305,-,2230
321,WOLB.0323.00017,1,1095038,1097268,+,2230
321,WOLB.0323.00104,1,1033900,1036118,+,2218
321,WOLB.0323.00007,1,264243,266461,-,2218
321,WOLB.0323.00001,1,1094540,1096747,+,2207
321,WOLB.0323.00100,1,1378605,1380823,+,2218
321,WOLB.0323.00070,1,1585916,1588120,+,2204
321,WOLB.0323.00006,1,873391,875599,-,2208
321,WOLB.0323.00042,1,1411533,1413743,-,2210
321,WOLB.0323.00119,1,302723,304925,-,2202
321,WOLB.0323.00149,1,736213,738443,-,2230
321,WOLB.0323.00014,1,1600284,1602488,+,2204
321,WOLB.0323.00096,1,382402,384604,+,2202
322,WOLB.0323.00090,1,967626,974602,+,6976
322,WOLB.0323.00002,1,1270519,1277498,+,6979
322,WOLB.0323.00138,1,871975,878951,-,6976
322,WOLB.0323.00132,1,947803,954782,+,6979
322,WOLB.0323.00143,1,260824,267794,-,6970
322,WOLB.0323.00106,1,260826,267796,-,6970
322,WOLB.0323.00121,1,1233887,1240865,+,6978
322,WOLB.0323.00135,1,635185,642153,+,6968
322,WOLB.0323.00103,1,1100812,1107785,+,6973
322,WOLB.0323.00107,1,1099372,1106344,+,6972
322,WOLB.0323.00019,1,294845,301836,-,6991
322,WOLB.0323.00060,1,976917,983896,+,6979
322,WOLB.0323.00074,1,1277492,1284479,-,6987
322,WOLB.0323.00120,1,1269767,1276754,-,6987
322,WOLB.0323.00039,1,1080245,1087236,-,6991
322,WOLB.0323.00041,1,373714,380701,+,6987
322,WOLB.0323.00031,1,519517,526487,+,6970
322,WOLB.0323.00056,1,1049700,1056679,-,6979
322,WOLB.0323.00142,1,1112831,1119809,+,6978
322,WOLB.0323.00023,1,593479,600458,+,6979
322,WOLB.0323.00153,1,1040805,1047781,+,6976
322,WOLB.0323.00093,1,551568,558544,-,6976
322,WOLB.0323.00088,1,1060555,1067534,+,6979
322,WOLB.0323.00008,1,1083225,1090201,-,6976
322,WOLB.0323.00024,1,705390,712369,+,6979
322,WOLB.0323.00064,1,856945,863924,+,6979
322,WOLB.0323.00030,1,1470581,1477560,+,6979
322,WOLB.0323.00105,1,1100819,1107792,+,6973
322,WOLB.0323.00133,1,1032801,1039779,-,6978
322,WOLB.0323.00084,1,967436,974412,-,6976
322,WOLB.0323.00021,1,1389612,1396588,+,6976
322,WOLB.0323.00043,1,1349678,1356657,+,6979
322,WOLB.0323.00020,1,1028604,1035583,-,6979
322,WOLB.0323.00122,1,460234,467209,-,6975
322,WOLB.0323.00118,1,887983,894962,+,6979
322,WOLB.0323.00004,1,1109744,1116722,+,6978
322,WOLB.0323.00011,1,478106,485084,+,6978
322,WOLB.0323.00035,1,998297,1005276,+,6979
322,WOLB.0323.00032,1,569346,576322,+,6976
322,WOLB.0323.00012,1,1064666,1071645,+,6979
322,WOLB.0323.00018,1,1111434,1118419,+,6985
322,WOLB.0323.00025,1,551771,558738,-,6967
322,WOLB.0323.00010,1,1402449,1409428,+,6979
322,WOLB.0323.00068,1,869266,876242,+,6976
322,WOLB.0323.00128,1,1257178,1264157,+,6979
322,WOLB.0323.00158,1,1159905,1166883,-,6978
322,WOLB.0323.00017,1,1098460,1105438,+,6978
322,WOLB.0323.00104,1,1038392,1045371,+,6979
322,WOLB.0323.00007,1,231840,238792,+,6952
322,WOLB.0323.00001,1,1100819,1107792,+,6973
322,WOLB.0323.00100,1,1383097,1390076,+,6979
322,WOLB.0323.00070,1,1589092,1596071,+,6979
322,WOLB.0323.00006,1,865178,872148,-,6970
322,WOLB.0323.00042,1,1403558,1410537,-,6979
322,WOLB.0323.00119,1,294730,301721,-,6991
322,WOLB.0323.00149,1,728043,735021,-,6978
322,WOLB.0323.00014,1,1603460,1610439,+,6979
322,WOLB.0323.00096,1,385569,392556,+,6987
323,WOLB.0323.00090,1,974678,975751,+,1073
323,WOLB.0323.00002,1,1277574,1278647,+,1073
323,WOLB.0323.00138,1,870826,871899,-,1073
323,WOLB.0323.00132,1,954858,955931,+,1073
323,WOLB.0323.00143,1,259672,260748,-,1076
323,WOLB.0323.00106,1,259674,260750,-,1076
323,WOLB.0323.00121,1,1240941,1242014,+,1073
323,WOLB.0323.00135,1,642229,643302,+,1073
323,WOLB.0323.00103,1,1108844,1109917,+,1073
323,WOLB.0323.00107,1,1107403,1108476,+,1073
323,WOLB.0323.00019,1,293703,294766,-,1063
323,WOLB.0323.00060,1,983972,985045,+,1073
323,WOLB.0323.00074,1,1276339,1277416,-,1077
323,WOLB.0323.00120,1,1268614,1269691,-,1077
323,WOLB.0323.00039,1,1079103,1080166,-,1063
323,WOLB.0323.00041,1,380777,381854,+,1077
323,WOLB.0323.00031,1,526563,527639,+,1076
323,WOLB.0323.00056,1,1048551,1049624,-,1073
323,WOLB.0323.00142,1,1119885,1120958,+,1073
323,WOLB.0323.00023,1,600534,601607,+,1073
323,WOLB.0323.00153,1,1047857,1048930,+,1073
323,WOLB.0323.00093,1,550419,551492,-,1073
323,WOLB.0323.00088,1,1067610,1068683,+,1073
323,WOLB.0323.00008,1,1082076,1083149,-,1073
323,WOLB.0323.00024,1,712445,713518,+,1073
323,WOLB.0323.00064,1,864000,865073,+,1073
323,WOLB.0323.00030,1,1477636,1478709,+,1073
323,WOLB.0323.00105,1,1108851,1109924,+,1073
323,WOLB.0323.00133,1,1031652,1032725,-,1073
323,WOLB.0323.00084,1,966287,967360,-,1073
323,WOLB.0323.00021,1,1396664,1397737,+,1073
323,WOLB.0323.00043,1,1356733,1357806,+,1073
323,WOLB.0323.00020,1,1027455,1028528,-,1073
323,WOLB.0323.00122,1,459085,460158,-,1073
323,WOLB.0323.00118,1,895038,896111,+,1073
323,WOLB.0323.00004,1,1116798,1117871,+,1073
323,WOLB.0323.00011,1,485160,486233,+,1073
323,WOLB.0323.00035,1,1005352,1006425,+,1073
323,WOLB.0323.00032,1,576398,577471,+,1073
323,WOLB.0323.00012,1,1071721,1072794,+,1073
323,WOLB.0323.00018,1,1118495,1119568,+,1073
323,WOLB.0323.00025,1,550610,551582,-,972
323,WOLB.0323.00010,1,1409520,1410576,+,1056
323,WOLB.0323.00068,1,876318,877391,+,1073
323,WOLB.0323.00128,1,1264233,1265306,+,1073
323,WOLB.0323.00158,1,1158756,1159829,-,1073
323,WOLB.0323.00017,1,1105514,1106587,+,1073
323,WOLB.0323.00104,1,1045447,1046520,+,1073
323,WOLB.0323.00007,1,238868,239941,+,1073
323,WOLB.0323.00001,1,1108851,1109924,+,1073
323,WOLB.0323.00100,1,1390152,1391225,+,1073
323,WOLB.0323.00070,1,1596147,1597220,+,1073
323,WOLB.0323.00006,1,864026,865102,-,1076
323,WOLB.0323.00042,1,1402409,1403482,-,1073
323,WOLB.0323.00119,1,293588,294651,-,1063
323,WOLB.0323.00149,1,726894,727967,-,1073
323,WOLB.0323.00014,1,1610515,1611588,+,1073
323,WOLB.0323.00096,1,392632,393709,+,1077
324,WOLB.0323.00090,1,976879,978667,+,1788
324,WOLB.0323.00002,1,1279776,1281567,+,1791
324,WOLB.0323.00138,1,867888,869676,-,1788
324,WOLB.0323.00132,1,957051,958838,+,1787
324,WOLB.0323.00143,1,256465,258253,-,1788
324,WOLB.0323.00106,1,256467,258255,-,1788
324,WOLB.0323.00121,1,1243142,1244929,+,1787
324,WOLB.0323.00135,1,644430,646217,+,1787
324,WOLB.0323.00103,1,1111057,1112845,+,1788
324,WOLB.0323.00107,1,1109616,1111404,+,1788
324,WOLB.0323.00019,1,290758,292556,-,1798
324,WOLB.0323.00060,1,986174,987962,+,1788
324,WOLB.0323.00074,1,1273419,1275210,-,1791
324,WOLB.0323.00120,1,1265694,1267485,-,1791
324,WOLB.0323.00039,1,1076168,1077957,-,1789
324,WOLB.0323.00041,1,382983,384774,+,1791
324,WOLB.0323.00031,1,529058,530846,+,1788
324,WOLB.0323.00056,1,1045634,1047422,-,1788
324,WOLB.0323.00142,1,1122086,1123873,+,1787
324,WOLB.0323.00023,1,602736,604524,+,1788
324,WOLB.0323.00153,1,1050058,1051846,+,1788
324,WOLB.0323.00093,1,547213,549000,-,1787
324,WOLB.0323.00088,1,1069811,1071598,+,1787
324,WOLB.0323.00008,1,1077768,1079556,-,1788
324,WOLB.0323.00024,1,716051,717839,+,1788
324,WOLB.0323.00064,1,866471,868258,+,1787
324,WOLB.0323.00030,1,1480107,1481894,+,1787
324,WOLB.0323.00105,1,1111064,1112852,+,1788
324,WOLB.0323.00133,1,1028743,1030531,-,1788
324,WOLB.0323.00084,1,963371,965159,-,1788
324,WOLB.0323.00021,1,1398865,1400653,+,1788
324,WOLB.0323.00043,1,1358935,1360726,+,1791
324,WOLB.0323.00020,1,1024540,1026327,-,1787
324,WOLB.0323.00122,1,456170,457957,-,1787
324,WOLB.0323.00118,1,897238,899026,+,1788
324,WOLB.0323.00004,1,1118999,1120786,+,1787
324,WOLB.0323.00011,1,487361,489148,+,1787
324,WOLB.0323.00035,1,1007553,1009340,+,1787
324,WOLB.0323.00032,1,578599,580386,+,1787
324,WOLB.0323.00012,1,1073922,1075709,+,1787
324,WOLB.0323.00018,1,1120682,1122472,+,1790
324,WOLB.0323.00025,1,984645,986413,-,1768
324,WOLB.0323.00010,1,1411705,1413496,+,1791
324,WOLB.0323.00068,1,878519,880307,+,1788
324,WOLB.0323.00128,1,1266435,1268262,+,1827
324,WOLB.0323.00158,1,1155841,1157628,-,1787
324,WOLB.0323.00017,1,1107715,1109502,+,1787
324,WOLB.0323.00104,1,1047648,1049435,+,1787
324,WOLB.0323.00007,1,241070,242858,+,1788
324,WOLB.0323.00001,1,1111064,1112852,+,1788
324,WOLB.0323.00100,1,1392353,1394140,+,1787
324,WOLB.0323.00070,1,1598349,1600140,+,1791
324,WOLB.0323.00006,1,860820,862608,-,1788
324,WOLB.0323.00042,1,1399489,1401280,-,1791
324,WOLB.0323.00119,1,290643,292441,-,1798
324,WOLB.0323.00149,1,723979,725766,-,1787
324,WOLB.0323.00014,1,1612717,1614508,+,1791
324,WOLB.0323.00096,1,394838,396629,+,1791
325,WOLB.0323.00090,1,979023,981684,+,2661
325,WOLB.0323.00002,1,1281923,1284584,+,2661
325,WOLB.0323.00138,1,864871,867532,-,2661
325,WOLB.0323.00132,1,959194,962080,+,2886
325,WOLB.0323.00143,1,253450,256109,-,2659
325,WOLB.0323.00106,1,253452,256111,-,2659
325,WOLB.0323.00121,1,1245285,1247946,+,2661
325,WOLB.0323.00135,1,648558,651198,+,2640
325,WOLB.0323.00103,1,1113201,1116087,+,2886
325,WOLB.0323.00107,1,1111760,1114646,+,2886
325,WOLB.0323.00019,1,287516,290402,-,2886
325,WOLB.0323.00060,1,988318,990979,+,2661
325,WOLB.0323.00074,1,1270403,1273063,-,2660
325,WOLB.0323.00120,1,1262678,1265338,-,2660
325,WOLB.0323.00039,1,1072926,1075812,-,2886
325,WOLB.0323.00041,1,385130,387790,+,2660
325,WOLB.0323.00031,1,531202,533861,+,2659
325,WOLB.0323.00056,1,1042617,1045278,-,2661
325,WOLB.0323.00142,1,1124229,1126890,+,2661
325,WOLB.0323.00023,1,604880,607541,+,2661
325,WOLB.0323.00153,1,1052203,1054863,+,2660
325,WOLB.0323.00093,1,543971,546857,-,2886
325,WOLB.0323.00088,1,1071954,1074841,+,2887
325,WOLB.0323.00008,1,1074751,1077412,-,2661
325,WOLB.0323.00024,1,718195,720862,+,2667
325,WOLB.0323.00064,1,868614,871275,+,2661
325,WOLB.0323.00030,1,1482250,1484911,+,2661
325,WOLB.0323.00105,1,1113208,1116094,+,2886
325,WOLB.0323.00133,1,1025726,1028387,-,2661
325,WOLB.0323.00084,1,960354,963015,-,2661
325,WOLB.0323.00021,1,1401009,1403670,+,2661
325,WOLB.0323.00043,1,1361082,1363743,+,2661
325,WOLB.0323.00020,1,1021297,1024184,-,2887
325,WOLB.0323.00122,1,453153,455814,-,2661
325,WOLB.0323.00118,1,899382,902043,+,2661
325,WOLB.0323.00004,1,1121142,1123803,+,2661
325,WOLB.0323.00011,1,489504,492165,+,2661
325,WOLB.0323.00035,1,1009696,1012583,+,2887
325,WOLB.0323.00032,1,580742,583403,+,2661
325,WOLB.0323.00012,1,1076065,1078952,+,2887
325,WOLB.0323.00018,1,1122828,1125495,+,2667
325,WOLB.0323.00025,1,343263,345922,-,2659
325,WOLB.0323.00010,1,1413852,1416513,+,2661
325,WOLB.0323.00068,1,880663,883324,+,2661
325,WOLB.0323.00128,1,1268618,1271279,+,2661
325,WOLB.0323.00158,1,1152824,1155485,-,2661
325,WOLB.0323.00017,1,1109858,1112519,+,2661
325,WOLB.0323.00104,1,1049791,1052678,+,2887
325,WOLB.0323.00007,1,243214,245875,+,2661
325,WOLB.0323.00001,1,1113208,1116094,+,2886
325,WOLB.0323.00100,1,1394496,1397383,+,2887
325,WOLB.0323.00070,1,1600496,1603157,+,2661
325,WOLB.0323.00006,1,857805,860464,-,2659
325,WOLB.0323.00042,1,1396472,1399133,-,2661
325,WOLB.0323.00119,1,287401,290287,-,2886
325,WOLB.0323.00149,1,720962,723623,-,2661
325,WOLB.0323.00014,1,1614864,1617525,+,2661
325,WOLB.0323.00096,1,396985,399645,+,2660
326,WOLB.0323.00090,1,982180,982890,+,710
326,WOLB.0323.00002,1,1285149,1285859,+,710
326,WOLB.0323.00138,1,863664,864375,-,711
326,WOLB.0323.00132,1,962645,963355,+,710
326,WOLB.0323.00143,1,252174,252866,-,692
326,WOLB.0323.00106,1,252176,252868,-,692
326,WOLB.0323.00121,1,1248442,1249152,+,710
326,WOLB.0323.00135,1,651763,652473,+,710
326,WOLB.0323.00103,1,1116585,1117293,+,708
326,WOLB.0323.00107,1,1115144,1115852,+,708
326,WOLB.0323.00019,1,286240,286932,-,692
326,WOLB.0323.00060,1,991475,992184,+,709
326,WOLB.0323.00074,1,1269127,1269838,-,711
326,WOLB.0323.00120,1,1261402,1262113,-,711
326,WOLB.0323.00039,1,1071650,1072342,-,692
326,WOLB.0323.00041,1,388355,389065,+,710
326,WOLB.0323.00031,1,534445,535136,+,691
326,WOLB.0323.00056,1,1041410,1042121,-,711
326,WOLB.0323.00142,1,1127386,1128096,+,710
326,WOLB.0323.00023,1,608037,608747,+,710
326,WOLB.0323.00153,1,1055359,1056069,+,710
326,WOLB.0323.00093,1,542695,543406,-,711
326,WOLB.0323.00088,1,1075406,1076116,+,710
326,WOLB.0323.00008,1,1073475,1074186,-,711
326,WOLB.0323.00024,1,721427,722137,+,710
326,WOLB.0323.00064,1,871771,872481,+,710
326,WOLB.0323.00030,1,1485407,1486117,+,710
326,WOLB.0323.00105,1,1116592,1117300,+,708
326,WOLB.0323.00133,1,1024508,1025161,-,653
326,WOLB.0323.00084,1,959147,959858,-,711
326,WOLB.0323.00021,1,1404166,1404876,+,710
326,WOLB.0323.00043,1,1364308,1365018,+,710
326,WOLB.0323.00020,1,1020021,1020732,-,711
326,WOLB.0323.00122,1,451946,452657,-,711
326,WOLB.0323.00118,1,902539,903249,+,710
326,WOLB.0323.00004,1,1124299,1125009,+,710
326,WOLB.0323.00011,1,492661,493371,+,710
326,WOLB.0323.00035,1,1013148,1013858,+,710
326,WOLB.0323.00032,1,583899,584609,+,710
326,WOLB.0323.00012,1,1079517,1080227,+,710
326,WOLB.0323.00018,1,1126060,1126770,+,710
326,WOLB.0323.00010,1,1417078,1417788,+,710
326,WOLB.0323.00068,1,883820,884530,+,710
326,WOLB.0323.00128,1,1271844,1272554,+,710
326,WOLB.0323.00158,1,1151617,1152328,-,711
326,WOLB.0323.00017,1,1113015,1113725,+,710
326,WOLB.0323.00104,1,1053243,1053953,+,710
326,WOLB.0323.00007,1,246371,247081,+,710
326,WOLB.0323.00001,1,1116592,1117300,+,708
326,WOLB.0323.00100,1,1397948,1398658,+,710
326,WOLB.0323.00070,1,1603722,1604432,+,710
326,WOLB.0323.00006,1,856529,857221,-,692
326,WOLB.0323.00042,1,1395265,1395976,-,711
326,WOLB.0323.00119,1,286125,286817,-,692
326,WOLB.0323.00149,1,719755,720466,-,711
326,WOLB.0323.00014,1,1618090,1618800,+,710
326,WOLB.0323.00096,1,400210,400920,+,710
327,WOLB.0323.00090,1,983255,984722,+,1467
327,WOLB.0323.00002,1,1286224,1287705,+,1481
327,WOLB.0323.00138,1,861831,863300,-,1469
327,WOLB.0323.00132,1,963717,965185,+,1468
327,WOLB.0323.00143,1,250338,251813,-,1475
327,WOLB.0323.00106,1,250340,251815,-,1475
327,WOLB.0323.00121,1,1249517,1250985,+,1468
327,WOLB.0323.00135,1,652835,654302,+,1467
327,WOLB.0323.00103,1,1117655,1119122,+,1467
327,WOLB.0323.00107,1,1116214,1117682,+,1468
327,WOLB.0323.00019,1,284397,285879,-,1482
327,WOLB.0323.00060,1,992549,994016,+,1467
327,WOLB.0323.00074,1,1267298,1268766,-,1468
327,WOLB.0323.00120,1,1259573,1261041,-,1468
327,WOLB.0323.00039,1,1069807,1071289,-,1482
327,WOLB.0323.00041,1,389427,390894,+,1467
327,WOLB.0323.00031,1,535498,536973,+,1475
327,WOLB.0323.00056,1,1039565,1041046,-,1481
327,WOLB.0323.00142,1,1128461,1129929,+,1468
327,WOLB.0323.00023,1,609109,610577,+,1468
327,WOLB.0323.00153,1,1056434,1057901,+,1467
327,WOLB.0323.00093,1,540883,542331,-,1448
327,WOLB.0323.00088,1,1076478,1077945,+,1467
327,WOLB.0323.00008,1,1071662,1073111,-,1449
327,WOLB.0323.00024,1,722502,723970,+,1468
327,WOLB.0323.00064,1,872843,874311,+,1468
327,WOLB.0323.00030,1,1486479,1487947,+,1468
327,WOLB.0323.00105,1,1117662,1119129,+,1467
327,WOLB.0323.00133,1,1013923,1015375,-,1452
327,WOLB.0323.00084,1,957314,958783,-,1469
327,WOLB.0323.00021,1,1405241,1406709,+,1468
327,WOLB.0323.00043,1,1365383,1366864,+,1481
327,WOLB.0323.00020,1,1018192,1019660,-,1468
327,WOLB.0323.00122,1,450117,451585,-,1468
327,WOLB.0323.00118,1,903614,905089,+,1475
327,WOLB.0323.00004,1,1125374,1126842,+,1468
327,WOLB.0323.00011,1,493736,495204,+,1468
327,WOLB.0323.00035,1,1014220,1015687,+,1467
327,WOLB.0323.00032,1,584974,586442,+,1468
327,WOLB.0323.00012,1,1080589,1082056,+,1467
327,WOLB.0323.00018,1,1127132,1128612,+,1480
327,WOLB.0323.00025,1,829927,831400,+,1473
327,WOLB.0323.00010,1,1418153,1419634,+,1481
327,WOLB.0323.00068,1,884895,886363,+,1468
327,WOLB.0323.00128,1,1272919,1274400,+,1481
327,WOLB.0323.00158,1,1149784,1151253,-,1469
327,WOLB.0323.00017,1,1114090,1115558,+,1468
327,WOLB.0323.00104,1,1054315,1055782,+,1467
327,WOLB.0323.00007,1,247446,248913,+,1467
327,WOLB.0323.00001,1,1117662,1119129,+,1467
327,WOLB.0323.00100,1,1399020,1400487,+,1467
327,WOLB.0323.00070,1,1604797,1606278,+,1481
327,WOLB.0323.00006,1,854703,856177,-,1474
327,WOLB.0323.00042,1,1393435,1394904,-,1469
327,WOLB.0323.00119,1,284282,285764,-,1482
327,WOLB.0323.00149,1,717922,719391,-,1469
327,WOLB.0323.00014,1,1619165,1620646,+,1481
327,WOLB.0323.00096,1,401282,402749,+,1467
328,WOLB.0323.00090,1,990909,991780,+,871
328,WOLB.0323.00002,1,1296221,1297092,+,871
328,WOLB.0323.00138,1,853638,854510,-,872
328,WOLB.0323.00132,1,970874,971745,+,871
328,WOLB.0323.00143,1,239742,240610,-,868
328,WOLB.0323.00106,1,239744,240612,-,868
328,WOLB.0323.00121,1,1258013,1258884,+,871
328,WOLB.0323.00135,1,660611,661482,+,871
328,WOLB.0323.00103,1,1124539,1125401,+,862
328,WOLB.0323.00107,1,1123099,1123961,+,862
328,WOLB.0323.00019,1,277714,278586,-,872
328,WOLB.0323.00060,1,999738,1000609,+,871
328,WOLB.0323.00074,1,1260401,1261273,-,872
328,WOLB.0323.00120,1,1252676,1253548,-,872
328,WOLB.0323.00039,1,1061928,1062800,-,872
328,WOLB.0323.00041,1,396920,397791,+,871
328,WOLB.0323.00031,1,546701,547568,+,867
328,WOLB.0323.00056,1,1028182,1029054,-,872
328,WOLB.0323.00142,1,1136957,1137828,+,871
328,WOLB.0323.00023,1,1048903,1049777,-,874
328,WOLB.0323.00153,1,1064099,1064970,+,871
328,WOLB.0323.00093,1,532635,533507,-,872
328,WOLB.0323.00088,1,1084407,1085278,+,871
328,WOLB.0323.00008,1,1063939,1064814,+,875
328,WOLB.0323.00024,1,385021,385895,-,874
328,WOLB.0323.00064,1,881028,881899,+,871
328,WOLB.0323.00030,1,257509,258381,-,872
328,WOLB.0323.00105,1,1124546,1125408,+,862
328,WOLB.0323.00133,1,1008362,1009234,-,872
328,WOLB.0323.00084,1,949123,949995,-,872
328,WOLB.0323.00021,1,1413530,1414401,+,871
328,WOLB.0323.00043,1,1373767,1374638,+,871
328,WOLB.0323.00020,1,1008750,1009622,-,872
328,WOLB.0323.00122,1,440390,441262,-,872
328,WOLB.0323.00118,1,912834,913705,+,871
328,WOLB.0323.00004,1,1133870,1134741,+,871
328,WOLB.0323.00011,1,502232,503103,+,871
328,WOLB.0323.00035,1,1022149,1023020,+,871
328,WOLB.0323.00032,1,595133,596004,+,871
328,WOLB.0323.00012,1,1088269,1089140,+,871
328,WOLB.0323.00018,1,1136931,1137805,+,874
328,WOLB.0323.00025,1,621709,622581,-,872
328,WOLB.0323.00010,1,1424964,1425838,+,874
328,WOLB.0323.00068,1,894553,895424,+,871
328,WOLB.0323.00128,1,1279805,1280676,+,871
328,WOLB.0323.00158,1,1140782,1141654,-,872
328,WOLB.0323.00017,1,1122586,1123457,+,871
328,WOLB.0323.00104,1,1062244,1063115,+,871
328,WOLB.0323.00007,1,254979,255850,+,871
328,WOLB.0323.00001,1,1124546,1125408,+,862
328,WOLB.0323.00100,1,1406688,1407559,+,871
328,WOLB.0323.00070,1,1611526,1612397,+,871
328,WOLB.0323.00006,1,746000,746868,-,868
328,WOLB.0323.00042,1,1386089,1386942,-,853
328,WOLB.0323.00119,1,277599,278471,-,872
328,WOLB.0323.00149,1,710023,710895,-,872
328,WOLB.0323.00014,1,1626515,1627386,+,871
328,WOLB.0323.00096,1,408775,409646,+,871
329,WOLB.0323.00090,1,992197,994003,+,1806
329,WOLB.0323.00002,1,1297509,1299301,+,1792
329,WOLB.0323.00138,1,851415,853221,-,1806
329,WOLB.0323.00132,1,972162,973968,+,1806
329,WOLB.0323.00143,1,237519,239325,-,1806
329,WOLB.0323.00106,1,237521,239327,-,1806
329,WOLB.0323.00121,1,1259301,1261107,+,1806
329,WOLB.0323.00135,1,661899,663705,+,1806
329,WOLB.0323.00103,1,1125818,1127624,+,1806
329,WOLB.0323.00107,1,1124378,1126184,+,1806
329,WOLB.0323.00019,1,275491,277297,-,1806
329,WOLB.0323.00060,1,1001026,1002832,+,1806
329,WOLB.0323.00074,1,1258178,1259984,-,1806
329,WOLB.0323.00120,1,1250453,1252259,-,1806
329,WOLB.0323.00039,1,1059705,1061511,-,1806
329,WOLB.0323.00041,1,398208,400014,+,1806
329,WOLB.0323.00031,1,547985,549791,+,1806
329,WOLB.0323.00056,1,1025959,1027765,-,1806
329,WOLB.0323.00142,1,1138245,1140051,+,1806
329,WOLB.0323.00023,1,1046682,1048488,-,1806
329,WOLB.0323.00153,1,1065387,1067193,+,1806
329,WOLB.0323.00093,1,530412,532218,-,1806
329,WOLB.0323.00088,1,1085695,1087501,+,1806
329,WOLB.0323.00008,1,1055112,1056918,-,1806
329,WOLB.0323.00024,1,382800,384606,-,1806
329,WOLB.0323.00064,1,882316,884122,+,1806
329,WOLB.0323.00030,1,255286,257092,-,1806
329,WOLB.0323.00105,1,1125825,1127631,+,1806
329,WOLB.0323.00133,1,1006139,1007945,-,1806
329,WOLB.0323.00084,1,946900,948706,-,1806
329,WOLB.0323.00021,1,1414818,1416624,+,1806
329,WOLB.0323.00043,1,1375055,1376861,+,1806
329,WOLB.0323.00020,1,1006527,1008333,-,1806
329,WOLB.0323.00122,1,438167,439973,-,1806
329,WOLB.0323.00118,1,914122,915928,+,1806
329,WOLB.0323.00004,1,1135158,1136964,+,1806
329,WOLB.0323.00011,1,503520,505342,+,1822
329,WOLB.0323.00035,1,1023437,1025243,+,1806
329,WOLB.0323.00032,1,596421,598227,+,1806
329,WOLB.0323.00012,1,1089557,1091363,+,1806
329,WOLB.0323.00018,1,1138219,1140025,+,1806
329,WOLB.0323.00025,1,619486,621292,-,1806
329,WOLB.0323.00010,1,1426252,1428058,+,1806
329,WOLB.0323.00068,1,895841,897647,+,1806
329,WOLB.0323.00128,1,1281093,1282899,+,1806
329,WOLB.0323.00158,1,1138559,1140365,-,1806
329,WOLB.0323.00017,1,1123874,1125680,+,1806
329,WOLB.0323.00104,1,1063532,1065338,+,1806
329,WOLB.0323.00007,1,256267,258073,+,1806
329,WOLB.0323.00001,1,1125825,1127631,+,1806
329,WOLB.0323.00100,1,1407976,1409782,+,1806
329,WOLB.0323.00070,1,1612814,1614620,+,1806
329,WOLB.0323.00006,1,743777,745583,-,1806
329,WOLB.0323.00042,1,1382922,1384735,-,1813
329,WOLB.0323.00119,1,275376,277182,-,1806
329,WOLB.0323.00149,1,707800,709606,-,1806
329,WOLB.0323.00014,1,1627803,1629609,+,1806
329,WOLB.0323.00096,1,410063,411869,+,1806
330,WOLB.0323.00090,1,994005,997921,+,3916
330,WOLB.0323.00002,1,1299303,1303219,+,3916
330,WOLB.0323.00138,1,847498,851414,-,3916
330,WOLB.0323.00132,1,973970,977886,+,3916
330,WOLB.0323.00143,1,233591,237518,-,3927
330,WOLB.0323.00106,1,233593,237520,-,3927
330,WOLB.0323.00121,1,1261109,1265025,+,3916
330,WOLB.0323.00135,1,663707,667623,+,3916
330,WOLB.0323.00103,1,1127626,1131542,+,3916
330,WOLB.0323.00107,1,1126186,1130102,+,3916
330,WOLB.0323.00019,1,271574,275490,-,3916
330,WOLB.0323.00060,1,1002834,1006750,+,3916
330,WOLB.0323.00074,1,1254266,1258177,-,3911
330,WOLB.0323.00120,1,1246541,1250452,-,3911
330,WOLB.0323.00039,1,1055788,1059704,-,3916
330,WOLB.0323.00041,1,400016,403927,+,3911
330,WOLB.0323.00031,1,549793,553720,+,3927
330,WOLB.0323.00056,1,1022042,1025958,-,3916
330,WOLB.0323.00142,1,1140053,1143969,+,3916
330,WOLB.0323.00023,1,1042765,1046681,-,3916
330,WOLB.0323.00153,1,1067195,1071111,+,3916
330,WOLB.0323.00093,1,526495,530411,-,3916
330,WOLB.0323.00088,1,1087503,1091419,+,3916
330,WOLB.0323.00008,1,1051195,1055111,-,3916
330,WOLB.0323.00024,1,378883,382799,-,3916
330,WOLB.0323.00064,1,884124,888040,+,3916
330,WOLB.0323.00030,1,251369,255285,-,3916
330,WOLB.0323.00105,1,1127633,1131549,+,3916
330,WOLB.0323.00133,1,1002222,1006138,-,3916
330,WOLB.0323.00084,1,942983,946899,-,3916
330,WOLB.0323.00021,1,1416626,1420542,+,3916
330,WOLB.0323.00043,1,1376863,1380779,+,3916
330,WOLB.0323.00020,1,1002610,1006526,-,3916
330,WOLB.0323.00122,1,434250,438166,-,3916
330,WOLB.0323.00118,1,915930,919846,+,3916
330,WOLB.0323.00004,1,1136966,1140882,+,3916
330,WOLB.0323.00011,1,506869,510753,+,3884
330,WOLB.0323.00035,1,1025245,1029161,+,3916
330,WOLB.0323.00032,1,598229,602145,+,3916
330,WOLB.0323.00012,1,1091365,1095281,+,3916
330,WOLB.0323.00018,1,1140027,1143943,+,3916
330,WOLB.0323.00025,1,615558,619485,-,3927
330,WOLB.0323.00010,1,1428060,1431976,+,3916
330,WOLB.0323.00068,1,897649,901565,+,3916
330,WOLB.0323.00128,1,1282901,1286817,+,3916
330,WOLB.0323.00158,1,1134642,1138558,-,3916
330,WOLB.0323.00017,1,1125682,1129598,+,3916
330,WOLB.0323.00104,1,1065340,1069256,+,3916
330,WOLB.0323.00007,1,258075,261991,+,3916
330,WOLB.0323.00001,1,1127633,1131549,+,3916
330,WOLB.0323.00100,1,1409784,1413700,+,3916
330,WOLB.0323.00070,1,1614622,1618538,+,3916
330,WOLB.0323.00006,1,739849,743776,-,3927
330,WOLB.0323.00042,1,1379005,1382921,-,3916
330,WOLB.0323.00119,1,271459,275375,-,3916
330,WOLB.0323.00149,1,703883,707799,-,3916
330,WOLB.0323.00014,1,1629611,1633527,+,3916
330,WOLB.0323.00096,1,411871,415782,+,3911
331,WOLB.0323.00090,1,1000479,1002444,+,1965
331,WOLB.0323.00002,1,1303742,1305707,+,1965
331,WOLB.0323.00138,1,843922,845887,-,1965
331,WOLB.0323.00132,1,978430,980381,+,1951
331,WOLB.0323.00143,1,231082,233040,-,1958
331,WOLB.0323.00106,1,231084,233042,-,1958
331,WOLB.0323.00121,1,1265485,1267450,+,1965
331,WOLB.0323.00135,1,630626,632591,-,1965
331,WOLB.0323.00103,1,1134362,1136256,+,1894
331,WOLB.0323.00107,1,1132921,1134815,+,1894
331,WOLB.0323.00019,1,269092,271057,-,1965
331,WOLB.0323.00060,1,1012017,1013982,+,1965
331,WOLB.0323.00074,1,1250778,1252743,-,1965
331,WOLB.0323.00120,1,1243053,1245018,-,1965
331,WOLB.0323.00039,1,1053306,1055271,-,1965
331,WOLB.0323.00041,1,405450,407415,+,1965
331,WOLB.0323.00031,1,554271,556229,+,1958
331,WOLB.0323.00056,1,1059275,1061240,+,1965
331,WOLB.0323.00142,1,1144429,1146394,+,1965
331,WOLB.0323.00023,1,1040285,1042249,-,1964
331,WOLB.0323.00153,1,1073669,1075634,+,1965
331,WOLB.0323.00093,1,524032,525997,-,1965
331,WOLB.0323.00088,1,1094001,1095966,+,1965
331,WOLB.0323.00008,1,1048708,1050673,-,1965
331,WOLB.0323.00024,1,376403,378353,-,1950
331,WOLB.0323.00064,1,888575,890526,+,1951
331,WOLB.0323.00030,1,248883,250833,-,1950
331,WOLB.0323.00105,1,1134369,1136263,+,1894
331,WOLB.0323.00133,1,999706,1001671,-,1965
331,WOLB.0323.00084,1,939407,941372,-,1965
331,WOLB.0323.00021,1,1422153,1424118,+,1965
331,WOLB.0323.00043,1,1381302,1383267,+,1965
331,WOLB.0323.00020,1,1038171,1040136,+,1965
331,WOLB.0323.00122,1,429620,431585,-,1965
331,WOLB.0323.00118,1,921399,923364,+,1965
331,WOLB.0323.00004,1,1141342,1143307,+,1965
331,WOLB.0323.00011,1,511213,513178,+,1965
331,WOLB.0323.00035,1,1031743,1033708,+,1965
331,WOLB.0323.00032,1,603756,605721,+,1965
331,WOLB.0323.00012,1,1097863,1099828,+,1965
331,WOLB.0323.00018,1,1144664,1146629,+,1965
331,WOLB.0323.00025,1,693960,695910,-,1950
331,WOLB.0323.00010,1,1432492,1434457,+,1965
331,WOLB.0323.00068,1,903176,905141,+,1965
331,WOLB.0323.00128,1,1287340,1289305,+,1965
331,WOLB.0323.00158,1,1132217,1134182,-,1965
331,WOLB.0323.00017,1,1130058,1132023,+,1965
331,WOLB.0323.00104,1,1071838,1073803,+,1965
331,WOLB.0323.00007,1,227279,229244,-,1965
331,WOLB.0323.00001,1,1134369,1136263,+,1894
331,WOLB.0323.00100,1,1416282,1418247,+,1965
331,WOLB.0323.00070,1,1619061,1621026,+,1965
331,WOLB.0323.00006,1,737340,739298,-,1958
331,WOLB.0323.00042,1,1376589,1378554,-,1965
331,WOLB.0323.00119,1,268977,270942,-,1965
331,WOLB.0323.00149,1,701458,703423,-,1965
331,WOLB.0323.00014,1,1634050,1636015,+,1965
331,WOLB.0323.00096,1,417305,419270,+,1965
332,WOLB.0323.00090,1,1002989,1003853,+,864
332,WOLB.0323.00002,1,1306253,1307116,+,863
332,WOLB.0323.00138,1,842513,843377,-,864
332,WOLB.0323.00132,1,980926,981790,+,864
332,WOLB.0323.00143,1,230112,230970,-,858
332,WOLB.0323.00106,1,230114,230972,-,858
332,WOLB.0323.00121,1,1267995,1268859,+,864
332,WOLB.0323.00135,1,629217,630081,-,864
332,WOLB.0323.00103,1,1136370,1137232,+,862
332,WOLB.0323.00107,1,1134929,1135791,+,862
332,WOLB.0323.00019,1,267683,268547,-,864
332,WOLB.0323.00060,1,1014527,1015391,+,864
332,WOLB.0323.00074,1,1249802,1250664,-,862
332,WOLB.0323.00120,1,1242077,1242939,-,862
332,WOLB.0323.00039,1,1051897,1052761,-,864
332,WOLB.0323.00041,1,407529,408391,+,862
332,WOLB.0323.00031,1,556341,557199,+,858
332,WOLB.0323.00056,1,1061785,1062649,+,864
332,WOLB.0323.00142,1,1146939,1147803,+,864
332,WOLB.0323.00023,1,1038876,1039740,-,864
332,WOLB.0323.00153,1,1076179,1077043,+,864
332,WOLB.0323.00093,1,522623,523487,-,864
332,WOLB.0323.00088,1,1096511,1097375,+,864
332,WOLB.0323.00008,1,1047732,1048582,-,850
332,WOLB.0323.00024,1,374994,375858,-,864
332,WOLB.0323.00064,1,891071,891935,+,864
332,WOLB.0323.00030,1,247474,248338,-,864
332,WOLB.0323.00105,1,1136377,1137239,+,862
332,WOLB.0323.00133,1,998297,999161,-,864
332,WOLB.0323.00084,1,937998,938862,-,864
332,WOLB.0323.00021,1,1424663,1425527,+,864
332,WOLB.0323.00043,1,1383813,1384676,+,863
332,WOLB.0323.00020,1,1040681,1041545,+,864
332,WOLB.0323.00122,1,428211,429075,-,864
332,WOLB.0323.00118,1,923909,924773,+,864
332,WOLB.0323.00004,1,1143852,1144716,+,864
332,WOLB.0323.00011,1,513723,514587,+,864
332,WOLB.0323.00035,1,1034253,1035117,+,864
332,WOLB.0323.00032,1,606266,607130,+,864
332,WOLB.0323.00012,1,1100373,1101237,+,864
332,WOLB.0323.00018,1,1147174,1148038,+,864
332,WOLB.0323.00025,1,692990,693848,-,858
332,WOLB.0323.00010,1,1435003,1435866,+,863
332,WOLB.0323.00068,1,905686,906550,+,864
332,WOLB.0323.00128,1,1289851,1290714,+,863
332,WOLB.0323.00158,1,1130808,1131672,-,864
332,WOLB.0323.00017,1,1132568,1133432,+,864
332,WOLB.0323.00104,1,1074348,1075212,+,864
332,WOLB.0323.00007,1,225870,226734,-,864
332,WOLB.0323.00001,1,1136377,1137239,+,862
332,WOLB.0323.00100,1,1418792,1419656,+,864
332,WOLB.0323.00070,1,1621572,1622435,+,863
332,WOLB.0323.00006,1,736370,737228,-,858
332,WOLB.0323.00042,1,1375180,1376044,-,864
332,WOLB.0323.00119,1,267568,268432,-,864
332,WOLB.0323.00149,1,700049,700913,-,864
332,WOLB.0323.00014,1,1636561,1637424,+,863
332,WOLB.0323.00096,1,419384,420246,+,862
333,WOLB.0323.00090,1,1004241,1010179,+,5938
333,WOLB.0323.00002,1,1307504,1313441,+,5937
333,WOLB.0323.00138,1,836187,842125,-,5938
333,WOLB.0323.00132,1,982178,988116,+,5938
333,WOLB.0323.00143,1,223774,229718,-,5944
333,WOLB.0323.00106,1,223776,229720,-,5944
333,WOLB.0323.00121,1,1269247,1275185,+,5938
333,WOLB.0323.00135,1,622891,628829,-,5938
333,WOLB.0323.00103,1,1137620,1143518,+,5898
333,WOLB.0323.00107,1,1136179,1142077,+,5898
333,WOLB.0323.00019,1,261357,267295,-,5938
333,WOLB.0323.00060,1,1015779,1021717,+,5938
333,WOLB.0323.00074,1,1243503,1249414,-,5911
333,WOLB.0323.00120,1,1235778,1241689,-,5911
333,WOLB.0323.00039,1,1045571,1051509,-,5938
333,WOLB.0323.00041,1,408779,414690,+,5911
333,WOLB.0323.00031,1,557593,563537,+,5944
333,WOLB.0323.00056,1,1063037,1068975,+,5938
333,WOLB.0323.00142,1,1148191,1154129,+,5938
333,WOLB.0323.00023,1,1032550,1038488,-,5938
333,WOLB.0323.00153,1,1077431,1083364,+,5933
333,WOLB.0323.00093,1,516321,522235,-,5914
333,WOLB.0323.00088,1,1097763,1103701,+,5938
333,WOLB.0323.00008,1,1041406,1047344,-,5938
333,WOLB.0323.00024,1,368668,374606,-,5938
333,WOLB.0323.00064,1,892323,898261,+,5938
333,WOLB.0323.00030,1,241148,247086,-,5938
333,WOLB.0323.00105,1,1137627,1143525,+,5898
333,WOLB.0323.00133,1,991977,997909,-,5932
333,WOLB.0323.00084,1,931672,937610,-,5938
333,WOLB.0323.00021,1,1425915,1431853,+,5938
333,WOLB.0323.00043,1,1385064,1391001,+,5937
333,WOLB.0323.00020,1,1041933,1047871,+,5938
333,WOLB.0323.00122,1,421885,427823,-,5938
333,WOLB.0323.00118,1,925161,931094,+,5933
333,WOLB.0323.00004,1,1145104,1151042,+,5938
333,WOLB.0323.00011,1,514975,520913,+,5938
333,WOLB.0323.00035,1,1035505,1041443,+,5938
333,WOLB.0323.00032,1,607518,613456,+,5938
333,WOLB.0323.00012,1,1101625,1107563,+,5938
333,WOLB.0323.00018,1,1148426,1154364,+,5938
333,WOLB.0323.00025,1,686499,692583,-,6084
333,WOLB.0323.00010,1,1436254,1442186,+,5932
333,WOLB.0323.00068,1,906938,912876,+,5938
333,WOLB.0323.00128,1,1291102,1297039,+,5937
333,WOLB.0323.00158,1,1124482,1130420,-,5938
333,WOLB.0323.00017,1,1133820,1139758,+,5938
333,WOLB.0323.00104,1,1075600,1081538,+,5938
333,WOLB.0323.00007,1,219544,225482,-,5938
333,WOLB.0323.00001,1,1137627,1143525,+,5898
333,WOLB.0323.00100,1,1420044,1425982,+,5938
333,WOLB.0323.00070,1,1622823,1628760,+,5937
333,WOLB.0323.00006,1,730032,735976,-,5944
333,WOLB.0323.00042,1,1368854,1374792,-,5938
333,WOLB.0323.00119,1,261242,267180,-,5938
333,WOLB.0323.00149,1,693723,699661,-,5938
333,WOLB.0323.00014,1,1637812,1643749,+,5937
333,WOLB.0323.00096,1,420634,426545,+,5911
334,WOLB.0323.00090,1,1011264,1011992,+,728
334,WOLB.0323.00002,1,1314535,1315263,+,728
334,WOLB.0323.00138,1,834374,835102,-,728
334,WOLB.0323.00132,1,989201,989929,+,728
334,WOLB.0323.00143,1,221952,222680,-,728
334,WOLB.0323.00106,1,221954,222682,-,728
334,WOLB.0323.00121,1,1276270,1276998,+,728
334,WOLB.0323.00135,1,621078,621806,-,728
334,WOLB.0323.00103,1,1144612,1145340,+,728
334,WOLB.0323.00107,1,1143171,1143899,+,728
334,WOLB.0323.00019,1,259535,260263,-,728
334,WOLB.0323.00060,1,1022802,1023530,+,728
334,WOLB.0323.00074,1,1241681,1242409,-,728
334,WOLB.0323.00120,1,1233956,1234684,-,728
334,WOLB.0323.00039,1,1043749,1044477,-,728
334,WOLB.0323.00041,1,415784,416512,+,728
334,WOLB.0323.00031,1,564631,565359,+,728
334,WOLB.0323.00056,1,1070060,1070788,+,728
334,WOLB.0323.00142,1,1155214,1155942,+,728
334,WOLB.0323.00023,1,1030737,1031465,-,728
334,WOLB.0323.00153,1,1084449,1085177,+,728
334,WOLB.0323.00093,1,514508,515236,-,728
334,WOLB.0323.00088,1,1104795,1105523,+,728
334,WOLB.0323.00008,1,1038285,1039013,-,728
334,WOLB.0323.00024,1,366867,367595,-,728
334,WOLB.0323.00064,1,899346,900074,+,728
334,WOLB.0323.00030,1,239335,240063,-,728
334,WOLB.0323.00105,1,1144619,1145347,+,728
334,WOLB.0323.00133,1,990148,990873,-,725
334,WOLB.0323.00084,1,929859,930587,-,728
334,WOLB.0323.00021,1,1432938,1433666,+,728
334,WOLB.0323.00043,1,1392095,1392823,+,728
334,WOLB.0323.00020,1,1048965,1049693,+,728
334,WOLB.0323.00122,1,420072,420800,-,728
334,WOLB.0323.00118,1,932179,932907,+,728
334,WOLB.0323.00004,1,1152127,1152855,+,728
334,WOLB.0323.00011,1,521998,522726,+,728
334,WOLB.0323.00035,1,1042537,1043265,+,728
334,WOLB.0323.00032,1,614541,615269,+,728
334,WOLB.0323.00012,1,1108657,1109385,+,728
334,WOLB.0323.00018,1,1155458,1156186,+,728
334,WOLB.0323.00025,1,684678,685406,-,728
334,WOLB.0323.00010,1,1443280,1444008,+,728
334,WOLB.0323.00068,1,913961,914689,+,728
334,WOLB.0323.00128,1,1298133,1298861,+,728
334,WOLB.0323.00158,1,1122669,1123397,-,728
334,WOLB.0323.00017,1,1140843,1141571,+,728
334,WOLB.0323.00104,1,1082632,1083360,+,728
334,WOLB.0323.00007,1,217731,218459,-,728
334,WOLB.0323.00001,1,1144619,1145347,+,728
334,WOLB.0323.00100,1,1427076,1427804,+,728
334,WOLB.0323.00070,1,1629854,1630582,+,728
334,WOLB.0323.00006,1,728210,728938,-,728
334,WOLB.0323.00042,1,1367032,1367760,-,728
334,WOLB.0323.00119,1,259420,260148,-,728
334,WOLB.0323.00149,1,691910,692638,-,728
334,WOLB.0323.00014,1,1644843,1645571,+,728
334,WOLB.0323.00096,1,427639,428367,+,728
335,WOLB.0323.00090,1,1012827,1016442,+,3615
335,WOLB.0323.00002,1,1316099,1319721,+,3622
335,WOLB.0323.00138,1,829924,833539,-,3615
335,WOLB.0323.00132,1,990765,994394,+,3629
335,WOLB.0323.00143,1,217523,221138,-,3615
335,WOLB.0323.00106,1,217525,221140,-,3615
335,WOLB.0323.00121,1,1277833,1281448,+,3615
335,WOLB.0323.00135,1,616628,620243,-,3615
335,WOLB.0323.00103,1,1146154,1149783,+,3629
335,WOLB.0323.00107,1,1144713,1148342,+,3629
335,WOLB.0323.00019,1,255107,258716,-,3609
335,WOLB.0323.00060,1,1024365,1027980,+,3615
335,WOLB.0323.00074,1,1237236,1240867,-,3631
335,WOLB.0323.00120,1,1229511,1233142,-,3631
335,WOLB.0323.00039,1,1039321,1042935,-,3614
335,WOLB.0323.00041,1,417326,420957,+,3631
335,WOLB.0323.00031,1,566173,569788,+,3615
335,WOLB.0323.00056,1,1071623,1075238,+,3615
335,WOLB.0323.00142,1,1156777,1160392,+,3615
335,WOLB.0323.00023,1,1026272,1029901,-,3629
335,WOLB.0323.00153,1,1086012,1089627,+,3615
335,WOLB.0323.00093,1,510043,513672,-,3629
335,WOLB.0323.00088,1,1106359,1109973,+,3614
335,WOLB.0323.00008,1,1033820,1037449,-,3629
335,WOLB.0323.00024,1,362402,366031,-,3629
335,WOLB.0323.00064,1,900910,904539,+,3629
335,WOLB.0323.00030,1,234870,238499,-,3629
335,WOLB.0323.00105,1,1146161,1149790,+,3629
335,WOLB.0323.00133,1,985720,989334,-,3614
335,WOLB.0323.00084,1,925409,929024,-,3615
335,WOLB.0323.00021,1,1434501,1438116,+,3615
335,WOLB.0323.00043,1,1393659,1397281,+,3622
335,WOLB.0323.00020,1,1050529,1054143,+,3614
335,WOLB.0323.00122,1,415622,419237,-,3615
335,WOLB.0323.00118,1,933742,937357,+,3615
335,WOLB.0323.00004,1,1153690,1157305,+,3615
335,WOLB.0323.00011,1,523561,527176,+,3615
335,WOLB.0323.00035,1,1044101,1047715,+,3614
335,WOLB.0323.00032,1,616104,619719,+,3615
335,WOLB.0323.00012,1,1110221,1113835,+,3614
335,WOLB.0323.00018,1,1157022,1160644,+,3622
335,WOLB.0323.00025,1,680249,683864,-,3615
335,WOLB.0323.00010,1,1444844,1448466,+,3622
335,WOLB.0323.00068,1,915524,919139,+,3615
335,WOLB.0323.00128,1,1299697,1303319,+,3622
335,WOLB.0323.00158,1,1118219,1121834,-,3615
335,WOLB.0323.00017,1,1142406,1146021,+,3615
335,WOLB.0323.00104,1,1084196,1087810,+,3614
335,WOLB.0323.00007,1,213281,216896,-,3615
335,WOLB.0323.00001,1,1146161,1149790,+,3629
335,WOLB.0323.00100,1,1428640,1432254,+,3614
335,WOLB.0323.00070,1,1631418,1635040,+,3622
335,WOLB.0323.00006,1,723781,727396,-,3615
335,WOLB.0323.00042,1,1362603,1366218,-,3615
335,WOLB.0323.00119,1,254992,258601,-,3609
335,WOLB.0323.00149,1,687460,691075,-,3615
335,WOLB.0323.00014,1,1646407,1650029,+,3622
335,WOLB.0323.00096,1,429181,432812,+,3631
336,WOLB.0323.00090,1,1016511,1018394,+,1883
336,WOLB.0323.00002,1,1319816,1321679,+,1863
336,WOLB.0323.00138,1,827971,829855,-,1884
336,WOLB.0323.00132,1,994463,996346,+,1883
336,WOLB.0323.00143,1,215555,217454,-,1899
336,WOLB.0323.00106,1,215557,217456,-,1899
336,WOLB.0323.00121,1,1281517,1283400,+,1883
336,WOLB.0323.00135,1,614675,616559,-,1884
336,WOLB.0323.00103,1,1153853,1155735,+,1882
336,WOLB.0323.00107,1,1152412,1154294,+,1882
336,WOLB.0323.00019,1,253145,255034,-,1889
336,WOLB.0323.00060,1,1028049,1029932,+,1883
336,WOLB.0323.00074,1,1235283,1237167,-,1884
336,WOLB.0323.00120,1,1227558,1229442,-,1884
336,WOLB.0323.00039,1,1037359,1039248,-,1889
336,WOLB.0323.00041,1,421026,422909,+,1883
336,WOLB.0323.00031,1,569857,571755,+,1898
336,WOLB.0323.00056,1,1075307,1077190,+,1883
336,WOLB.0323.00142,1,1160461,1162344,+,1883
336,WOLB.0323.00023,1,1024322,1026203,-,1881
336,WOLB.0323.00153,1,1089696,1091579,+,1883
336,WOLB.0323.00093,1,508090,509974,-,1884
336,WOLB.0323.00088,1,1110042,1111925,+,1883
336,WOLB.0323.00008,1,1031867,1033751,-,1884
336,WOLB.0323.00024,1,360449,362333,-,1884
336,WOLB.0323.00064,1,904608,906488,+,1880
336,WOLB.0323.00030,1,232920,234801,-,1881
336,WOLB.0323.00105,1,1153860,1155742,+,1882
336,WOLB.0323.00133,1,983759,985651,-,1892
336,WOLB.0323.00084,1,923456,925340,-,1884
336,WOLB.0323.00021,1,1438185,1440068,+,1883
336,WOLB.0323.00043,1,1397376,1399239,+,1863
336,WOLB.0323.00020,1,1054212,1056095,+,1883
336,WOLB.0323.00122,1,413669,415553,-,1884
336,WOLB.0323.00118,1,937426,939309,+,1883
336,WOLB.0323.00004,1,1157374,1159257,+,1883
336,WOLB.0323.00011,1,527245,529128,+,1883
336,WOLB.0323.00035,1,1047784,1049667,+,1883
336,WOLB.0323.00032,1,619788,621671,+,1883
336,WOLB.0323.00012,1,1113904,1115787,+,1883
336,WOLB.0323.00018,1,1160739,1162602,+,1863
336,WOLB.0323.00025,1,678281,680180,-,1899
336,WOLB.0323.00010,1,1448561,1450424,+,1863
336,WOLB.0323.00068,1,919208,921091,+,1883
336,WOLB.0323.00128,1,1303414,1305277,+,1863
336,WOLB.0323.00158,1,1116266,1118150,-,1884
336,WOLB.0323.00017,1,1146090,1147973,+,1883
336,WOLB.0323.00104,1,1087879,1089762,+,1883
336,WOLB.0323.00007,1,211328,213212,-,1884
336,WOLB.0323.00001,1,1153860,1155742,+,1882
336,WOLB.0323.00100,1,1432323,1434206,+,1883
336,WOLB.0323.00070,1,1635135,1636998,+,1863
336,WOLB.0323.00006,1,721813,723712,-,1899
336,WOLB.0323.00042,1,1360641,1362534,-,1893
336,WOLB.0323.00119,1,253030,254919,-,1889
336,WOLB.0323.00149,1,685507,687391,-,1884
336,WOLB.0323.00014,1,1650124,1651987,+,1863
336,WOLB.0323.00096,1,432881,434764,+,1883
337,WOLB.0323.00090,1,1018671,1019336,+,665
337,WOLB.0323.00002,1,1321956,1322621,+,665
337,WOLB.0323.00138,1,827029,827695,-,666
337,WOLB.0323.00132,1,996623,997288,+,665
337,WOLB.0323.00143,1,214613,215257,-,644
337,WOLB.0323.00106,1,214615,215259,-,644
337,WOLB.0323.00121,1,1283677,1284342,+,665
337,WOLB.0323.00135,1,613733,614399,-,666
337,WOLB.0323.00103,1,1156012,1156677,+,665
337,WOLB.0323.00107,1,1154571,1155236,+,665
337,WOLB.0323.00060,1,1030209,1030874,+,665
337,WOLB.0323.00074,1,1234341,1235007,-,666
337,WOLB.0323.00120,1,1226616,1227282,-,666
337,WOLB.0323.00041,1,423186,423851,+,665
337,WOLB.0323.00031,1,572054,572697,+,643
337,WOLB.0323.00056,1,1077467,1078132,+,665
337,WOLB.0323.00142,1,1162621,1163286,+,665
337,WOLB.0323.00023,1,1023380,1024046,-,666
337,WOLB.0323.00153,1,1091856,1092521,+,665
337,WOLB.0323.00093,1,507148,507814,-,666
337,WOLB.0323.00088,1,1112202,1112867,+,665
337,WOLB.0323.00008,1,1096344,1096923,+,579
337,WOLB.0323.00024,1,359507,360173,-,666
337,WOLB.0323.00064,1,906765,907430,+,665
337,WOLB.0323.00030,1,231978,232644,-,666
337,WOLB.0323.00105,1,1156019,1156684,+,665
337,WOLB.0323.00084,1,922514,923180,-,666
337,WOLB.0323.00021,1,1440345,1441010,+,665
337,WOLB.0323.00043,1,1399516,1400181,+,665
337,WOLB.0323.00020,1,1056372,1057037,+,665
337,WOLB.0323.00122,1,412727,413393,-,666
337,WOLB.0323.00118,1,939586,940251,+,665
337,WOLB.0323.00004,1,1159534,1160199,+,665
337,WOLB.0323.00011,1,529405,530070,+,665
337,WOLB.0323.00035,1,1049944,1050609,+,665
337,WOLB.0323.00032,1,621948,622613,+,665
337,WOLB.0323.00012,1,1116064,1116729,+,665
337,WOLB.0323.00018,1,1162879,1163544,+,665
337,WOLB.0323.00025,1,677339,677983,-,644
337,WOLB.0323.00010,1,1450701,1451366,+,665
337,WOLB.0323.00068,1,921368,922033,+,665
337,WOLB.0323.00128,1,1305554,1306219,+,665
337,WOLB.0323.00158,1,1115324,1115990,-,666
337,WOLB.0323.00017,1,1148250,1148915,+,665
337,WOLB.0323.00104,1,1090039,1090704,+,665
337,WOLB.0323.00007,1,210386,211052,-,666
337,WOLB.0323.00001,1,1156019,1156684,+,665
337,WOLB.0323.00100,1,1434483,1435148,+,665
337,WOLB.0323.00070,1,1637275,1637940,+,665
337,WOLB.0323.00006,1,720871,721515,-,644
337,WOLB.0323.00042,1,1358787,1359453,-,666
337,WOLB.0323.00149,1,684565,685231,-,666
337,WOLB.0323.00014,1,1652264,1652929,+,665
337,WOLB.0323.00096,1,435041,435706,+,665
338,WOLB.0323.00090,1,1019338,1020468,+,1130
338,WOLB.0323.00002,1,1322623,1323756,+,1133
338,WOLB.0323.00138,1,825898,827028,-,1130
338,WOLB.0323.00132,1,997290,998426,+,1136
338,WOLB.0323.00143,1,213481,214612,-,1131
338,WOLB.0323.00106,1,213483,214614,-,1131
338,WOLB.0323.00121,1,1284344,1285474,+,1130
338,WOLB.0323.00135,1,612602,613732,-,1130
338,WOLB.0323.00103,1,1156679,1157810,+,1131
338,WOLB.0323.00107,1,1155238,1156369,+,1131
338,WOLB.0323.00019,1,251834,252965,-,1131
338,WOLB.0323.00060,1,1030876,1032006,+,1130
338,WOLB.0323.00074,1,1233210,1234340,-,1130
338,WOLB.0323.00120,1,1225485,1226615,-,1130
338,WOLB.0323.00039,1,1036048,1037179,-,1131
338,WOLB.0323.00041,1,423853,424983,+,1130
338,WOLB.0323.00031,1,572699,573830,+,1131
338,WOLB.0323.00056,1,1078134,1079264,+,1130
338,WOLB.0323.00142,1,1163288,1164418,+,1130
338,WOLB.0323.00023,1,1022243,1023379,-,1136
338,WOLB.0323.00153,1,1092523,1093653,+,1130
338,WOLB.0323.00093,1,506079,507147,-,1068
338,WOLB.0323.00088,1,1112869,1113999,+,1130
338,WOLB.0323.00008,1,1096925,1098061,+,1136
338,WOLB.0323.00024,1,358370,359506,-,1136
338,WOLB.0323.00064,1,907432,908562,+,1130
338,WOLB.0323.00030,1,230847,231977,-,1130
338,WOLB.0323.00105,1,1156686,1157817,+,1131
338,WOLB.0323.00133,1,982450,983580,-,1130
338,WOLB.0323.00084,1,921383,922513,-,1130
338,WOLB.0323.00021,1,1441012,1442142,+,1130
338,WOLB.0323.00043,1,1400183,1401316,+,1133
338,WOLB.0323.00020,1,1057039,1058169,+,1130
338,WOLB.0323.00122,1,411596,412726,-,1130
338,WOLB.0323.00118,1,940253,941383,+,1130
338,WOLB.0323.00004,1,1160201,1161331,+,1130
338,WOLB.0323.00011,1,530072,531202,+,1130
338,WOLB.0323.00035,1,1050611,1051741,+,1130
338,WOLB.0323.00032,1,622615,623745,+,1130
338,WOLB.0323.00012,1,1116731,1117861,+,1130
338,WOLB.0323.00018,1,1163546,1164682,+,1136
338,WOLB.0323.00025,1,676207,677338,-,1131
338,WOLB.0323.00010,1,1451368,1452501,+,1133
338,WOLB.0323.00068,1,922035,923165,+,1130
338,WOLB.0323.00128,1,1306221,1307354,+,1133
338,WOLB.0323.00158,1,1114193,1115323,-,1130
338,WOLB.0323.00017,1,1148917,1150047,+,1130
338,WOLB.0323.00104,1,1090706,1091836,+,1130
338,WOLB.0323.00007,1,209255,210385,-,1130
338,WOLB.0323.00001,1,1156686,1157817,+,1131
338,WOLB.0323.00100,1,1435150,1436280,+,1130
338,WOLB.0323.00070,1,1637942,1639075,+,1133
338,WOLB.0323.00006,1,719739,720870,-,1131
338,WOLB.0323.00042,1,1357649,1358786,-,1137
338,WOLB.0323.00119,1,251719,252850,-,1131
338,WOLB.0323.00149,1,683434,684564,-,1130
338,WOLB.0323.00014,1,1652931,1654064,+,1133
338,WOLB.0323.00096,1,435708,436838,+,1130
339,WOLB.0323.00090,1,1021135,1023106,+,1971
339,WOLB.0323.00002,1,1324414,1326385,+,1971
339,WOLB.0323.00138,1,823259,825230,-,1971
339,WOLB.0323.00132,1,999093,1001064,+,1971
339,WOLB.0323.00143,1,210842,212813,-,1971
339,WOLB.0323.00106,1,210844,212815,-,1971
339,WOLB.0323.00121,1,1286141,1288112,+,1971
339,WOLB.0323.00135,1,609963,611934,-,1971
339,WOLB.0323.00103,1,1158477,1160448,+,1971
339,WOLB.0323.00107,1,1157036,1159007,+,1971
339,WOLB.0323.00019,1,249186,251157,-,1971
339,WOLB.0323.00060,1,1032673,1034644,+,1971
339,WOLB.0323.00074,1,1230571,1232542,-,1971
339,WOLB.0323.00120,1,1222846,1224817,-,1971
339,WOLB.0323.00039,1,1033400,1035371,-,1971
339,WOLB.0323.00041,1,425650,427621,+,1971
339,WOLB.0323.00031,1,574497,576468,+,1971
339,WOLB.0323.00056,1,1079931,1081902,+,1971
339,WOLB.0323.00142,1,1165085,1167056,+,1971
339,WOLB.0323.00023,1,1019604,1021575,-,1971
339,WOLB.0323.00153,1,1094320,1096291,+,1971
339,WOLB.0323.00093,1,503440,505411,-,1971
339,WOLB.0323.00088,1,1114666,1116636,+,1970
339,WOLB.0323.00008,1,1098728,1100699,+,1971
339,WOLB.0323.00024,1,355736,357713,-,1977
339,WOLB.0323.00064,1,909229,911200,+,1971
339,WOLB.0323.00030,1,228104,230179,-,2075
339,WOLB.0323.00105,1,1158484,1160455,+,1971
339,WOLB.0323.00084,1,918744,920715,-,1971
339,WOLB.0323.00021,1,1442809,1444780,+,1971
339,WOLB.0323.00043,1,1401974,1403945,+,1971
339,WOLB.0323.00020,1,1058836,1060807,+,1971
339,WOLB.0323.00122,1,408957,410928,-,1971
339,WOLB.0323.00118,1,942050,944021,+,1971
339,WOLB.0323.00004,1,1161998,1163969,+,1971
339,WOLB.0323.00011,1,531869,533840,+,1971
339,WOLB.0323.00035,1,1052408,1054379,+,1971
339,WOLB.0323.00032,1,624412,626383,+,1971
339,WOLB.0323.00012,1,1118528,1120499,+,1971
339,WOLB.0323.00018,1,1165337,1167308,+,1971
339,WOLB.0323.00025,1,11052,13023,+,1971
339,WOLB.0323.00010,1,1453159,1455129,+,1970
339,WOLB.0323.00068,1,923832,925803,+,1971
339,WOLB.0323.00128,1,1308013,1309984,+,1971
339,WOLB.0323.00158,1,1111554,1113525,-,1971
339,WOLB.0323.00017,1,1150714,1152685,+,1971
339,WOLB.0323.00104,1,1092503,1094474,+,1971
339,WOLB.0323.00007,1,206616,208587,-,1971
339,WOLB.0323.00001,1,1158484,1160455,+,1971
339,WOLB.0323.00100,1,1436947,1438918,+,1971
339,WOLB.0323.00070,1,1639733,1641704,+,1971
339,WOLB.0323.00006,1,717100,719071,-,1971
339,WOLB.0323.00042,1,1355010,1356985,-,1975
339,WOLB.0323.00119,1,249071,251042,-,1971
339,WOLB.0323.00149,1,680795,682766,-,1971
339,WOLB.0323.00014,1,1654722,1656693,+,1971
339,WOLB.0323.00096,1,437505,439476,+,1971
340,WOLB.0323.00090,1,1023108,1023817,+,709
340,WOLB.0323.00002,1,1326387,1327096,+,709
340,WOLB.0323.00138,1,822549,823258,-,709
340,WOLB.0323.00132,1,1001066,1001775,+,709
340,WOLB.0323.00143,1,210132,210841,-,709
340,WOLB.0323.00106,1,210134,210843,-,709
340,WOLB.0323.00121,1,1288114,1288823,+,709
340,WOLB.0323.00135,1,609253,609962,-,709
340,WOLB.0323.00103,1,1160450,1161159,+,709
340,WOLB.0323.00107,1,1159009,1159718,+,709
340,WOLB.0323.00019,1,248476,249185,-,709
340,WOLB.0323.00060,1,1034646,1035355,+,709
340,WOLB.0323.00074,1,1229865,1230570,-,705
340,WOLB.0323.00120,1,1222140,1222845,-,705
340,WOLB.0323.00039,1,1032690,1033399,-,709
340,WOLB.0323.00041,1,427623,428328,+,705
340,WOLB.0323.00031,1,576470,577179,+,709
340,WOLB.0323.00056,1,1081904,1082613,+,709
340,WOLB.0323.00142,1,1167058,1167767,+,709
340,WOLB.0323.00023,1,1018894,1019603,-,709
340,WOLB.0323.00153,1,1096293,1097002,+,709
340,WOLB.0323.00093,1,502727,503439,-,712
340,WOLB.0323.00088,1,1116638,1117347,+,709
340,WOLB.0323.00008,1,1100701,1101410,+,709
340,WOLB.0323.00024,1,355026,355735,-,709
340,WOLB.0323.00064,1,911202,911911,+,709
340,WOLB.0323.00030,1,227394,228103,-,709
340,WOLB.0323.00105,1,1160457,1161166,+,709
340,WOLB.0323.00133,1,516092,516795,-,703
340,WOLB.0323.00084,1,918034,918743,-,709
340,WOLB.0323.00021,1,1444782,1445491,+,709
340,WOLB.0323.00043,1,1403947,1404656,+,709
340,WOLB.0323.00020,1,1060809,1061518,+,709
340,WOLB.0323.00122,1,408247,408956,-,709
340,WOLB.0323.00118,1,944023,944732,+,709
340,WOLB.0323.00004,1,1163971,1164680,+,709
340,WOLB.0323.00011,1,533842,534551,+,709
340,WOLB.0323.00035,1,1054381,1055090,+,709
340,WOLB.0323.00032,1,626385,627094,+,709
340,WOLB.0323.00012,1,1120501,1121210,+,709
340,WOLB.0323.00018,1,1167310,1168019,+,709
340,WOLB.0323.00025,1,13025,13734,+,709
340,WOLB.0323.00010,1,1455131,1455840,+,709
340,WOLB.0323.00068,1,925805,926514,+,709
340,WOLB.0323.00128,1,1309986,1310695,+,709
340,WOLB.0323.00158,1,1110844,1111553,-,709
340,WOLB.0323.00017,1,1152687,1153396,+,709
340,WOLB.0323.00104,1,1094476,1095185,+,709
340,WOLB.0323.00007,1,205906,206615,-,709
340,WOLB.0323.00001,1,1160457,1161166,+,709
340,WOLB.0323.00100,1,1438920,1439629,+,709
340,WOLB.0323.00070,1,1641706,1642415,+,709
340,WOLB.0323.00006,1,716390,717099,-,709
340,WOLB.0323.00042,1,1354300,1355009,-,709
340,WOLB.0323.00119,1,248361,249070,-,709
340,WOLB.0323.00149,1,680085,680794,-,709
340,WOLB.0323.00014,1,1656695,1657404,+,709
340,WOLB.0323.00096,1,439478,440183,+,705
341,WOLB.0323.00090,1,1023824,1027804,+,3980
341,WOLB.0323.00002,1,1327103,1331083,+,3980
341,WOLB.0323.00138,1,818562,822542,-,3980
341,WOLB.0323.00132,1,1001782,1005762,+,3980
341,WOLB.0323.00143,1,206153,210125,-,3972
341,WOLB.0323.00106,1,206155,210127,-,3972
341,WOLB.0323.00121,1,1288830,1292810,+,3980
341,WOLB.0323.00135,1,605266,609246,-,3980
341,WOLB.0323.00103,1,1161166,1165147,+,3981
341,WOLB.0323.00107,1,1159725,1163706,+,3981
341,WOLB.0323.00019,1,244489,248469,-,3980
341,WOLB.0323.00060,1,1035362,1039342,+,3980
341,WOLB.0323.00074,1,1225875,1229854,-,3979
341,WOLB.0323.00120,1,1218150,1222129,-,3979
341,WOLB.0323.00039,1,1028703,1032683,-,3980
341,WOLB.0323.00041,1,428339,432318,+,3979
341,WOLB.0323.00031,1,577186,581158,+,3972
341,WOLB.0323.00056,1,1082620,1086600,+,3980
341,WOLB.0323.00142,1,1167774,1171754,+,3980
341,WOLB.0323.00023,1,1014907,1018887,-,3980
341,WOLB.0323.00153,1,1097009,1100989,+,3980
341,WOLB.0323.00093,1,498740,502720,-,3980
341,WOLB.0323.00088,1,1117354,1121334,+,3980
341,WOLB.0323.00008,1,1101417,1105389,+,3972
341,WOLB.0323.00024,1,351039,355019,-,3980
341,WOLB.0323.00064,1,911918,915898,+,3980
341,WOLB.0323.00030,1,223407,227387,-,3980
341,WOLB.0323.00105,1,1161173,1165154,+,3981
341,WOLB.0323.00133,1,512105,516085,-,3980
341,WOLB.0323.00084,1,914047,918027,-,3980
341,WOLB.0323.00021,1,1445498,1449478,+,3980
341,WOLB.0323.00043,1,1404663,1408643,+,3980
341,WOLB.0323.00020,1,1061525,1065505,+,3980
341,WOLB.0323.00122,1,404260,408240,-,3980
341,WOLB.0323.00118,1,944739,948719,+,3980
341,WOLB.0323.00004,1,1164687,1168667,+,3980
341,WOLB.0323.00011,1,534558,538538,+,3980
341,WOLB.0323.00035,1,1055097,1059077,+,3980
341,WOLB.0323.00032,1,627101,631081,+,3980
341,WOLB.0323.00012,1,1121217,1125197,+,3980
341,WOLB.0323.00018,1,1168026,1172006,+,3980
341,WOLB.0323.00025,1,946298,950260,-,3962
341,WOLB.0323.00010,1,1455847,1459828,+,3981
341,WOLB.0323.00068,1,926521,930501,+,3980
341,WOLB.0323.00128,1,1310702,1314682,+,3980
341,WOLB.0323.00158,1,1106857,1110837,-,3980
341,WOLB.0323.00017,1,1153403,1157383,+,3980
341,WOLB.0323.00104,1,1095192,1099172,+,3980
341,WOLB.0323.00007,1,201919,205899,-,3980
341,WOLB.0323.00001,1,1161173,1165154,+,3981
341,WOLB.0323.00100,1,1439636,1443616,+,3980
341,WOLB.0323.00070,1,1642422,1646402,+,3980
341,WOLB.0323.00006,1,712411,716383,-,3972
341,WOLB.0323.00042,1,1350313,1354293,-,3980
341,WOLB.0323.00119,1,244374,248354,-,3980
341,WOLB.0323.00149,1,676098,680078,-,3980
341,WOLB.0323.00014,1,1657411,1661391,+,3980
341,WOLB.0323.00096,1,440194,444173,+,3979
342,WOLB.0323.00090,1,1028235,1031625,+,3390
342,WOLB.0323.00002,1,1331514,1334903,+,3389
342,WOLB.0323.00138,1,814741,818131,-,3390
342,WOLB.0323.00132,1,1006193,1009583,+,3390
342,WOLB.0323.00143,1,202383,205773,-,3390
342,WOLB.0323.00106,1,202385,205775,-,3390
342,WOLB.0323.00121,1,1293241,1296631,+,3390
342,WOLB.0323.00135,1,601445,604835,-,3390
342,WOLB.0323.00103,1,1165578,1168966,+,3388
342,WOLB.0323.00107,1,1164137,1167525,+,3388
342,WOLB.0323.00019,1,240668,244058,-,3390
342,WOLB.0323.00060,1,1039773,1043163,+,3390
342,WOLB.0323.00074,1,1222001,1225379,-,3378
342,WOLB.0323.00120,1,1214276,1217654,-,3378
342,WOLB.0323.00039,1,1024882,1028272,-,3390
342,WOLB.0323.00041,1,432814,436192,+,3378
342,WOLB.0323.00031,1,581538,584928,+,3390
342,WOLB.0323.00056,1,1087031,1090421,+,3390
342,WOLB.0323.00142,1,1172185,1175575,+,3390
342,WOLB.0323.00023,1,1011086,1014476,-,3390
342,WOLB.0323.00153,1,1101420,1104810,+,3390
342,WOLB.0323.00093,1,494919,498309,-,3390
342,WOLB.0323.00088,1,1121765,1125155,+,3390
342,WOLB.0323.00008,1,1105813,1109203,+,3390
342,WOLB.0323.00024,1,347218,350608,-,3390
342,WOLB.0323.00064,1,916329,919719,+,3390
342,WOLB.0323.00030,1,219586,222976,-,3390
342,WOLB.0323.00105,1,1165585,1168973,+,3388
342,WOLB.0323.00133,1,977680,981070,-,3390
342,WOLB.0323.00084,1,910226,913616,-,3390
342,WOLB.0323.00021,1,1449909,1453299,+,3390
342,WOLB.0323.00043,1,1409074,1412464,+,3390
342,WOLB.0323.00020,1,1065936,1069326,+,3390
342,WOLB.0323.00122,1,400439,403829,-,3390
342,WOLB.0323.00118,1,949150,952540,+,3390
342,WOLB.0323.00004,1,1169098,1172488,+,3390
342,WOLB.0323.00011,1,538969,542359,+,3390
342,WOLB.0323.00035,1,1059508,1062898,+,3390
342,WOLB.0323.00032,1,631512,634902,+,3390
342,WOLB.0323.00012,1,1125628,1129018,+,3390
342,WOLB.0323.00018,1,1172437,1175827,+,3390
342,WOLB.0323.00025,1,942528,945918,-,3390
342,WOLB.0323.00010,1,1460259,1463649,+,3390
342,WOLB.0323.00068,1,930932,934322,+,3390
342,WOLB.0323.00128,1,1315113,1318502,+,3389
342,WOLB.0323.00158,1,1103036,1106426,-,3390
342,WOLB.0323.00017,1,1157814,1161204,+,3390
342,WOLB.0323.00104,1,1099603,1102993,+,3390
342,WOLB.0323.00007,1,198098,201488,-,3390
342,WOLB.0323.00001,1,1165585,1168973,+,3388
342,WOLB.0323.00100,1,1444047,1447437,+,3390
342,WOLB.0323.00070,1,1646833,1650222,+,3389
342,WOLB.0323.00006,1,708641,712031,-,3390
342,WOLB.0323.00042,1,1346492,1349882,-,3390
342,WOLB.0323.00119,1,240553,243943,-,3390
342,WOLB.0323.00149,1,672277,675667,-,3390
342,WOLB.0323.00014,1,1661822,1665211,+,3389
342,WOLB.0323.00096,1,444669,448047,+,3378
343,WOLB.0323.00090,1,1032639,1033173,+,534
343,WOLB.0323.00002,1,1335917,1336451,+,534
343,WOLB.0323.00138,1,813193,813726,-,533
343,WOLB.0323.00132,1,1010597,1011131,+,534
343,WOLB.0323.00143,1,200854,201368,-,514
343,WOLB.0323.00106,1,200856,201370,-,514
343,WOLB.0323.00121,1,1297645,1298179,+,534
343,WOLB.0323.00103,1,1170635,1171169,+,534
343,WOLB.0323.00107,1,1169194,1169728,+,534
343,WOLB.0323.00019,1,239122,239655,-,533
343,WOLB.0323.00060,1,1044177,1044711,+,534
343,WOLB.0323.00074,1,1220463,1220986,-,523
343,WOLB.0323.00120,1,1212738,1213261,-,523
343,WOLB.0323.00039,1,1023336,1023869,-,533
343,WOLB.0323.00041,1,437206,437730,+,524
343,WOLB.0323.00031,1,585942,586457,+,515
343,WOLB.0323.00056,1,1091435,1091969,+,534
343,WOLB.0323.00142,1,1176589,1177123,+,534
343,WOLB.0323.00023,1,1009538,1010071,-,533
343,WOLB.0323.00153,1,1105824,1106358,+,534
343,WOLB.0323.00093,1,493371,493904,-,533
343,WOLB.0323.00088,1,1126169,1126703,+,534
343,WOLB.0323.00008,1,1110217,1110751,+,534
343,WOLB.0323.00024,1,344550,345083,-,533
343,WOLB.0323.00064,1,920733,921267,+,534
343,WOLB.0323.00030,1,218038,218571,-,533
343,WOLB.0323.00105,1,1170642,1171176,+,534
343,WOLB.0323.00133,1,976134,976667,-,533
343,WOLB.0323.00084,1,908678,909211,-,533
343,WOLB.0323.00021,1,1454313,1454847,+,534
343,WOLB.0323.00043,1,1413478,1414012,+,534
343,WOLB.0323.00020,1,1070340,1070874,+,534
343,WOLB.0323.00122,1,398891,399424,-,533
343,WOLB.0323.00118,1,953554,954088,+,534
343,WOLB.0323.00004,1,1173502,1174036,+,534
343,WOLB.0323.00011,1,543373,543907,+,534
343,WOLB.0323.00035,1,1063912,1064446,+,534
343,WOLB.0323.00032,1,635916,636450,+,534
343,WOLB.0323.00012,1,1130032,1130566,+,534
343,WOLB.0323.00018,1,1176841,1177375,+,534
343,WOLB.0323.00025,1,418852,419366,-,514
343,WOLB.0323.00010,1,1464663,1465197,+,534
343,WOLB.0323.00068,1,935336,935870,+,534
343,WOLB.0323.00128,1,1319516,1320050,+,534
343,WOLB.0323.00158,1,1101488,1102021,-,533
343,WOLB.0323.00017,1,1162218,1162752,+,534
343,WOLB.0323.00104,1,1104007,1104541,+,534
343,WOLB.0323.00007,1,196550,197083,-,533
343,WOLB.0323.00001,1,1170642,1171176,+,534
343,WOLB.0323.00100,1,1448451,1448985,+,534
343,WOLB.0323.00070,1,1651236,1651770,+,534
343,WOLB.0323.00006,1,707112,707626,-,514
343,WOLB.0323.00042,1,1344944,1345477,-,533
343,WOLB.0323.00119,1,239007,239540,-,533
343,WOLB.0323.00149,1,670729,671262,-,533
343,WOLB.0323.00014,1,1666225,1666759,+,534
343,WOLB.0323.00096,1,449061,449585,+,524
344,WOLB.0323.00090,1,1033929,1037360,+,3431
344,WOLB.0323.00002,1,1337204,1340656,+,3452
344,WOLB.0323.00138,1,809002,812440,-,3438
344,WOLB.0323.00132,1,1011884,1015336,+,3452
344,WOLB.0323.00143,1,196657,200101,-,3444
344,WOLB.0323.00106,1,196659,200103,-,3444
344,WOLB.0323.00121,1,1298932,1302378,+,3446
344,WOLB.0323.00135,1,595714,599150,-,3436
344,WOLB.0323.00103,1,1171922,1175373,+,3451
344,WOLB.0323.00107,1,1170481,1173932,+,3451
344,WOLB.0323.00019,1,234911,238363,-,3452
344,WOLB.0323.00060,1,1045464,1048904,+,3440
344,WOLB.0323.00074,1,1216272,1219716,-,3444
344,WOLB.0323.00120,1,1208547,1211991,-,3444
344,WOLB.0323.00039,1,1019124,1022577,-,3453
344,WOLB.0323.00041,1,438477,441920,+,3443
344,WOLB.0323.00031,1,587210,590653,+,3443
344,WOLB.0323.00056,1,1092722,1096162,+,3440
344,WOLB.0323.00142,1,1177876,1181322,+,3446
344,WOLB.0323.00023,1,1005332,1008785,-,3453
344,WOLB.0323.00153,1,1107114,1110545,+,3431
344,WOLB.0323.00093,1,489174,492618,-,3444
344,WOLB.0323.00088,1,1127459,1130890,+,3431
344,WOLB.0323.00008,1,1111504,1114947,+,3443
344,WOLB.0323.00024,1,340345,343797,-,3452
344,WOLB.0323.00064,1,922020,925472,+,3452
344,WOLB.0323.00030,1,213832,217285,-,3453
344,WOLB.0323.00105,1,1171929,1175381,+,3452
344,WOLB.0323.00133,1,971923,975366,-,3443
344,WOLB.0323.00084,1,904487,907925,-,3438
344,WOLB.0323.00021,1,1455600,1459037,+,3437
344,WOLB.0323.00043,1,1414765,1418217,+,3452
344,WOLB.0323.00020,1,1071630,1075061,+,3431
344,WOLB.0323.00122,1,394670,398138,-,3468
344,WOLB.0323.00118,1,954847,958278,+,3431
344,WOLB.0323.00004,1,1174789,1178235,+,3446
344,WOLB.0323.00011,1,544660,548106,+,3446
344,WOLB.0323.00035,1,1065202,1068633,+,3431
344,WOLB.0323.00032,1,637203,640640,+,3437
344,WOLB.0323.00012,1,1131322,1134753,+,3431
344,WOLB.0323.00018,1,1178128,1181580,+,3452
344,WOLB.0323.00025,1,414655,418099,-,3444
344,WOLB.0323.00010,1,1465950,1469401,+,3451
344,WOLB.0323.00068,1,936623,940060,+,3437
344,WOLB.0323.00128,1,1320803,1324255,+,3452
344,WOLB.0323.00158,1,1097288,1100735,-,3447
344,WOLB.0323.00017,1,1163505,1166951,+,3446
344,WOLB.0323.00104,1,1105297,1108728,+,3431
344,WOLB.0323.00007,1,192356,195797,-,3441
344,WOLB.0323.00001,1,1171929,1175381,+,3452
344,WOLB.0323.00100,1,1449741,1453172,+,3431
344,WOLB.0323.00070,1,1652523,1655975,+,3452
344,WOLB.0323.00006,1,702915,706359,-,3444
344,WOLB.0323.00042,1,1340743,1344188,-,3445
344,WOLB.0323.00119,1,234796,238248,-,3452
344,WOLB.0323.00149,1,666529,669976,-,3447
344,WOLB.0323.00014,1,1667512,1670964,+,3452
344,WOLB.0323.00096,1,450332,453775,+,3443
345,WOLB.0323.00090,1,1038747,1042130,+,3383
345,WOLB.0323.00002,1,1344760,1348110,+,3350
345,WOLB.0323.00138,1,804233,807616,-,3383
345,WOLB.0323.00132,1,1016715,1020098,+,3383
345,WOLB.0323.00143,1,191896,195275,-,3379
345,WOLB.0323.00106,1,191898,195277,-,3379
345,WOLB.0323.00121,1,1303765,1307148,+,3383
345,WOLB.0323.00135,1,590947,594330,-,3383
345,WOLB.0323.00103,1,1177587,1180958,+,3371
345,WOLB.0323.00107,1,1176146,1179517,+,3371
345,WOLB.0323.00019,1,230150,233530,-,3380
345,WOLB.0323.00060,1,1050291,1053673,+,3382
345,WOLB.0323.00074,1,1201145,1204528,+,3383
345,WOLB.0323.00120,1,1193420,1196803,+,3383
345,WOLB.0323.00039,1,1014362,1017743,-,3381
345,WOLB.0323.00041,1,453665,457048,-,3383
345,WOLB.0323.00031,1,592036,595415,+,3379
345,WOLB.0323.00056,1,1097549,1100932,+,3383
345,WOLB.0323.00142,1,1183812,1187195,+,3383
345,WOLB.0323.00023,1,1000569,1003952,-,3383
345,WOLB.0323.00153,1,1111932,1115314,+,3382
345,WOLB.0323.00093,1,1583039,1586410,+,3371
345,WOLB.0323.00088,1,1132277,1135660,+,3383
345,WOLB.0323.00008,1,1117164,1120535,+,3371
345,WOLB.0323.00024,1,334640,338021,-,3381
345,WOLB.0323.00064,1,926851,930234,+,3383
345,WOLB.0323.00030,1,209071,212454,-,3383
345,WOLB.0323.00105,1,1177595,1180966,+,3371
345,WOLB.0323.00133,1,967162,970544,-,3382
345,WOLB.0323.00084,1,899718,903101,-,3383
345,WOLB.0323.00021,1,1460424,1463806,+,3382
345,WOLB.0323.00043,1,1419598,1422981,+,3383
345,WOLB.0323.00020,1,1076448,1079831,+,3383
345,WOLB.0323.00122,1,1262584,1265967,+,3383
345,WOLB.0323.00118,1,959665,963048,+,3383
345,WOLB.0323.00004,1,1179622,1183005,+,3383
345,WOLB.0323.00011,1,549493,552876,+,3383
345,WOLB.0323.00035,1,1070020,1073403,+,3383
345,WOLB.0323.00032,1,642027,645409,+,3382
345,WOLB.0323.00012,1,1136140,1139523,+,3383
345,WOLB.0323.00018,1,1338506,1341889,-,3383
345,WOLB.0323.00025,1,79495,82870,-,3375
345,WOLB.0323.00010,1,1470780,1474163,+,3383
345,WOLB.0323.00068,1,941447,944829,+,3382
345,WOLB.0323.00128,1,1325636,1329019,+,3383
345,WOLB.0323.00158,1,1092519,1095902,-,3383
345,WOLB.0323.00017,1,1168338,1171721,+,3383
345,WOLB.0323.00104,1,1110115,1113498,+,3383
345,WOLB.0323.00007,1,187587,190970,-,3383
345,WOLB.0323.00001,1,1177595,1180966,+,3371
345,WOLB.0323.00100,1,1454559,1457942,+,3383
345,WOLB.0323.00070,1,1657356,1660739,+,3383
345,WOLB.0323.00006,1,698154,701533,-,3379
345,WOLB.0323.00042,1,1335981,1339364,-,3383
345,WOLB.0323.00119,1,230035,233415,-,3380
345,WOLB.0323.00149,1,661760,665143,-,3383
345,WOLB.0323.00014,1,1672345,1675728,+,3383
345,WOLB.0323.00096,1,465520,468903,-,3383
346,WOLB.0323.00090,1,1042131,1043791,+,1660
346,WOLB.0323.00002,1,1348111,1349781,+,1670
346,WOLB.0323.00138,1,802572,804231,-,1659
346,WOLB.0323.00132,1,1020099,1021733,+,1634
346,WOLB.0323.00143,1,190234,191894,-,1660
346,WOLB.0323.00106,1,190236,191896,-,1660
346,WOLB.0323.00121,1,1307149,1308809,+,1660
346,WOLB.0323.00135,1,589286,590945,-,1659
346,WOLB.0323.00103,1,1180960,1182619,+,1659
346,WOLB.0323.00107,1,1179519,1181178,+,1659
346,WOLB.0323.00019,1,228498,230148,-,1650
346,WOLB.0323.00060,1,1055331,1056987,+,1656
346,WOLB.0323.00074,1,1204529,1206199,+,1670
346,WOLB.0323.00120,1,1196804,1198474,+,1670
346,WOLB.0323.00039,1,1012710,1014360,-,1650
346,WOLB.0323.00041,1,451994,453663,-,1669
346,WOLB.0323.00031,1,595416,597077,+,1661
346,WOLB.0323.00056,1,1100933,1102593,+,1660
346,WOLB.0323.00142,1,1187196,1188856,+,1660
346,WOLB.0323.00023,1,998898,1000562,-,1664
346,WOLB.0323.00153,1,1118624,1120280,+,1656
346,WOLB.0323.00093,1,1586412,1588080,+,1668
346,WOLB.0323.00088,1,1135661,1137321,+,1660
346,WOLB.0323.00008,1,1120537,1122205,+,1668
346,WOLB.0323.00024,1,332969,334638,-,1669
346,WOLB.0323.00064,1,930235,931905,+,1670
346,WOLB.0323.00030,1,207400,209069,-,1669
346,WOLB.0323.00105,1,1180968,1182627,+,1659
346,WOLB.0323.00133,1,965500,967160,-,1660
346,WOLB.0323.00084,1,898057,899716,-,1659
346,WOLB.0323.00021,1,1465464,1467120,+,1656
346,WOLB.0323.00043,1,1422982,1424652,+,1670
346,WOLB.0323.00020,1,1079832,1081492,+,1660
346,WOLB.0323.00122,1,1265968,1267630,+,1662
346,WOLB.0323.00118,1,963049,964709,+,1660
346,WOLB.0323.00004,1,1183006,1184666,+,1660
346,WOLB.0323.00011,1,552877,554537,+,1660
346,WOLB.0323.00035,1,1073404,1075064,+,1660
346,WOLB.0323.00032,1,647067,648723,+,1656
346,WOLB.0323.00012,1,1139524,1141184,+,1660
346,WOLB.0323.00018,1,1336836,1338504,-,1668
346,WOLB.0323.00025,1,77833,79493,-,1660
346,WOLB.0323.00010,1,1474164,1475834,+,1670
346,WOLB.0323.00068,1,393757,395412,-,1655
346,WOLB.0323.00128,1,1329020,1330690,+,1670
346,WOLB.0323.00158,1,1090858,1092517,-,1659
346,WOLB.0323.00017,1,1171722,1173382,+,1660
346,WOLB.0323.00104,1,1113499,1115159,+,1660
346,WOLB.0323.00007,1,185926,187585,-,1659
346,WOLB.0323.00001,1,1180968,1182627,+,1659
346,WOLB.0323.00100,1,1457943,1459603,+,1660
346,WOLB.0323.00070,1,1660740,1662410,+,1670
346,WOLB.0323.00006,1,696492,698152,-,1660
346,WOLB.0323.00042,1,1334310,1335979,-,1669
346,WOLB.0323.00119,1,228383,230033,-,1650
346,WOLB.0323.00149,1,660099,661758,-,1659
346,WOLB.0323.00014,1,1675729,1677399,+,1670
346,WOLB.0323.00096,1,463849,465518,-,1669
347,WOLB.0323.00090,1,1044129,1044798,+,669
347,WOLB.0323.00002,1,1350119,1350788,+,669
347,WOLB.0323.00138,1,801564,802234,-,670
347,WOLB.0323.00132,1,1022071,1022740,+,669
347,WOLB.0323.00143,1,189214,189896,-,682
347,WOLB.0323.00106,1,189216,189898,-,682
347,WOLB.0323.00121,1,1309147,1309816,+,669
347,WOLB.0323.00135,1,588278,588948,-,670
347,WOLB.0323.00103,1,1182958,1183631,+,673
347,WOLB.0323.00107,1,1181517,1182190,+,673
347,WOLB.0323.00019,1,224750,225420,-,670
347,WOLB.0323.00060,1,1057325,1057994,+,669
347,WOLB.0323.00074,1,1206537,1207225,+,688
347,WOLB.0323.00120,1,1198812,1199500,+,688
347,WOLB.0323.00039,1,1010411,1011081,-,670
347,WOLB.0323.00041,1,450967,451629,-,662
347,WOLB.0323.00031,1,597415,598097,+,682
347,WOLB.0323.00056,1,1102931,1103600,+,669
347,WOLB.0323.00142,1,1189194,1189863,+,669
347,WOLB.0323.00023,1,997890,998560,-,670
347,WOLB.0323.00153,1,1120618,1121287,+,669
347,WOLB.0323.00093,1,1589834,1590503,+,669
347,WOLB.0323.00088,1,1137659,1138328,+,669
347,WOLB.0323.00008,1,1122544,1123213,+,669
347,WOLB.0323.00024,1,330568,331231,-,663
347,WOLB.0323.00064,1,932243,932912,+,669
347,WOLB.0323.00030,1,206392,207062,-,670
347,WOLB.0323.00105,1,1182966,1183639,+,673
347,WOLB.0323.00133,1,964491,965158,-,667
347,WOLB.0323.00084,1,897049,897719,-,670
347,WOLB.0323.00021,1,1467458,1468127,+,669
347,WOLB.0323.00043,1,1424990,1425659,+,669
347,WOLB.0323.00020,1,1081830,1082499,+,669
347,WOLB.0323.00122,1,1267968,1268637,+,669
347,WOLB.0323.00118,1,965047,965716,+,669
347,WOLB.0323.00004,1,1185004,1185673,+,669
347,WOLB.0323.00011,1,554875,555544,+,669
347,WOLB.0323.00035,1,1075402,1076071,+,669
347,WOLB.0323.00032,1,649061,649730,+,669
347,WOLB.0323.00012,1,1141522,1142191,+,669
347,WOLB.0323.00018,1,1335828,1336498,-,670
347,WOLB.0323.00025,1,138517,139186,+,669
347,WOLB.0323.00010,1,1476172,1476841,+,669
347,WOLB.0323.00068,1,392749,393419,-,670
347,WOLB.0323.00128,1,1331028,1331697,+,669
347,WOLB.0323.00158,1,1089850,1090520,-,670
347,WOLB.0323.00017,1,1173720,1174389,+,669
347,WOLB.0323.00104,1,1115497,1116166,+,669
347,WOLB.0323.00007,1,184918,185588,-,670
347,WOLB.0323.00001,1,1182966,1183639,+,673
347,WOLB.0323.00100,1,1459941,1460610,+,669
347,WOLB.0323.00070,1,1662748,1663417,+,669
347,WOLB.0323.00006,1,695472,696154,-,682
347,WOLB.0323.00042,1,1333302,1333972,-,670
347,WOLB.0323.00119,1,63622,64291,+,669
347,WOLB.0323.00149,1,659091,659761,-,670
347,WOLB.0323.00014,1,1677737,1678406,+,669
347,WOLB.0323.00096,1,462822,463484,-,662
348,WOLB.0323.00090,1,1046666,1050858,+,4192
348,WOLB.0323.00002,1,1352665,1356848,+,4183
348,WOLB.0323.00138,1,795506,799697,-,4191
348,WOLB.0323.00132,1,1024608,1028800,+,4192
348,WOLB.0323.00143,1,183167,187350,-,4183
348,WOLB.0323.00106,1,183169,187352,-,4183
348,WOLB.0323.00121,1,1311684,1315876,+,4192
348,WOLB.0323.00135,1,582219,586411,-,4192
348,WOLB.0323.00103,1,1185500,1189632,+,4132
348,WOLB.0323.00107,1,1184059,1188191,+,4132
348,WOLB.0323.00019,1,1203090,1207250,-,4160
348,WOLB.0323.00060,1,1059863,1064054,+,4191
348,WOLB.0323.00074,1,1209081,1213267,+,4186
348,WOLB.0323.00120,1,1201356,1205542,+,4186
348,WOLB.0323.00039,1,1004363,1008523,-,4160
348,WOLB.0323.00041,1,444926,449112,-,4186
348,WOLB.0323.00031,1,599961,604144,+,4183
348,WOLB.0323.00056,1,1105473,1109660,+,4187
348,WOLB.0323.00142,1,1191731,1195923,+,4192
348,WOLB.0323.00023,1,991831,996023,-,4192
348,WOLB.0323.00153,1,1123155,1127347,+,4192
348,WOLB.0323.00093,1,1592372,1596536,+,4164
348,WOLB.0323.00088,1,1140196,1144368,+,4172
348,WOLB.0323.00008,1,1125082,1129268,+,4186
348,WOLB.0323.00024,1,324337,328366,-,4029
348,WOLB.0323.00064,1,934780,938972,+,4192
348,WOLB.0323.00030,1,200333,204525,-,4192
348,WOLB.0323.00105,1,1185508,1189640,+,4132
348,WOLB.0323.00133,1,958494,962623,-,4129
348,WOLB.0323.00084,1,890991,895182,-,4191
348,WOLB.0323.00021,1,1469995,1474186,+,4191
348,WOLB.0323.00043,1,1427536,1431719,+,4183
348,WOLB.0323.00020,1,1084367,1088539,+,4172
348,WOLB.0323.00122,1,1270505,1274697,+,4192
348,WOLB.0323.00118,1,967585,971776,+,4191
348,WOLB.0323.00004,1,1187541,1191733,+,4192
348,WOLB.0323.00011,1,557412,561604,+,4192
348,WOLB.0323.00035,1,1077939,1082111,+,4172
348,WOLB.0323.00032,1,651598,655789,+,4191
348,WOLB.0323.00012,1,1144059,1148231,+,4172
348,WOLB.0323.00018,1,1329776,1333961,-,4185
348,WOLB.0323.00025,1,141012,145196,+,4184
348,WOLB.0323.00010,1,1478717,1482900,+,4183
348,WOLB.0323.00068,1,386691,390882,-,4191
348,WOLB.0323.00128,1,1333574,1337757,+,4183
348,WOLB.0323.00158,1,1083791,1087983,-,4192
348,WOLB.0323.00017,1,1176257,1180449,+,4192
348,WOLB.0323.00104,1,1118034,1122206,+,4172
348,WOLB.0323.00007,1,178859,183050,-,4191
348,WOLB.0323.00001,1,1185508,1189640,+,4132
348,WOLB.0323.00100,1,1462478,1466650,+,4172
348,WOLB.0323.00070,1,1665294,1669477,+,4183
348,WOLB.0323.00006,1,689425,693616,-,4191
348,WOLB.0323.00042,1,1327250,1331434,-,4184
348,WOLB.0323.00119,1,1276219,1280379,-,4160
348,WOLB.0323.00149,1,653032,657224,-,4192
348,WOLB.0323.00014,1,1680283,1684466,+,4183
348,WOLB.0323.00096,1,456781,460967,-,4186
349,WOLB.0323.00090,1,1059784,1069980,+,10196
349,WOLB.0323.00002,1,1367968,1378146,+,10178
349,WOLB.0323.00138,1,772600,782796,-,10196
349,WOLB.0323.00132,1,1037297,1047475,+,10178
349,WOLB.0323.00143,1,154080,164273,+,10193
349,WOLB.0323.00106,1,154082,164275,+,10193
349,WOLB.0323.00121,1,1327211,1337407,+,10196
349,WOLB.0323.00135,1,561897,572093,-,10196
349,WOLB.0323.00103,1,76912,87105,-,10193
349,WOLB.0323.00107,1,76911,87104,-,10193
349,WOLB.0323.00019,1,147140,157336,+,10196
349,WOLB.0323.00060,1,1074182,1084378,+,10196
349,WOLB.0323.00074,1,1181581,1191743,-,10162
349,WOLB.0323.00120,1,1173856,1184018,-,10162
349,WOLB.0323.00039,1,983244,993443,-,10199
349,WOLB.0323.00041,1,466450,476612,+,10162
349,WOLB.0323.00031,1,623038,633231,-,10193
349,WOLB.0323.00056,1,1119814,1130012,+,10198
349,WOLB.0323.00142,1,1207258,1217454,+,10196
349,WOLB.0323.00023,1,915342,925559,+,10217
349,WOLB.0323.00153,1,1137500,1147696,+,10196
349,WOLB.0323.00093,1,1608519,1618715,+,10196
349,WOLB.0323.00088,1,1154521,1164717,+,10196
349,WOLB.0323.00008,1,1132518,1142699,+,10181
349,WOLB.0323.00024,1,288365,298532,-,10167
349,WOLB.0323.00064,1,948204,958382,+,10178
349,WOLB.0323.00030,1,180923,191101,-,10178
349,WOLB.0323.00105,1,76912,87105,-,10193
349,WOLB.0323.00133,1,917640,927836,-,10196
349,WOLB.0323.00084,1,869490,879686,-,10196
349,WOLB.0323.00021,1,1486914,1497110,+,10196
349,WOLB.0323.00043,1,1447351,1457529,+,10178
349,WOLB.0323.00020,1,1098692,1108888,+,10196
349,WOLB.0323.00122,1,1292610,1302806,+,10196
349,WOLB.0323.00118,1,1105196,1115392,+,10196
349,WOLB.0323.00004,1,1203068,1213264,+,10196
349,WOLB.0323.00011,1,572939,583135,+,10196
349,WOLB.0323.00035,1,1092264,1102460,+,10196
349,WOLB.0323.00032,1,668499,678695,+,10196
349,WOLB.0323.00012,1,1158384,1168580,+,10196
349,WOLB.0323.00018,1,1309450,1319629,-,10179
349,WOLB.0323.00025,1,900798,910990,-,10192
349,WOLB.0323.00010,1,1492859,1503038,+,10179
349,WOLB.0323.00068,1,362032,372229,-,10197
349,WOLB.0323.00128,1,1347648,1357826,+,10178
349,WOLB.0323.00158,1,1062260,1072456,-,10196
349,WOLB.0323.00017,1,1193751,1203947,+,10196
349,WOLB.0323.00104,1,1132359,1142555,+,10196
349,WOLB.0323.00007,1,158499,168695,-,10196
349,WOLB.0323.00001,1,76912,87105,-,10193
349,WOLB.0323.00100,1,1476803,1486999,+,10196
349,WOLB.0323.00070,1,1680445,1690623,+,10178
349,WOLB.0323.00006,1,836300,846493,-,10193
349,WOLB.0323.00042,1,1304939,1315138,-,10199
349,WOLB.0323.00119,1,131706,141902,-,10196
349,WOLB.0323.00149,1,631501,641697,-,10196
349,WOLB.0323.00014,1,1695434,1705603,+,10169
349,WOLB.0323.00096,1,478305,488467,+,10162
350,WOLB.0323.00090,1,1070541,1071337,+,796
350,WOLB.0323.00153,1,1148257,1149053,+,796
350,WOLB.0323.00118,1,1115953,1116749,+,796
351,WOLB.0323.00090,1,1071549,1073430,+,1881
351,WOLB.0323.00002,1,1379540,1381430,+,1890
351,WOLB.0323.00138,1,769894,771784,-,1890
351,WOLB.0323.00132,1,1048868,1050758,+,1890
351,WOLB.0323.00143,1,164837,166724,+,1887
351,WOLB.0323.00106,1,164839,166726,+,1887
351,WOLB.0323.00121,1,1338223,1340113,+,1890
351,WOLB.0323.00135,1,559200,561081,-,1881
351,WOLB.0323.00103,1,73409,75291,-,1882
351,WOLB.0323.00107,1,73408,75290,-,1882
351,WOLB.0323.00019,1,158960,160847,+,1887
351,WOLB.0323.00060,1,1085194,1087075,+,1881
351,WOLB.0323.00074,1,1177375,1179265,-,1890
351,WOLB.0323.00120,1,1169650,1171540,-,1890
351,WOLB.0323.00039,1,979733,981623,-,1890
351,WOLB.0323.00041,1,478928,480818,+,1890
351,WOLB.0323.00031,1,620587,622474,-,1887
351,WOLB.0323.00056,1,1130828,1132709,+,1881
351,WOLB.0323.00142,1,1218270,1220160,+,1890
351,WOLB.0323.00023,1,926952,928842,+,1890
351,WOLB.0323.00153,1,1149265,1151146,+,1881
351,WOLB.0323.00093,1,1620336,1622226,+,1890
351,WOLB.0323.00088,1,1165533,1167414,+,1881
351,WOLB.0323.00008,1,1145619,1147509,+,1890
351,WOLB.0323.00024,1,285074,286964,-,1890
351,WOLB.0323.00064,1,959775,961665,+,1890
351,WOLB.0323.00030,1,177640,179530,-,1890
351,WOLB.0323.00105,1,73409,75291,-,1882
351,WOLB.0323.00133,1,914236,916096,-,1860
351,WOLB.0323.00084,1,866784,868674,-,1890
351,WOLB.0323.00021,1,1497926,1499816,+,1890
351,WOLB.0323.00043,1,1458923,1460813,+,1890
351,WOLB.0323.00020,1,1109704,1111585,+,1881
351,WOLB.0323.00122,1,1303622,1305512,+,1890
351,WOLB.0323.00118,1,1116961,1118842,+,1881
351,WOLB.0323.00004,1,1214080,1215970,+,1890
351,WOLB.0323.00011,1,583951,585841,+,1890
351,WOLB.0323.00035,1,1103276,1105157,+,1881
351,WOLB.0323.00032,1,679493,681383,+,1890
351,WOLB.0323.00012,1,1169396,1171277,+,1881
351,WOLB.0323.00018,1,1306999,1308889,-,1890
351,WOLB.0323.00025,1,898088,899978,-,1890
351,WOLB.0323.00010,1,1504431,1506321,+,1890
351,WOLB.0323.00068,1,359326,361216,-,1890
351,WOLB.0323.00128,1,1359220,1361110,+,1890
351,WOLB.0323.00158,1,1059554,1061444,-,1890
351,WOLB.0323.00017,1,1204763,1206653,+,1890
351,WOLB.0323.00104,1,1144313,1146194,+,1881
351,WOLB.0323.00007,1,155802,157683,-,1881
351,WOLB.0323.00001,1,73409,75291,-,1882
351,WOLB.0323.00100,1,1487815,1489696,+,1881
351,WOLB.0323.00070,1,1692017,1693907,+,1890
351,WOLB.0323.00006,1,833849,835736,-,1887
351,WOLB.0323.00042,1,1301656,1303546,-,1890
351,WOLB.0323.00119,1,128195,130082,-,1887
351,WOLB.0323.00149,1,628795,630685,-,1890
351,WOLB.0323.00014,1,1706997,1708887,+,1890
351,WOLB.0323.00096,1,490783,492673,+,1890
351,WOLB.0323.00096,1,499657,501513,-,1856
351,WOLB.0323.00096,1,501520,503410,+,1890
352,WOLB.0323.00090,1,1073488,1080243,+,6755
352,WOLB.0323.00002,1,1381479,1388237,+,6758
352,WOLB.0323.00138,1,763090,769845,-,6755
352,WOLB.0323.00132,1,1050807,1057565,+,6758
352,WOLB.0323.00143,1,166773,173548,+,6775
352,WOLB.0323.00106,1,166775,173550,+,6775
352,WOLB.0323.00121,1,1340162,1346917,+,6755
352,WOLB.0323.00135,1,552367,559142,-,6775
352,WOLB.0323.00103,1,66577,73352,-,6775
352,WOLB.0323.00107,1,66577,73351,-,6774
352,WOLB.0323.00019,1,160896,167671,+,6775
352,WOLB.0323.00060,1,1087133,1093908,+,6775
352,WOLB.0323.00074,1,1170551,1177326,-,6775
352,WOLB.0323.00120,1,1162826,1169601,-,6775
352,WOLB.0323.00039,1,972909,979684,-,6775
352,WOLB.0323.00041,1,480867,487642,+,6775
352,WOLB.0323.00031,1,613763,620538,-,6775
352,WOLB.0323.00056,1,1132767,1139542,+,6775
352,WOLB.0323.00142,1,1220209,1226964,+,6755
352,WOLB.0323.00023,1,928891,935649,+,6758
352,WOLB.0323.00153,1,1151204,1157959,+,6755
352,WOLB.0323.00093,1,1622285,1629057,+,6772
352,WOLB.0323.00088,1,1167472,1174247,+,6775
352,WOLB.0323.00008,1,1147568,1154342,+,6774
352,WOLB.0323.00024,1,278254,285025,-,6771
352,WOLB.0323.00064,1,961714,968472,+,6758
352,WOLB.0323.00030,1,170833,177591,-,6758
352,WOLB.0323.00105,1,66577,73352,-,6775
352,WOLB.0323.00133,1,907382,914157,-,6775
352,WOLB.0323.00084,1,859980,866735,-,6755
352,WOLB.0323.00021,1,1499865,1506620,+,6755
352,WOLB.0323.00043,1,1460862,1467620,+,6758
352,WOLB.0323.00020,1,1111643,1118418,+,6775
352,WOLB.0323.00122,1,1305561,1312336,+,6775
352,WOLB.0323.00118,1,1118900,1125675,+,6775
352,WOLB.0323.00004,1,1216019,1222774,+,6755
352,WOLB.0323.00011,1,585890,592645,+,6755
352,WOLB.0323.00035,1,1105215,1111990,+,6775
352,WOLB.0323.00032,1,681432,688187,+,6755
352,WOLB.0323.00012,1,1171335,1178110,+,6775
352,WOLB.0323.00018,1,1300192,1306950,-,6758
352,WOLB.0323.00025,1,891264,898039,-,6775
352,WOLB.0323.00010,1,1506370,1513128,+,6758
352,WOLB.0323.00068,1,352522,359277,-,6755
352,WOLB.0323.00128,1,1361159,1367917,+,6758
352,WOLB.0323.00158,1,1052750,1059505,-,6755
352,WOLB.0323.00017,1,1206702,1213457,+,6755
352,WOLB.0323.00104,1,1146252,1153027,+,6775
352,WOLB.0323.00007,1,148969,155744,-,6775
352,WOLB.0323.00001,1,66577,73352,-,6775
352,WOLB.0323.00100,1,1489754,1496529,+,6775
352,WOLB.0323.00070,1,1693956,1700714,+,6758
352,WOLB.0323.00006,1,827025,833800,-,6775
352,WOLB.0323.00042,1,1294849,1301607,-,6758
352,WOLB.0323.00119,1,121371,128146,-,6775
352,WOLB.0323.00149,1,621991,628746,-,6755
352,WOLB.0323.00014,1,1708936,1715694,+,6758
352,WOLB.0323.00096,1,492784,499563,-,6779
352,WOLB.0323.00096,1,503459,510234,+,6775
353,WOLB.0323.00090,1,1080244,1082092,+,1848
353,WOLB.0323.00002,1,1388238,1390086,+,1848
353,WOLB.0323.00138,1,761241,763088,-,1847
353,WOLB.0323.00132,1,1057566,1059414,+,1848
353,WOLB.0323.00143,1,173549,175397,+,1848
353,WOLB.0323.00106,1,173551,175399,+,1848
353,WOLB.0323.00121,1,1346918,1348766,+,1848
353,WOLB.0323.00135,1,550518,552365,-,1847
353,WOLB.0323.00103,1,64728,66575,-,1847
353,WOLB.0323.00107,1,64728,66575,-,1847
353,WOLB.0323.00019,1,167672,169520,+,1848
353,WOLB.0323.00060,1,1093909,1095752,+,1843
353,WOLB.0323.00074,1,1168702,1170549,-,1847
353,WOLB.0323.00120,1,1160977,1162824,-,1847
353,WOLB.0323.00039,1,971060,972907,-,1847
353,WOLB.0323.00041,1,487643,489491,+,1848
353,WOLB.0323.00031,1,611914,613761,-,1847
353,WOLB.0323.00056,1,1139543,1141391,+,1848
353,WOLB.0323.00142,1,1226965,1228813,+,1848
353,WOLB.0323.00023,1,935650,937498,+,1848
353,WOLB.0323.00153,1,1157960,1159808,+,1848
353,WOLB.0323.00093,1,1629058,1630906,+,1848
353,WOLB.0323.00088,1,1174248,1176096,+,1848
353,WOLB.0323.00008,1,1154343,1156192,+,1849
353,WOLB.0323.00024,1,276405,278252,-,1847
353,WOLB.0323.00064,1,968473,970321,+,1848
353,WOLB.0323.00030,1,168984,170831,-,1847
353,WOLB.0323.00105,1,64728,66575,-,1847
353,WOLB.0323.00133,1,905550,907380,-,1830
353,WOLB.0323.00084,1,858131,859978,-,1847
353,WOLB.0323.00021,1,1506621,1508469,+,1848
353,WOLB.0323.00043,1,1467621,1469469,+,1848
353,WOLB.0323.00020,1,1118419,1120267,+,1848
353,WOLB.0323.00122,1,1312337,1314185,+,1848
353,WOLB.0323.00118,1,1125676,1127524,+,1848
353,WOLB.0323.00004,1,1222775,1224623,+,1848
353,WOLB.0323.00011,1,592646,594494,+,1848
353,WOLB.0323.00035,1,1111991,1113839,+,1848
353,WOLB.0323.00032,1,688188,690036,+,1848
353,WOLB.0323.00012,1,1178111,1179959,+,1848
353,WOLB.0323.00018,1,1298343,1300190,-,1847
353,WOLB.0323.00025,1,889415,891262,-,1847
353,WOLB.0323.00010,1,1513129,1514977,+,1848
353,WOLB.0323.00068,1,350673,352520,-,1847
353,WOLB.0323.00128,1,1367918,1369766,+,1848
353,WOLB.0323.00158,1,1050901,1052748,-,1847
353,WOLB.0323.00017,1,1213458,1215306,+,1848
353,WOLB.0323.00104,1,1153028,1154876,+,1848
353,WOLB.0323.00007,1,147120,148967,-,1847
353,WOLB.0323.00001,1,64728,66575,-,1847
353,WOLB.0323.00100,1,1496530,1498378,+,1848
353,WOLB.0323.00070,1,1700715,1702563,+,1848
353,WOLB.0323.00006,1,825176,827023,-,1847
353,WOLB.0323.00042,1,1293000,1294847,-,1847
353,WOLB.0323.00119,1,119522,121369,-,1847
353,WOLB.0323.00149,1,620142,621989,-,1847
353,WOLB.0323.00014,1,1715695,1717543,+,1848
353,WOLB.0323.00096,1,510235,512083,+,1848
354,WOLB.0323.00090,1,1082629,1085304,+,2675
354,WOLB.0323.00002,1,1390620,1393295,+,2675
354,WOLB.0323.00138,1,758028,760704,-,2676
354,WOLB.0323.00132,1,1059948,1062623,+,2675
354,WOLB.0323.00143,1,175931,178606,+,2675
354,WOLB.0323.00106,1,175933,178608,+,2675
354,WOLB.0323.00121,1,1349303,1351978,+,2675
354,WOLB.0323.00135,1,547305,549981,-,2676
354,WOLB.0323.00103,1,61518,64194,-,2676
354,WOLB.0323.00107,1,61518,64194,-,2676
354,WOLB.0323.00019,1,170054,172729,+,2675
354,WOLB.0323.00060,1,1096289,1098964,+,2675
354,WOLB.0323.00074,1,1165492,1168168,-,2676
354,WOLB.0323.00120,1,1157767,1160443,-,2676
354,WOLB.0323.00039,1,967850,970526,-,2676
354,WOLB.0323.00041,1,490025,492700,+,2675
354,WOLB.0323.00031,1,608704,611380,-,2676
354,WOLB.0323.00056,1,1141928,1144603,+,2675
354,WOLB.0323.00142,1,1229350,1232025,+,2675
354,WOLB.0323.00023,1,938032,940707,+,2675
354,WOLB.0323.00153,1,1160345,1163020,+,2675
354,WOLB.0323.00093,1,1631440,1634115,+,2675
354,WOLB.0323.00088,1,1176633,1179308,+,2675
354,WOLB.0323.00008,1,1156632,1159323,+,2691
354,WOLB.0323.00024,1,273180,275871,-,2691
354,WOLB.0323.00064,1,970855,973530,+,2675
354,WOLB.0323.00030,1,165774,168450,-,2676
354,WOLB.0323.00105,1,61518,64194,-,2676
354,WOLB.0323.00133,1,902329,905005,-,2676
354,WOLB.0323.00084,1,854918,857594,-,2676
354,WOLB.0323.00021,1,1509006,1511681,+,2675
354,WOLB.0323.00043,1,1470003,1472678,+,2675
354,WOLB.0323.00020,1,1120804,1123479,+,2675
354,WOLB.0323.00122,1,1314722,1317397,+,2675
354,WOLB.0323.00118,1,1128061,1130736,+,2675
354,WOLB.0323.00004,1,1225160,1227835,+,2675
354,WOLB.0323.00011,1,595031,597706,+,2675
354,WOLB.0323.00035,1,1114376,1117051,+,2675
354,WOLB.0323.00032,1,690573,693248,+,2675
354,WOLB.0323.00012,1,1180496,1183171,+,2675
354,WOLB.0323.00018,1,1295133,1297809,-,2676
354,WOLB.0323.00025,1,886205,888881,-,2676
354,WOLB.0323.00010,1,1515511,1518186,+,2675
354,WOLB.0323.00068,1,347460,350136,-,2676
354,WOLB.0323.00128,1,1370300,1372975,+,2675
354,WOLB.0323.00158,1,1047688,1050364,-,2676
354,WOLB.0323.00017,1,1215843,1218518,+,2675
354,WOLB.0323.00104,1,1155413,1158088,+,2675
354,WOLB.0323.00007,1,143907,146583,-,2676
354,WOLB.0323.00001,1,61518,64194,-,2676
354,WOLB.0323.00100,1,1498915,1501590,+,2675
354,WOLB.0323.00070,1,1703097,1705772,+,2675
354,WOLB.0323.00006,1,821966,824642,-,2676
354,WOLB.0323.00042,1,1289790,1292466,-,2676
354,WOLB.0323.00119,1,116312,118988,-,2676
354,WOLB.0323.00149,1,616929,619605,-,2676
354,WOLB.0323.00014,1,1718077,1720752,+,2675
354,WOLB.0323.00096,1,512617,515292,+,2675
355,WOLB.0323.00090,1,1085306,1086651,+,1345
355,WOLB.0323.00002,1,1393297,1394642,+,1345
355,WOLB.0323.00138,1,756682,758027,-,1345
355,WOLB.0323.00132,1,1062625,1063970,+,1345
355,WOLB.0323.00143,1,178608,179953,+,1345
355,WOLB.0323.00106,1,178610,179955,+,1345
355,WOLB.0323.00121,1,1351980,1353325,+,1345
355,WOLB.0323.00135,1,545959,547304,-,1345
355,WOLB.0323.00103,1,60173,61517,-,1344
355,WOLB.0323.00107,1,60173,61517,-,1344
355,WOLB.0323.00019,1,172731,174076,+,1345
355,WOLB.0323.00060,1,1098966,1100311,+,1345
355,WOLB.0323.00074,1,1164145,1165491,-,1346
355,WOLB.0323.00120,1,1156420,1157766,-,1346
355,WOLB.0323.00039,1,966504,967849,-,1345
355,WOLB.0323.00041,1,492702,494048,+,1346
355,WOLB.0323.00031,1,607358,608703,-,1345
355,WOLB.0323.00056,1,1144605,1145950,+,1345
355,WOLB.0323.00142,1,1232027,1233372,+,1345
355,WOLB.0323.00023,1,940709,942054,+,1345
355,WOLB.0323.00153,1,1163022,1164367,+,1345
355,WOLB.0323.00093,1,1634117,1635462,+,1345
355,WOLB.0323.00088,1,1179310,1180656,+,1346
355,WOLB.0323.00008,1,1159325,1160670,+,1345
355,WOLB.0323.00024,1,245820,247136,+,1316
355,WOLB.0323.00064,1,973532,974877,+,1345
355,WOLB.0323.00030,1,164428,165773,-,1345
355,WOLB.0323.00105,1,60173,61517,-,1344
355,WOLB.0323.00133,1,900983,902328,-,1345
355,WOLB.0323.00084,1,853572,854917,-,1345
355,WOLB.0323.00021,1,1511683,1513028,+,1345
355,WOLB.0323.00043,1,1472680,1474025,+,1345
355,WOLB.0323.00020,1,1123481,1124827,+,1346
355,WOLB.0323.00122,1,1317399,1318744,+,1345
355,WOLB.0323.00118,1,1130738,1132083,+,1345
355,WOLB.0323.00004,1,1227837,1229182,+,1345
355,WOLB.0323.00011,1,597708,599053,+,1345
355,WOLB.0323.00035,1,1117053,1118399,+,1346
355,WOLB.0323.00032,1,693250,694595,+,1345
355,WOLB.0323.00012,1,1183173,1184519,+,1346
355,WOLB.0323.00018,1,1293787,1295132,-,1345
355,WOLB.0323.00025,1,884878,886204,-,1326
355,WOLB.0323.00010,1,1518188,1519536,+,1348
355,WOLB.0323.00068,1,346114,347459,-,1345
355,WOLB.0323.00128,1,1372977,1374322,+,1345
355,WOLB.0323.00158,1,1046342,1047687,-,1345
355,WOLB.0323.00017,1,1218520,1219865,+,1345
355,WOLB.0323.00104,1,1158090,1159436,+,1346
355,WOLB.0323.00007,1,142561,143906,-,1345
355,WOLB.0323.00001,1,60173,61517,-,1344
355,WOLB.0323.00100,1,1501592,1502938,+,1346
355,WOLB.0323.00070,1,1705774,1707119,+,1345
355,WOLB.0323.00006,1,820626,821965,-,1339
355,WOLB.0323.00042,1,1288444,1289789,-,1345
355,WOLB.0323.00119,1,114966,116311,-,1345
355,WOLB.0323.00149,1,615583,616928,-,1345
355,WOLB.0323.00014,1,1720754,1722099,+,1345
355,WOLB.0323.00096,1,515294,516640,+,1346
356,WOLB.0323.00090,1,1087293,1089097,+,1804
356,WOLB.0323.00002,1,1395284,1397088,+,1804
356,WOLB.0323.00138,1,754236,756040,-,1804
356,WOLB.0323.00132,1,1064612,1066411,+,1799
356,WOLB.0323.00143,1,381862,383668,-,1806
356,WOLB.0323.00106,1,381865,383671,-,1806
356,WOLB.0323.00121,1,1353967,1355771,+,1804
356,WOLB.0323.00135,1,543513,545317,-,1804
356,WOLB.0323.00103,1,55647,57450,-,1803
356,WOLB.0323.00107,1,55647,57450,-,1803
356,WOLB.0323.00019,1,174718,176523,+,1805
356,WOLB.0323.00060,1,1100953,1102750,+,1797
356,WOLB.0323.00074,1,1161958,1163764,-,1806
356,WOLB.0323.00120,1,1154233,1156039,-,1806
356,WOLB.0323.00039,1,964056,965862,-,1806
356,WOLB.0323.00041,1,494429,496235,+,1806
356,WOLB.0323.00031,1,403642,405448,+,1806
356,WOLB.0323.00056,1,1146592,1148389,+,1797
356,WOLB.0323.00142,1,1234014,1235818,+,1804
356,WOLB.0323.00023,1,942696,944495,+,1799
356,WOLB.0323.00153,1,1165009,1166813,+,1804
356,WOLB.0323.00093,1,1636104,1637903,+,1799
356,WOLB.0323.00088,1,1181298,1183102,+,1804
356,WOLB.0323.00008,1,1161416,1163222,+,1806
356,WOLB.0323.00024,1,247778,249576,+,1798
356,WOLB.0323.00064,1,975519,977318,+,1799
356,WOLB.0323.00030,1,161987,163786,-,1799
356,WOLB.0323.00105,1,55647,57450,-,1803
356,WOLB.0323.00133,1,898535,900341,-,1806
356,WOLB.0323.00084,1,851126,852930,-,1804
356,WOLB.0323.00021,1,1513670,1515474,+,1804
356,WOLB.0323.00043,1,1474667,1476471,+,1804
356,WOLB.0323.00020,1,1125469,1127273,+,1804
356,WOLB.0323.00122,1,1319386,1321190,+,1804
356,WOLB.0323.00118,1,1132725,1134529,+,1804
356,WOLB.0323.00004,1,1229824,1231628,+,1804
356,WOLB.0323.00011,1,599695,601499,+,1804
356,WOLB.0323.00035,1,1119041,1120845,+,1804
356,WOLB.0323.00032,1,695237,697041,+,1804
356,WOLB.0323.00012,1,1185161,1186965,+,1804
356,WOLB.0323.00018,1,1291341,1293145,-,1804
356,WOLB.0323.00025,1,882674,884480,-,1806
356,WOLB.0323.00010,1,1520177,1521983,+,1806
356,WOLB.0323.00068,1,343668,345472,-,1804
356,WOLB.0323.00128,1,1374964,1376768,+,1804
356,WOLB.0323.00158,1,1043896,1045700,-,1804
356,WOLB.0323.00017,1,1220507,1222311,+,1804
356,WOLB.0323.00104,1,1160078,1161882,+,1804
356,WOLB.0323.00007,1,140122,141919,-,1797
356,WOLB.0323.00001,1,55647,57450,-,1803
356,WOLB.0323.00100,1,1503580,1505384,+,1804
356,WOLB.0323.00070,1,1707761,1709565,+,1804
356,WOLB.0323.00006,1,752877,754683,+,1806
356,WOLB.0323.00042,1,1286003,1287802,-,1799
356,WOLB.0323.00119,1,112519,114324,-,1805
356,WOLB.0323.00149,1,613137,614941,-,1804
356,WOLB.0323.00014,1,1722741,1724545,+,1804
356,WOLB.0323.00096,1,517021,518827,+,1806
357,WOLB.0323.00090,1,1091962,1092918,+,956
357,WOLB.0323.00002,1,1399018,1399973,+,955
357,WOLB.0323.00138,1,750415,751371,-,956
357,WOLB.0323.00132,1,1069149,1070105,+,956
357,WOLB.0323.00143,1,385960,386916,-,956
357,WOLB.0323.00106,1,385963,386919,-,956
357,WOLB.0323.00121,1,1358636,1359592,+,956
357,WOLB.0323.00135,1,539693,540648,-,955
357,WOLB.0323.00103,1,1425471,1426427,+,956
357,WOLB.0323.00107,1,1423898,1424854,+,956
357,WOLB.0323.00019,1,125265,126208,+,943
357,WOLB.0323.00060,1,1246440,1247396,-,956
357,WOLB.0323.00074,1,1157321,1158276,-,955
357,WOLB.0323.00120,1,1149596,1150551,-,955
357,WOLB.0323.00039,1,960241,961184,-,943
357,WOLB.0323.00041,1,499917,500872,+,955
357,WOLB.0323.00031,1,400394,401350,+,956
357,WOLB.0323.00056,1,1154562,1155518,+,956
357,WOLB.0323.00142,1,1238542,1239498,+,956
357,WOLB.0323.00023,1,948496,949452,+,956
357,WOLB.0323.00153,1,1169678,1170634,+,956
357,WOLB.0323.00093,1,1641286,1642242,+,956
357,WOLB.0323.00088,1,1185967,1186923,+,956
357,WOLB.0323.00008,1,1167495,1168450,+,955
357,WOLB.0323.00024,1,256888,257843,+,955
357,WOLB.0323.00064,1,979508,980451,+,943
357,WOLB.0323.00030,1,158854,159797,-,943
357,WOLB.0323.00105,1,1425625,1426581,+,956
357,WOLB.0323.00133,1,894709,895652,-,943
357,WOLB.0323.00084,1,847304,848261,-,957
357,WOLB.0323.00021,1,1518339,1519295,+,956
357,WOLB.0323.00043,1,1478401,1479356,+,955
357,WOLB.0323.00020,1,1130138,1131094,+,956
357,WOLB.0323.00122,1,1324055,1325010,+,955
357,WOLB.0323.00118,1,1137394,1138349,+,955
357,WOLB.0323.00004,1,1234493,1235449,+,956
357,WOLB.0323.00011,1,604364,605320,+,956
357,WOLB.0323.00035,1,1123710,1124666,+,956
357,WOLB.0323.00032,1,699906,700862,+,956
357,WOLB.0323.00012,1,1189830,1190786,+,956
357,WOLB.0323.00018,1,1288456,1289412,-,956
357,WOLB.0323.00025,1,877466,878422,-,956
357,WOLB.0323.00010,1,1524712,1525667,+,955
357,WOLB.0323.00068,1,339847,340803,-,956
357,WOLB.0323.00128,1,1378698,1379653,+,955
357,WOLB.0323.00158,1,1040075,1041031,-,956
357,WOLB.0323.00017,1,1225176,1226132,+,956
357,WOLB.0323.00104,1,1164747,1165703,+,956
357,WOLB.0323.00007,1,136803,137759,-,956
357,WOLB.0323.00001,1,1425625,1426581,+,956
357,WOLB.0323.00100,1,1508249,1509205,+,956
357,WOLB.0323.00070,1,1711495,1712450,+,955
357,WOLB.0323.00006,1,631232,632188,-,956
357,WOLB.0323.00042,1,1282343,1283273,-,930
357,WOLB.0323.00119,1,162834,163777,-,943
357,WOLB.0323.00149,1,609316,610272,-,956
357,WOLB.0323.00014,1,1726475,1727430,+,955
357,WOLB.0323.00096,1,522509,523464,+,955
358,WOLB.0323.00090,1,1094106,1094843,+,737
358,WOLB.0323.00002,1,1403819,1404557,+,738
358,WOLB.0323.00138,1,748496,749228,-,732
358,WOLB.0323.00132,1,1071287,1072025,+,738
358,WOLB.0323.00143,1,147377,148125,-,748
358,WOLB.0323.00106,1,147379,148127,-,748
358,WOLB.0323.00121,1,1360780,1361517,+,737
358,WOLB.0323.00135,1,537767,538505,-,738
358,WOLB.0323.00019,1,127391,128129,+,738
358,WOLB.0323.00060,1,1244515,1245253,-,738
358,WOLB.0323.00074,1,1155386,1156134,-,748
358,WOLB.0323.00120,1,1147661,1148409,-,748
358,WOLB.0323.00039,1,958320,959059,-,739
358,WOLB.0323.00041,1,502059,502806,+,747
358,WOLB.0323.00031,1,639186,639933,+,747
358,WOLB.0323.00056,1,1156705,1157442,+,737
358,WOLB.0323.00142,1,1240686,1241423,+,737
358,WOLB.0323.00023,1,950640,951378,+,738
358,WOLB.0323.00153,1,1171822,1172559,+,737
358,WOLB.0323.00093,1,1643424,1644150,+,726
358,WOLB.0323.00088,1,1188110,1188847,+,737
358,WOLB.0323.00008,1,1169641,1170368,+,727
358,WOLB.0323.00024,1,259034,259772,+,738
358,WOLB.0323.00064,1,981633,982371,+,738
358,WOLB.0323.00030,1,156933,157672,-,739
358,WOLB.0323.00133,1,893066,893814,-,748
358,WOLB.0323.00084,1,845385,846117,-,732
358,WOLB.0323.00021,1,1520482,1521213,+,731
358,WOLB.0323.00043,1,1743090,1743829,-,739
358,WOLB.0323.00020,1,1132281,1133018,+,737
358,WOLB.0323.00122,1,1326198,1326929,+,731
358,WOLB.0323.00118,1,1139531,1140269,+,738
358,WOLB.0323.00004,1,1236637,1237374,+,737
358,WOLB.0323.00011,1,606508,607245,+,737
358,WOLB.0323.00035,1,1125853,1126590,+,737
358,WOLB.0323.00032,1,702049,702780,+,731
358,WOLB.0323.00012,1,1191973,1192710,+,737
358,WOLB.0323.00018,1,1284961,1285688,-,727
358,WOLB.0323.00025,1,845427,846175,-,748
358,WOLB.0323.00010,1,1528138,1528876,+,738
358,WOLB.0323.00068,1,337928,338660,-,732
358,WOLB.0323.00128,1,1519855,1520594,-,739
358,WOLB.0323.00158,1,1038149,1038887,-,738
358,WOLB.0323.00017,1,1227320,1228057,+,737
358,WOLB.0323.00104,1,1166890,1167627,+,737
358,WOLB.0323.00007,1,134878,135616,-,738
358,WOLB.0323.00100,1,1510392,1511129,+,737
358,WOLB.0323.00070,1,1783709,1784448,-,739
358,WOLB.0323.00006,1,627973,628721,-,748
358,WOLB.0323.00042,1,1279485,1280217,-,732
358,WOLB.0323.00119,1,160912,161651,-,739
358,WOLB.0323.00149,1,607390,608128,-,738
358,WOLB.0323.00014,1,1800484,1801223,-,739
358,WOLB.0323.00096,1,529159,529908,-,749
358,WOLB.0323.00096,1,531302,532049,+,747
359,WOLB.0323.00090,1,1095076,1096081,+,1005
359,WOLB.0323.00002,1,1404790,1405795,+,1005
359,WOLB.0323.00138,1,747258,748264,-,1006
359,WOLB.0323.00132,1,1072258,1073263,+,1005
359,WOLB.0323.00143,1,146142,147145,-,1003
359,WOLB.0323.00106,1,146144,147147,-,1003
359,WOLB.0323.00121,1,1361750,1362755,+,1005
359,WOLB.0323.00135,1,536530,537535,-,1005
359,WOLB.0323.00103,1,1408973,1409978,+,1005
359,WOLB.0323.00107,1,1407400,1408405,+,1005
359,WOLB.0323.00019,1,128362,129367,+,1005
359,WOLB.0323.00060,1,1243278,1244283,-,1005
359,WOLB.0323.00074,1,1154151,1155154,-,1003
359,WOLB.0323.00120,1,1146426,1147429,-,1003
359,WOLB.0323.00039,1,957083,958088,-,1005
359,WOLB.0323.00041,1,503039,504042,+,1003
359,WOLB.0323.00031,1,640166,641169,+,1003
359,WOLB.0323.00056,1,1157675,1158680,+,1005
359,WOLB.0323.00142,1,1241656,1242661,+,1005
359,WOLB.0323.00023,1,951611,952616,+,1005
359,WOLB.0323.00153,1,1172792,1173797,+,1005
359,WOLB.0323.00093,1,1644383,1645393,+,1010
359,WOLB.0323.00088,1,1189080,1190085,+,1005
359,WOLB.0323.00008,1,1170466,1171460,+,994
359,WOLB.0323.00024,1,260005,261010,+,1005
359,WOLB.0323.00064,1,982604,983609,+,1005
359,WOLB.0323.00030,1,155696,156701,-,1005
359,WOLB.0323.00105,1,1409127,1410132,+,1005
359,WOLB.0323.00133,1,891829,892833,-,1004
359,WOLB.0323.00084,1,844147,845153,-,1006
359,WOLB.0323.00021,1,1521446,1522451,+,1005
359,WOLB.0323.00043,1,1741853,1742858,-,1005
359,WOLB.0323.00020,1,1133251,1134256,+,1005
359,WOLB.0323.00122,1,1327162,1328167,+,1005
359,WOLB.0323.00118,1,1140502,1141507,+,1005
359,WOLB.0323.00004,1,1237607,1238612,+,1005
359,WOLB.0323.00011,1,607478,608483,+,1005
359,WOLB.0323.00035,1,1126823,1127828,+,1005
359,WOLB.0323.00032,1,703013,704018,+,1005
359,WOLB.0323.00012,1,1192943,1193948,+,1005
359,WOLB.0323.00018,1,1283729,1284734,-,1005
359,WOLB.0323.00025,1,844192,845195,-,1003
359,WOLB.0323.00010,1,1529109,1530114,+,1005
359,WOLB.0323.00068,1,336690,337696,-,1006
359,WOLB.0323.00128,1,1518618,1519623,-,1005
359,WOLB.0323.00158,1,1036912,1037917,-,1005
359,WOLB.0323.00017,1,1228290,1229295,+,1005
359,WOLB.0323.00104,1,1167860,1168865,+,1005
359,WOLB.0323.00007,1,133641,134646,-,1005
359,WOLB.0323.00001,1,1409127,1410132,+,1005
359,WOLB.0323.00100,1,1511362,1512367,+,1005
359,WOLB.0323.00070,1,1782472,1783477,-,1005
359,WOLB.0323.00006,1,626738,627741,-,1003
359,WOLB.0323.00042,1,1278249,1279253,-,1004
359,WOLB.0323.00119,1,159675,160680,-,1005
359,WOLB.0323.00149,1,606153,607158,-,1005
359,WOLB.0323.00014,1,1799247,1800252,-,1005
359,WOLB.0323.00096,1,527927,528928,-,1001
359,WOLB.0323.00096,1,532282,533285,+,1003
360,WOLB.0323.00090,1,1096083,1096800,+,717
360,WOLB.0323.00002,1,1405797,1406514,+,717
360,WOLB.0323.00138,1,746540,747257,-,717
360,WOLB.0323.00132,1,1073265,1073982,+,717
360,WOLB.0323.00143,1,145423,146140,-,717
360,WOLB.0323.00106,1,145425,146142,-,717
360,WOLB.0323.00121,1,1362757,1363474,+,717
360,WOLB.0323.00135,1,535811,536528,-,717
360,WOLB.0323.00103,1,1409980,1410697,+,717
360,WOLB.0323.00107,1,1408407,1409124,+,717
360,WOLB.0323.00019,1,129369,130086,+,717
360,WOLB.0323.00060,1,1242559,1243276,-,717
360,WOLB.0323.00074,1,1153434,1154149,-,715
360,WOLB.0323.00120,1,1144827,1145532,-,705
360,WOLB.0323.00120,1,1145709,1146424,-,715
360,WOLB.0323.00039,1,956364,957081,-,717
360,WOLB.0323.00041,1,504044,504759,+,715
360,WOLB.0323.00031,1,641171,641888,+,717
360,WOLB.0323.00056,1,1158682,1159399,+,717
360,WOLB.0323.00142,1,1242663,1243380,+,717
360,WOLB.0323.00023,1,952618,953335,+,717
360,WOLB.0323.00153,1,1173799,1174516,+,717
360,WOLB.0323.00093,1,1645395,1646107,+,712
360,WOLB.0323.00088,1,1190087,1190804,+,717
360,WOLB.0323.00008,1,1171473,1172190,+,717
360,WOLB.0323.00024,1,261012,261729,+,717
360,WOLB.0323.00064,1,983611,984328,+,717
360,WOLB.0323.00030,1,154977,155694,-,717
360,WOLB.0323.00105,1,1410134,1410851,+,717
360,WOLB.0323.00133,1,891110,891827,-,717
360,WOLB.0323.00084,1,843429,844146,-,717
360,WOLB.0323.00021,1,1522453,1523170,+,717
360,WOLB.0323.00043,1,1741134,1741851,-,717
360,WOLB.0323.00020,1,1134258,1134975,+,717
360,WOLB.0323.00122,1,1328169,1328886,+,717
360,WOLB.0323.00118,1,1141509,1142226,+,717
360,WOLB.0323.00004,1,1238614,1239331,+,717
360,WOLB.0323.00011,1,608485,609202,+,717
360,WOLB.0323.00035,1,1127830,1128547,+,717
360,WOLB.0323.00032,1,704020,704737,+,717
360,WOLB.0323.00012,1,1193950,1194667,+,717
360,WOLB.0323.00018,1,1283010,1283727,-,717
360,WOLB.0323.00025,1,843473,844190,-,717
360,WOLB.0323.00010,1,1530116,1530833,+,717
360,WOLB.0323.00068,1,335972,336689,-,717
360,WOLB.0323.00128,1,1517899,1518616,-,717
360,WOLB.0323.00158,1,1036193,1036910,-,717
360,WOLB.0323.00017,1,1229297,1230014,+,717
360,WOLB.0323.00104,1,1168867,1169584,+,717
360,WOLB.0323.00007,1,132922,133639,-,717
360,WOLB.0323.00001,1,1410134,1410851,+,717
360,WOLB.0323.00100,1,1512369,1513086,+,717
360,WOLB.0323.00070,1,1781753,1782470,-,717
360,WOLB.0323.00006,1,626019,626736,-,717
360,WOLB.0323.00042,1,1277530,1278247,-,717
360,WOLB.0323.00119,1,158956,159673,-,717
360,WOLB.0323.00149,1,605434,606151,-,717
360,WOLB.0323.00014,1,1798528,1799245,-,717
360,WOLB.0323.00096,1,527206,527925,-,719
360,WOLB.0323.00096,1,533287,534002,+,715
361,WOLB.0323.00090,1,1096802,1097637,+,835
361,WOLB.0323.00002,1,1406516,1407351,+,835
361,WOLB.0323.00138,1,745703,746538,-,835
361,WOLB.0323.00132,1,1073984,1074819,+,835
361,WOLB.0323.00143,1,144586,145421,-,835
361,WOLB.0323.00106,1,144588,145423,-,835
361,WOLB.0323.00121,1,1363476,1364311,+,835
361,WOLB.0323.00135,1,534974,535809,-,835
361,WOLB.0323.00103,1,1410699,1411534,+,835
361,WOLB.0323.00107,1,1409126,1409961,+,835
361,WOLB.0323.00019,1,130088,130923,+,835
361,WOLB.0323.00060,1,1241722,1242557,-,835
361,WOLB.0323.00074,1,1113153,1113969,+,816
361,WOLB.0323.00120,1,1097789,1098605,+,816
361,WOLB.0323.00039,1,955527,956362,-,835
361,WOLB.0323.00041,1,544224,545040,-,816
361,WOLB.0323.00031,1,641890,642725,+,835
361,WOLB.0323.00056,1,1159401,1160236,+,835
361,WOLB.0323.00142,1,1243382,1244217,+,835
361,WOLB.0323.00023,1,953337,954172,+,835
361,WOLB.0323.00153,1,1174518,1175353,+,835
361,WOLB.0323.00093,1,1646109,1646944,+,835
361,WOLB.0323.00088,1,1190806,1191641,+,835
361,WOLB.0323.00008,1,1172192,1173027,+,835
361,WOLB.0323.00024,1,261731,262566,+,835
361,WOLB.0323.00064,1,984330,985165,+,835
361,WOLB.0323.00030,1,154140,154975,-,835
361,WOLB.0323.00105,1,1410853,1411688,+,835
361,WOLB.0323.00133,1,890273,891108,-,835
361,WOLB.0323.00084,1,842592,843427,-,835
361,WOLB.0323.00021,1,1523172,1524007,+,835
361,WOLB.0323.00043,1,1740297,1741132,-,835
361,WOLB.0323.00020,1,1134977,1135812,+,835
361,WOLB.0323.00122,1,1328888,1329723,+,835
361,WOLB.0323.00118,1,1142228,1143063,+,835
361,WOLB.0323.00004,1,1239333,1240168,+,835
361,WOLB.0323.00011,1,609204,610039,+,835
361,WOLB.0323.00035,1,1128549,1129384,+,835
361,WOLB.0323.00032,1,704739,705574,+,835
361,WOLB.0323.00012,1,1194669,1195504,+,835
361,WOLB.0323.00018,1,1282173,1283008,-,835
361,WOLB.0323.00025,1,842636,843471,-,835
361,WOLB.0323.00010,1,1530835,1531670,+,835
361,WOLB.0323.00068,1,335135,335970,-,835
361,WOLB.0323.00128,1,1517062,1517897,-,835
361,WOLB.0323.00158,1,1035356,1036191,-,835
361,WOLB.0323.00017,1,1230016,1230851,+,835
361,WOLB.0323.00104,1,1169586,1170421,+,835
361,WOLB.0323.00007,1,132085,132920,-,835
361,WOLB.0323.00001,1,1410853,1411688,+,835
361,WOLB.0323.00100,1,1513088,1513923,+,835
361,WOLB.0323.00070,1,1780916,1781751,-,835
361,WOLB.0323.00006,1,625182,626017,-,835
361,WOLB.0323.00042,1,1276693,1277528,-,835
361,WOLB.0323.00119,1,158119,158954,-,835
361,WOLB.0323.00149,1,604597,605432,-,835
361,WOLB.0323.00014,1,1797691,1798526,-,835
361,WOLB.0323.00096,1,582713,583529,-,816
362,WOLB.0323.00090,1,1097811,1101053,+,3242
362,WOLB.0323.00002,1,1407525,1410767,+,3242
362,WOLB.0323.00138,1,742286,745528,-,3242
362,WOLB.0323.00132,1,1074994,1078241,+,3247
362,WOLB.0323.00143,1,140940,144208,-,3268
362,WOLB.0323.00106,1,140942,144210,-,3268
362,WOLB.0323.00121,1,1364485,1367727,+,3242
362,WOLB.0323.00135,1,531557,534799,-,3242
362,WOLB.0323.00103,1,1411902,1415169,+,3267
362,WOLB.0323.00107,1,1410329,1413596,+,3267
362,WOLB.0323.00019,1,131273,134527,+,3254
362,WOLB.0323.00060,1,1238305,1241547,-,3242
362,WOLB.0323.00074,1,1045079,1048324,-,3245
362,WOLB.0323.00120,1,1029715,1032960,-,3245
362,WOLB.0323.00039,1,951922,955177,-,3255
362,WOLB.0323.00041,1,609869,613113,+,3244
362,WOLB.0323.00031,1,643103,646370,+,3267
362,WOLB.0323.00056,1,1160410,1163652,+,3242
362,WOLB.0323.00142,1,1244391,1247633,+,3242
362,WOLB.0323.00023,1,954272,957501,+,3229
362,WOLB.0323.00153,1,1175527,1178769,+,3242
362,WOLB.0323.00093,1,1743789,1747027,-,3238
362,WOLB.0323.00088,1,1191741,1194970,+,3229
362,WOLB.0323.00008,1,1402907,1406154,-,3247
362,WOLB.0323.00024,1,262740,265991,+,3251
362,WOLB.0323.00064,1,985544,988807,+,3263
362,WOLB.0323.00030,1,150497,153761,-,3264
362,WOLB.0323.00105,1,1412056,1415323,+,3267
362,WOLB.0323.00133,1,886340,889549,-,3209
362,WOLB.0323.00084,1,839175,842417,-,3242
362,WOLB.0323.00021,1,1524181,1527423,+,3242
362,WOLB.0323.00043,1,1736880,1740122,-,3242
362,WOLB.0323.00020,1,1135912,1139140,+,3228
362,WOLB.0323.00122,1,1329897,1333139,+,3242
362,WOLB.0323.00118,1,1143924,1147157,+,3233
362,WOLB.0323.00004,1,1240342,1243584,+,3242
362,WOLB.0323.00011,1,610213,613455,+,3242
362,WOLB.0323.00035,1,1129484,1132712,+,3228
362,WOLB.0323.00032,1,705748,708990,+,3242
362,WOLB.0323.00012,1,1195604,1198832,+,3228
362,WOLB.0323.00018,1,1278853,1282091,-,3238
362,WOLB.0323.00025,1,873525,876794,-,3269
362,WOLB.0323.00010,1,1531844,1535095,+,3251
362,WOLB.0323.00068,1,331718,334960,-,3242
362,WOLB.0323.00128,1,1513645,1516887,-,3242
362,WOLB.0323.00158,1,1031939,1035181,-,3242
362,WOLB.0323.00017,1,1231025,1234268,+,3243
362,WOLB.0323.00104,1,1170521,1173749,+,3228
362,WOLB.0323.00007,1,128668,131910,-,3242
362,WOLB.0323.00001,1,1412056,1415323,+,3267
362,WOLB.0323.00100,1,1514023,1517251,+,3228
362,WOLB.0323.00070,1,1777499,1780741,-,3242
362,WOLB.0323.00006,1,621536,624804,-,3268
362,WOLB.0323.00042,1,1273364,1276593,-,3229
362,WOLB.0323.00119,1,154514,157769,-,3255
362,WOLB.0323.00149,1,601180,604422,-,3242
362,WOLB.0323.00014,1,1794274,1797516,-,3242
362,WOLB.0323.00096,1,648358,651602,+,3244
363,WOLB.0323.00090,1,1102167,1103920,+,1753
363,WOLB.0323.00002,1,1411792,1413544,+,1752
363,WOLB.0323.00138,1,739422,741175,-,1753
363,WOLB.0323.00132,1,1079356,1081108,+,1752
363,WOLB.0323.00143,1,138076,139828,-,1752
363,WOLB.0323.00106,1,138078,139830,-,1752
363,WOLB.0323.00121,1,1368841,1370594,+,1753
363,WOLB.0323.00135,1,528691,530444,-,1753
363,WOLB.0323.00103,1,1416281,1418060,+,1779
363,WOLB.0323.00107,1,1414708,1416487,+,1779
363,WOLB.0323.00019,1,135639,137391,+,1752
363,WOLB.0323.00060,1,1235439,1237192,-,1753
363,WOLB.0323.00074,1,1035505,1037257,-,1752
363,WOLB.0323.00074,1,1038949,1040704,+,1755
363,WOLB.0323.00120,1,1020228,1021980,-,1752
363,WOLB.0323.00120,1,1023742,1025491,+,1749
363,WOLB.0323.00039,1,949058,950810,-,1752
363,WOLB.0323.00041,1,614226,615978,+,1752
363,WOLB.0323.00031,1,647483,649235,+,1752
363,WOLB.0323.00056,1,1164765,1166518,+,1753
363,WOLB.0323.00142,1,1248747,1250500,+,1753
363,WOLB.0323.00023,1,958616,960350,+,1734
363,WOLB.0323.00153,1,1179883,1181636,+,1753
363,WOLB.0323.00093,1,1740925,1742676,-,1751
363,WOLB.0323.00088,1,1196084,1197818,+,1734
363,WOLB.0323.00008,1,1400043,1401796,-,1753
363,WOLB.0323.00024,1,267106,268858,+,1752
363,WOLB.0323.00064,1,989922,991675,+,1753
363,WOLB.0323.00030,1,147630,149383,-,1753
363,WOLB.0323.00105,1,1416435,1418214,+,1779
363,WOLB.0323.00133,1,883491,885167,-,1676
363,WOLB.0323.00084,1,836311,838064,-,1753
363,WOLB.0323.00021,1,1528535,1530288,+,1753
363,WOLB.0323.00043,1,1734104,1735856,-,1752
363,WOLB.0323.00020,1,1140254,1141988,+,1734
363,WOLB.0323.00122,1,1334253,1336006,+,1753
363,WOLB.0323.00118,1,1149368,1151121,+,1753
363,WOLB.0323.00004,1,1244698,1246451,+,1753
363,WOLB.0323.00011,1,614569,616322,+,1753
363,WOLB.0323.00035,1,1133826,1135560,+,1734
363,WOLB.0323.00032,1,710102,711855,+,1753
363,WOLB.0323.00012,1,1199946,1201679,+,1733
363,WOLB.0323.00018,1,1276080,1277832,-,1752
363,WOLB.0323.00025,1,870668,872413,-,1745
363,WOLB.0323.00010,1,1536120,1537869,+,1749
363,WOLB.0323.00068,1,328854,330607,-,1753
363,WOLB.0323.00128,1,1510869,1512621,-,1752
363,WOLB.0323.00158,1,1029073,1030826,-,1753
363,WOLB.0323.00017,1,1235382,1237135,+,1753
363,WOLB.0323.00104,1,1174863,1176597,+,1734
363,WOLB.0323.00007,1,125803,127556,-,1753
363,WOLB.0323.00001,1,1416435,1418214,+,1779
363,WOLB.0323.00100,1,1518365,1520099,+,1734
363,WOLB.0323.00070,1,1774723,1776475,-,1752
363,WOLB.0323.00006,1,618672,620424,-,1752
363,WOLB.0323.00042,1,1270516,1272250,-,1734
363,WOLB.0323.00119,1,151651,153403,-,1752
363,WOLB.0323.00149,1,598314,600067,-,1753
363,WOLB.0323.00014,1,1791498,1793250,-,1752
363,WOLB.0323.00096,1,652715,654467,+,1752
364,WOLB.0323.00090,1,1104179,1105388,+,1209
364,WOLB.0323.00002,1,1413804,1415013,+,1209
364,WOLB.0323.00138,1,737953,739163,-,1210
364,WOLB.0323.00132,1,1081369,1082579,+,1210
364,WOLB.0323.00143,1,135057,136268,-,1211
364,WOLB.0323.00106,1,135059,136270,-,1211
364,WOLB.0323.00121,1,1370853,1372062,+,1209
364,WOLB.0323.00135,1,527222,528432,-,1210
364,WOLB.0323.00103,1,1419503,1420712,+,1209
364,WOLB.0323.00107,1,1417930,1419139,+,1209
364,WOLB.0323.00019,1,137658,138868,+,1210
364,WOLB.0323.00060,1,1233970,1235180,-,1210
364,WOLB.0323.00074,1,1030684,1031895,-,1211
364,WOLB.0323.00120,1,1015407,1016618,-,1211
364,WOLB.0323.00039,1,947580,948791,-,1211
364,WOLB.0323.00041,1,619588,620798,+,1210
364,WOLB.0323.00031,1,651043,652253,+,1210
364,WOLB.0323.00056,1,1166777,1167986,+,1209
364,WOLB.0323.00142,1,1250759,1251968,+,1209
364,WOLB.0323.00023,1,960610,961819,+,1209
364,WOLB.0323.00153,1,1181895,1183104,+,1209
364,WOLB.0323.00093,1,1739455,1740665,-,1210
364,WOLB.0323.00088,1,1198078,1199287,+,1209
364,WOLB.0323.00008,1,1398574,1399784,-,1210
364,WOLB.0323.00024,1,97855,99065,+,1210
364,WOLB.0323.00064,1,991941,993151,+,1210
364,WOLB.0323.00030,1,146153,147364,-,1211
364,WOLB.0323.00105,1,1419657,1420866,+,1209
364,WOLB.0323.00133,1,881999,883210,-,1211
364,WOLB.0323.00084,1,834842,836052,-,1210
364,WOLB.0323.00021,1,1530547,1531756,+,1209
364,WOLB.0323.00043,1,1732634,1733844,-,1210
364,WOLB.0323.00020,1,1142248,1143457,+,1209
364,WOLB.0323.00122,1,1336265,1337474,+,1209
364,WOLB.0323.00118,1,1151387,1152596,+,1209
364,WOLB.0323.00004,1,1246710,1247919,+,1209
364,WOLB.0323.00011,1,616581,617790,+,1209
364,WOLB.0323.00035,1,1135820,1137029,+,1209
364,WOLB.0323.00032,1,712114,713323,+,1209
364,WOLB.0323.00012,1,1201940,1203149,+,1209
364,WOLB.0323.00018,1,1274609,1275819,-,1210
364,WOLB.0323.00025,1,868859,870070,-,1211
364,WOLB.0323.00010,1,1538132,1539341,+,1209
364,WOLB.0323.00068,1,327385,328595,-,1210
364,WOLB.0323.00128,1,1509399,1510609,-,1210
364,WOLB.0323.00158,1,1027604,1028814,-,1210
364,WOLB.0323.00017,1,1237394,1238603,+,1209
364,WOLB.0323.00104,1,1176857,1178066,+,1209
364,WOLB.0323.00007,1,124334,125544,-,1210
364,WOLB.0323.00001,1,1419657,1420866,+,1209
364,WOLB.0323.00100,1,1520359,1521568,+,1209
364,WOLB.0323.00070,1,1773253,1774463,-,1210
364,WOLB.0323.00006,1,615653,616864,-,1211
364,WOLB.0323.00042,1,1269039,1270256,-,1217
364,WOLB.0323.00119,1,150173,151384,-,1211
364,WOLB.0323.00149,1,596845,598055,-,1210
364,WOLB.0323.00014,1,1790028,1791238,-,1210
364,WOLB.0323.00096,1,658077,659287,+,1210
365,WOLB.0323.00090,1,1106211,1106802,+,591
365,WOLB.0323.00002,1,1415966,1416557,+,591
365,WOLB.0323.00138,1,736410,737001,-,591
365,WOLB.0323.00132,1,1083401,1083992,+,591
365,WOLB.0323.00121,1,1373015,1373606,+,591
365,WOLB.0323.00135,1,525679,526270,-,591
365,WOLB.0323.00103,1,49827,50418,-,591
365,WOLB.0323.00107,1,49827,50418,-,591
365,WOLB.0323.00019,1,139690,140280,+,590
365,WOLB.0323.00060,1,1232557,1233148,-,591
365,WOLB.0323.00039,1,946168,946759,-,591
365,WOLB.0323.00056,1,1168809,1169400,+,591
365,WOLB.0323.00142,1,1252921,1253512,+,591
365,WOLB.0323.00153,1,1183927,1184518,+,591
365,WOLB.0323.00088,1,1200110,1200701,+,591
365,WOLB.0323.00024,1,99982,100573,+,591
365,WOLB.0323.00064,1,993973,994564,+,591
365,WOLB.0323.00030,1,144741,145332,-,591
365,WOLB.0323.00105,1,49827,50418,-,591
365,WOLB.0323.00133,1,879733,880333,-,600
365,WOLB.0323.00084,1,833299,833890,-,591
365,WOLB.0323.00021,1,1532709,1533300,+,591
365,WOLB.0323.00043,1,1731091,1731682,-,591
365,WOLB.0323.00020,1,1144280,1144871,+,591
365,WOLB.0323.00122,1,1338427,1339018,+,591
365,WOLB.0323.00118,1,1153549,1154139,+,590
365,WOLB.0323.00004,1,1248872,1249463,+,591
365,WOLB.0323.00011,1,618743,619334,+,591
365,WOLB.0323.00035,1,1137852,1138443,+,591
365,WOLB.0323.00032,1,714276,714867,+,591
365,WOLB.0323.00012,1,1203972,1204563,+,591
365,WOLB.0323.00018,1,1273066,1273657,-,591
365,WOLB.0323.00010,1,1540295,1540886,+,591
365,WOLB.0323.00068,1,325842,326433,-,591
365,WOLB.0323.00128,1,1507856,1508447,-,591
365,WOLB.0323.00158,1,1026061,1026652,-,591
365,WOLB.0323.00017,1,1239556,1240147,+,591
365,WOLB.0323.00104,1,1178889,1179480,+,591
365,WOLB.0323.00007,1,122921,123512,-,591
365,WOLB.0323.00001,1,49827,50418,-,591
365,WOLB.0323.00100,1,1522391,1522982,+,591
365,WOLB.0323.00070,1,1771710,1772301,-,591
365,WOLB.0323.00042,1,1266568,1267159,-,591
365,WOLB.0323.00119,1,148762,149352,-,590
365,WOLB.0323.00149,1,595302,595893,-,591
365,WOLB.0323.00014,1,1788485,1789076,-,591
366,WOLB.0323.00090,1,1108370,1109850,+,1480
366,WOLB.0323.00002,1,1418116,1419596,+,1480
366,WOLB.0323.00138,1,733364,734844,-,1480
366,WOLB.0323.00132,1,1085563,1087043,+,1480
366,WOLB.0323.00143,1,131753,133232,-,1479
366,WOLB.0323.00106,1,131755,133234,-,1479
366,WOLB.0323.00121,1,1377475,1378954,+,1479
366,WOLB.0323.00135,1,522632,524112,-,1480
366,WOLB.0323.00103,1,46778,48258,-,1480
366,WOLB.0323.00107,1,46778,48258,-,1480
366,WOLB.0323.00019,1,141856,143335,+,1479
366,WOLB.0323.00060,1,1229511,1230990,-,1479
366,WOLB.0323.00074,1,1028107,1029587,-,1480
366,WOLB.0323.00120,1,1012830,1014310,-,1480
366,WOLB.0323.00039,1,943112,944591,-,1479
366,WOLB.0323.00041,1,621896,623376,+,1480
366,WOLB.0323.00031,1,654079,655558,+,1479
366,WOLB.0323.00056,1,1170967,1172446,+,1479
366,WOLB.0323.00142,1,1255081,1256560,+,1479
366,WOLB.0323.00023,1,963023,964503,+,1480
366,WOLB.0323.00153,1,1186086,1187566,+,1480
366,WOLB.0323.00093,1,1736765,1738245,-,1480
366,WOLB.0323.00088,1,1202268,1203748,+,1480
366,WOLB.0323.00008,1,19657,21137,+,1480
366,WOLB.0323.00024,1,105126,106605,+,1479
366,WOLB.0323.00064,1,996135,997615,+,1480
366,WOLB.0323.00030,1,141690,143170,-,1480
366,WOLB.0323.00105,1,46778,48258,-,1480
366,WOLB.0323.00133,1,876698,878177,-,1479
366,WOLB.0323.00084,1,830253,831733,-,1480
366,WOLB.0323.00021,1,1534866,1536346,+,1480
366,WOLB.0323.00043,1,1728052,1729532,-,1480
366,WOLB.0323.00020,1,1146438,1147918,+,1480
366,WOLB.0323.00122,1,1340587,1342066,+,1479
366,WOLB.0323.00118,1,1155705,1157185,+,1480
366,WOLB.0323.00004,1,1251032,1252511,+,1479
366,WOLB.0323.00011,1,620903,622382,+,1479
366,WOLB.0323.00035,1,1140010,1141490,+,1480
366,WOLB.0323.00032,1,716433,717913,+,1480
366,WOLB.0323.00012,1,1206130,1207610,+,1480
366,WOLB.0323.00018,1,1270027,1271507,-,1480
366,WOLB.0323.00025,1,865287,866766,-,1479
366,WOLB.0323.00010,1,1542452,1543932,+,1480
366,WOLB.0323.00068,1,322796,324276,-,1480
366,WOLB.0323.00128,1,1504817,1506297,-,1480
366,WOLB.0323.00158,1,1021208,1022687,-,1479
366,WOLB.0323.00017,1,1241716,1243195,+,1479
366,WOLB.0323.00104,1,1181047,1182527,+,1480
366,WOLB.0323.00007,1,119875,121354,-,1479
366,WOLB.0323.00001,1,46778,48258,-,1480
366,WOLB.0323.00100,1,1524549,1526029,+,1480
366,WOLB.0323.00070,1,1768671,1770151,-,1480
366,WOLB.0323.00006,1,612349,613828,-,1479
366,WOLB.0323.00042,1,1262585,1264065,-,1480
366,WOLB.0323.00119,1,145707,147186,-,1479
366,WOLB.0323.00149,1,592254,593733,-,1479
366,WOLB.0323.00014,1,1785446,1786926,-,1480
366,WOLB.0323.00096,1,660385,661865,+,1480
367,WOLB.0323.00090,1,1110910,1112311,+,1401
367,WOLB.0323.00002,1,1420654,1422055,+,1401
367,WOLB.0323.00138,1,730902,732303,-,1401
367,WOLB.0323.00132,1,1088103,1089504,+,1401
367,WOLB.0323.00143,1,129067,130456,-,1389
367,WOLB.0323.00106,1,129068,130458,-,1390
367,WOLB.0323.00121,1,1380014,1381415,+,1401
367,WOLB.0323.00135,1,520436,521837,-,1401
367,WOLB.0323.00103,1,44317,45718,-,1401
367,WOLB.0323.00107,1,44317,45718,-,1401
367,WOLB.0323.00019,1,58194,59595,+,1401
367,WOLB.0323.00060,1,1227049,1228450,-,1401
367,WOLB.0323.00074,1,1025646,1027047,-,1401
367,WOLB.0323.00120,1,1010369,1011770,-,1401
367,WOLB.0323.00039,1,940651,942052,-,1401
367,WOLB.0323.00041,1,624436,625837,+,1401
367,WOLB.0323.00031,1,656855,658245,+,1390
367,WOLB.0323.00056,1,1173507,1174908,+,1401
367,WOLB.0323.00142,1,1257620,1259021,+,1401
367,WOLB.0323.00023,1,965563,966964,+,1401
367,WOLB.0323.00153,1,1188626,1190027,+,1401
367,WOLB.0323.00093,1,1734313,1735714,-,1401
367,WOLB.0323.00088,1,1204808,1206209,+,1401
367,WOLB.0323.00008,1,22197,23598,+,1401
367,WOLB.0323.00024,1,2030715,2032116,+,1401
367,WOLB.0323.00064,1,998676,1000077,+,1401
367,WOLB.0323.00030,1,139229,140630,-,1401
367,WOLB.0323.00105,1,44317,45718,-,1401
367,WOLB.0323.00133,1,874028,875429,-,1401
367,WOLB.0323.00084,1,827792,829193,-,1401
367,WOLB.0323.00021,1,1537407,1538808,+,1401
367,WOLB.0323.00043,1,1725593,1726994,-,1401
367,WOLB.0323.00020,1,1148978,1150379,+,1401
367,WOLB.0323.00122,1,1343126,1344527,+,1401
367,WOLB.0323.00118,1,1158243,1159644,+,1401
367,WOLB.0323.00004,1,1253571,1254972,+,1401
367,WOLB.0323.00011,1,623442,624843,+,1401
367,WOLB.0323.00035,1,1142550,1143951,+,1401
367,WOLB.0323.00032,1,718973,720374,+,1401
367,WOLB.0323.00012,1,1208670,1210071,+,1401
367,WOLB.0323.00018,1,1267566,1268967,-,1401
367,WOLB.0323.00025,1,862442,863843,-,1401
367,WOLB.0323.00010,1,1544984,1546385,+,1401
367,WOLB.0323.00068,1,320334,321735,-,1401
367,WOLB.0323.00128,1,1502358,1503759,-,1401
367,WOLB.0323.00017,1,1244255,1245656,+,1401
367,WOLB.0323.00104,1,1183587,1184988,+,1401
367,WOLB.0323.00007,1,117413,118814,-,1401
367,WOLB.0323.00001,1,44317,45718,-,1401
367,WOLB.0323.00100,1,1527089,1528490,+,1401
367,WOLB.0323.00070,1,1766212,1767613,-,1401
367,WOLB.0323.00006,1,609662,611052,-,1390
367,WOLB.0323.00042,1,1260124,1261525,-,1401
367,WOLB.0323.00119,1,58079,59480,+,1401
367,WOLB.0323.00149,1,589793,591194,-,1401
367,WOLB.0323.00014,1,1782987,1784388,-,1401
367,WOLB.0323.00096,1,662925,664326,+,1401
368,WOLB.0323.00090,1,1114169,1115162,+,993
368,WOLB.0323.00138,1,728050,729044,-,994
368,WOLB.0323.00132,1,1091374,1092367,+,993
368,WOLB.0323.00121,1,1383273,1384266,+,993
368,WOLB.0323.00135,1,517584,518578,-,994
368,WOLB.0323.00060,1,1221853,1222847,-,994
368,WOLB.0323.00056,1,1414586,1415579,+,993
368,WOLB.0323.00142,1,1260879,1261872,+,993
368,WOLB.0323.00153,1,1191885,1192878,+,993
368,WOLB.0323.00088,1,1208067,1209060,+,993
368,WOLB.0323.00084,1,824940,825934,-,994
368,WOLB.0323.00021,1,1540666,1541659,+,993
368,WOLB.0323.00020,1,1152237,1153230,+,993
368,WOLB.0323.00122,1,1346385,1347378,+,993
368,WOLB.0323.00118,1,1161502,1162495,+,993
368,WOLB.0323.00004,1,1256830,1257823,+,993
368,WOLB.0323.00011,1,626701,627694,+,993
368,WOLB.0323.00035,1,1145809,1146802,+,993
368,WOLB.0323.00032,1,722232,723225,+,993
368,WOLB.0323.00012,1,1211929,1212922,+,993
368,WOLB.0323.00010,1,1548255,1549248,+,993
368,WOLB.0323.00068,1,317482,318476,-,994
368,WOLB.0323.00158,1,1017700,1018694,-,994
368,WOLB.0323.00017,1,1247514,1248507,+,993
368,WOLB.0323.00104,1,1186846,1187839,+,993
368,WOLB.0323.00007,1,114516,115510,-,994
368,WOLB.0323.00100,1,1530348,1531341,+,993
368,WOLB.0323.00149,1,586941,587935,-,994
369,WOLB.0323.00090,1,1115875,1117135,+,1260
369,WOLB.0323.00002,1,1424426,1425686,+,1260
369,WOLB.0323.00138,1,726077,727338,-,1261
369,WOLB.0323.00132,1,1093042,1094302,+,1260
369,WOLB.0323.00143,1,125067,126328,-,1261
369,WOLB.0323.00106,1,125068,126329,-,1261
369,WOLB.0323.00121,1,1384979,1386239,+,1260
369,WOLB.0323.00135,1,515611,516872,-,1261
369,WOLB.0323.00103,1,484904,486175,-,1271
369,WOLB.0323.00107,1,484902,486173,-,1271
369,WOLB.0323.00019,1,65069,66329,+,1260
369,WOLB.0323.00060,1,1219881,1221142,-,1261
369,WOLB.0323.00074,1,1021733,1022994,-,1261
369,WOLB.0323.00120,1,1006456,1007717,-,1261
369,WOLB.0323.00039,1,935364,936625,-,1261
369,WOLB.0323.00041,1,628489,629749,+,1260
369,WOLB.0323.00031,1,660984,662244,+,1260
369,WOLB.0323.00056,1,1416291,1417551,+,1260
369,WOLB.0323.00142,1,1262585,1263845,+,1260
369,WOLB.0323.00023,1,969695,970955,+,1260
369,WOLB.0323.00153,1,1193591,1194851,+,1260
369,WOLB.0323.00093,1,1730324,1731585,-,1261
369,WOLB.0323.00088,1,1209773,1211033,+,1260
369,WOLB.0323.00008,1,26343,27603,+,1260
369,WOLB.0323.00024,1,2037536,2038796,+,1260
369,WOLB.0323.00064,1,1002813,1004073,+,1260
369,WOLB.0323.00030,1,135232,136493,-,1261
369,WOLB.0323.00105,1,484908,486179,-,1271
369,WOLB.0323.00133,1,870017,871278,-,1261
369,WOLB.0323.00084,1,822967,824228,-,1261
369,WOLB.0323.00021,1,1542372,1543632,+,1260
369,WOLB.0323.00043,1,1721961,1723222,-,1261
369,WOLB.0323.00020,1,1153943,1155203,+,1260
369,WOLB.0323.00122,1,1348091,1349351,+,1260
369,WOLB.0323.00118,1,1163182,1164442,+,1260
369,WOLB.0323.00004,1,1258536,1259796,+,1260
369,WOLB.0323.00011,1,628407,629667,+,1260
369,WOLB.0323.00035,1,1149528,1150760,+,1232
369,WOLB.0323.00032,1,723938,725198,+,1260
369,WOLB.0323.00012,1,1213635,1214895,+,1260
369,WOLB.0323.00018,1,1263569,1264830,-,1261
369,WOLB.0323.00025,1,672508,673762,-,1254
369,WOLB.0323.00010,1,1549934,1551194,+,1260
369,WOLB.0323.00068,1,315509,316770,-,1261
369,WOLB.0323.00128,1,1498726,1499987,-,1261
369,WOLB.0323.00158,1,1015727,1016988,-,1261
369,WOLB.0323.00017,1,1249220,1250480,+,1260
369,WOLB.0323.00104,1,1188552,1189812,+,1260
369,WOLB.0323.00007,1,112544,113805,-,1261
369,WOLB.0323.00001,1,484908,486179,-,1271
369,WOLB.0323.00100,1,1532054,1533314,+,1260
369,WOLB.0323.00070,1,1762580,1763841,-,1261
369,WOLB.0323.00006,1,605662,606923,-,1261
369,WOLB.0323.00042,1,1256135,1257396,-,1261
369,WOLB.0323.00119,1,222712,223973,-,1261
369,WOLB.0323.00149,1,584968,586229,-,1261
369,WOLB.0323.00014,1,1779355,1780616,-,1261
369,WOLB.0323.00096,1,666978,668238,+,1260
370,WOLB.0323.00090,1,1117137,1118486,+,1349
370,WOLB.0323.00002,1,1425688,1427037,+,1349
370,WOLB.0323.00138,1,724727,726076,-,1349
370,WOLB.0323.00132,1,1094304,1095653,+,1349
370,WOLB.0323.00143,1,123711,125066,-,1355
370,WOLB.0323.00106,1,123712,125067,-,1355
370,WOLB.0323.00121,1,1386241,1387590,+,1349
370,WOLB.0323.00135,1,514255,515610,-,1355
370,WOLB.0323.00103,1,483558,484902,-,1344
370,WOLB.0323.00107,1,483556,484900,-,1344
370,WOLB.0323.00019,1,66331,67686,+,1355
370,WOLB.0323.00060,1,1218531,1219880,-,1349
370,WOLB.0323.00074,1,1020383,1021732,-,1349
370,WOLB.0323.00120,1,1005106,1006455,-,1349
370,WOLB.0323.00039,1,934008,935363,-,1355
370,WOLB.0323.00041,1,629751,631100,+,1349
370,WOLB.0323.00031,1,662246,663601,+,1355
370,WOLB.0323.00056,1,1417553,1418902,+,1349
370,WOLB.0323.00142,1,1263847,1265196,+,1349
370,WOLB.0323.00023,1,970957,972288,+,1331
370,WOLB.0323.00153,1,1194853,1196202,+,1349
370,WOLB.0323.00093,1,1728974,1730323,-,1349
370,WOLB.0323.00088,1,1211035,1212384,+,1349
370,WOLB.0323.00008,1,27605,28954,+,1349
370,WOLB.0323.00024,1,2038798,2040147,+,1349
370,WOLB.0323.00064,1,1004075,1005415,+,1340
370,WOLB.0323.00030,1,133891,135231,-,1340
370,WOLB.0323.00105,1,483562,484906,-,1344
370,WOLB.0323.00133,1,868661,870016,-,1355
370,WOLB.0323.00084,1,821617,822966,-,1349
370,WOLB.0323.00021,1,1543634,1544983,+,1349
370,WOLB.0323.00043,1,1720611,1721960,-,1349
370,WOLB.0323.00020,1,1155205,1156554,+,1349
370,WOLB.0323.00122,1,1349353,1350702,+,1349
370,WOLB.0323.00118,1,1164444,1165793,+,1349
370,WOLB.0323.00004,1,1259798,1261147,+,1349
370,WOLB.0323.00011,1,629669,631018,+,1349
370,WOLB.0323.00035,1,1150762,1152111,+,1349
370,WOLB.0323.00032,1,725200,726549,+,1349
370,WOLB.0323.00012,1,1214897,1216246,+,1349
370,WOLB.0323.00018,1,1262219,1263568,-,1349
370,WOLB.0323.00025,1,94488,95839,+,1351
370,WOLB.0323.00010,1,1551196,1552545,+,1349
370,WOLB.0323.00068,1,314159,315508,-,1349
370,WOLB.0323.00128,1,1497376,1498725,-,1349
370,WOLB.0323.00158,1,1014407,1015726,-,1319
370,WOLB.0323.00017,1,1250482,1251831,+,1349
370,WOLB.0323.00104,1,1189814,1191163,+,1349
370,WOLB.0323.00007,1,111194,112543,-,1349
370,WOLB.0323.00001,1,483562,484906,-,1344
370,WOLB.0323.00100,1,1533316,1534665,+,1349
370,WOLB.0323.00070,1,1761230,1762579,-,1349
370,WOLB.0323.00006,1,604306,605661,-,1355
370,WOLB.0323.00042,1,1254785,1256134,-,1349
370,WOLB.0323.00119,1,221356,222711,-,1355
370,WOLB.0323.00149,1,583618,584967,-,1349
370,WOLB.0323.00014,1,1778005,1779354,-,1349
370,WOLB.0323.00096,1,668240,669589,+,1349
371,WOLB.0323.00090,1,1120740,1122567,+,1827
371,WOLB.0323.00002,1,1427638,1429466,+,1828
371,WOLB.0323.00138,1,722297,724126,-,1829
371,WOLB.0323.00132,1,1096254,1098082,+,1828
371,WOLB.0323.00143,1,121281,123110,-,1829
371,WOLB.0323.00106,1,121282,123111,-,1829
371,WOLB.0323.00121,1,1388191,1390019,+,1828
371,WOLB.0323.00135,1,511825,513654,-,1829
371,WOLB.0323.00103,1,481128,482957,-,1829
371,WOLB.0323.00107,1,481126,482955,-,1829
371,WOLB.0323.00019,1,68287,70115,+,1828
371,WOLB.0323.00060,1,1216101,1217930,-,1829
371,WOLB.0323.00074,1,1017953,1019782,-,1829
371,WOLB.0323.00120,1,1002676,1004505,-,1829
371,WOLB.0323.00039,1,931578,933407,-,1829
371,WOLB.0323.00041,1,631701,633529,+,1828
371,WOLB.0323.00031,1,664202,666030,+,1828
371,WOLB.0323.00056,1,1419503,1421331,+,1828
371,WOLB.0323.00142,1,1265797,1267625,+,1828
371,WOLB.0323.00023,1,972889,974717,+,1828
371,WOLB.0323.00153,1,1196803,1198631,+,1828
371,WOLB.0323.00093,1,1726544,1728373,-,1829
371,WOLB.0323.00088,1,1212985,1214813,+,1828
371,WOLB.0323.00008,1,29555,31383,+,1828
371,WOLB.0323.00024,1,2040748,2042576,+,1828
371,WOLB.0323.00064,1,1006016,1007844,+,1828
371,WOLB.0323.00030,1,131461,133290,-,1829
371,WOLB.0323.00105,1,481132,482961,-,1829
371,WOLB.0323.00133,1,866238,868060,-,1822
371,WOLB.0323.00084,1,817535,819362,-,1827
371,WOLB.0323.00021,1,1545584,1547412,+,1828
371,WOLB.0323.00043,1,1716193,1718022,-,1829
371,WOLB.0323.00020,1,1157155,1158983,+,1828
371,WOLB.0323.00122,1,1351303,1353131,+,1828
371,WOLB.0323.00118,1,1166394,1168222,+,1828
371,WOLB.0323.00004,1,1261748,1263576,+,1828
371,WOLB.0323.00011,1,631619,633447,+,1828
371,WOLB.0323.00035,1,1152712,1154540,+,1828
371,WOLB.0323.00032,1,727150,728978,+,1828
371,WOLB.0323.00012,1,1216847,1218675,+,1828
371,WOLB.0323.00018,1,1259789,1261618,-,1829
371,WOLB.0323.00025,1,96440,98284,+,1844
371,WOLB.0323.00010,1,1553146,1554974,+,1828
371,WOLB.0323.00068,1,311729,313558,-,1829
371,WOLB.0323.00128,1,1494946,1496775,-,1829
371,WOLB.0323.00158,1,1010844,1012673,-,1829
371,WOLB.0323.00017,1,1252432,1254260,+,1828
371,WOLB.0323.00104,1,1191764,1193592,+,1828
371,WOLB.0323.00007,1,108764,110593,-,1829
371,WOLB.0323.00001,1,481132,482961,-,1829
371,WOLB.0323.00100,1,1535266,1537094,+,1828
371,WOLB.0323.00070,1,1758800,1760629,-,1829
371,WOLB.0323.00006,1,601876,603705,-,1829
371,WOLB.0323.00042,1,1252355,1254174,-,1819
371,WOLB.0323.00119,1,218926,220755,-,1829
371,WOLB.0323.00149,1,581188,583017,-,1829
371,WOLB.0323.00014,1,1775575,1777404,-,1829
371,WOLB.0323.00096,1,670190,672018,+,1828
372,WOLB.0323.00090,1,1122569,1123217,+,648
372,WOLB.0323.00002,1,1429468,1430107,+,639
372,WOLB.0323.00138,1,721647,722296,-,649
372,WOLB.0323.00132,1,1098084,1098732,+,648
372,WOLB.0323.00143,1,120631,121280,-,649
372,WOLB.0323.00106,1,120632,121281,-,649
372,WOLB.0323.00121,1,1390021,1390669,+,648
372,WOLB.0323.00135,1,511175,511824,-,649
372,WOLB.0323.00103,1,480476,481127,-,651
372,WOLB.0323.00107,1,480474,481125,-,651
372,WOLB.0323.00019,1,70117,70765,+,648
372,WOLB.0323.00060,1,1215451,1216100,-,649
372,WOLB.0323.00074,1,1017303,1017952,-,649
372,WOLB.0323.00120,1,1002026,1002675,-,649
372,WOLB.0323.00039,1,930928,931577,-,649
372,WOLB.0323.00041,1,633531,634179,+,648
372,WOLB.0323.00031,1,666032,666680,+,648
372,WOLB.0323.00056,1,1421333,1421981,+,648
372,WOLB.0323.00142,1,1267627,1268275,+,648
372,WOLB.0323.00023,1,974719,975358,+,639
372,WOLB.0323.00153,1,1198633,1199281,+,648
372,WOLB.0323.00093,1,1725894,1726543,-,649
372,WOLB.0323.00088,1,1214815,1215463,+,648
372,WOLB.0323.00008,1,31385,32035,+,650
372,WOLB.0323.00024,1,2042578,2043226,+,648
372,WOLB.0323.00064,1,1007846,1008494,+,648
372,WOLB.0323.00030,1,130811,131460,-,649
372,WOLB.0323.00105,1,480480,481131,-,651
372,WOLB.0323.00133,1,865588,866237,-,649
372,WOLB.0323.00084,1,816885,817534,-,649
372,WOLB.0323.00021,1,1547414,1548062,+,648
372,WOLB.0323.00043,1,1715552,1716192,-,640
372,WOLB.0323.00020,1,1158985,1159633,+,648
372,WOLB.0323.00122,1,1353133,1353781,+,648
372,WOLB.0323.00118,1,1168224,1168872,+,648
372,WOLB.0323.00004,1,1263578,1264226,+,648
372,WOLB.0323.00011,1,633449,634097,+,648
372,WOLB.0323.00035,1,1154542,1155190,+,648
372,WOLB.0323.00032,1,728980,729628,+,648
372,WOLB.0323.00012,1,1218677,1219325,+,648
372,WOLB.0323.00018,1,1259139,1259788,-,649
372,WOLB.0323.00025,1,360498,361118,+,620
372,WOLB.0323.00010,1,1554976,1555624,+,648
372,WOLB.0323.00068,1,311079,311728,-,649
372,WOLB.0323.00128,1,1494305,1494945,-,640
372,WOLB.0323.00158,1,1010194,1010843,-,649
372,WOLB.0323.00017,1,1254262,1254910,+,648
372,WOLB.0323.00104,1,1193594,1194242,+,648
372,WOLB.0323.00007,1,108114,108763,-,649
372,WOLB.0323.00001,1,480480,481131,-,651
372,WOLB.0323.00100,1,1537096,1537744,+,648
372,WOLB.0323.00070,1,1758159,1758799,-,640
372,WOLB.0323.00006,1,601226,601875,-,649
372,WOLB.0323.00042,1,1251705,1252354,-,649
372,WOLB.0323.00119,1,218276,218925,-,649
372,WOLB.0323.00149,1,580538,581187,-,649
372,WOLB.0323.00014,1,1774934,1775574,-,640
372,WOLB.0323.00096,1,672020,672668,+,648
373,WOLB.0323.00090,1,1123219,1126678,+,3459
373,WOLB.0323.00002,1,1430109,1433572,+,3463
373,WOLB.0323.00138,1,718183,721646,-,3463
373,WOLB.0323.00132,1,1098734,1102196,+,3462
373,WOLB.0323.00143,1,117167,120630,-,3463
373,WOLB.0323.00106,1,117168,120631,-,3463
373,WOLB.0323.00121,1,1390671,1394134,+,3463
373,WOLB.0323.00135,1,507711,511174,-,3463
373,WOLB.0323.00103,1,477017,480475,-,3458
373,WOLB.0323.00107,1,477015,480473,-,3458
373,WOLB.0323.00019,1,70767,74226,+,3459
373,WOLB.0323.00060,1,1211987,1215450,-,3463
373,WOLB.0323.00074,1,1006124,1009556,+,3432
373,WOLB.0323.00074,1,1013841,1017302,-,3461
373,WOLB.0323.00120,1,998564,1002025,-,3461
373,WOLB.0323.00039,1,927468,930927,-,3459
373,WOLB.0323.00041,1,634181,637642,+,3461
373,WOLB.0323.00031,1,666682,670145,+,3463
373,WOLB.0323.00056,1,1421983,1425446,+,3463
373,WOLB.0323.00142,1,1268277,1271740,+,3463
373,WOLB.0323.00023,1,975360,978819,+,3459
373,WOLB.0323.00153,1,1199283,1202742,+,3459
373,WOLB.0323.00093,1,1722431,1725893,-,3462
373,WOLB.0323.00088,1,1215465,1218928,+,3463
373,WOLB.0323.00008,1,32037,35495,+,3458
373,WOLB.0323.00024,1,2043228,2046689,+,3461
373,WOLB.0323.00064,1,1008496,1011958,+,3462
373,WOLB.0323.00030,1,127348,130810,-,3462
373,WOLB.0323.00105,1,477021,480479,-,3458
373,WOLB.0323.00133,1,862128,865587,-,3459
373,WOLB.0323.00084,1,813421,816884,-,3463
373,WOLB.0323.00021,1,1548064,1551527,+,3463
373,WOLB.0323.00043,1,1712088,1715551,-,3463
373,WOLB.0323.00020,1,1159635,1163098,+,3463
373,WOLB.0323.00122,1,1353783,1357246,+,3463
373,WOLB.0323.00118,1,1168874,1172338,+,3464
373,WOLB.0323.00004,1,1264228,1267691,+,3463
373,WOLB.0323.00011,1,634099,637562,+,3463
373,WOLB.0323.00035,1,1155192,1158655,+,3463
373,WOLB.0323.00032,1,729630,733093,+,3463
373,WOLB.0323.00012,1,1219327,1222790,+,3463
373,WOLB.0323.00018,1,1255675,1259138,-,3463
373,WOLB.0323.00025,1,361120,364582,+,3462
373,WOLB.0323.00010,1,1555626,1559089,+,3463
373,WOLB.0323.00068,1,307615,311078,-,3463
373,WOLB.0323.00128,1,1490841,1494304,-,3463
373,WOLB.0323.00158,1,1006730,1010193,-,3463
373,WOLB.0323.00017,1,1254912,1258375,+,3463
373,WOLB.0323.00104,1,1194244,1197707,+,3463
373,WOLB.0323.00007,1,104650,108113,-,3463
373,WOLB.0323.00001,1,477021,480479,-,3458
373,WOLB.0323.00100,1,1537746,1541209,+,3463
373,WOLB.0323.00070,1,1754695,1758158,-,3463
373,WOLB.0323.00006,1,597762,601225,-,3463
373,WOLB.0323.00042,1,1248238,1251704,-,3466
373,WOLB.0323.00119,1,214816,218275,-,3459
373,WOLB.0323.00149,1,577074,580537,-,3463
373,WOLB.0323.00014,1,1771470,1774933,-,3463
373,WOLB.0323.00096,1,672670,676131,+,3461
374,WOLB.0323.00090,1,1129277,1129804,+,527
374,WOLB.0323.00002,1,1506830,1507357,-,527
374,WOLB.0323.00138,1,715057,715584,-,527
374,WOLB.0323.00132,1,1105698,1106225,+,527
374,WOLB.0323.00143,1,112764,113291,-,527
374,WOLB.0323.00106,1,112765,113292,-,527
374,WOLB.0323.00121,1,1396733,1397260,+,527
374,WOLB.0323.00135,1,504585,505112,-,527
374,WOLB.0323.00103,1,471994,472521,-,527
374,WOLB.0323.00107,1,471992,472519,-,527
374,WOLB.0323.00019,1,76828,77330,+,502
374,WOLB.0323.00060,1,1208861,1209388,-,527
374,WOLB.0323.00074,1,1001572,1002099,-,527
374,WOLB.0323.00120,1,992958,993485,-,527
374,WOLB.0323.00039,1,924364,924866,-,502
374,WOLB.0323.00041,1,642721,643248,+,527
374,WOLB.0323.00031,1,674021,674548,+,527
374,WOLB.0323.00056,1,1429554,1430081,+,527
374,WOLB.0323.00142,1,1274339,1274866,+,527
374,WOLB.0323.00023,1,912184,912709,-,525
374,WOLB.0323.00153,1,1205341,1205868,+,527
374,WOLB.0323.00093,1,1662058,1662585,+,527
374,WOLB.0323.00088,1,1221527,1222054,+,527
374,WOLB.0323.00008,1,39101,39628,+,527
374,WOLB.0323.00024,1,2052430,2052957,+,527
374,WOLB.0323.00064,1,1015468,1015995,+,527
374,WOLB.0323.00030,1,123311,123838,-,527
374,WOLB.0323.00105,1,471998,472525,-,527
374,WOLB.0323.00133,1,858093,858620,-,527
374,WOLB.0323.00084,1,810295,810822,-,527
374,WOLB.0323.00021,1,1554126,1554653,+,527
374,WOLB.0323.00043,1,1541699,1542226,-,527
374,WOLB.0323.00043,1,1638620,1639147,+,527
374,WOLB.0323.00020,1,1165697,1166224,+,527
374,WOLB.0323.00122,1,1359855,1360372,+,517
374,WOLB.0323.00118,1,1174937,1175464,+,527
374,WOLB.0323.00004,1,1270290,1270817,+,527
374,WOLB.0323.00011,1,640161,640688,+,527
374,WOLB.0323.00035,1,1161254,1161781,+,527
374,WOLB.0323.00032,1,735692,736219,+,527
374,WOLB.0323.00012,1,1225389,1225916,+,527
374,WOLB.0323.00018,1,1251625,1252152,-,527
374,WOLB.0323.00025,1,254544,255071,+,527
374,WOLB.0323.00010,1,1562611,1563121,+,510
374,WOLB.0323.00068,1,304496,305023,-,527
374,WOLB.0323.00128,1,1424480,1425007,+,527
374,WOLB.0323.00158,1,1003604,1004131,-,527
374,WOLB.0323.00017,1,1260974,1261501,+,527
374,WOLB.0323.00104,1,1200306,1200833,+,527
374,WOLB.0323.00007,1,101524,102051,-,527
374,WOLB.0323.00001,1,471998,472525,-,527
374,WOLB.0323.00100,1,1543808,1544335,+,527
374,WOLB.0323.00070,1,1817738,1818265,-,527
374,WOLB.0323.00006,1,806155,806682,-,527
374,WOLB.0323.00042,1,1244189,1244716,-,527
374,WOLB.0323.00119,1,211712,212214,-,502
374,WOLB.0323.00149,1,573948,574475,-,527
374,WOLB.0323.00014,1,647994,648521,+,527
374,WOLB.0323.00096,1,681210,681737,+,527
375,WOLB.0323.00090,1,1132619,1137705,+,5086
375,WOLB.0323.00002,1,1498995,1504034,-,5039
375,WOLB.0323.00138,1,706311,711341,-,5030
375,WOLB.0323.00132,1,1109031,1114450,+,5419
375,WOLB.0323.00143,1,104764,109950,-,5186
375,WOLB.0323.00106,1,104765,109951,-,5186
375,WOLB.0323.00121,1,1400976,1406005,+,5029
375,WOLB.0323.00135,1,495828,500869,-,5041
375,WOLB.0323.00103,1,463405,468435,-,5030
375,WOLB.0323.00107,1,463403,468433,-,5030
375,WOLB.0323.00019,1,80169,85520,+,5351
375,WOLB.0323.00060,1,1198606,1203636,-,5030
375,WOLB.0323.00074,1,973103,978135,-,5032
375,WOLB.0323.00120,1,964489,969521,-,5032
375,WOLB.0323.00039,1,916173,921525,-,5352
375,WOLB.0323.00041,1,666685,671716,+,5031
375,WOLB.0323.00031,1,677360,682545,+,5185
375,WOLB.0323.00056,1,1435306,1440335,+,5029
375,WOLB.0323.00142,1,1278582,1283611,+,5029
375,WOLB.0323.00023,1,903921,909307,-,5386
375,WOLB.0323.00153,1,1208683,1213769,+,5086
375,WOLB.0323.00093,1,1686495,1691534,+,5039
375,WOLB.0323.00088,1,1225770,1230799,+,5029
375,WOLB.0323.00008,1,1255963,1261001,+,5038
375,WOLB.0323.00024,1,2056891,2062303,+,5412
375,WOLB.0323.00064,1,1018809,1024228,+,5419
375,WOLB.0323.00030,1,115077,120497,-,5420
375,WOLB.0323.00105,1,463409,468439,-,5030
375,WOLB.0323.00133,1,849910,855285,-,5375
375,WOLB.0323.00084,1,801549,806579,-,5030
375,WOLB.0323.00021,1,1558369,1563398,+,5029
375,WOLB.0323.00043,1,1533864,1538903,-,5039
375,WOLB.0323.00043,1,1641943,1646981,+,5038
375,WOLB.0323.00020,1,1169940,1174969,+,5029
375,WOLB.0323.00122,1,1366700,1371729,+,5029
375,WOLB.0323.00118,1,1179196,1184282,+,5086
375,WOLB.0323.00004,1,1274533,1279562,+,5029
375,WOLB.0323.00011,1,644404,649433,+,5029
375,WOLB.0323.00035,1,1165497,1170526,+,5029
375,WOLB.0323.00032,1,739935,744964,+,5029
375,WOLB.0323.00012,1,1229632,1234661,+,5029
375,WOLB.0323.00018,1,1243477,1248829,-,5352
375,WOLB.0323.00025,1,951165,956260,+,5095
375,WOLB.0323.00010,1,1567897,1573248,+,5351
375,WOLB.0323.00068,1,295750,300780,-,5030
375,WOLB.0323.00128,1,1427803,1432841,+,5038
375,WOLB.0323.00158,1,994858,999888,-,5030
375,WOLB.0323.00017,1,1265217,1270246,+,5029
375,WOLB.0323.00104,1,1204549,1209578,+,5029
375,WOLB.0323.00007,1,92778,97808,-,5030
375,WOLB.0323.00001,1,463409,468439,-,5030
375,WOLB.0323.00100,1,1548051,1553080,+,5029
375,WOLB.0323.00070,1,1809903,1814942,-,5039
375,WOLB.0323.00006,1,798156,803342,-,5186
375,WOLB.0323.00042,1,1235931,1241319,-,5388
375,WOLB.0323.00119,1,203521,208873,-,5352
375,WOLB.0323.00149,1,565202,570232,-,5030
375,WOLB.0323.00014,1,651317,656355,+,5038
375,WOLB.0323.00096,1,705174,710205,+,5031
376,WOLB.0323.00090,1,1140004,1140632,+,628
376,WOLB.0323.00002,1,97675,98303,+,628
376,WOLB.0323.00138,1,703724,704353,-,629
376,WOLB.0323.00132,1,1131054,1131683,-,629
376,WOLB.0323.00143,1,103110,103739,-,629
376,WOLB.0323.00106,1,103111,103740,-,629
376,WOLB.0323.00121,1,1407963,1408591,+,628
376,WOLB.0323.00135,1,492395,493024,-,629
376,WOLB.0323.00103,1,461542,462162,-,620
376,WOLB.0323.00107,1,461540,462160,-,620
376,WOLB.0323.00019,1,86515,87134,+,619
376,WOLB.0323.00060,1,1130993,1131621,-,628
376,WOLB.0323.00074,1,971184,971804,-,620
376,WOLB.0323.00120,1,962570,963190,-,620
376,WOLB.0323.00039,1,914558,915178,-,620
376,WOLB.0323.00041,1,673016,673635,+,619
376,WOLB.0323.00031,1,683571,684199,+,628
376,WOLB.0323.00056,1,1441309,1441936,+,627
376,WOLB.0323.00142,1,1285569,1286197,+,628
376,WOLB.0323.00023,1,885009,885637,+,628
376,WOLB.0323.00153,1,1216068,1216696,+,628
376,WOLB.0323.00093,1,69038,69665,+,627
376,WOLB.0323.00088,1,1232113,1232740,+,627
376,WOLB.0323.00008,1,1295817,1296445,-,628
376,WOLB.0323.00024,1,892856,893484,+,628
376,WOLB.0323.00064,1,1040897,1041522,-,625
376,WOLB.0323.00030,1,97780,98408,+,628
376,WOLB.0323.00105,1,461545,462165,-,620
376,WOLB.0323.00133,1,848089,848709,-,620
376,WOLB.0323.00084,1,798857,799486,-,629
376,WOLB.0323.00021,1,1565462,1566090,+,628
376,WOLB.0323.00043,1,96372,97000,+,628
376,WOLB.0323.00020,1,1176283,1176910,+,627
376,WOLB.0323.00122,1,1372702,1373330,+,628
376,WOLB.0323.00118,1,1186241,1186869,+,628
376,WOLB.0323.00004,1,1281520,1282148,+,628
376,WOLB.0323.00011,1,651391,652019,+,628
376,WOLB.0323.00035,1,1171840,1172467,+,627
376,WOLB.0323.00032,1,747028,747656,+,628
376,WOLB.0323.00012,1,1235975,1236602,+,627
376,WOLB.0323.00018,1,129927,130555,+,628
376,WOLB.0323.00025,1,957730,958358,+,628
376,WOLB.0323.00010,1,101792,102420,+,628
376,WOLB.0323.00068,1,294275,294904,-,629
376,WOLB.0323.00128,1,96997,97625,+,628
376,WOLB.0323.00158,1,582515,583143,+,628
376,WOLB.0323.00017,1,1272204,1272832,+,628
376,WOLB.0323.00104,1,1210892,1211519,+,627
376,WOLB.0323.00007,1,91177,91805,-,628
376,WOLB.0323.00001,1,461545,462165,-,620
376,WOLB.0323.00100,1,1554394,1555021,+,627
376,WOLB.0323.00070,1,96344,96972,+,628
376,WOLB.0323.00006,1,796502,797131,-,629
376,WOLB.0323.00042,1,99584,100212,+,628
376,WOLB.0323.00119,1,201907,202527,-,620
376,WOLB.0323.00149,1,562616,563245,-,629
376,WOLB.0323.00014,1,97687,98315,+,628
376,WOLB.0323.00096,1,711505,712124,+,619
377,WOLB.0323.00090,1,1140634,1141750,+,1116
377,WOLB.0323.00002,1,98305,99421,+,1116
377,WOLB.0323.00138,1,702606,703723,-,1117
377,WOLB.0323.00132,1,1129936,1131053,-,1117
377,WOLB.0323.00143,1,101992,103109,-,1117
377,WOLB.0323.00106,1,101993,103110,-,1117
377,WOLB.0323.00121,1,1408593,1409709,+,1116
377,WOLB.0323.00135,1,491277,492394,-,1117
377,WOLB.0323.00103,1,460423,461541,-,1118
377,WOLB.0323.00107,1,460421,461539,-,1118
377,WOLB.0323.00019,1,87136,88252,+,1116
377,WOLB.0323.00060,1,1129875,1130992,-,1117
377,WOLB.0323.00074,1,970067,971183,-,1116
377,WOLB.0323.00120,1,951403,952483,+,1080
377,WOLB.0323.00120,1,961453,962569,-,1116
377,WOLB.0323.00039,1,913440,914557,-,1117
377,WOLB.0323.00041,1,673637,674752,+,1115
377,WOLB.0323.00031,1,684201,685317,+,1116
377,WOLB.0323.00056,1,1441938,1443054,+,1116
377,WOLB.0323.00142,1,1286199,1287315,+,1116
377,WOLB.0323.00023,1,885639,886755,+,1116
377,WOLB.0323.00153,1,1216698,1217814,+,1116
377,WOLB.0323.00093,1,69667,70783,+,1116
377,WOLB.0323.00088,1,1232742,1233858,+,1116
377,WOLB.0323.00008,1,1294684,1295816,-,1132
377,WOLB.0323.00024,1,893486,894602,+,1116
377,WOLB.0323.00064,1,1039779,1040896,-,1117
377,WOLB.0323.00030,1,98410,99526,+,1116
377,WOLB.0323.00105,1,460426,461544,-,1118
377,WOLB.0323.00133,1,846971,848088,-,1117
377,WOLB.0323.00084,1,797739,798856,-,1117
377,WOLB.0323.00021,1,1566092,1567208,+,1116
377,WOLB.0323.00043,1,97002,98118,+,1116
377,WOLB.0323.00020,1,1176912,1178028,+,1116
377,WOLB.0323.00122,1,1373332,1374448,+,1116
377,WOLB.0323.00118,1,1186871,1187987,+,1116
377,WOLB.0323.00004,1,1282150,1283266,+,1116
377,WOLB.0323.00011,1,652021,653137,+,1116
377,WOLB.0323.00035,1,1172469,1173585,+,1116
377,WOLB.0323.00032,1,747658,748774,+,1116
377,WOLB.0323.00012,1,1236604,1237720,+,1116
377,WOLB.0323.00018,1,130557,131673,+,1116
377,WOLB.0323.00025,1,958360,959476,+,1116
377,WOLB.0323.00010,1,102422,103538,+,1116
377,WOLB.0323.00068,1,293157,294274,-,1117
377,WOLB.0323.00128,1,97627,98743,+,1116
377,WOLB.0323.00158,1,583145,584261,+,1116
377,WOLB.0323.00017,1,1272834,1273950,+,1116
377,WOLB.0323.00104,1,1211521,1212637,+,1116
377,WOLB.0323.00007,1,90059,91176,-,1117
377,WOLB.0323.00001,1,460426,461544,-,1118
377,WOLB.0323.00100,1,1555023,1556139,+,1116
377,WOLB.0323.00070,1,96974,98090,+,1116
377,WOLB.0323.00006,1,795384,796501,-,1117
377,WOLB.0323.00042,1,100214,101330,+,1116
377,WOLB.0323.00119,1,200789,201906,-,1117
377,WOLB.0323.00149,1,561498,562615,-,1117
377,WOLB.0323.00014,1,98317,99433,+,1116
377,WOLB.0323.00096,1,712126,713241,+,1115
378,WOLB.0323.00090,1,1141752,1142704,+,952
378,WOLB.0323.00002,1,99423,100363,+,940
378,WOLB.0323.00138,1,701653,702605,-,952
378,WOLB.0323.00132,1,1128983,1129935,-,952
378,WOLB.0323.00143,1,101039,101991,-,952
378,WOLB.0323.00106,1,101040,101992,-,952
378,WOLB.0323.00121,1,1409711,1410663,+,952
378,WOLB.0323.00135,1,490324,491276,-,952
378,WOLB.0323.00103,1,459470,460422,-,952
378,WOLB.0323.00107,1,459468,460420,-,952
378,WOLB.0323.00019,1,88254,89205,+,951
378,WOLB.0323.00060,1,1128922,1129874,-,952
378,WOLB.0323.00074,1,968175,969124,-,949
378,WOLB.0323.00074,1,969149,970066,-,917
378,WOLB.0323.00120,1,952485,953436,+,951
378,WOLB.0323.00120,1,960500,961452,-,952
378,WOLB.0323.00039,1,912487,913439,-,952
378,WOLB.0323.00041,1,674754,675706,+,952
378,WOLB.0323.00031,1,685319,686271,+,952
378,WOLB.0323.00056,1,1443056,1444008,+,952
378,WOLB.0323.00142,1,1287317,1288269,+,952
378,WOLB.0323.00023,1,886757,887709,+,952
378,WOLB.0323.00153,1,1217816,1218768,+,952
378,WOLB.0323.00093,1,70785,71736,+,951
378,WOLB.0323.00088,1,1233860,1234812,+,952
378,WOLB.0323.00008,1,1292639,1293572,-,933
378,WOLB.0323.00024,1,894604,895555,+,951
378,WOLB.0323.00064,1,1038826,1039778,-,952
378,WOLB.0323.00030,1,99528,100480,+,952
378,WOLB.0323.00105,1,459473,460425,-,952
378,WOLB.0323.00133,1,846018,846970,-,952
378,WOLB.0323.00084,1,796786,797738,-,952
378,WOLB.0323.00021,1,1567210,1568162,+,952
378,WOLB.0323.00043,1,98120,99071,+,951
378,WOLB.0323.00020,1,1178030,1178982,+,952
378,WOLB.0323.00122,1,1374450,1375402,+,952
378,WOLB.0323.00118,1,1187989,1188941,+,952
378,WOLB.0323.00004,1,1283268,1284220,+,952
378,WOLB.0323.00011,1,653139,654091,+,952
378,WOLB.0323.00035,1,1173587,1174539,+,952
378,WOLB.0323.00032,1,748776,749728,+,952
378,WOLB.0323.00012,1,1237722,1238674,+,952
378,WOLB.0323.00018,1,131675,132627,+,952
378,WOLB.0323.00025,1,959478,960436,+,958
378,WOLB.0323.00010,1,103540,104492,+,952
378,WOLB.0323.00068,1,292204,293156,-,952
378,WOLB.0323.00128,1,98745,99697,+,952
378,WOLB.0323.00158,1,584263,585215,+,952
378,WOLB.0323.00017,1,1273952,1274904,+,952
378,WOLB.0323.00104,1,1212639,1213591,+,952
378,WOLB.0323.00007,1,89106,90058,-,952
378,WOLB.0323.00001,1,459473,460425,-,952
378,WOLB.0323.00100,1,1556141,1557093,+,952
378,WOLB.0323.00070,1,98092,99044,+,952
378,WOLB.0323.00006,1,794431,795383,-,952
378,WOLB.0323.00042,1,101332,102284,+,952
378,WOLB.0323.00119,1,199837,200788,-,951
378,WOLB.0323.00149,1,560545,561497,-,952
378,WOLB.0323.00014,1,99435,100387,+,952
378,WOLB.0323.00096,1,713243,714195,+,952
379,WOLB.0323.00090,1,1142787,1143722,+,935
379,WOLB.0323.00002,1,100446,101381,+,935
379,WOLB.0323.00138,1,700635,701570,-,935
379,WOLB.0323.00132,1,1127965,1128900,-,935
379,WOLB.0323.00143,1,13459,14394,+,935
379,WOLB.0323.00106,1,13459,14394,+,935
379,WOLB.0323.00121,1,1410746,1411681,+,935
379,WOLB.0323.00135,1,489306,490241,-,935
379,WOLB.0323.00103,1,458456,459387,-,931
379,WOLB.0323.00107,1,458454,459385,-,931
379,WOLB.0323.00019,1,89288,90223,+,935
379,WOLB.0323.00060,1,1126616,1127551,-,935
379,WOLB.0323.00074,1,967166,968089,-,923
379,WOLB.0323.00120,1,953522,954444,+,922
379,WOLB.0323.00120,1,959491,960414,-,923
379,WOLB.0323.00039,1,911469,912404,-,935
379,WOLB.0323.00041,1,675792,676715,+,923
379,WOLB.0323.00031,1,775929,776864,+,935
379,WOLB.0323.00056,1,1445377,1446312,+,935
379,WOLB.0323.00142,1,1288352,1289287,+,935
379,WOLB.0323.00023,1,887792,888727,+,935
379,WOLB.0323.00153,1,1218851,1219786,+,935
379,WOLB.0323.00093,1,71819,72750,+,931
379,WOLB.0323.00088,1,1234895,1235830,+,935
379,WOLB.0323.00008,1,1291625,1292556,-,931
379,WOLB.0323.00024,1,895638,896573,+,935
379,WOLB.0323.00064,1,1037808,1038743,-,935
379,WOLB.0323.00030,1,100563,101498,+,935
379,WOLB.0323.00105,1,458459,459390,-,931
379,WOLB.0323.00133,1,845000,845935,-,935
379,WOLB.0323.00084,1,795768,796703,-,935
379,WOLB.0323.00021,1,1568245,1569180,+,935
379,WOLB.0323.00043,1,99154,100089,+,935
379,WOLB.0323.00020,1,1179065,1180000,+,935
379,WOLB.0323.00122,1,1375485,1376420,+,935
379,WOLB.0323.00118,1,1189024,1189959,+,935
379,WOLB.0323.00004,1,1284303,1285238,+,935
379,WOLB.0323.00011,1,654174,655109,+,935
379,WOLB.0323.00035,1,1174622,1175557,+,935
379,WOLB.0323.00032,1,749811,750746,+,935
379,WOLB.0323.00012,1,1238757,1239692,+,935
379,WOLB.0323.00018,1,132710,133645,+,935
379,WOLB.0323.00025,1,960519,961458,+,939
379,WOLB.0323.00010,1,104575,105510,+,935
379,WOLB.0323.00068,1,291186,292121,-,935
379,WOLB.0323.00128,1,99780,100715,+,935
379,WOLB.0323.00158,1,585298,586233,+,935
379,WOLB.0323.00017,1,1274987,1275922,+,935
379,WOLB.0323.00104,1,1213674,1214609,+,935
379,WOLB.0323.00007,1,86800,87735,-,935
379,WOLB.0323.00001,1,458459,459390,-,931
379,WOLB.0323.00100,1,1557176,1558111,+,935
379,WOLB.0323.00070,1,99127,100062,+,935
379,WOLB.0323.00006,1,685327,686262,-,935
379,WOLB.0323.00042,1,102367,103302,+,935
379,WOLB.0323.00119,1,198819,199754,-,935
379,WOLB.0323.00149,1,559527,560462,-,935
379,WOLB.0323.00014,1,100470,101405,+,935
379,WOLB.0323.00096,1,714281,715204,+,923
380,WOLB.0323.00090,1,1144155,1145093,+,938
380,WOLB.0323.00002,1,101815,102753,+,938
380,WOLB.0323.00138,1,699264,700202,-,938
380,WOLB.0323.00132,1,1126593,1127531,-,938
380,WOLB.0323.00143,1,14828,15769,+,941
380,WOLB.0323.00106,1,14828,15769,+,941
380,WOLB.0323.00121,1,1412179,1413117,+,938
380,WOLB.0323.00135,1,487870,488808,-,938
380,WOLB.0323.00103,1,457019,457957,-,938
380,WOLB.0323.00107,1,457017,457955,-,938
380,WOLB.0323.00019,1,90657,91598,+,941
380,WOLB.0323.00060,1,1125245,1126183,-,938
380,WOLB.0323.00074,1,965786,966733,-,947
380,WOLB.0323.00120,1,954876,955822,+,946
380,WOLB.0323.00120,1,958111,959058,-,947
380,WOLB.0323.00039,1,910094,911035,-,941
380,WOLB.0323.00041,1,677148,678095,+,947
380,WOLB.0323.00031,1,777298,778239,+,941
380,WOLB.0323.00056,1,1446745,1447683,+,938
380,WOLB.0323.00142,1,1289785,1290723,+,938
380,WOLB.0323.00023,1,889161,890099,+,938
380,WOLB.0323.00153,1,1220219,1221157,+,938
380,WOLB.0323.00093,1,73183,74115,+,932
380,WOLB.0323.00088,1,1236328,1237266,+,938
380,WOLB.0323.00008,1,1290259,1291191,-,932
380,WOLB.0323.00024,1,897007,897945,+,938
380,WOLB.0323.00064,1,1036435,1037373,-,938
380,WOLB.0323.00030,1,101933,102871,+,938
380,WOLB.0323.00105,1,457022,457960,-,938
380,WOLB.0323.00133,1,843625,844566,-,941
380,WOLB.0323.00084,1,794397,795335,-,938
380,WOLB.0323.00021,1,1569613,1570551,+,938
380,WOLB.0323.00043,1,100523,101461,+,938
380,WOLB.0323.00020,1,1180498,1181436,+,938
380,WOLB.0323.00122,1,1376918,1377856,+,938
380,WOLB.0323.00118,1,1190392,1191330,+,938
380,WOLB.0323.00004,1,1285736,1286674,+,938
380,WOLB.0323.00011,1,655607,656545,+,938
380,WOLB.0323.00035,1,1176055,1176993,+,938
380,WOLB.0323.00032,1,751179,752117,+,938
380,WOLB.0323.00012,1,1240190,1241128,+,938
380,WOLB.0323.00018,1,134080,135018,+,938
380,WOLB.0323.00025,1,961891,962832,+,941
380,WOLB.0323.00010,1,105944,106882,+,938
380,WOLB.0323.00068,1,289815,290753,-,938
380,WOLB.0323.00128,1,101149,102087,+,938
380,WOLB.0323.00158,1,586731,587669,+,938
380,WOLB.0323.00017,1,1276420,1277358,+,938
380,WOLB.0323.00104,1,1215107,1216045,+,938
380,WOLB.0323.00007,1,85429,86367,-,938
380,WOLB.0323.00001,1,457022,457960,-,938
380,WOLB.0323.00100,1,1558609,1559547,+,938
380,WOLB.0323.00070,1,100496,101434,+,938
380,WOLB.0323.00006,1,683952,684893,-,941
380,WOLB.0323.00042,1,103736,104674,+,938
380,WOLB.0323.00119,1,197444,198385,-,941
380,WOLB.0323.00149,1,558091,559029,-,938
380,WOLB.0323.00014,1,101839,102777,+,938
380,WOLB.0323.00096,1,715637,716584,+,947
381,WOLB.0323.00090,1,1145879,1146492,+,613
381,WOLB.0323.00002,1,103539,104152,+,613
381,WOLB.0323.00138,1,697865,698478,-,613
381,WOLB.0323.00132,1,1125194,1125807,-,613
381,WOLB.0323.00143,1,16554,17146,+,592
381,WOLB.0323.00106,1,16554,17146,+,592
381,WOLB.0323.00121,1,1413903,1414516,+,613
381,WOLB.0323.00135,1,486471,487084,-,613
381,WOLB.0323.00103,1,455626,456239,-,613
381,WOLB.0323.00107,1,455624,456237,-,613
381,WOLB.0323.00019,1,92384,92997,+,613
381,WOLB.0323.00060,1,1123846,1124459,-,613
381,WOLB.0323.00074,1,964393,965006,-,613
381,WOLB.0323.00120,1,950110,950723,-,613
381,WOLB.0323.00120,1,956740,957331,-,591
381,WOLB.0323.00039,1,908695,909308,-,613
381,WOLB.0323.00041,1,678875,679488,+,613
381,WOLB.0323.00031,1,779024,779616,+,592
381,WOLB.0323.00056,1,1448469,1449082,+,613
381,WOLB.0323.00142,1,1291509,1292122,+,613
381,WOLB.0323.00023,1,890885,891498,+,613
381,WOLB.0323.00153,1,1221943,1222556,+,613
381,WOLB.0323.00093,1,74901,75514,+,613
381,WOLB.0323.00088,1,1238052,1238665,+,613
381,WOLB.0323.00008,1,1288860,1289473,-,613
381,WOLB.0323.00024,1,898731,899344,+,613
381,WOLB.0323.00064,1,1035036,1035649,-,613
381,WOLB.0323.00030,1,103657,104270,+,613
381,WOLB.0323.00105,1,455629,456242,-,613
381,WOLB.0323.00133,1,842226,842839,-,613
381,WOLB.0323.00084,1,792998,793611,-,613
381,WOLB.0323.00021,1,1571337,1571950,+,613
381,WOLB.0323.00043,1,102247,102860,+,613
381,WOLB.0323.00020,1,1182222,1182835,+,613
381,WOLB.0323.00122,1,1378642,1379255,+,613
381,WOLB.0323.00118,1,1192116,1192729,+,613
381,WOLB.0323.00004,1,1287460,1288073,+,613
381,WOLB.0323.00011,1,657331,657944,+,613
381,WOLB.0323.00035,1,1177779,1178392,+,613
381,WOLB.0323.00032,1,752903,753516,+,613
381,WOLB.0323.00012,1,1241914,1242527,+,613
381,WOLB.0323.00018,1,135804,136417,+,613
381,WOLB.0323.00025,1,963617,964209,+,592
381,WOLB.0323.00010,1,107668,108281,+,613
381,WOLB.0323.00068,1,288416,289029,-,613
381,WOLB.0323.00128,1,102873,103486,+,613
381,WOLB.0323.00158,1,588455,589068,+,613
381,WOLB.0323.00017,1,1278144,1278757,+,613
381,WOLB.0323.00104,1,1216831,1217444,+,613
381,WOLB.0323.00007,1,84030,84643,-,613
381,WOLB.0323.00001,1,455629,456242,-,613
381,WOLB.0323.00100,1,1560333,1560946,+,613
381,WOLB.0323.00070,1,102220,102833,+,613
381,WOLB.0323.00006,1,682575,683167,-,592
381,WOLB.0323.00042,1,105460,106073,+,613
381,WOLB.0323.00119,1,196045,196658,-,613
381,WOLB.0323.00149,1,556692,557305,-,613
381,WOLB.0323.00014,1,103563,104176,+,613
381,WOLB.0323.00096,1,717364,717977,+,613
382,WOLB.0323.00090,1,1147021,1149018,+,1997
382,WOLB.0323.00002,1,164396,166394,-,1998
382,WOLB.0323.00138,1,695338,697336,-,1998
382,WOLB.0323.00132,1,1388090,1390088,-,1998
382,WOLB.0323.00143,1,17697,19694,+,1997
382,WOLB.0323.00106,1,17697,19694,+,1997
382,WOLB.0323.00121,1,1415045,1417042,+,1997
382,WOLB.0323.00135,1,483944,485942,-,1998
382,WOLB.0323.00103,1,453123,455082,-,1959
382,WOLB.0323.00107,1,453121,455080,-,1959
382,WOLB.0323.00019,1,93527,95524,+,1997
382,WOLB.0323.00060,1,1121304,1123317,-,2013
382,WOLB.0323.00074,1,961859,963863,-,2004
382,WOLB.0323.00120,1,947576,949580,-,2004
382,WOLB.0323.00039,1,906167,908165,-,1998
382,WOLB.0323.00041,1,680018,682021,+,2003
382,WOLB.0323.00031,1,780167,782164,+,1997
382,WOLB.0323.00056,1,1449611,1451608,+,1997
382,WOLB.0323.00142,1,1292651,1294648,+,1997
382,WOLB.0323.00023,1,703070,705067,+,1997
382,WOLB.0323.00153,1,1223085,1225082,+,1997
382,WOLB.0323.00093,1,76043,78040,+,1997
382,WOLB.0323.00088,1,1239194,1241191,+,1997
382,WOLB.0323.00008,1,1286332,1288330,-,1998
382,WOLB.0323.00024,1,1995655,1997652,+,1997
382,WOLB.0323.00064,1,1149924,1151921,+,1997
382,WOLB.0323.00030,1,1757782,1759780,-,1998
382,WOLB.0323.00105,1,453126,455085,-,1959
382,WOLB.0323.00133,1,839698,841696,-,1998
382,WOLB.0323.00084,1,790471,792469,-,1998
382,WOLB.0323.00021,1,1572479,1574476,+,1997
382,WOLB.0323.00043,1,161903,163901,-,1998
382,WOLB.0323.00020,1,1183364,1185361,+,1997
382,WOLB.0323.00122,1,1379784,1381781,+,1997
382,WOLB.0323.00118,1,1193258,1195255,+,1997
382,WOLB.0323.00004,1,1288602,1290599,+,1997
382,WOLB.0323.00011,1,658473,660470,+,1997
382,WOLB.0323.00035,1,1178921,1180918,+,1997
382,WOLB.0323.00032,1,754045,756042,+,1997
382,WOLB.0323.00012,1,1243056,1245053,+,1997
382,WOLB.0323.00018,1,138209,140206,+,1997
382,WOLB.0323.00025,1,964760,966757,+,1997
382,WOLB.0323.00010,1,167265,169263,-,1998
382,WOLB.0323.00068,1,285889,287887,-,1998
382,WOLB.0323.00128,1,162281,164279,-,1998
382,WOLB.0323.00158,1,589597,591594,+,1997
382,WOLB.0323.00017,1,1279286,1281283,+,1997
382,WOLB.0323.00104,1,1217973,1219970,+,1997
382,WOLB.0323.00007,1,81503,83501,-,1998
382,WOLB.0323.00001,1,453126,455085,-,1959
382,WOLB.0323.00100,1,1561475,1563472,+,1997
382,WOLB.0323.00070,1,161874,163873,-,1999
382,WOLB.0323.00006,1,680026,682024,-,1998
382,WOLB.0323.00042,1,169202,171200,-,1998
382,WOLB.0323.00119,1,193517,195515,-,1998
382,WOLB.0323.00149,1,554165,556163,-,1998
382,WOLB.0323.00014,1,164591,166589,-,1998
382,WOLB.0323.00096,1,718507,720510,+,2003
383,WOLB.0323.00090,1,1149020,1149986,+,966
383,WOLB.0323.00002,1,163429,164395,-,966
383,WOLB.0323.00138,1,694371,695337,-,966
383,WOLB.0323.00132,1,1387123,1388089,-,966
383,WOLB.0323.00143,1,19696,20716,+,1020
383,WOLB.0323.00106,1,19696,20716,+,1020
383,WOLB.0323.00121,1,1417044,1418010,+,966
383,WOLB.0323.00135,1,482977,483943,-,966
383,WOLB.0323.00103,1,452156,453122,-,966
383,WOLB.0323.00107,1,452154,453120,-,966
383,WOLB.0323.00019,1,95526,96492,+,966
383,WOLB.0323.00060,1,1118977,1119918,-,941
383,WOLB.0323.00074,1,960900,961858,-,958
383,WOLB.0323.00120,1,946617,947575,-,958
383,WOLB.0323.00039,1,905200,906166,-,966
383,WOLB.0323.00041,1,682023,682981,+,958
383,WOLB.0323.00031,1,782166,783186,+,1020
383,WOLB.0323.00056,1,1451610,1452576,+,966
383,WOLB.0323.00142,1,1294650,1295616,+,966
383,WOLB.0323.00023,1,705069,706035,+,966
383,WOLB.0323.00153,1,1225084,1226050,+,966
383,WOLB.0323.00093,1,78042,79008,+,966
383,WOLB.0323.00088,1,1241193,1242159,+,966
383,WOLB.0323.00008,1,1285365,1286331,-,966
383,WOLB.0323.00024,1,1997654,1998620,+,966
383,WOLB.0323.00064,1,1151923,1152889,+,966
383,WOLB.0323.00030,1,1756815,1757781,-,966
383,WOLB.0323.00105,1,452159,453125,-,966
383,WOLB.0323.00133,1,838731,839697,-,966
383,WOLB.0323.00084,1,789504,790470,-,966
383,WOLB.0323.00021,1,1574478,1575444,+,966
383,WOLB.0323.00043,1,160936,161902,-,966
383,WOLB.0323.00020,1,1185363,1186329,+,966
383,WOLB.0323.00122,1,1381783,1382749,+,966
383,WOLB.0323.00118,1,1195257,1196223,+,966
383,WOLB.0323.00004,1,1290601,1291567,+,966
383,WOLB.0323.00011,1,660472,661438,+,966
383,WOLB.0323.00035,1,1180920,1181886,+,966
383,WOLB.0323.00032,1,756044,757010,+,966
383,WOLB.0323.00012,1,1245055,1246021,+,966
383,WOLB.0323.00018,1,140208,141174,+,966
383,WOLB.0323.00025,1,966759,967788,+,1029
383,WOLB.0323.00010,1,166298,167264,-,966
383,WOLB.0323.00068,1,284922,285888,-,966
383,WOLB.0323.00128,1,161314,162280,-,966
383,WOLB.0323.00158,1,591596,592562,+,966
383,WOLB.0323.00017,1,1281285,1282251,+,966
383,WOLB.0323.00104,1,1219972,1220938,+,966
383,WOLB.0323.00007,1,80536,81502,-,966
383,WOLB.0323.00001,1,452159,453125,-,966
383,WOLB.0323.00100,1,1563474,1564440,+,966
383,WOLB.0323.00070,1,160907,161873,-,966
383,WOLB.0323.00006,1,679005,680025,-,1020
383,WOLB.0323.00042,1,168235,169201,-,966
383,WOLB.0323.00119,1,192550,193516,-,966
383,WOLB.0323.00149,1,553198,554164,-,966
383,WOLB.0323.00014,1,163624,164590,-,966
383,WOLB.0323.00096,1,720512,721470,+,958
384,WOLB.0323.00090,1,1150370,1151843,+,1473
384,WOLB.0323.00002,1,161579,163052,-,1473
384,WOLB.0323.00138,1,692514,693987,-,1473
384,WOLB.0323.00132,1,1385263,1386736,-,1473
384,WOLB.0323.00143,1,21766,23239,+,1473
384,WOLB.0323.00106,1,21766,23239,+,1473
384,WOLB.0323.00121,1,1419049,1420522,+,1473
384,WOLB.0323.00135,1,480480,481953,-,1473
384,WOLB.0323.00103,1,449052,450525,-,1473
384,WOLB.0323.00107,1,449050,450523,-,1473
384,WOLB.0323.00019,1,97380,98853,+,1473
384,WOLB.0323.00060,1,1117120,1118593,-,1473
384,WOLB.0323.00074,1,958540,960013,-,1473
384,WOLB.0323.00120,1,944257,945730,-,1473
384,WOLB.0323.00039,1,902839,904312,-,1473
384,WOLB.0323.00041,1,683868,685341,+,1473
384,WOLB.0323.00031,1,784236,785709,+,1473
384,WOLB.0323.00056,1,1452960,1454433,+,1473
384,WOLB.0323.00142,1,1296655,1298128,+,1473
384,WOLB.0323.00023,1,706412,707885,+,1473
384,WOLB.0323.00153,1,1226434,1227907,+,1473
384,WOLB.0323.00093,1,80049,81522,+,1473
384,WOLB.0323.00088,1,1243183,1244656,+,1473
384,WOLB.0323.00008,1,1283515,1284988,-,1473
384,WOLB.0323.00024,1,1999505,2000978,+,1473
384,WOLB.0323.00064,1,1153273,1154746,+,1473
384,WOLB.0323.00030,1,1754958,1756431,-,1473
384,WOLB.0323.00105,1,449055,450528,-,1473
384,WOLB.0323.00133,1,836371,837844,-,1473
384,WOLB.0323.00084,1,787647,789120,-,1473
384,WOLB.0323.00021,1,1575828,1577301,+,1473
384,WOLB.0323.00043,1,159086,160559,-,1473
384,WOLB.0323.00020,1,1187353,1188826,+,1473
384,WOLB.0323.00122,1,1383129,1384602,+,1473
384,WOLB.0323.00118,1,1197264,1198737,+,1473
384,WOLB.0323.00004,1,1292606,1294079,+,1473
384,WOLB.0323.00011,1,662477,663950,+,1473
384,WOLB.0323.00035,1,1182910,1184383,+,1473
384,WOLB.0323.00032,1,757394,758867,+,1473
384,WOLB.0323.00012,1,1247045,1248518,+,1473
384,WOLB.0323.00018,1,141551,143024,+,1473
384,WOLB.0323.00025,1,968831,970300,+,1469
384,WOLB.0323.00010,1,164448,165921,-,1473
384,WOLB.0323.00068,1,283066,284538,-,1472
384,WOLB.0323.00128,1,159464,160937,-,1473
384,WOLB.0323.00158,1,593601,595074,+,1473
384,WOLB.0323.00017,1,1283290,1284763,+,1473
384,WOLB.0323.00104,1,1221962,1223435,+,1473
384,WOLB.0323.00007,1,78679,80152,-,1473
384,WOLB.0323.00001,1,449055,450528,-,1473
384,WOLB.0323.00100,1,1565464,1566937,+,1473
384,WOLB.0323.00070,1,159057,160530,-,1473
384,WOLB.0323.00006,1,676482,677955,-,1473
384,WOLB.0323.00042,1,166385,167858,-,1473
384,WOLB.0323.00119,1,190189,191662,-,1473
384,WOLB.0323.00149,1,550686,552159,-,1473
384,WOLB.0323.00014,1,161774,163247,-,1473
384,WOLB.0323.00096,1,722357,723830,+,1473
385,WOLB.0323.00090,1,1152050,1153168,+,1118
385,WOLB.0323.00002,1,160254,161372,-,1118
385,WOLB.0323.00138,1,691187,692305,-,1118
385,WOLB.0323.00132,1,1383602,1384720,-,1118
385,WOLB.0323.00143,1,23448,24571,+,1123
385,WOLB.0323.00106,1,23448,24571,+,1123
385,WOLB.0323.00121,1,1420729,1421847,+,1118
385,WOLB.0323.00135,1,479153,480271,-,1118
385,WOLB.0323.00103,1,445958,447073,-,1115
385,WOLB.0323.00107,1,445956,447071,-,1115
385,WOLB.0323.00019,1,99062,100180,+,1118
385,WOLB.0323.00060,1,1115793,1116911,-,1118
385,WOLB.0323.00074,1,978559,979677,+,1118
385,WOLB.0323.00120,1,969945,971063,+,1118
385,WOLB.0323.00039,1,901512,902630,-,1118
385,WOLB.0323.00041,1,665143,666261,-,1118
385,WOLB.0323.00031,1,785918,787041,+,1123
385,WOLB.0323.00056,1,1454642,1455760,+,1118
385,WOLB.0323.00142,1,1298335,1299453,+,1118
385,WOLB.0323.00023,1,708094,709212,+,1118
385,WOLB.0323.00153,1,1228114,1229232,+,1118
385,WOLB.0323.00093,1,1682555,1683673,-,1118
385,WOLB.0323.00088,1,1244863,1245981,+,1118
385,WOLB.0323.00008,1,59923,61041,-,1118
385,WOLB.0323.00024,1,148827,149945,-,1118
385,WOLB.0323.00064,1,1155289,1156407,+,1118
385,WOLB.0323.00030,1,1753297,1754415,-,1118
385,WOLB.0323.00105,1,445961,447076,-,1115
385,WOLB.0323.00133,1,835044,836162,-,1118
385,WOLB.0323.00084,1,786320,787438,-,1118
385,WOLB.0323.00021,1,1577510,1578628,+,1118
385,WOLB.0323.00043,1,157761,158879,-,1118
385,WOLB.0323.00020,1,1189033,1190151,+,1118
385,WOLB.0323.00122,1,1384809,1385896,+,1087
385,WOLB.0323.00118,1,1199280,1200398,+,1118
385,WOLB.0323.00004,1,1294286,1295404,+,1118
385,WOLB.0323.00011,1,664157,665275,+,1118
385,WOLB.0323.00035,1,1184590,1185708,+,1118
385,WOLB.0323.00032,1,759076,760194,+,1118
385,WOLB.0323.00012,1,1248725,1249843,+,1118
385,WOLB.0323.00018,1,143231,144349,+,1118
385,WOLB.0323.00025,1,970513,971636,+,1123
385,WOLB.0323.00010,1,163123,164241,-,1118
385,WOLB.0323.00068,1,281739,282857,-,1118
385,WOLB.0323.00128,1,158139,159257,-,1118
385,WOLB.0323.00158,1,595281,596399,+,1118
385,WOLB.0323.00017,1,1284970,1286088,+,1118
385,WOLB.0323.00104,1,1223642,1224760,+,1118
385,WOLB.0323.00007,1,77352,78470,-,1118
385,WOLB.0323.00001,1,445961,447076,-,1115
385,WOLB.0323.00100,1,1567144,1568262,+,1118
385,WOLB.0323.00070,1,157732,158850,-,1118
385,WOLB.0323.00006,1,675150,676273,-,1123
385,WOLB.0323.00042,1,165058,166176,-,1118
385,WOLB.0323.00119,1,188862,189980,-,1118
385,WOLB.0323.00149,1,549361,550479,-,1118
385,WOLB.0323.00014,1,160449,161567,-,1118
385,WOLB.0323.00096,1,703632,704750,-,1118
386,WOLB.0323.00090,1,1153188,1157667,+,4479
386,WOLB.0323.00002,1,155758,160234,-,4476
386,WOLB.0323.00138,1,686691,691167,-,4476
386,WOLB.0323.00132,1,1379095,1383582,-,4487
386,WOLB.0323.00143,1,24591,29085,+,4494
386,WOLB.0323.00106,1,24591,29085,+,4494
386,WOLB.0323.00121,1,1421867,1426349,+,4482
386,WOLB.0323.00135,1,474654,479133,-,4479
386,WOLB.0323.00103,1,441469,445938,-,4469
386,WOLB.0323.00107,1,441467,445936,-,4469
386,WOLB.0323.00019,1,100200,104678,+,4478
386,WOLB.0323.00060,1,1111292,1115773,-,4481
386,WOLB.0323.00074,1,979697,984176,+,4479
386,WOLB.0323.00120,1,971083,975562,+,4479
386,WOLB.0323.00039,1,897013,901492,-,4479
386,WOLB.0323.00041,1,660644,665123,-,4479
386,WOLB.0323.00031,1,787061,791555,+,4494
386,WOLB.0323.00056,1,1455780,1460261,+,4481
386,WOLB.0323.00142,1,1299473,1303955,+,4482
386,WOLB.0323.00023,1,709232,713710,+,4478
386,WOLB.0323.00153,1,1229252,1233731,+,4479
386,WOLB.0323.00093,1,1678042,1682535,-,4493
386,WOLB.0323.00088,1,1246001,1250483,+,4482
386,WOLB.0323.00008,1,55410,59903,-,4493
386,WOLB.0323.00024,1,144328,148807,-,4479
386,WOLB.0323.00064,1,1156427,1160900,+,4473
386,WOLB.0323.00030,1,1748804,1753277,-,4473
386,WOLB.0323.00105,1,441472,445941,-,4469
386,WOLB.0323.00133,1,830549,835024,-,4475
386,WOLB.0323.00084,1,781824,786300,-,4476
386,WOLB.0323.00021,1,1578648,1583124,+,4476
386,WOLB.0323.00043,1,153265,157741,-,4476
386,WOLB.0323.00020,1,1190171,1194653,+,4482
386,WOLB.0323.00122,1,1387050,1391529,+,4479
386,WOLB.0323.00118,1,1200418,1204894,+,4476
386,WOLB.0323.00004,1,1295424,1299906,+,4482
386,WOLB.0323.00011,1,665295,669777,+,4482
386,WOLB.0323.00035,1,1185728,1190210,+,4482
386,WOLB.0323.00032,1,760214,764690,+,4476
386,WOLB.0323.00012,1,1249863,1254345,+,4482
386,WOLB.0323.00018,1,144369,148848,+,4479
386,WOLB.0323.00025,1,971656,976150,+,4494
386,WOLB.0323.00010,1,158616,163103,-,4487
386,WOLB.0323.00068,1,277243,281719,-,4476
386,WOLB.0323.00128,1,153643,158119,-,4476
386,WOLB.0323.00158,1,596419,600901,+,4482
386,WOLB.0323.00017,1,1286108,1290590,+,4482
386,WOLB.0323.00104,1,1224780,1229262,+,4482
386,WOLB.0323.00007,1,72851,77332,-,4481
386,WOLB.0323.00001,1,441472,445941,-,4469
386,WOLB.0323.00100,1,1568282,1572764,+,4482
386,WOLB.0323.00070,1,153236,157712,-,4476
386,WOLB.0323.00006,1,670660,675130,-,4470
386,WOLB.0323.00042,1,159653,164077,-,4424
386,WOLB.0323.00119,1,184364,188842,-,4478
386,WOLB.0323.00149,1,544859,549341,-,4482
386,WOLB.0323.00014,1,155953,160429,-,4476
386,WOLB.0323.00096,1,699133,703612,-,4479
387,WOLB.0323.00090,1,1157862,1159938,+,2076
387,WOLB.0323.00002,1,153491,155563,-,2072
387,WOLB.0323.00138,1,684420,686496,-,2076
387,WOLB.0323.00132,1,1376828,1378900,-,2072
387,WOLB.0323.00143,1,29280,31354,+,2074
387,WOLB.0323.00106,1,29280,31355,+,2075
387,WOLB.0323.00121,1,1426544,1428620,+,2076
387,WOLB.0323.00135,1,472383,474459,-,2076
387,WOLB.0323.00103,1,439198,441274,-,2076
387,WOLB.0323.00107,1,439196,441272,-,2076
387,WOLB.0323.00019,1,104870,106946,+,2076
387,WOLB.0323.00060,1,1109021,1111097,-,2076
387,WOLB.0323.00074,1,984371,986337,+,1966
387,WOLB.0323.00120,1,975757,977723,+,1966
387,WOLB.0323.00039,1,894742,896818,-,2076
387,WOLB.0323.00041,1,658483,660449,-,1966
387,WOLB.0323.00031,1,791750,793824,+,2074
387,WOLB.0323.00056,1,1460456,1462532,+,2076
387,WOLB.0323.00142,1,1304150,1306226,+,2076
387,WOLB.0323.00023,1,713944,716016,+,2072
387,WOLB.0323.00153,1,1233926,1236002,+,2076
387,WOLB.0323.00093,1,1675771,1677847,-,2076
387,WOLB.0323.00088,1,1250678,1252745,+,2067
387,WOLB.0323.00008,1,53139,55215,-,2076
387,WOLB.0323.00024,1,142061,144133,-,2072
387,WOLB.0323.00064,1,1161134,1163206,+,2072
387,WOLB.0323.00030,1,1746498,1748570,-,2072
387,WOLB.0323.00105,1,439201,441277,-,2076
387,WOLB.0323.00133,1,828278,830354,-,2076
387,WOLB.0323.00084,1,779553,781629,-,2076
387,WOLB.0323.00021,1,1583319,1585382,+,2063
387,WOLB.0323.00043,1,150998,153070,-,2072
387,WOLB.0323.00020,1,1194848,1196924,+,2076
387,WOLB.0323.00122,1,1391724,1393800,+,2076
387,WOLB.0323.00118,1,1205089,1207104,+,2015
387,WOLB.0323.00004,1,1300101,1302177,+,2076
387,WOLB.0323.00011,1,669972,672048,+,2076
387,WOLB.0323.00035,1,1190405,1192481,+,2076
387,WOLB.0323.00032,1,764885,766961,+,2076
387,WOLB.0323.00012,1,1254540,1256616,+,2076
387,WOLB.0323.00018,1,149043,151115,+,2072
387,WOLB.0323.00025,1,939687,941762,-,2075
387,WOLB.0323.00010,1,156349,158421,-,2072
387,WOLB.0323.00068,1,274972,277048,-,2076
387,WOLB.0323.00128,1,151376,153448,-,2072
387,WOLB.0323.00158,1,601096,603172,+,2076
387,WOLB.0323.00017,1,1290785,1292861,+,2076
387,WOLB.0323.00104,1,1229457,1231533,+,2076
387,WOLB.0323.00007,1,70580,72656,-,2076
387,WOLB.0323.00001,1,439201,441277,-,2076
387,WOLB.0323.00100,1,1572959,1575035,+,2076
387,WOLB.0323.00070,1,150969,153041,-,2072
387,WOLB.0323.00006,1,668390,670465,-,2075
387,WOLB.0323.00042,1,157347,159411,-,2064
387,WOLB.0323.00119,1,182096,184172,-,2076
387,WOLB.0323.00149,1,542588,544664,-,2076
387,WOLB.0323.00014,1,153686,155758,-,2072
387,WOLB.0323.00096,1,696972,698938,-,1966
388,WOLB.0323.00090,1,1160504,1161030,+,526
388,WOLB.0323.00002,1,1496558,1497081,-,523
388,WOLB.0323.00138,1,680578,681104,-,526
388,WOLB.0323.00132,1,1300707,1301233,-,526
388,WOLB.0323.00143,1,31920,32446,+,526
388,WOLB.0323.00106,1,31921,32447,+,526
388,WOLB.0323.00121,1,1429186,1429710,+,524
388,WOLB.0323.00135,1,471291,471817,-,526
388,WOLB.0323.00103,1,438277,438803,-,526
388,WOLB.0323.00107,1,438275,438801,-,526
388,WOLB.0323.00019,1,107512,108038,+,526
388,WOLB.0323.00060,1,1106278,1106803,-,525
388,WOLB.0323.00074,1,986696,987222,+,526
388,WOLB.0323.00120,1,978082,978608,+,526
388,WOLB.0323.00039,1,893650,894176,-,526
388,WOLB.0323.00041,1,657598,658124,-,526
388,WOLB.0323.00031,1,794390,794916,+,526
388,WOLB.0323.00056,1,1464750,1465274,+,524
388,WOLB.0323.00142,1,1306792,1307318,+,526
388,WOLB.0323.00023,1,650681,651207,+,526
388,WOLB.0323.00153,1,1236568,1237094,+,526
388,WOLB.0323.00093,1,1674679,1675205,-,526
388,WOLB.0323.00088,1,1253311,1253837,+,526
388,WOLB.0323.00008,1,52047,52573,-,526
388,WOLB.0323.00024,1,489353,489880,+,527
388,WOLB.0323.00064,1,1264757,1265283,-,526
388,WOLB.0323.00030,1,1644361,1644887,+,526
388,WOLB.0323.00105,1,438280,438806,-,526
388,WOLB.0323.00133,1,827186,827712,-,526
388,WOLB.0323.00084,1,775711,776237,-,526
388,WOLB.0323.00021,1,1588639,1589165,+,526
388,WOLB.0323.00043,1,1531428,1531950,-,522
388,WOLB.0323.00043,1,1648895,1649417,+,522
388,WOLB.0323.00020,1,1197490,1198016,+,526
388,WOLB.0323.00122,1,1394366,1394890,+,524
388,WOLB.0323.00118,1,1207596,1208122,+,526
388,WOLB.0323.00004,1,1302743,1303269,+,526
388,WOLB.0323.00011,1,672614,673138,+,524
388,WOLB.0323.00035,1,1193047,1193573,+,526
388,WOLB.0323.00032,1,770277,770801,+,524
388,WOLB.0323.00012,1,1257182,1257708,+,526
388,WOLB.0323.00018,1,53959,54485,+,526
388,WOLB.0323.00025,1,938595,939121,-,526
388,WOLB.0323.00010,1,1628189,1628715,-,526
388,WOLB.0323.00068,1,1252608,1253134,+,526
388,WOLB.0323.00128,1,1435743,1436267,+,524
388,WOLB.0323.00158,1,603738,604264,+,526
388,WOLB.0323.00017,1,1293427,1293953,+,526
388,WOLB.0323.00104,1,1232099,1232625,+,526
388,WOLB.0323.00007,1,69469,70014,-,545
388,WOLB.0323.00001,1,438280,438806,-,526
388,WOLB.0323.00100,1,1575601,1576127,+,526
388,WOLB.0323.00070,1,1807466,1807989,-,523
388,WOLB.0323.00006,1,667298,667824,-,526
388,WOLB.0323.00042,1,1757150,1757676,-,526
388,WOLB.0323.00119,1,181004,181530,-,526
388,WOLB.0323.00149,1,541496,542022,-,526
388,WOLB.0323.00014,1,658269,658793,+,524
388,WOLB.0323.00096,1,696087,696613,-,526
389,WOLB.0323.00090,1,1161156,1162209,+,1053
389,WOLB.0323.00002,1,1495379,1496431,-,1052
389,WOLB.0323.00138,1,679399,680451,-,1052
389,WOLB.0323.00132,1,1299528,1300580,-,1052
389,WOLB.0323.00143,1,32572,33624,+,1052
389,WOLB.0323.00106,1,32573,33625,+,1052
389,WOLB.0323.00121,1,1431347,1432400,+,1053
389,WOLB.0323.00135,1,468148,469203,-,1055
389,WOLB.0323.00103,1,437099,438150,-,1051
389,WOLB.0323.00107,1,437097,438148,-,1051
389,WOLB.0323.00019,1,108164,109216,+,1052
389,WOLB.0323.00060,1,1249376,1250429,+,1053
389,WOLB.0323.00074,1,987348,988400,+,1052
389,WOLB.0323.00120,1,978734,979786,+,1052
389,WOLB.0323.00039,1,892472,893523,-,1051
389,WOLB.0323.00041,1,656420,657471,-,1051
389,WOLB.0323.00031,1,795042,796094,+,1052
389,WOLB.0323.00056,1,1466911,1467964,+,1053
389,WOLB.0323.00142,1,1309406,1310461,+,1055
389,WOLB.0323.00023,1,651333,652364,+,1031
389,WOLB.0323.00153,1,1237220,1238273,+,1053
389,WOLB.0323.00093,1,1673499,1674552,-,1053
389,WOLB.0323.00088,1,1253963,1255016,+,1053
389,WOLB.0323.00008,1,50869,51920,-,1051
389,WOLB.0323.00024,1,490006,491059,+,1053
389,WOLB.0323.00064,1,1263578,1264630,-,1052
389,WOLB.0323.00030,1,1645013,1646066,+,1053
389,WOLB.0323.00105,1,437102,438153,-,1051
389,WOLB.0323.00133,1,826008,827059,-,1051
389,WOLB.0323.00084,1,774532,775584,-,1052
389,WOLB.0323.00021,1,1589291,1590344,+,1053
389,WOLB.0323.00043,1,1651054,1652107,+,1053
389,WOLB.0323.00020,1,1198142,1199195,+,1053
389,WOLB.0323.00122,1,1473291,1474346,+,1055
389,WOLB.0323.00118,1,1208248,1209300,+,1052
389,WOLB.0323.00004,1,1305357,1306412,+,1055
389,WOLB.0323.00011,1,674775,675828,+,1053
389,WOLB.0323.00035,1,1193699,1194752,+,1053
389,WOLB.0323.00032,1,772438,773491,+,1053
389,WOLB.0323.00012,1,1257834,1258887,+,1053
389,WOLB.0323.00018,1,54611,55664,+,1053
389,WOLB.0323.00025,1,937417,938468,-,1051
389,WOLB.0323.00010,1,1627009,1628062,-,1053
389,WOLB.0323.00068,1,1253260,1254313,+,1053
389,WOLB.0323.00128,1,1436393,1437446,+,1053
389,WOLB.0323.00158,1,606352,607407,+,1055
389,WOLB.0323.00017,1,1296041,1297096,+,1055
389,WOLB.0323.00104,1,1232751,1233804,+,1053
389,WOLB.0323.00007,1,1434587,1435640,+,1053
389,WOLB.0323.00001,1,437102,438153,-,1051
389,WOLB.0323.00100,1,1576253,1577306,+,1053
389,WOLB.0323.00070,1,1806287,1807339,-,1052
389,WOLB.0323.00006,1,666120,667171,-,1051
389,WOLB.0323.00042,1,1755971,1757023,-,1052
389,WOLB.0323.00119,1,179826,180877,-,1051
389,WOLB.0323.00149,1,540317,541369,-,1052
389,WOLB.0323.00014,1,658919,659972,+,1053
389,WOLB.0323.00096,1,694909,695960,-,1051
390,WOLB.0323.00090,1,1162210,1165658,+,3448
390,WOLB.0323.00002,1,1491960,1495377,-,3417
390,WOLB.0323.00138,1,675950,679397,-,3447
390,WOLB.0323.00132,1,1296109,1299526,-,3417
390,WOLB.0323.00143,1,33625,37041,+,3416
390,WOLB.0323.00106,1,33626,37042,+,3416
390,WOLB.0323.00121,1,1432401,1435849,+,3448
390,WOLB.0323.00135,1,464699,468146,-,3447
390,WOLB.0323.00103,1,433680,437097,-,3417
390,WOLB.0323.00107,1,433678,437095,-,3417
390,WOLB.0323.00019,1,109217,112631,+,3414
390,WOLB.0323.00060,1,1250430,1253878,+,3448
390,WOLB.0323.00074,1,988401,991817,+,3416
390,WOLB.0323.00120,1,979787,983203,+,3416
390,WOLB.0323.00039,1,889057,892470,-,3413
390,WOLB.0323.00041,1,653003,656418,-,3415
390,WOLB.0323.00031,1,796095,799511,+,3416
390,WOLB.0323.00056,1,1467965,1471413,+,3448
390,WOLB.0323.00142,1,1310462,1313910,+,3448
390,WOLB.0323.00023,1,653861,657298,+,3437
390,WOLB.0323.00153,1,1238274,1241722,+,3448
390,WOLB.0323.00093,1,1670050,1673497,-,3447
390,WOLB.0323.00088,1,1255017,1258465,+,3448
390,WOLB.0323.00008,1,47420,50867,-,3447
390,WOLB.0323.00024,1,491060,494478,+,3418
390,WOLB.0323.00064,1,1260159,1263576,-,3417
390,WOLB.0323.00030,1,1646067,1649485,+,3418
390,WOLB.0323.00105,1,433683,437100,-,3417
390,WOLB.0323.00133,1,822588,826006,-,3418
390,WOLB.0323.00084,1,771083,774530,-,3447
390,WOLB.0323.00021,1,1590345,1593793,+,3448
390,WOLB.0323.00043,1,1652108,1655526,+,3418
390,WOLB.0323.00020,1,1199196,1202644,+,3448
390,WOLB.0323.00122,1,1474347,1477795,+,3448
390,WOLB.0323.00118,1,1209301,1212749,+,3448
390,WOLB.0323.00004,1,1306413,1309861,+,3448
390,WOLB.0323.00011,1,675829,679277,+,3448
390,WOLB.0323.00035,1,1194753,1198201,+,3448
390,WOLB.0323.00032,1,773492,776940,+,3448
390,WOLB.0323.00012,1,1258888,1262336,+,3448
390,WOLB.0323.00018,1,55665,59087,+,3422
390,WOLB.0323.00025,1,934009,937415,-,3406
390,WOLB.0323.00010,1,1623586,1627007,-,3421
390,WOLB.0323.00068,1,1254314,1257762,+,3448
390,WOLB.0323.00128,1,1437447,1440865,+,3418
390,WOLB.0323.00158,1,607408,610856,+,3448
390,WOLB.0323.00017,1,1297097,1300545,+,3448
390,WOLB.0323.00104,1,1233805,1237253,+,3448
390,WOLB.0323.00007,1,1435641,1439089,+,3448
390,WOLB.0323.00001,1,433683,437100,-,3417
390,WOLB.0323.00100,1,1577307,1580755,+,3448
390,WOLB.0323.00070,1,1802868,1806285,-,3417
390,WOLB.0323.00006,1,662703,666118,-,3415
390,WOLB.0323.00042,1,1752522,1755969,-,3447
390,WOLB.0323.00119,1,176411,179824,-,3413
390,WOLB.0323.00149,1,536868,540315,-,3447
390,WOLB.0323.00014,1,659973,663391,+,3418
390,WOLB.0323.00096,1,691492,694907,-,3415
391,WOLB.0323.00090,1,1166194,1168520,+,2326
391,WOLB.0323.00002,1,1488090,1490410,-,2320
391,WOLB.0323.00138,1,673088,675413,-,2325
391,WOLB.0323.00132,1,1292241,1294577,-,2336
391,WOLB.0323.00143,1,38551,40872,+,2321
391,WOLB.0323.00106,1,38552,40873,+,2321
391,WOLB.0323.00121,1,1436385,1438711,+,2326
391,WOLB.0323.00135,1,461837,464162,-,2325
391,WOLB.0323.00103,1,1469826,1472091,+,2265
391,WOLB.0323.00107,1,1468253,1470517,+,2264
391,WOLB.0323.00019,1,114114,116442,+,2328
391,WOLB.0323.00060,1,1254414,1256740,+,2326
391,WOLB.0323.00074,1,993377,995689,+,2312
391,WOLB.0323.00120,1,984763,987075,+,2312
391,WOLB.0323.00039,1,885245,887573,-,2328
391,WOLB.0323.00041,1,649131,651442,-,2311
391,WOLB.0323.00031,1,801021,803342,+,2321
391,WOLB.0323.00056,1,1471949,1474275,+,2326
391,WOLB.0323.00142,1,1314446,1316772,+,2326
391,WOLB.0323.00023,1,658784,661114,+,2330
391,WOLB.0323.00153,1,1242258,1244584,+,2326
391,WOLB.0323.00093,1,1667187,1669513,-,2326
391,WOLB.0323.00088,1,1259001,1261327,+,2326
391,WOLB.0323.00008,1,44557,46883,-,2326
391,WOLB.0323.00024,1,971416,973708,+,2292
391,WOLB.0323.00064,1,1256292,1258628,-,2336
391,WOLB.0323.00030,1,1651016,1653352,+,2336
391,WOLB.0323.00105,1,1469980,1472245,+,2265
391,WOLB.0323.00133,1,818731,821072,-,2341
391,WOLB.0323.00084,1,768221,770546,-,2325
391,WOLB.0323.00021,1,1594329,1596655,+,2326
391,WOLB.0323.00043,1,1657075,1659396,+,2321
391,WOLB.0323.00020,1,1203180,1205506,+,2326
391,WOLB.0323.00122,1,1478331,1480659,+,2328
391,WOLB.0323.00118,1,1213285,1215613,+,2328
391,WOLB.0323.00004,1,1310397,1312723,+,2326
391,WOLB.0323.00011,1,679813,682139,+,2326
391,WOLB.0323.00035,1,1198737,1201063,+,2326
391,WOLB.0323.00032,1,777476,779802,+,2326
391,WOLB.0323.00012,1,1262872,1265198,+,2326
391,WOLB.0323.00018,1,60577,62907,+,2330
391,WOLB.0323.00025,1,913686,915959,-,2273
391,WOLB.0323.00010,1,1619756,1622076,-,2320
391,WOLB.0323.00068,1,1258298,1260624,+,2326
391,WOLB.0323.00128,1,1442414,1444735,+,2321
391,WOLB.0323.00158,1,611392,613718,+,2326
391,WOLB.0323.00017,1,1301081,1303407,+,2326
391,WOLB.0323.00104,1,1237789,1240115,+,2326
391,WOLB.0323.00007,1,1439625,1441951,+,2326
391,WOLB.0323.00001,1,1469980,1472245,+,2265
391,WOLB.0323.00100,1,1581291,1583617,+,2326
391,WOLB.0323.00070,1,1798998,1801318,-,2320
391,WOLB.0323.00006,1,658872,661192,-,2320
391,WOLB.0323.00042,1,1493942,1496202,+,2260
391,WOLB.0323.00119,1,172600,174928,-,2328
391,WOLB.0323.00149,1,534006,536331,-,2325
391,WOLB.0323.00014,1,664940,667261,+,2321
391,WOLB.0323.00096,1,687620,689931,-,2311
392,WOLB.0323.00090,1,1169149,1173409,+,4260
392,WOLB.0323.00002,1,1458967,1463227,-,4260
392,WOLB.0323.00138,1,668199,672459,-,4260
392,WOLB.0323.00132,1,1255186,1259446,+,4260
392,WOLB.0323.00143,1,42559,46819,+,4260
392,WOLB.0323.00106,1,42560,46820,+,4260
392,WOLB.0323.00121,1,1439340,1443600,+,4260
392,WOLB.0323.00135,1,456948,461208,-,4260
392,WOLB.0323.00103,1,1472720,1476980,+,4260
392,WOLB.0323.00107,1,1471146,1475406,+,4260
392,WOLB.0323.00019,1,117071,121328,+,4257
392,WOLB.0323.00060,1,1257369,1261629,+,4260
392,WOLB.0323.00074,1,1083989,1088241,+,4252
392,WOLB.0323.00120,1,1068625,1072877,+,4252
392,WOLB.0323.00039,1,880358,884618,-,4260
392,WOLB.0323.00041,1,569952,574204,-,4252
392,WOLB.0323.00031,1,805029,809289,+,4260
392,WOLB.0323.00056,1,1474904,1479164,+,4260
392,WOLB.0323.00142,1,1317401,1321661,+,4260
392,WOLB.0323.00023,1,643560,647820,-,4260
392,WOLB.0323.00153,1,1245213,1249473,+,4260
392,WOLB.0323.00093,1,37564,41824,+,4260
392,WOLB.0323.00088,1,1261956,1266216,+,4260
392,WOLB.0323.00008,1,1307607,1311867,-,4260
392,WOLB.0323.00024,1,483398,487658,-,4260
392,WOLB.0323.00064,1,1294059,1298319,-,4260
392,WOLB.0323.00030,1,1609497,1613757,+,4260
392,WOLB.0323.00105,1,1472874,1477134,+,4260
392,WOLB.0323.00133,1,813841,818101,-,4260
392,WOLB.0323.00084,1,763332,767592,-,4260
392,WOLB.0323.00021,1,1597284,1601544,+,4260
392,WOLB.0323.00043,1,1680135,1684395,+,4260
392,WOLB.0323.00020,1,1206135,1210395,+,4260
392,WOLB.0323.00122,1,1481288,1485548,+,4260
392,WOLB.0323.00118,1,1055488,1059748,-,4260
392,WOLB.0323.00004,1,1313352,1317612,+,4260
392,WOLB.0323.00011,1,682768,687028,+,4260
392,WOLB.0323.00035,1,1201692,1205952,+,4260
392,WOLB.0323.00032,1,780431,784691,+,4260
392,WOLB.0323.00012,1,1265827,1270087,+,4260
392,WOLB.0323.00018,1,1192225,1196485,+,4260
392,WOLB.0323.00025,1,196927,201189,-,4262
392,WOLB.0323.00010,1,1652495,1656755,-,4260
392,WOLB.0323.00068,1,1261259,1265513,+,4254
392,WOLB.0323.00128,1,1458886,1463146,+,4260
392,WOLB.0323.00158,1,614347,618607,+,4260
392,WOLB.0323.00017,1,1304036,1308296,+,4260
392,WOLB.0323.00104,1,1240744,1245004,+,4260
392,WOLB.0323.00007,1,1442580,1446840,+,4260
392,WOLB.0323.00001,1,1472874,1477134,+,4260
392,WOLB.0323.00100,1,1584246,1588506,+,4260
392,WOLB.0323.00070,1,1725041,1729301,+,4260
392,WOLB.0323.00006,1,652925,657185,-,4260
392,WOLB.0323.00042,1,1785302,1789528,-,4226
392,WOLB.0323.00119,1,167714,171971,-,4257
392,WOLB.0323.00149,1,529117,533377,-,4260
392,WOLB.0323.00014,1,1741818,1746078,+,4260
392,WOLB.0323.00096,1,608441,612693,-,4252
393,WOLB.0323.00090,1,1174116,1175432,+,1316
393,WOLB.0323.00002,1,1456940,1458260,-,1320
393,WOLB.0323.00138,1,666176,667492,-,1316
393,WOLB.0323.00132,1,1260153,1261473,+,1320
393,WOLB.0323.00143,1,47526,48842,+,1316
393,WOLB.0323.00106,1,47527,48843,+,1316
393,WOLB.0323.00121,1,1444307,1445623,+,1316
393,WOLB.0323.00135,1,454925,456241,-,1316
393,WOLB.0323.00103,1,1477687,1478986,+,1299
393,WOLB.0323.00107,1,1476113,1477412,+,1299
393,WOLB.0323.00019,1,1005360,1006676,+,1316
393,WOLB.0323.00060,1,1262336,1263652,+,1316
393,WOLB.0323.00074,1,1088949,1090257,+,1308
393,WOLB.0323.00120,1,1073585,1074893,+,1308
393,WOLB.0323.00039,1,878335,879651,-,1316
393,WOLB.0323.00041,1,567936,569244,-,1308
393,WOLB.0323.00031,1,809996,811312,+,1316
393,WOLB.0323.00056,1,1479871,1481187,+,1316
393,WOLB.0323.00142,1,1322368,1323684,+,1316
393,WOLB.0323.00023,1,641533,642853,-,1320
393,WOLB.0323.00153,1,1250180,1251496,+,1316
393,WOLB.0323.00093,1,42531,43847,+,1316
393,WOLB.0323.00088,1,1266923,1268239,+,1316
393,WOLB.0323.00008,1,1305584,1306900,-,1316
393,WOLB.0323.00024,1,480251,481530,-,1279
393,WOLB.0323.00064,1,1292032,1293352,-,1320
393,WOLB.0323.00030,1,1614464,1615784,+,1320
393,WOLB.0323.00105,1,1477841,1479140,+,1299
393,WOLB.0323.00133,1,811818,813134,-,1316
393,WOLB.0323.00084,1,761309,762625,-,1316
393,WOLB.0323.00021,1,1602251,1603567,+,1316
393,WOLB.0323.00043,1,1685102,1686422,+,1320
393,WOLB.0323.00020,1,1211102,1212418,+,1316
393,WOLB.0323.00122,1,1488219,1489535,+,1316
393,WOLB.0323.00118,1,1053465,1054781,-,1316
393,WOLB.0323.00004,1,1318319,1319635,+,1316
393,WOLB.0323.00011,1,687735,689051,+,1316
393,WOLB.0323.00035,1,1206659,1207975,+,1316
393,WOLB.0323.00032,1,785398,786714,+,1316
393,WOLB.0323.00012,1,1270794,1272110,+,1316
393,WOLB.0323.00018,1,1197192,1198512,+,1320
393,WOLB.0323.00025,1,194904,196220,-,1316
393,WOLB.0323.00010,1,1650479,1651788,-,1309
393,WOLB.0323.00068,1,1266220,1267536,+,1316
393,WOLB.0323.00128,1,1463853,1465173,+,1320
393,WOLB.0323.00158,1,619314,620630,+,1316
393,WOLB.0323.00017,1,1309003,1310319,+,1316
393,WOLB.0323.00104,1,1245711,1247027,+,1316
393,WOLB.0323.00007,1,1447547,1448863,+,1316
393,WOLB.0323.00001,1,1477841,1479140,+,1299
393,WOLB.0323.00100,1,1589213,1590529,+,1316
393,WOLB.0323.00070,1,1730008,1731328,+,1320
393,WOLB.0323.00006,1,650902,652218,-,1316
393,WOLB.0323.00042,1,1783279,1784595,-,1316
393,WOLB.0323.00119,1,1009455,1010771,+,1316
393,WOLB.0323.00149,1,527094,528410,-,1316
393,WOLB.0323.00014,1,1746785,1748105,+,1320
393,WOLB.0323.00096,1,606425,607733,-,1308
394,WOLB.0323.00090,1,1176663,1178504,+,1841
394,WOLB.0323.00002,1,1453917,1455757,-,1840
394,WOLB.0323.00138,1,663104,664944,-,1840
394,WOLB.0323.00132,1,1321031,1322838,-,1807
394,WOLB.0323.00143,1,50073,51877,+,1804
394,WOLB.0323.00106,1,50074,51878,+,1804
394,WOLB.0323.00121,1,1446854,1448695,+,1841
394,WOLB.0323.00135,1,451853,453693,-,1840
394,WOLB.0323.00103,1,90867,92706,+,1839
394,WOLB.0323.00107,1,90866,92705,+,1839
394,WOLB.0323.00019,1,1007907,1009715,+,1808
394,WOLB.0323.00060,1,1264883,1266724,+,1841
394,WOLB.0323.00074,1,1091488,1093297,+,1809
394,WOLB.0323.00120,1,1076124,1077933,+,1809
394,WOLB.0323.00039,1,875296,877103,-,1807
394,WOLB.0323.00041,1,564896,566704,-,1808
394,WOLB.0323.00031,1,812543,814347,+,1804
394,WOLB.0323.00056,1,1482418,1484259,+,1841
394,WOLB.0323.00142,1,1324915,1326756,+,1841
394,WOLB.0323.00023,1,634418,636225,-,1807
394,WOLB.0323.00153,1,1252727,1254568,+,1841
394,WOLB.0323.00093,1,45078,46886,+,1808
394,WOLB.0323.00088,1,1269470,1271311,+,1841
394,WOLB.0323.00008,1,1302545,1304352,-,1807
394,WOLB.0323.00024,1,691440,693263,-,1823
394,WOLB.0323.00064,1,1287380,1289187,-,1807
394,WOLB.0323.00030,1,1618628,1620436,+,1808
394,WOLB.0323.00105,1,90867,92706,+,1839
394,WOLB.0323.00133,1,954542,956349,-,1807
394,WOLB.0323.00084,1,758237,760077,-,1840
394,WOLB.0323.00021,1,1604798,1606639,+,1841
394,WOLB.0323.00043,1,1687604,1689445,+,1841
394,WOLB.0323.00020,1,1213649,1215490,+,1841
394,WOLB.0323.00122,1,1490766,1492607,+,1841
394,WOLB.0323.00118,1,1050393,1052233,-,1840
394,WOLB.0323.00004,1,1320866,1322707,+,1841
394,WOLB.0323.00011,1,690282,692123,+,1841
394,WOLB.0323.00035,1,1209206,1211047,+,1841
394,WOLB.0323.00032,1,787945,789786,+,1841
394,WOLB.0323.00012,1,1273341,1275182,+,1841
394,WOLB.0323.00018,1,1199751,1201592,+,1841
394,WOLB.0323.00025,1,724020,725824,+,1804
394,WOLB.0323.00010,1,1647446,1649286,-,1840
394,WOLB.0323.00068,1,1268767,1270608,+,1841
394,WOLB.0323.00128,1,1466355,1468196,+,1841
394,WOLB.0323.00158,1,621861,623702,+,1841
394,WOLB.0323.00017,1,1311550,1313391,+,1841
394,WOLB.0323.00104,1,1248258,1250099,+,1841
394,WOLB.0323.00007,1,1450094,1451935,+,1841
394,WOLB.0323.00001,1,90867,92706,+,1839
394,WOLB.0323.00100,1,1591760,1593601,+,1841
394,WOLB.0323.00070,1,1732510,1734351,+,1841
394,WOLB.0323.00006,1,647867,649670,-,1803
394,WOLB.0323.00042,1,1780242,1782047,-,1805
394,WOLB.0323.00119,1,1012002,1013810,+,1808
394,WOLB.0323.00149,1,524022,525862,-,1840
394,WOLB.0323.00014,1,1749287,1751128,+,1841
394,WOLB.0323.00096,1,603385,605193,-,1808
395,WOLB.0323.00090,1,1179001,1179964,+,963
395,WOLB.0323.00002,1,1452465,1453420,-,955
395,WOLB.0323.00138,1,661643,662607,-,964
395,WOLB.0323.00132,1,1319537,1320501,-,964
395,WOLB.0323.00143,1,52411,53374,+,963
395,WOLB.0323.00106,1,52412,53375,+,963
395,WOLB.0323.00121,1,1449192,1450155,+,963
395,WOLB.0323.00135,1,450392,451356,-,964
395,WOLB.0323.00103,1,93203,94166,+,963
395,WOLB.0323.00107,1,93202,94165,+,963
395,WOLB.0323.00019,1,1010245,1011208,+,963
395,WOLB.0323.00060,1,1267221,1268184,+,963
395,WOLB.0323.00074,1,1093827,1094790,+,963
395,WOLB.0323.00120,1,1078463,1079426,+,963
395,WOLB.0323.00039,1,873802,874766,-,964
395,WOLB.0323.00041,1,563402,564366,-,964
395,WOLB.0323.00031,1,814881,815844,+,963
395,WOLB.0323.00056,1,1484756,1485719,+,963
395,WOLB.0323.00142,1,1327253,1328216,+,963
395,WOLB.0323.00023,1,632924,633888,-,964
395,WOLB.0323.00153,1,1255065,1256028,+,963
395,WOLB.0323.00093,1,47416,48379,+,963
395,WOLB.0323.00088,1,1271808,1272771,+,963
395,WOLB.0323.00008,1,1301051,1302015,-,964
395,WOLB.0323.00024,1,689946,690910,-,964
395,WOLB.0323.00064,1,1285886,1286850,-,964
395,WOLB.0323.00030,1,1620966,1621929,+,963
395,WOLB.0323.00105,1,93203,94166,+,963
395,WOLB.0323.00133,1,953048,954012,-,964
395,WOLB.0323.00084,1,756776,757740,-,964
395,WOLB.0323.00021,1,1607136,1608099,+,963
395,WOLB.0323.00043,1,1689942,1690896,+,954
395,WOLB.0323.00020,1,1215987,1216950,+,963
395,WOLB.0323.00122,1,1493104,1494067,+,963
395,WOLB.0323.00118,1,1048932,1049896,-,964
395,WOLB.0323.00004,1,1323204,1324167,+,963
395,WOLB.0323.00011,1,692620,693583,+,963
395,WOLB.0323.00035,1,1211544,1212507,+,963
395,WOLB.0323.00032,1,790283,791246,+,963
395,WOLB.0323.00012,1,1275679,1276642,+,963
395,WOLB.0323.00018,1,1202089,1203059,+,970
395,WOLB.0323.00025,1,726358,727321,+,963
395,WOLB.0323.00010,1,1645994,1646949,-,955
395,WOLB.0323.00068,1,1271105,1272068,+,963
395,WOLB.0323.00128,1,1468693,1469647,+,954
395,WOLB.0323.00158,1,624199,625162,+,963
395,WOLB.0323.00017,1,1313888,1314851,+,963
395,WOLB.0323.00104,1,1250596,1251559,+,963
395,WOLB.0323.00007,1,1452432,1453395,+,963
395,WOLB.0323.00001,1,93203,94166,+,963
395,WOLB.0323.00100,1,1594098,1595061,+,963
395,WOLB.0323.00070,1,1734848,1735802,+,954
395,WOLB.0323.00006,1,646369,647333,-,964
395,WOLB.0323.00042,1,1778748,1779712,-,964
395,WOLB.0323.00119,1,1014340,1015303,+,963
395,WOLB.0323.00149,1,522561,523525,-,964
395,WOLB.0323.00014,1,1751625,1752579,+,954
395,WOLB.0323.00096,1,601891,602855,-,964
396,WOLB.0323.00090,1,1180485,1181861,+,1376
396,WOLB.0323.00002,1,1450560,1451945,-,1385
396,WOLB.0323.00138,1,659746,661123,-,1377
396,WOLB.0323.00132,1,1317632,1319017,-,1385
396,WOLB.0323.00143,1,53895,55278,+,1383
396,WOLB.0323.00106,1,53896,55279,+,1383
396,WOLB.0323.00121,1,1450676,1452052,+,1376
396,WOLB.0323.00135,1,448495,449872,-,1377
396,WOLB.0323.00103,1,94687,96071,+,1384
396,WOLB.0323.00107,1,94686,96070,+,1384
396,WOLB.0323.00019,1,1011727,1013123,+,1396
396,WOLB.0323.00060,1,1270357,1271733,+,1376
396,WOLB.0323.00074,1,1095311,1096679,+,1368
396,WOLB.0323.00120,1,1079947,1081315,+,1368
396,WOLB.0323.00039,1,871899,873284,-,1385
396,WOLB.0323.00041,1,561513,562882,-,1369
396,WOLB.0323.00031,1,816365,817748,+,1383
396,WOLB.0323.00056,1,1487892,1489268,+,1376
396,WOLB.0323.00142,1,1328737,1330113,+,1376
396,WOLB.0323.00023,1,631019,632404,-,1385
396,WOLB.0323.00153,1,1256549,1257925,+,1376
396,WOLB.0323.00093,1,48900,50284,+,1384
396,WOLB.0323.00088,1,1273292,1274668,+,1376
396,WOLB.0323.00008,1,1378217,1379541,-,1324
396,WOLB.0323.00024,1,688041,689426,-,1385
396,WOLB.0323.00064,1,1283981,1285366,-,1385
396,WOLB.0323.00030,1,1622450,1623834,+,1384
396,WOLB.0323.00105,1,94687,96071,+,1384
396,WOLB.0323.00133,1,950876,952528,-,1652
396,WOLB.0323.00084,1,754879,756256,-,1377
396,WOLB.0323.00021,1,1608620,1609996,+,1376
396,WOLB.0323.00043,1,1691417,1692801,+,1384
396,WOLB.0323.00020,1,1217471,1218847,+,1376
396,WOLB.0323.00122,1,1494588,1495964,+,1376
396,WOLB.0323.00118,1,1047035,1048412,-,1377
396,WOLB.0323.00004,1,1324688,1326064,+,1376
396,WOLB.0323.00011,1,694104,695480,+,1376
396,WOLB.0323.00035,1,1213028,1214404,+,1376
396,WOLB.0323.00032,1,791767,793143,+,1376
396,WOLB.0323.00012,1,1277163,1278539,+,1376
396,WOLB.0323.00018,1,34958,36342,+,1384
396,WOLB.0323.00025,1,727842,729226,+,1384
396,WOLB.0323.00010,1,1644096,1645474,-,1378
396,WOLB.0323.00068,1,1272589,1273965,+,1376
396,WOLB.0323.00128,1,1470168,1471552,+,1384
396,WOLB.0323.00158,1,625683,627059,+,1376
396,WOLB.0323.00017,1,1315372,1316748,+,1376
396,WOLB.0323.00104,1,1252080,1253456,+,1376
396,WOLB.0323.00007,1,1453916,1455292,+,1376
396,WOLB.0323.00001,1,94687,96071,+,1384
396,WOLB.0323.00100,1,1595582,1596958,+,1376
396,WOLB.0323.00070,1,1736323,1737707,+,1384
396,WOLB.0323.00006,1,644465,645849,-,1384
396,WOLB.0323.00042,1,1776843,1778228,-,1385
396,WOLB.0323.00119,1,1015822,1017218,+,1396
396,WOLB.0323.00149,1,520664,522041,-,1377
396,WOLB.0323.00014,1,1753100,1754481,+,1381
396,WOLB.0323.00096,1,600002,601371,-,1369
397,WOLB.0323.00090,1,1181863,1187608,+,5745
397,WOLB.0323.00002,1,1444816,1450559,-,5743
397,WOLB.0323.00138,1,654000,659745,-,5745
397,WOLB.0323.00132,1,1311888,1317631,-,5743
397,WOLB.0323.00143,1,55280,61023,+,5743
397,WOLB.0323.00106,1,55281,61024,+,5743
397,WOLB.0323.00121,1,1452054,1457799,+,5745
397,WOLB.0323.00135,1,442749,448494,-,5745
397,WOLB.0323.00103,1,96073,101814,+,5741
397,WOLB.0323.00107,1,96072,101813,+,5741
397,WOLB.0323.00019,1,869015,874758,+,5743
397,WOLB.0323.00060,1,1271735,1277480,+,5745
397,WOLB.0323.00074,1,1096681,1102431,+,5750
397,WOLB.0323.00120,1,1081317,1087067,+,5750
397,WOLB.0323.00039,1,866155,871898,-,5743
397,WOLB.0323.00041,1,555762,561512,-,5750
397,WOLB.0323.00031,1,817750,823493,+,5743
397,WOLB.0323.00056,1,1489270,1495015,+,5745
397,WOLB.0323.00142,1,1330115,1335860,+,5745
397,WOLB.0323.00023,1,625274,631018,-,5744
397,WOLB.0323.00153,1,1257927,1263672,+,5745
397,WOLB.0323.00093,1,50286,56023,+,5737
397,WOLB.0323.00088,1,1274670,1280415,+,5745
397,WOLB.0323.00008,1,1371183,1376919,-,5736
397,WOLB.0323.00024,1,682321,688040,-,5719
397,WOLB.0323.00064,1,1278237,1283980,-,5743
397,WOLB.0323.00030,1,1623836,1629579,+,5743
397,WOLB.0323.00105,1,96073,101813,+,5740
397,WOLB.0323.00133,1,945133,950875,-,5742
397,WOLB.0323.00084,1,749133,754878,-,5745
397,WOLB.0323.00021,1,1609998,1615743,+,5745
397,WOLB.0323.00043,1,1692803,1698546,+,5743
397,WOLB.0323.00020,1,1218849,1224594,+,5745
397,WOLB.0323.00122,1,1495966,1501711,+,5745
397,WOLB.0323.00118,1,1041289,1047034,-,5745
397,WOLB.0323.00004,1,1326066,1331811,+,5745
397,WOLB.0323.00011,1,695482,701227,+,5745
397,WOLB.0323.00035,1,1214406,1220151,+,5745
397,WOLB.0323.00032,1,793145,798890,+,5745
397,WOLB.0323.00012,1,1278541,1284286,+,5745
397,WOLB.0323.00018,1,36344,42087,+,5743
397,WOLB.0323.00025,1,729228,734971,+,5743
397,WOLB.0323.00010,1,1638353,1644095,-,5742
397,WOLB.0323.00068,1,1273967,1279712,+,5745
397,WOLB.0323.00128,1,1471554,1477297,+,5743
397,WOLB.0323.00158,1,627061,632806,+,5745
397,WOLB.0323.00017,1,1316750,1322495,+,5745
397,WOLB.0323.00104,1,1253458,1259203,+,5745
397,WOLB.0323.00007,1,1455294,1461039,+,5745
397,WOLB.0323.00001,1,96073,101813,+,5740
397,WOLB.0323.00100,1,1596960,1602705,+,5745
397,WOLB.0323.00070,1,1737709,1743452,+,5743
397,WOLB.0323.00006,1,638721,644464,-,5743
397,WOLB.0323.00042,1,1771099,1776842,-,5743
397,WOLB.0323.00119,1,871669,877412,+,5743
397,WOLB.0323.00149,1,514918,520663,-,5745
397,WOLB.0323.00014,1,1754483,1760226,+,5743
397,WOLB.0323.00096,1,594251,600001,-,5750
398,WOLB.0323.00090,1,1187609,1188893,+,1284
398,WOLB.0323.00002,1,1443529,1444814,-,1285
398,WOLB.0323.00138,1,652714,653998,-,1284
398,WOLB.0323.00132,1,1310601,1311886,-,1285
398,WOLB.0323.00143,1,61024,62313,+,1289
398,WOLB.0323.00106,1,61025,62314,+,1289
398,WOLB.0323.00121,1,1457800,1459084,+,1284
398,WOLB.0323.00135,1,441463,442747,-,1284
398,WOLB.0323.00103,1,101815,103100,+,1285
398,WOLB.0323.00107,1,101814,103099,+,1285
398,WOLB.0323.00019,1,874759,876043,+,1284
398,WOLB.0323.00060,1,1277481,1278765,+,1284
398,WOLB.0323.00074,1,1102432,1103717,+,1285
398,WOLB.0323.00120,1,1087068,1088353,+,1285
398,WOLB.0323.00039,1,864869,866153,-,1284
398,WOLB.0323.00041,1,554475,555760,-,1285
398,WOLB.0323.00031,1,823494,824783,+,1289
398,WOLB.0323.00056,1,1495016,1496300,+,1284
398,WOLB.0323.00142,1,1335861,1337145,+,1284
398,WOLB.0323.00023,1,623987,625272,-,1285
398,WOLB.0323.00153,1,1263673,1264957,+,1284
398,WOLB.0323.00093,1,56024,57306,+,1282
398,WOLB.0323.00088,1,1280416,1281700,+,1284
398,WOLB.0323.00008,1,1369899,1371181,-,1282
398,WOLB.0323.00024,1,679324,680626,-,1302
398,WOLB.0323.00064,1,1276950,1278235,-,1285
398,WOLB.0323.00030,1,1629580,1630865,+,1285
398,WOLB.0323.00105,1,101814,103099,+,1285
398,WOLB.0323.00133,1,943846,945131,-,1285
398,WOLB.0323.00084,1,747847,749131,-,1284
398,WOLB.0323.00021,1,1615744,1617028,+,1284
398,WOLB.0323.00043,1,1698547,1699832,+,1285
398,WOLB.0323.00020,1,1224595,1225879,+,1284
398,WOLB.0323.00122,1,1501712,1502997,+,1285
398,WOLB.0323.00118,1,1040003,1041287,-,1284
398,WOLB.0323.00004,1,1331812,1333096,+,1284
398,WOLB.0323.00011,1,701228,702512,+,1284
398,WOLB.0323.00035,1,1220152,1221436,+,1284
398,WOLB.0323.00032,1,798891,800175,+,1284
398,WOLB.0323.00012,1,1284287,1285571,+,1284
398,WOLB.0323.00018,1,42088,43373,+,1285
398,WOLB.0323.00025,1,734972,736254,+,1282
398,WOLB.0323.00010,1,1637066,1638351,-,1285
398,WOLB.0323.00068,1,1279713,1280997,+,1284
398,WOLB.0323.00128,1,1477298,1478583,+,1285
398,WOLB.0323.00158,1,632807,634091,+,1284
398,WOLB.0323.00017,1,1322496,1323780,+,1284
398,WOLB.0323.00104,1,1259204,1260488,+,1284
398,WOLB.0323.00007,1,1461040,1462324,+,1284
398,WOLB.0323.00001,1,101814,103099,+,1285
398,WOLB.0323.00100,1,1602706,1603990,+,1284
398,WOLB.0323.00070,1,1743453,1744738,+,1285
398,WOLB.0323.00006,1,637431,638719,-,1288
398,WOLB.0323.00042,1,1769812,1771097,-,1285
398,WOLB.0323.00119,1,877413,878697,+,1284
398,WOLB.0323.00149,1,513632,514916,-,1284
398,WOLB.0323.00014,1,1760227,1761512,+,1285
398,WOLB.0323.00096,1,592964,594249,-,1285
399,WOLB.0323.00090,1,1189463,1190343,+,880
399,WOLB.0323.00002,1,1442080,1442960,-,880
399,WOLB.0323.00138,1,651265,652145,-,880
399,WOLB.0323.00132,1,1309152,1310032,-,880
399,WOLB.0323.00143,1,62879,63762,+,883
399,WOLB.0323.00106,1,62880,63763,+,883
399,WOLB.0323.00121,1,1459654,1460534,+,880
399,WOLB.0323.00135,1,440014,440894,-,880
399,WOLB.0323.00103,1,530755,531638,+,883
399,WOLB.0323.00107,1,530757,531640,+,883
399,WOLB.0323.00019,1,876613,877496,+,883
399,WOLB.0323.00060,1,1279335,1280215,+,880
399,WOLB.0323.00074,1,1104284,1105153,+,869
399,WOLB.0323.00120,1,1088920,1089789,+,869
399,WOLB.0323.00039,1,863417,864300,-,883
399,WOLB.0323.00041,1,553040,553909,-,869
399,WOLB.0323.00031,1,825349,826232,+,883
399,WOLB.0323.00056,1,1496870,1497750,+,880
399,WOLB.0323.00142,1,1337715,1338595,+,880
399,WOLB.0323.00023,1,622538,623418,-,880
399,WOLB.0323.00153,1,1265527,1266407,+,880
399,WOLB.0323.00093,1,57876,58759,+,883
399,WOLB.0323.00088,1,1282270,1283150,+,880
399,WOLB.0323.00008,1,1368450,1369330,-,880
399,WOLB.0323.00024,1,677874,678754,-,880
399,WOLB.0323.00064,1,1275501,1276381,-,880
399,WOLB.0323.00030,1,1631435,1632315,+,880
399,WOLB.0323.00105,1,530764,531647,+,883
399,WOLB.0323.00133,1,942393,943277,-,884
399,WOLB.0323.00084,1,746398,747278,-,880
399,WOLB.0323.00021,1,1617598,1618478,+,880
399,WOLB.0323.00043,1,1700402,1701282,+,880
399,WOLB.0323.00020,1,1226449,1227329,+,880
399,WOLB.0323.00122,1,1503567,1504447,+,880
399,WOLB.0323.00118,1,1038553,1039433,-,880
399,WOLB.0323.00004,1,1333666,1334546,+,880
399,WOLB.0323.00011,1,703082,703962,+,880
399,WOLB.0323.00035,1,1222006,1222886,+,880
399,WOLB.0323.00032,1,800745,801625,+,880
399,WOLB.0323.00012,1,1286141,1287021,+,880
399,WOLB.0323.00018,1,43943,44797,+,854
399,WOLB.0323.00025,1,148855,149689,+,834
399,WOLB.0323.00010,1,1635617,1636497,-,880
399,WOLB.0323.00068,1,1281567,1282447,+,880
399,WOLB.0323.00128,1,1479153,1480033,+,880
399,WOLB.0323.00158,1,634661,635541,+,880
399,WOLB.0323.00017,1,1324350,1325230,+,880
399,WOLB.0323.00104,1,1261058,1261938,+,880
399,WOLB.0323.00007,1,1462894,1463774,+,880
399,WOLB.0323.00001,1,530764,531647,+,883
399,WOLB.0323.00100,1,1604560,1605440,+,880
399,WOLB.0323.00070,1,1745308,1746188,+,880
399,WOLB.0323.00006,1,635982,636865,-,883
399,WOLB.0323.00042,1,1768363,1769243,-,880
399,WOLB.0323.00119,1,879267,880150,+,883
399,WOLB.0323.00149,1,512183,513063,-,880
399,WOLB.0323.00014,1,1762082,1762962,+,880
399,WOLB.0323.00096,1,591529,592398,-,869
400,WOLB.0323.00090,1,1190351,1190976,+,625
400,WOLB.0323.00002,1,1441447,1442072,-,625
400,WOLB.0323.00138,1,650631,651257,-,626
400,WOLB.0323.00132,1,1308512,1309144,-,632
400,WOLB.0323.00143,1,63770,64407,+,637
400,WOLB.0323.00106,1,63771,64408,+,637
400,WOLB.0323.00121,1,1460542,1461167,+,625
400,WOLB.0323.00135,1,439380,440006,-,626
400,WOLB.0323.00103,1,531646,532272,+,626
400,WOLB.0323.00107,1,531648,532274,+,626
400,WOLB.0323.00019,1,877504,878140,+,636
400,WOLB.0323.00060,1,1280223,1280848,+,625
400,WOLB.0323.00074,1,1105179,1105803,+,624
400,WOLB.0323.00120,1,1089815,1090439,+,624
400,WOLB.0323.00039,1,862773,863409,-,636
400,WOLB.0323.00041,1,552390,553014,-,624
400,WOLB.0323.00031,1,826240,826877,+,637
400,WOLB.0323.00056,1,1497758,1498383,+,625
400,WOLB.0323.00142,1,1338603,1339228,+,625
400,WOLB.0323.00023,1,621898,622530,-,632
400,WOLB.0323.00153,1,1266415,1267040,+,625
400,WOLB.0323.00093,1,58767,59395,+,628
400,WOLB.0323.00088,1,1283158,1283783,+,625
400,WOLB.0323.00008,1,1367812,1368442,-,630
400,WOLB.0323.00024,1,677234,677866,-,632
400,WOLB.0323.00064,1,1274863,1275493,-,630
400,WOLB.0323.00030,1,1632323,1632952,+,629
400,WOLB.0323.00105,1,531655,532281,+,626
400,WOLB.0323.00133,1,941753,942385,-,632
400,WOLB.0323.00084,1,745764,746390,-,626
400,WOLB.0323.00021,1,1618486,1619111,+,625
400,WOLB.0323.00043,1,1701290,1701918,+,628
400,WOLB.0323.00020,1,1227337,1227962,+,625
400,WOLB.0323.00122,1,1504455,1505086,+,631
400,WOLB.0323.00118,1,1037919,1038545,-,626
400,WOLB.0323.00004,1,1334554,1335179,+,625
400,WOLB.0323.00011,1,703970,704595,+,625
400,WOLB.0323.00035,1,1222894,1223519,+,625
400,WOLB.0323.00032,1,801633,802258,+,625
400,WOLB.0323.00012,1,1287029,1287654,+,625
400,WOLB.0323.00018,1,46818,47449,+,631
400,WOLB.0323.00025,1,149697,150333,+,636
400,WOLB.0323.00010,1,1634977,1635609,-,632
400,WOLB.0323.00068,1,1282455,1283080,+,625
400,WOLB.0323.00128,1,1480041,1480670,+,629
400,WOLB.0323.00158,1,635549,636174,+,625
400,WOLB.0323.00017,1,1325238,1325863,+,625
400,WOLB.0323.00104,1,1261946,1262571,+,625
400,WOLB.0323.00007,1,1463782,1464407,+,625
400,WOLB.0323.00001,1,531655,532281,+,626
400,WOLB.0323.00100,1,1605448,1606073,+,625
400,WOLB.0323.00070,1,1746196,1746821,+,625
400,WOLB.0323.00006,1,635336,635974,-,638
400,WOLB.0323.00042,1,1767725,1768355,-,630
400,WOLB.0323.00119,1,880158,880794,+,636
400,WOLB.0323.00149,1,511549,512175,-,626
400,WOLB.0323.00014,1,1762970,1763595,+,625
400,WOLB.0323.00096,1,590879,591503,-,624
401,WOLB.0323.00090,1,1193283,1197748,+,4465
401,WOLB.0323.00002,1,1436971,1441439,-,4468
401,WOLB.0323.00138,1,643860,648325,-,4465
401,WOLB.0323.00132,1,1304044,1308511,-,4467
401,WOLB.0323.00143,1,426561,431026,-,4465
401,WOLB.0323.00106,1,426564,431029,-,4465
401,WOLB.0323.00121,1,1463473,1467938,+,4465
401,WOLB.0323.00135,1,432609,437074,-,4465
401,WOLB.0323.00103,1,532288,536745,+,4457
401,WOLB.0323.00107,1,532290,536747,+,4457
401,WOLB.0323.00019,1,880441,884906,+,4465
401,WOLB.0323.00060,1,1283154,1287619,+,4465
401,WOLB.0323.00074,1,1105819,1110284,+,4465
401,WOLB.0323.00120,1,1090455,1094920,+,4465
401,WOLB.0323.00039,1,828772,833237,+,4465
401,WOLB.0323.00041,1,547908,552374,-,4466
401,WOLB.0323.00031,1,356282,360747,+,4465
401,WOLB.0323.00056,1,1500689,1505154,+,4465
401,WOLB.0323.00142,1,1341534,1345999,+,4465
401,WOLB.0323.00023,1,617430,621897,-,4467
401,WOLB.0323.00153,1,1269347,1273812,+,4465
401,WOLB.0323.00093,1,59400,63866,+,4466
401,WOLB.0323.00088,1,1286089,1290554,+,4465
401,WOLB.0323.00008,1,1361353,1365821,-,4468
401,WOLB.0323.00024,1,672766,677233,-,4467
401,WOLB.0323.00064,1,1268093,1272557,-,4464
401,WOLB.0323.00030,1,1637106,1641571,+,4465
401,WOLB.0323.00105,1,532297,536754,+,4457
401,WOLB.0323.00133,1,937292,941752,-,4460
401,WOLB.0323.00084,1,738993,743458,-,4465
401,WOLB.0323.00021,1,1621417,1625882,+,4465
401,WOLB.0323.00043,1,1704224,1708689,+,4465
401,WOLB.0323.00020,1,1230268,1234733,+,4465
401,WOLB.0323.00122,1,1505088,1509555,+,4467
401,WOLB.0323.00118,1,1222939,1227404,+,4465
401,WOLB.0323.00004,1,1337485,1341950,+,4465
401,WOLB.0323.00011,1,706901,711366,+,4465
401,WOLB.0323.00035,1,1225825,1230290,+,4465
401,WOLB.0323.00032,1,804564,809029,+,4465
401,WOLB.0323.00012,1,1289960,1294425,+,4465
401,WOLB.0323.00018,1,47451,51918,+,4467
401,WOLB.0323.00025,1,150349,154812,+,4463
401,WOLB.0323.00010,1,1630508,1634976,-,4468
401,WOLB.0323.00068,1,1285386,1289851,+,4465
401,WOLB.0323.00128,1,1482976,1487441,+,4465
401,WOLB.0323.00158,1,638480,642945,+,4465
401,WOLB.0323.00017,1,1328169,1332634,+,4465
401,WOLB.0323.00104,1,1264877,1269342,+,4465
401,WOLB.0323.00007,1,1466713,1471178,+,4465
401,WOLB.0323.00001,1,532297,536754,+,4457
401,WOLB.0323.00100,1,1608379,1612844,+,4465
401,WOLB.0323.00070,1,1746829,1751295,+,4466
401,WOLB.0323.00006,1,760368,764833,+,4465
401,WOLB.0323.00042,1,1760954,1765419,-,4465
401,WOLB.0323.00119,1,883095,887560,+,4465
401,WOLB.0323.00149,1,504778,509243,-,4465
401,WOLB.0323.00014,1,1763603,1768070,+,4467
401,WOLB.0323.00096,1,586397,590863,-,4466
402,WOLB.0323.00090,1,1198234,1199248,+,1014
402,WOLB.0323.00135,1,431109,432124,-,1015
402,WOLB.0323.00153,1,1274298,1275312,+,1014
402,WOLB.0323.00093,1,1692581,1693595,+,1014
403,WOLB.0323.00090,1,1199703,1201077,+,1374
403,WOLB.0323.00002,1,1538937,1540310,-,1373
403,WOLB.0323.00138,1,638796,640161,-,1365
403,WOLB.0323.00132,1,1279247,1280609,-,1362
403,WOLB.0323.00143,1,421152,422517,-,1365
403,WOLB.0323.00106,1,421155,422520,-,1365
403,WOLB.0323.00121,1,1471074,1472454,+,1380
403,WOLB.0323.00135,1,429281,430655,-,1374
403,WOLB.0323.00103,1,540755,542111,+,1356
403,WOLB.0323.00107,1,540757,542113,+,1356
403,WOLB.0323.00019,1,887405,888773,+,1368
403,WOLB.0323.00060,1,1289496,1290876,+,1380
403,WOLB.0323.00074,1,1148785,1150229,-,1444
403,WOLB.0323.00120,1,1140178,1141622,-,1444
403,WOLB.0323.00039,1,835736,837104,+,1368
403,WOLB.0323.00041,1,507964,509408,+,1444
403,WOLB.0323.00031,1,364792,366157,+,1365
403,WOLB.0323.00056,1,1507044,1508411,+,1367
403,WOLB.0323.00142,1,1349135,1350515,+,1380
403,WOLB.0323.00023,1,672609,673971,+,1362
403,WOLB.0323.00153,1,1275767,1277141,+,1374
403,WOLB.0323.00093,1,1694010,1695368,+,1358
403,WOLB.0323.00088,1,1292609,1293942,+,1333
403,WOLB.0323.00008,1,1263814,1265169,+,1355
403,WOLB.0323.00024,1,225591,227062,+,1471
403,WOLB.0323.00064,1,1242370,1243735,-,1365
403,WOLB.0323.00030,1,1665945,1667310,+,1365
403,WOLB.0323.00105,1,540764,542120,+,1356
403,WOLB.0323.00133,1,93680,95058,+,1378
403,WOLB.0323.00084,1,733716,735081,-,1365
403,WOLB.0323.00021,1,1629795,1631160,+,1365
403,WOLB.0323.00043,1,1481762,1483135,+,1373
403,WOLB.0323.00020,1,1236788,1238121,+,1333
403,WOLB.0323.00122,1,1512697,1514078,+,1381
403,WOLB.0323.00118,1,1229268,1230645,+,1377
403,WOLB.0323.00004,1,1345086,1346466,+,1380
403,WOLB.0323.00011,1,714501,715881,+,1380
403,WOLB.0323.00035,1,1232345,1233678,+,1333
403,WOLB.0323.00032,1,1267352,1268706,+,1354
403,WOLB.0323.00012,1,1296468,1297801,+,1333
403,WOLB.0323.00018,1,1222040,1223400,-,1360
403,WOLB.0323.00025,1,47275,48603,+,1328
403,WOLB.0323.00010,1,1605295,1606668,-,1373
403,WOLB.0323.00068,1,1357520,1358874,+,1354
403,WOLB.0323.00128,1,1391527,1392900,+,1373
403,WOLB.0323.00158,1,646081,647461,+,1380
403,WOLB.0323.00017,1,1335770,1337150,+,1380
403,WOLB.0323.00104,1,1271385,1272718,+,1333
403,WOLB.0323.00007,1,1473055,1474435,+,1380
403,WOLB.0323.00001,1,540764,542120,+,1356
403,WOLB.0323.00100,1,1614899,1616232,+,1333
403,WOLB.0323.00070,1,1849845,1851218,-,1373
403,WOLB.0323.00006,1,767651,769016,+,1365
403,WOLB.0323.00042,1,1507515,1508896,+,1381
403,WOLB.0323.00119,1,890059,891427,+,1368
403,WOLB.0323.00149,1,500263,501643,-,1380
403,WOLB.0323.00014,1,615026,616399,+,1373
403,WOLB.0323.00096,1,537207,538651,+,1444
404,WOLB.0323.00090,1,1201136,1201768,+,632
404,WOLB.0323.00002,1,1538245,1538877,-,632
404,WOLB.0323.00138,1,638105,638737,-,632
404,WOLB.0323.00132,1,1278557,1279188,-,631
404,WOLB.0323.00143,1,420461,421093,-,632
404,WOLB.0323.00106,1,420464,421096,-,632
404,WOLB.0323.00121,1,1472513,1473145,+,632
404,WOLB.0323.00135,1,428590,429222,-,632
404,WOLB.0323.00103,1,542170,542800,+,630
404,WOLB.0323.00107,1,542172,542802,+,630
404,WOLB.0323.00019,1,888832,889456,+,624
404,WOLB.0323.00060,1,1290935,1291567,+,632
404,WOLB.0323.00074,1,1148095,1148726,-,631
404,WOLB.0323.00120,1,1132731,1133362,-,631
404,WOLB.0323.00120,1,1133441,1134072,+,631
404,WOLB.0323.00120,1,1139530,1140119,-,589
404,WOLB.0323.00039,1,837163,837787,+,624
404,WOLB.0323.00041,1,509467,510098,+,631
404,WOLB.0323.00031,1,366216,366848,+,632
404,WOLB.0323.00056,1,1508470,1509102,+,632
404,WOLB.0323.00142,1,1350574,1351206,+,632
404,WOLB.0323.00023,1,674030,674662,+,632
404,WOLB.0323.00153,1,1277200,1277832,+,632
404,WOLB.0323.00093,1,1697871,1698502,+,631
404,WOLB.0323.00088,1,1294001,1294633,+,632
404,WOLB.0323.00008,1,1265228,1265860,+,632
404,WOLB.0323.00024,1,227121,227753,+,632
404,WOLB.0323.00064,1,1241679,1242311,-,632
404,WOLB.0323.00030,1,1667369,1668001,+,632
404,WOLB.0323.00105,1,542179,542809,+,630
404,WOLB.0323.00133,1,95126,95751,+,625
404,WOLB.0323.00084,1,733025,733657,-,632
404,WOLB.0323.00021,1,1631219,1631851,+,632
404,WOLB.0323.00043,1,1483195,1483827,+,632
404,WOLB.0323.00020,1,1238180,1238812,+,632
404,WOLB.0323.00122,1,1514137,1514769,+,632
404,WOLB.0323.00118,1,1230704,1231336,+,632
404,WOLB.0323.00004,1,1346525,1347157,+,632
404,WOLB.0323.00011,1,715940,716572,+,632
404,WOLB.0323.00035,1,1233737,1234369,+,632
404,WOLB.0323.00032,1,1268765,1269397,+,632
404,WOLB.0323.00012,1,1297860,1298492,+,632
404,WOLB.0323.00018,1,1221348,1221980,-,632
404,WOLB.0323.00025,1,48662,49294,+,632
404,WOLB.0323.00010,1,1604603,1605235,-,632
404,WOLB.0323.00068,1,1358933,1359565,+,632
404,WOLB.0323.00128,1,1392960,1393592,+,632
404,WOLB.0323.00158,1,647520,648152,+,632
404,WOLB.0323.00017,1,1337209,1337841,+,632
404,WOLB.0323.00104,1,1272777,1273409,+,632
404,WOLB.0323.00007,1,1474494,1475126,+,632
404,WOLB.0323.00001,1,542179,542809,+,630
404,WOLB.0323.00100,1,1616291,1616923,+,632
404,WOLB.0323.00070,1,1849153,1849785,-,632
404,WOLB.0323.00006,1,769075,769707,+,632
404,WOLB.0323.00042,1,1508955,1509587,+,632
404,WOLB.0323.00119,1,891486,892110,+,624
404,WOLB.0323.00149,1,499572,500204,-,632
404,WOLB.0323.00014,1,616459,617091,+,632
404,WOLB.0323.00096,1,538710,539341,+,631
405,WOLB.0323.00090,1,1201769,1203075,+,1306
405,WOLB.0323.00002,1,1536944,1538243,-,1299
405,WOLB.0323.00138,1,636797,638103,-,1306
405,WOLB.0323.00132,1,1277249,1278555,-,1306
405,WOLB.0323.00143,1,419160,420459,-,1299
405,WOLB.0323.00106,1,419163,420462,-,1299
405,WOLB.0323.00121,1,1473146,1474453,+,1307
405,WOLB.0323.00135,1,427282,428588,-,1306
405,WOLB.0323.00103,1,542801,544107,+,1306
405,WOLB.0323.00107,1,542803,544109,+,1306
405,WOLB.0323.00019,1,889457,890763,+,1306
405,WOLB.0323.00060,1,1291568,1292874,+,1306
405,WOLB.0323.00074,1,1146794,1148093,-,1299
405,WOLB.0323.00120,1,1131430,1132729,-,1299
405,WOLB.0323.00120,1,1134073,1135372,+,1299
405,WOLB.0323.00039,1,837788,839094,+,1306
405,WOLB.0323.00041,1,510099,511398,+,1299
405,WOLB.0323.00031,1,366849,368148,+,1299
405,WOLB.0323.00056,1,1509103,1510409,+,1306
405,WOLB.0323.00142,1,1351207,1352514,+,1307
405,WOLB.0323.00023,1,674663,675969,+,1306
405,WOLB.0323.00153,1,1277833,1279139,+,1306
405,WOLB.0323.00093,1,1698503,1699809,+,1306
405,WOLB.0323.00088,1,1294634,1295940,+,1306
405,WOLB.0323.00008,1,1265861,1267115,+,1254
405,WOLB.0323.00024,1,227754,229060,+,1306
405,WOLB.0323.00064,1,1240371,1241677,-,1306
405,WOLB.0323.00030,1,1668002,1669308,+,1306
405,WOLB.0323.00105,1,542810,544116,+,1306
405,WOLB.0323.00133,1,95752,97050,+,1298
405,WOLB.0323.00084,1,731717,733023,-,1306
405,WOLB.0323.00021,1,1631852,1633158,+,1306
405,WOLB.0323.00043,1,1483828,1485127,+,1299
405,WOLB.0323.00020,1,1238813,1240119,+,1306
405,WOLB.0323.00122,1,1514770,1516076,+,1306
405,WOLB.0323.00118,1,1231337,1232643,+,1306
405,WOLB.0323.00004,1,1347158,1348465,+,1307
405,WOLB.0323.00011,1,716573,717880,+,1307
405,WOLB.0323.00035,1,1234370,1235676,+,1306
405,WOLB.0323.00032,1,1269398,1270704,+,1306
405,WOLB.0323.00012,1,1298493,1299799,+,1306
405,WOLB.0323.00018,1,1220047,1221346,-,1299
405,WOLB.0323.00025,1,49295,50596,+,1301
405,WOLB.0323.00010,1,1603302,1604601,-,1299
405,WOLB.0323.00068,1,1359566,1360872,+,1306
405,WOLB.0323.00128,1,1393593,1394892,+,1299
405,WOLB.0323.00158,1,648153,649460,+,1307
405,WOLB.0323.00017,1,1337842,1339149,+,1307
405,WOLB.0323.00104,1,1273410,1274716,+,1306
405,WOLB.0323.00007,1,1475127,1476433,+,1306
405,WOLB.0323.00001,1,542810,544116,+,1306
405,WOLB.0323.00100,1,1616924,1618230,+,1306
405,WOLB.0323.00070,1,1847852,1849151,-,1299
405,WOLB.0323.00006,1,769708,771007,+,1299
405,WOLB.0323.00042,1,1509588,1510887,+,1299
405,WOLB.0323.00119,1,892111,893417,+,1306
405,WOLB.0323.00149,1,498263,499570,-,1307
405,WOLB.0323.00014,1,617092,618391,+,1299
405,WOLB.0323.00096,1,539342,540641,+,1299
406,WOLB.0323.00090,1,1203077,1206366,+,3289
406,WOLB.0323.00002,1,1533654,1536943,-,3289
406,WOLB.0323.00138,1,633507,636796,-,3289
406,WOLB.0323.00132,1,1273959,1277248,-,3289
406,WOLB.0323.00143,1,415866,419159,-,3293
406,WOLB.0323.00106,1,415869,419162,-,3293
406,WOLB.0323.00121,1,1474455,1477744,+,3289
406,WOLB.0323.00135,1,423992,427281,-,3289
406,WOLB.0323.00103,1,544109,547398,+,3289
406,WOLB.0323.00107,1,544111,547400,+,3289
406,WOLB.0323.00019,1,890765,894054,+,3289
406,WOLB.0323.00060,1,1292876,1296165,+,3289
406,WOLB.0323.00074,1,1143500,1146793,-,3293
406,WOLB.0323.00120,1,1128136,1131429,-,3293
406,WOLB.0323.00120,1,1135374,1138665,+,3291
406,WOLB.0323.00039,1,839096,842385,+,3289
406,WOLB.0323.00041,1,511400,514693,+,3293
406,WOLB.0323.00031,1,368150,371443,+,3293
406,WOLB.0323.00056,1,1510411,1513698,+,3287
406,WOLB.0323.00142,1,1352516,1355805,+,3289
406,WOLB.0323.00023,1,675971,679251,+,3280
406,WOLB.0323.00153,1,1279141,1282430,+,3289
406,WOLB.0323.00093,1,1699811,1703096,+,3285
406,WOLB.0323.00088,1,1295942,1299231,+,3289
406,WOLB.0323.00008,1,1268276,1271561,+,3285
406,WOLB.0323.00024,1,229062,232347,+,3285
406,WOLB.0323.00064,1,1237085,1240370,-,3285
406,WOLB.0323.00030,1,1669310,1672595,+,3285
406,WOLB.0323.00105,1,544118,547407,+,3289
406,WOLB.0323.00133,1,97052,100341,+,3289
406,WOLB.0323.00084,1,728427,731716,-,3289
406,WOLB.0323.00021,1,1633160,1636449,+,3289
406,WOLB.0323.00043,1,1485129,1488418,+,3289
406,WOLB.0323.00020,1,1240121,1243410,+,3289
406,WOLB.0323.00122,1,1516078,1519367,+,3289
406,WOLB.0323.00118,1,1232645,1235934,+,3289
406,WOLB.0323.00004,1,1348467,1351756,+,3289
406,WOLB.0323.00011,1,717882,721171,+,3289
406,WOLB.0323.00035,1,1235678,1238967,+,3289
406,WOLB.0323.00032,1,1270706,1273995,+,3289
406,WOLB.0323.00012,1,1299801,1303090,+,3289
406,WOLB.0323.00018,1,1216770,1220046,-,3276
406,WOLB.0323.00025,1,50598,53891,+,3293
406,WOLB.0323.00010,1,1600013,1603301,-,3288
406,WOLB.0323.00068,1,1360874,1364163,+,3289
406,WOLB.0323.00128,1,1394894,1398183,+,3289
406,WOLB.0323.00158,1,649462,652751,+,3289
406,WOLB.0323.00017,1,1339151,1342440,+,3289
406,WOLB.0323.00104,1,1274718,1278007,+,3289
406,WOLB.0323.00007,1,1476435,1479724,+,3289
406,WOLB.0323.00001,1,544118,547407,+,3289
406,WOLB.0323.00100,1,1618232,1621521,+,3289
406,WOLB.0323.00070,1,1844562,1847851,-,3289
406,WOLB.0323.00006,1,771009,774302,+,3293
406,WOLB.0323.00042,1,1510889,1514169,+,3280
406,WOLB.0323.00119,1,893419,896708,+,3289
406,WOLB.0323.00149,1,494973,498262,-,3289
406,WOLB.0323.00014,1,618393,621682,+,3289
406,WOLB.0323.00096,1,540643,543936,+,3293
407,WOLB.0323.00090,1,1207230,1209999,+,2769
407,WOLB.0323.00002,1,1529989,1532758,-,2769
407,WOLB.0323.00138,1,629872,632642,-,2770
407,WOLB.0323.00132,1,1270294,1273063,-,2769
407,WOLB.0323.00143,1,412213,414982,-,2769
407,WOLB.0323.00106,1,412216,414985,-,2769
407,WOLB.0323.00121,1,1478608,1481378,+,2770
407,WOLB.0323.00135,1,420357,423127,-,2770
407,WOLB.0323.00103,1,548280,551049,+,2769
407,WOLB.0323.00107,1,548282,551047,+,2765
407,WOLB.0323.00019,1,894951,897720,+,2769
407,WOLB.0323.00060,1,1297029,1299799,+,2770
407,WOLB.0323.00074,1,1139900,1142669,-,2769
407,WOLB.0323.00120,1,1124536,1127305,-,2769
407,WOLB.0323.00039,1,843282,846051,+,2769
407,WOLB.0323.00041,1,515523,518292,+,2769
407,WOLB.0323.00031,1,372326,375095,+,2769
407,WOLB.0323.00056,1,1514564,1517334,+,2770
407,WOLB.0323.00142,1,1356669,1359439,+,2770
407,WOLB.0323.00023,1,680146,682915,+,2769
407,WOLB.0323.00153,1,1283294,1286063,+,2769
407,WOLB.0323.00093,1,1703977,1706746,+,2769
407,WOLB.0323.00088,1,1300095,1302865,+,2770
407,WOLB.0323.00008,1,1272442,1275211,+,2769
407,WOLB.0323.00024,1,234065,236834,+,2769
407,WOLB.0323.00064,1,1232587,1235365,-,2778
407,WOLB.0323.00030,1,1674313,1677091,+,2778
407,WOLB.0323.00105,1,548289,551058,+,2769
407,WOLB.0323.00133,1,101213,103982,+,2769
407,WOLB.0323.00084,1,724792,727562,-,2770
407,WOLB.0323.00021,1,1637313,1640083,+,2770
407,WOLB.0323.00043,1,1489313,1492082,+,2769
407,WOLB.0323.00020,1,1244274,1247044,+,2770
407,WOLB.0323.00122,1,1520231,1523001,+,2770
407,WOLB.0323.00118,1,1236798,1239567,+,2769
407,WOLB.0323.00004,1,1352620,1355390,+,2770
407,WOLB.0323.00011,1,722035,724805,+,2770
407,WOLB.0323.00035,1,1239831,1242601,+,2770
407,WOLB.0323.00032,1,1274859,1277629,+,2770
407,WOLB.0323.00012,1,1303954,1306724,+,2770
407,WOLB.0323.00018,1,1204629,1207390,+,2761
407,WOLB.0323.00025,1,54732,57501,+,2769
407,WOLB.0323.00010,1,1596348,1599117,-,2769
407,WOLB.0323.00068,1,1365027,1367797,+,2770
407,WOLB.0323.00128,1,1399078,1401847,+,2769
407,WOLB.0323.00158,1,653615,656385,+,2770
407,WOLB.0323.00017,1,1343304,1346074,+,2770
407,WOLB.0323.00104,1,1278871,1281641,+,2770
407,WOLB.0323.00007,1,1480588,1483358,+,2770
407,WOLB.0323.00001,1,548289,551058,+,2769
407,WOLB.0323.00100,1,1622385,1625155,+,2770
407,WOLB.0323.00070,1,1840897,1843666,-,2769
407,WOLB.0323.00006,1,775185,777954,+,2769
407,WOLB.0323.00042,1,1515051,1517820,+,2769
407,WOLB.0323.00119,1,897605,900374,+,2769
407,WOLB.0323.00149,1,491338,494108,-,2770
407,WOLB.0323.00014,1,622577,625346,+,2769
407,WOLB.0323.00096,1,544766,547535,+,2769
408,WOLB.0323.00090,1,1210001,1212581,+,2580
408,WOLB.0323.00002,1,1527410,1529988,-,2578
408,WOLB.0323.00138,1,627291,629871,-,2580
408,WOLB.0323.00132,1,1267713,1270293,-,2580
408,WOLB.0323.00143,1,409632,412212,-,2580
408,WOLB.0323.00106,1,409635,412215,-,2580
408,WOLB.0323.00121,1,1481380,1483960,+,2580
408,WOLB.0323.00135,1,417776,420356,-,2580
408,WOLB.0323.00103,1,551051,553631,+,2580
408,WOLB.0323.00107,1,551049,553629,+,2580
408,WOLB.0323.00019,1,897722,900302,+,2580
408,WOLB.0323.00060,1,1299801,1302376,+,2575
408,WOLB.0323.00074,1,1137319,1139899,-,2580
408,WOLB.0323.00120,1,1121955,1124535,-,2580
408,WOLB.0323.00039,1,846053,848633,+,2580
408,WOLB.0323.00041,1,518294,520874,+,2580
408,WOLB.0323.00031,1,375097,377677,+,2580
408,WOLB.0323.00056,1,1517336,1519911,+,2575
408,WOLB.0323.00142,1,1359441,1362021,+,2580
408,WOLB.0323.00023,1,682917,685495,+,2578
408,WOLB.0323.00153,1,1286065,1288645,+,2580
408,WOLB.0323.00093,1,1706748,1709328,+,2580
408,WOLB.0323.00088,1,1302867,1305447,+,2580
408,WOLB.0323.00008,1,1275213,1277793,+,2580
408,WOLB.0323.00024,1,236836,239416,+,2580
408,WOLB.0323.00064,1,1230006,1232586,-,2580
408,WOLB.0323.00030,1,1677093,1679673,+,2580
408,WOLB.0323.00105,1,551060,553640,+,2580
408,WOLB.0323.00133,1,103984,106564,+,2580
408,WOLB.0323.00084,1,722211,724791,-,2580
408,WOLB.0323.00021,1,1640085,1642665,+,2580
408,WOLB.0323.00043,1,1492084,1494662,+,2578
408,WOLB.0323.00020,1,1247046,1249626,+,2580
408,WOLB.0323.00122,1,1523003,1525583,+,2580
408,WOLB.0323.00118,1,1239569,1242149,+,2580
408,WOLB.0323.00004,1,1355392,1357972,+,2580
408,WOLB.0323.00011,1,724807,727387,+,2580
408,WOLB.0323.00035,1,1242603,1245183,+,2580
408,WOLB.0323.00032,1,1277631,1280211,+,2580
408,WOLB.0323.00012,1,1306726,1309306,+,2580
408,WOLB.0323.00018,1,1207392,1209970,+,2578
408,WOLB.0323.00025,1,57503,60083,+,2580
408,WOLB.0323.00010,1,1593769,1596347,-,2578
408,WOLB.0323.00068,1,1367799,1370379,+,2580
408,WOLB.0323.00128,1,1401849,1404427,+,2578
408,WOLB.0323.00158,1,656387,658967,+,2580
408,WOLB.0323.00017,1,1346076,1348656,+,2580
408,WOLB.0323.00104,1,1281643,1284223,+,2580
408,WOLB.0323.00007,1,1483360,1485935,+,2575
408,WOLB.0323.00001,1,551060,553640,+,2580
408,WOLB.0323.00100,1,1625157,1627737,+,2580
408,WOLB.0323.00070,1,1838318,1840896,-,2578
408,WOLB.0323.00006,1,777956,780536,+,2580
408,WOLB.0323.00042,1,1517822,1520402,+,2580
408,WOLB.0323.00119,1,900376,902956,+,2580
408,WOLB.0323.00149,1,488757,491337,-,2580
408,WOLB.0323.00014,1,625348,627926,+,2578
408,WOLB.0323.00096,1,547537,550117,+,2580
408,WOLB.0323.00096,1,560956,563537,-,2581
409,WOLB.0323.00090,1,1213369,1213981,+,612
409,WOLB.0323.00002,1,1526125,1526734,-,609
409,WOLB.0323.00138,1,625891,626502,-,611
409,WOLB.0323.00132,1,1266314,1266926,-,612
409,WOLB.0323.00143,1,408085,408697,-,612
409,WOLB.0323.00106,1,408088,408700,-,612
409,WOLB.0323.00121,1,1484748,1485360,+,612
409,WOLB.0323.00135,1,414965,415577,-,612
409,WOLB.0323.00103,1,554297,554909,+,612
409,WOLB.0323.00107,1,554295,554907,+,612
409,WOLB.0323.00019,1,901090,901702,+,612
409,WOLB.0323.00060,1,1304505,1305117,+,612
409,WOLB.0323.00074,1,1136033,1136645,-,612
409,WOLB.0323.00120,1,1120669,1121281,-,612
409,WOLB.0323.00039,1,849421,850033,+,612
409,WOLB.0323.00041,1,521548,522160,+,612
409,WOLB.0323.00031,1,378612,379224,+,612
409,WOLB.0323.00056,1,1522040,1522652,+,612
409,WOLB.0323.00142,1,1362809,1363421,+,612
409,WOLB.0323.00023,1,686285,686897,+,612
409,WOLB.0323.00153,1,1289433,1290045,+,612
409,WOLB.0323.00093,1,1710007,1710614,+,607
409,WOLB.0323.00088,1,1306235,1306847,+,612
409,WOLB.0323.00008,1,1278472,1279079,+,607
409,WOLB.0323.00024,1,240204,240816,+,612
409,WOLB.0323.00064,1,1227303,1227915,-,612
409,WOLB.0323.00030,1,1681785,1682397,+,612
409,WOLB.0323.00105,1,554306,554918,+,612
409,WOLB.0323.00133,1,107502,108114,+,612
409,WOLB.0323.00084,1,720811,721422,-,611
409,WOLB.0323.00021,1,1643454,1644065,+,611
409,WOLB.0323.00043,1,1495338,1495947,+,609
409,WOLB.0323.00020,1,1250414,1251026,+,612
409,WOLB.0323.00122,1,1526371,1526983,+,612
409,WOLB.0323.00118,1,1242937,1243549,+,612
409,WOLB.0323.00004,1,1358760,1359372,+,612
409,WOLB.0323.00011,1,728175,728787,+,612
409,WOLB.0323.00035,1,1245971,1246583,+,612
409,WOLB.0323.00032,1,1281000,1281611,+,611
409,WOLB.0323.00012,1,1310094,1310706,+,612
409,WOLB.0323.00018,1,1210760,1211372,+,612
409,WOLB.0323.00025,1,62495,63107,+,612
409,WOLB.0323.00010,1,1592484,1593093,-,609
409,WOLB.0323.00068,1,1371168,1371779,+,611
409,WOLB.0323.00128,1,1405103,1405712,+,609
409,WOLB.0323.00158,1,659755,660367,+,612
409,WOLB.0323.00017,1,1349444,1350056,+,612
409,WOLB.0323.00104,1,1285011,1285623,+,612
409,WOLB.0323.00007,1,1487431,1488043,+,612
409,WOLB.0323.00001,1,554306,554918,+,612
409,WOLB.0323.00100,1,1628525,1629137,+,612
409,WOLB.0323.00070,1,1837033,1837642,-,609
409,WOLB.0323.00006,1,781492,782104,+,612
409,WOLB.0323.00042,1,1521181,1521793,+,612
409,WOLB.0323.00119,1,903744,904356,+,612
409,WOLB.0323.00149,1,487357,487969,-,612
409,WOLB.0323.00014,1,628602,629211,+,609
409,WOLB.0323.00096,1,550791,551403,+,612
409,WOLB.0323.00096,1,559667,560279,-,612
410,WOLB.0323.00090,1,1217016,1218159,+,1143
410,WOLB.0323.00002,1,1518867,1520010,-,1143
410,WOLB.0323.00138,1,621779,622922,-,1143
410,WOLB.0323.00132,1,1121668,1122811,-,1143
410,WOLB.0323.00143,1,404434,405577,-,1143
410,WOLB.0323.00106,1,404437,405580,-,1143
410,WOLB.0323.00121,1,1488470,1489613,+,1143
410,WOLB.0323.00135,1,410787,411930,-,1143
410,WOLB.0323.00103,1,1399475,1400618,+,1143
410,WOLB.0323.00107,1,1397902,1399045,+,1143
410,WOLB.0323.00019,1,1294841,1295984,+,1143
410,WOLB.0323.00060,1,1308086,1309229,+,1143
410,WOLB.0323.00074,1,1131928,1133069,-,1141
410,WOLB.0323.00120,1,1116564,1117705,-,1141
410,WOLB.0323.00039,1,854274,855417,+,1143
410,WOLB.0323.00041,1,525124,526265,+,1141
410,WOLB.0323.00031,1,381732,382875,+,1143
410,WOLB.0323.00056,1,1525621,1526764,+,1143
410,WOLB.0323.00142,1,1366531,1367674,+,1143
410,WOLB.0323.00023,1,895458,896601,+,1143
410,WOLB.0323.00153,1,1293080,1294223,+,1143
410,WOLB.0323.00093,1,1713715,1714856,+,1141
410,WOLB.0323.00088,1,1309816,1310959,+,1143
410,WOLB.0323.00008,1,16258,17399,-,1141
410,WOLB.0323.00024,1,917000,918143,-,1143
410,WOLB.0323.00064,1,1031499,1032642,-,1143
410,WOLB.0323.00030,1,106664,107807,+,1143
410,WOLB.0323.00105,1,1399629,1400772,+,1143
410,WOLB.0323.00133,1,111144,112287,+,1143
410,WOLB.0323.00084,1,716699,717842,-,1143
410,WOLB.0323.00021,1,1647034,1648177,+,1143
410,WOLB.0323.00043,1,1502061,1503204,+,1143
410,WOLB.0323.00020,1,1253995,1255138,+,1143
410,WOLB.0323.00122,1,1530018,1531161,+,1143
410,WOLB.0323.00118,1,1246632,1247775,+,1143
410,WOLB.0323.00004,1,1362482,1363625,+,1143
410,WOLB.0323.00011,1,731897,733040,+,1143
410,WOLB.0323.00035,1,1249552,1250695,+,1143
410,WOLB.0323.00032,1,1132786,1133929,-,1143
410,WOLB.0323.00012,1,1313675,1314818,+,1143
410,WOLB.0323.00018,1,1234867,1236010,+,1143
410,WOLB.0323.00025,1,65771,66914,+,1143
410,WOLB.0323.00010,1,1580653,1581796,-,1143
410,WOLB.0323.00068,1,1376518,1377661,+,1143
410,WOLB.0323.00128,1,1411827,1412970,+,1143
410,WOLB.0323.00158,1,663477,664620,+,1143
410,WOLB.0323.00017,1,1353166,1354309,+,1143
410,WOLB.0323.00104,1,1288592,1289735,+,1143
410,WOLB.0323.00007,1,1491012,1492155,+,1143
410,WOLB.0323.00001,1,1399629,1400772,+,1143
410,WOLB.0323.00100,1,1632106,1633249,+,1143
410,WOLB.0323.00070,1,1829775,1830918,-,1143
410,WOLB.0323.00006,1,784540,785683,+,1143
410,WOLB.0323.00042,1,1524783,1525926,+,1143
410,WOLB.0323.00119,1,1296329,1297472,+,1143
410,WOLB.0323.00149,1,483104,484247,-,1143
410,WOLB.0323.00014,1,635326,636469,+,1143
410,WOLB.0323.00096,1,554368,555498,+,1130
410,WOLB.0323.00096,1,555562,556698,-,1136
410,WOLB.0323.00096,1,563613,564754,+,1141
411,WOLB.0323.00090,1,1218511,1220808,+,2297
411,WOLB.0323.00002,1,1516219,1518515,-,2296
411,WOLB.0323.00138,1,619130,621427,-,2297
411,WOLB.0323.00132,1,1119020,1121316,-,2296
411,WOLB.0323.00143,1,401790,404087,-,2297
411,WOLB.0323.00106,1,401793,404090,-,2297
411,WOLB.0323.00121,1,1489965,1492262,+,2297
411,WOLB.0323.00135,1,408138,410435,-,2297
411,WOLB.0323.00103,1,1400970,1403267,+,2297
411,WOLB.0323.00107,1,1399397,1401694,+,2297
411,WOLB.0323.00019,1,1296336,1298633,+,2297
411,WOLB.0323.00060,1,1309581,1311878,+,2297
411,WOLB.0323.00074,1,1129284,1131581,-,2297
411,WOLB.0323.00120,1,1113920,1116217,-,2297
411,WOLB.0323.00039,1,855769,858066,+,2297
411,WOLB.0323.00041,1,526612,528909,+,2297
411,WOLB.0323.00031,1,383222,385519,+,2297
411,WOLB.0323.00056,1,1527116,1529413,+,2297
411,WOLB.0323.00142,1,1368026,1370323,+,2297
411,WOLB.0323.00023,1,896953,899249,+,2296
411,WOLB.0323.00153,1,1294575,1296872,+,2297
411,WOLB.0323.00093,1,1715208,1717504,+,2296
411,WOLB.0323.00088,1,1311311,1313608,+,2297
411,WOLB.0323.00008,1,13610,15906,-,2296
411,WOLB.0323.00024,1,914352,916648,-,2296
411,WOLB.0323.00064,1,1028851,1031147,-,2296
411,WOLB.0323.00030,1,108159,110455,+,2296
411,WOLB.0323.00105,1,1401124,1403421,+,2297
411,WOLB.0323.00133,1,112639,114936,+,2297
411,WOLB.0323.00084,1,714050,716347,-,2297
411,WOLB.0323.00021,1,1648529,1650826,+,2297
411,WOLB.0323.00043,1,1503556,1505852,+,2296
411,WOLB.0323.00020,1,1255490,1257787,+,2297
411,WOLB.0323.00122,1,1531513,1533810,+,2297
411,WOLB.0323.00118,1,1248127,1250424,+,2297
411,WOLB.0323.00004,1,1363977,1366274,+,2297
411,WOLB.0323.00011,1,733392,735689,+,2297
411,WOLB.0323.00035,1,1251047,1253344,+,2297
411,WOLB.0323.00032,1,1130137,1132434,-,2297
411,WOLB.0323.00012,1,1315170,1317467,+,2297
411,WOLB.0323.00018,1,1236362,1238658,+,2296
411,WOLB.0323.00025,1,67261,69558,+,2297
411,WOLB.0323.00010,1,1578005,1580301,-,2296
411,WOLB.0323.00068,1,1378013,1380310,+,2297
411,WOLB.0323.00128,1,1413322,1415618,+,2296
411,WOLB.0323.00158,1,664972,667269,+,2297
411,WOLB.0323.00017,1,1354661,1356958,+,2297
411,WOLB.0323.00104,1,1290087,1292384,+,2297
411,WOLB.0323.00007,1,1492507,1494804,+,2297
411,WOLB.0323.00001,1,1401124,1403421,+,2297
411,WOLB.0323.00100,1,1633601,1635898,+,2297
411,WOLB.0323.00070,1,1827127,1829423,-,2296
411,WOLB.0323.00006,1,786030,788327,+,2297
411,WOLB.0323.00042,1,1527205,1529496,+,2291
411,WOLB.0323.00119,1,1297824,1300121,+,2297
411,WOLB.0323.00149,1,480455,482752,-,2297
411,WOLB.0323.00014,1,636821,639117,+,2296
411,WOLB.0323.00096,1,565101,567398,+,2297
412,WOLB.0323.00090,1,1221213,1223277,+,2064
412,WOLB.0323.00002,1,1513681,1515730,-,2049
412,WOLB.0323.00138,1,616661,618725,-,2064
412,WOLB.0323.00132,1,1116617,1118615,-,1998
412,WOLB.0323.00143,1,399312,401385,-,2073
412,WOLB.0323.00106,1,399315,401388,-,2073
412,WOLB.0323.00121,1,1492667,1494734,+,2067
412,WOLB.0323.00135,1,405669,407733,-,2064
412,WOLB.0323.00103,1,1403672,1405733,+,2061
412,WOLB.0323.00107,1,1402099,1404160,+,2061
412,WOLB.0323.00019,1,1299038,1301039,+,2001
412,WOLB.0323.00060,1,1312283,1314347,+,2064
412,WOLB.0323.00074,1,1127015,1129009,-,1994
412,WOLB.0323.00120,1,1111651,1113645,-,1994
412,WOLB.0323.00039,1,858471,860472,+,2001
412,WOLB.0323.00041,1,529184,531178,+,1994
412,WOLB.0323.00031,1,385924,387997,+,2073
412,WOLB.0323.00056,1,1529818,1531882,+,2064
412,WOLB.0323.00142,1,1370728,1372795,+,2067
412,WOLB.0323.00023,1,899654,901706,+,2052
412,WOLB.0323.00153,1,1297277,1299341,+,2064
412,WOLB.0323.00093,1,1717909,1719975,+,2066
412,WOLB.0323.00088,1,1314013,1316077,+,2064
412,WOLB.0323.00008,1,11207,13205,-,1998
412,WOLB.0323.00024,1,911946,913947,-,2001
412,WOLB.0323.00064,1,1026447,1028446,-,1999
412,WOLB.0323.00030,1,110860,112859,+,1999
412,WOLB.0323.00105,1,1403826,1405887,+,2061
412,WOLB.0323.00133,1,115341,117342,+,2001
412,WOLB.0323.00084,1,711581,713645,-,2064
412,WOLB.0323.00021,1,1651231,1653295,+,2064
412,WOLB.0323.00043,1,1506341,1508390,+,2049
412,WOLB.0323.00020,1,1258192,1260256,+,2064
412,WOLB.0323.00122,1,1534215,1536279,+,2064
412,WOLB.0323.00118,1,1250829,1252893,+,2064
412,WOLB.0323.00004,1,1366679,1368746,+,2067
412,WOLB.0323.00011,1,736094,738161,+,2067
412,WOLB.0323.00035,1,1253749,1255813,+,2064
412,WOLB.0323.00032,1,1127668,1129732,-,2064
412,WOLB.0323.00012,1,1317872,1319936,+,2064
412,WOLB.0323.00018,1,1239147,1241196,+,2049
412,WOLB.0323.00025,1,69967,72030,+,2063
412,WOLB.0323.00010,1,1575467,1577516,-,2049
412,WOLB.0323.00068,1,1380715,1382779,+,2064
412,WOLB.0323.00128,1,1416107,1418156,+,2049
412,WOLB.0323.00158,1,667674,669741,+,2067
412,WOLB.0323.00017,1,1357363,1359430,+,2067
412,WOLB.0323.00104,1,1292789,1294853,+,2064
412,WOLB.0323.00007,1,1495209,1497273,+,2064
412,WOLB.0323.00001,1,1403826,1405887,+,2061
412,WOLB.0323.00100,1,1636303,1638367,+,2064
412,WOLB.0323.00070,1,1824589,1826638,-,2049
412,WOLB.0323.00006,1,788732,790805,+,2073
412,WOLB.0323.00042,1,1529901,1531957,+,2056
412,WOLB.0323.00119,1,1300526,1302527,+,2001
412,WOLB.0323.00149,1,477983,480050,-,2067
412,WOLB.0323.00014,1,639606,641655,+,2049
412,WOLB.0323.00096,1,567673,569667,+,1994
413,WOLB.0323.00090,1,1223362,1224525,+,1163
413,WOLB.0323.00002,1,1512436,1513596,-,1160
413,WOLB.0323.00138,1,615413,616576,-,1163
413,WOLB.0323.00132,1,1115369,1116532,-,1163
413,WOLB.0323.00143,1,398068,399229,-,1161
413,WOLB.0323.00106,1,398071,399232,-,1161
413,WOLB.0323.00121,1,1494817,1495979,+,1162
413,WOLB.0323.00135,1,404421,405584,-,1163
413,WOLB.0323.00103,1,1405816,1406978,+,1162
413,WOLB.0323.00107,1,1404243,1405405,+,1162
413,WOLB.0323.00019,1,1304864,1306024,+,1160
413,WOLB.0323.00060,1,1314432,1315595,+,1163
413,WOLB.0323.00074,1,1125776,1126932,-,1156
413,WOLB.0323.00120,1,1110412,1111568,-,1156
413,WOLB.0323.00039,1,825227,826387,-,1160
413,WOLB.0323.00041,1,531261,532417,+,1156
413,WOLB.0323.00031,1,388080,389242,+,1162
413,WOLB.0323.00056,1,1531967,1533130,+,1163
413,WOLB.0323.00142,1,1372878,1374040,+,1162
413,WOLB.0323.00023,1,901789,902949,+,1160
413,WOLB.0323.00153,1,1299426,1300589,+,1163
413,WOLB.0323.00093,1,1720051,1721214,+,1163
413,WOLB.0323.00088,1,1316162,1317325,+,1163
413,WOLB.0323.00008,1,9960,11122,-,1162
413,WOLB.0323.00024,1,910700,911863,-,1163
413,WOLB.0323.00064,1,1025199,1026362,-,1163
413,WOLB.0323.00030,1,112944,114107,+,1163
413,WOLB.0323.00105,1,1405970,1407132,+,1162
413,WOLB.0323.00133,1,117425,118588,+,1163
413,WOLB.0323.00084,1,710333,711496,-,1163
413,WOLB.0323.00021,1,1653380,1654543,+,1163
413,WOLB.0323.00043,1,1508475,1509638,+,1163
413,WOLB.0323.00020,1,1260341,1261504,+,1163
413,WOLB.0323.00122,1,1536364,1537527,+,1163
413,WOLB.0323.00118,1,1252978,1254141,+,1163
413,WOLB.0323.00004,1,1368829,1369991,+,1162
413,WOLB.0323.00011,1,738244,739406,+,1162
413,WOLB.0323.00035,1,1255898,1257061,+,1163
413,WOLB.0323.00032,1,1126420,1127583,-,1163
413,WOLB.0323.00012,1,1320021,1321184,+,1163
413,WOLB.0323.00018,1,1241281,1242441,+,1160
413,WOLB.0323.00025,1,72113,73275,+,1162
413,WOLB.0323.00010,1,1574222,1575382,-,1160
413,WOLB.0323.00068,1,1382864,1384027,+,1163
413,WOLB.0323.00128,1,1418241,1419401,+,1160
413,WOLB.0323.00158,1,669824,670986,+,1162
413,WOLB.0323.00017,1,1359513,1360675,+,1162
413,WOLB.0323.00104,1,1294938,1296101,+,1163
413,WOLB.0323.00007,1,1497358,1498521,+,1163
413,WOLB.0323.00001,1,1405970,1407132,+,1162
413,WOLB.0323.00100,1,1638452,1639615,+,1163
413,WOLB.0323.00070,1,1823344,1824504,-,1160
413,WOLB.0323.00006,1,790888,792050,+,1162
413,WOLB.0323.00042,1,1532055,1533197,+,1142
413,WOLB.0323.00119,1,1306352,1307512,+,1160
413,WOLB.0323.00149,1,476738,477900,-,1162
413,WOLB.0323.00014,1,641740,642900,+,1160
413,WOLB.0323.00096,1,569750,570906,+,1156
414,WOLB.0323.00090,1,1226596,1227320,+,724
414,WOLB.0323.00138,1,611529,612253,-,724
414,WOLB.0323.00121,1,1498040,1498764,+,724
414,WOLB.0323.00135,1,369799,370523,-,724
414,WOLB.0323.00019,1,1308069,1308793,+,724
414,WOLB.0323.00039,1,822457,823181,-,724
414,WOLB.0323.00142,1,1376101,1376825,+,724
414,WOLB.0323.00023,1,770666,771368,+,702
414,WOLB.0323.00153,1,1302660,1303384,+,724
414,WOLB.0323.00088,1,1319396,1320120,+,724
414,WOLB.0323.00008,1,1389565,1390289,-,724
414,WOLB.0323.00024,1,1992965,1993689,-,724
414,WOLB.0323.00133,1,120649,121275,+,626
414,WOLB.0323.00084,1,706449,707173,-,724
414,WOLB.0323.00021,1,1657702,1658426,+,724
414,WOLB.0323.00020,1,1264619,1265343,+,724
414,WOLB.0323.00122,1,1540701,1541425,+,724
414,WOLB.0323.00004,1,1372052,1372776,+,724
414,WOLB.0323.00011,1,741467,742191,+,724
414,WOLB.0323.00035,1,1259132,1259856,+,724
414,WOLB.0323.00032,1,959853,960577,+,724
414,WOLB.0323.00012,1,1323255,1323979,+,724
414,WOLB.0323.00068,1,1387186,1387910,+,724
414,WOLB.0323.00158,1,673047,673771,+,724
414,WOLB.0323.00017,1,1362736,1363460,+,724
414,WOLB.0323.00104,1,1298172,1298896,+,724
414,WOLB.0323.00100,1,1641686,1642410,+,724
414,WOLB.0323.00119,1,1309557,1310281,+,724
414,WOLB.0323.00149,1,473952,474676,-,724
415,WOLB.0323.00090,1,1227658,1232591,+,4933
415,WOLB.0323.00002,1,1467147,1472080,+,4933
415,WOLB.0323.00138,1,606256,611197,-,4941
415,WOLB.0323.00132,1,1393128,1398061,+,4933
415,WOLB.0323.00143,1,2447,7380,-,4933
415,WOLB.0323.00106,1,2447,7380,-,4933
415,WOLB.0323.00121,1,1499094,1504027,+,4933
415,WOLB.0323.00135,1,364529,369462,-,4933
415,WOLB.0323.00103,1,1432002,1436943,-,4941
415,WOLB.0323.00107,1,1430429,1435370,-,4941
415,WOLB.0323.00019,1,1310117,1315058,+,4941
415,WOLB.0323.00060,1,1318750,1323683,+,4933
415,WOLB.0323.00074,1,1116297,1121216,-,4919
415,WOLB.0323.00120,1,1100933,1105852,-,4919
415,WOLB.0323.00039,1,816192,821133,-,4941
415,WOLB.0323.00041,1,536977,541896,+,4919
415,WOLB.0323.00031,1,764917,769850,-,4933
415,WOLB.0323.00056,1,1536285,1541218,+,4933
415,WOLB.0323.00142,1,1377155,1382088,+,4933
415,WOLB.0323.00023,1,771705,776646,+,4941
415,WOLB.0323.00153,1,1303722,1308655,+,4933
415,WOLB.0323.00093,1,1649280,1654208,-,4928
415,WOLB.0323.00088,1,1320458,1325391,+,4933
415,WOLB.0323.00008,1,1384290,1389231,-,4941
415,WOLB.0323.00024,1,1987696,1992629,-,4933
415,WOLB.0323.00064,1,1141943,1146876,-,4933
415,WOLB.0323.00030,1,1762828,1767761,+,4933
415,WOLB.0323.00105,1,1432156,1437097,-,4941
415,WOLB.0323.00133,1,121612,126545,+,4933
415,WOLB.0323.00084,1,701176,706117,-,4941
415,WOLB.0323.00021,1,1658759,1663700,+,4941
415,WOLB.0323.00043,1,1672658,1677591,-,4933
415,WOLB.0323.00020,1,1265681,1270614,+,4933
415,WOLB.0323.00122,1,1541763,1546696,+,4933
415,WOLB.0323.00118,1,1258394,1263327,+,4933
415,WOLB.0323.00004,1,1373106,1378039,+,4933
415,WOLB.0323.00011,1,742521,747454,+,4933
415,WOLB.0323.00035,1,1260194,1265127,+,4933
415,WOLB.0323.00032,1,960910,965851,+,4941
415,WOLB.0323.00012,1,1324317,1329250,+,4933
415,WOLB.0323.00018,1,1184860,1189793,+,4933
415,WOLB.0323.00025,1,422706,427639,-,4933
415,WOLB.0323.00010,1,1659307,1664240,+,4933
415,WOLB.0323.00068,1,1388243,1393184,+,4941
415,WOLB.0323.00128,1,1383679,1388612,-,4933
415,WOLB.0323.00158,1,674101,679034,+,4933
415,WOLB.0323.00017,1,1363790,1368723,+,4933
415,WOLB.0323.00104,1,1299234,1304167,+,4933
415,WOLB.0323.00007,1,1501676,1506609,+,4933
415,WOLB.0323.00001,1,1432156,1437097,-,4941
415,WOLB.0323.00100,1,1642748,1647681,+,4933
415,WOLB.0323.00070,1,1717566,1722499,-,4933
415,WOLB.0323.00006,1,583610,588543,-,4933
415,WOLB.0323.00042,1,1794840,1799768,+,4928
415,WOLB.0323.00119,1,1311605,1316546,+,4941
415,WOLB.0323.00149,1,468690,473623,-,4933
415,WOLB.0323.00014,1,1732965,1737898,-,4933
415,WOLB.0323.00096,1,575466,580385,+,4919
416,WOLB.0323.00002,1,71837,72356,+,519
416,WOLB.0323.00143,1,1172916,1173435,-,519
416,WOLB.0323.00106,1,1172919,1173438,-,519
416,WOLB.0323.00031,1,887401,887921,+,520
416,WOLB.0323.00023,1,857383,857903,+,520
416,WOLB.0323.00093,1,114748,115269,-,521
416,WOLB.0323.00043,1,70477,70996,+,519
416,WOLB.0323.00010,1,73784,74303,+,519
416,WOLB.0323.00128,1,70465,70984,+,519
416,WOLB.0323.00070,1,70501,71020,+,519
416,WOLB.0323.00006,1,451488,452006,-,518
416,WOLB.0323.00014,1,70466,70985,+,519
417,WOLB.0323.00002,1,260364,261982,+,1618
417,WOLB.0323.00132,1,73102,74773,+,1671
417,WOLB.0323.00074,1,646630,648285,+,1655
417,WOLB.0323.00120,1,632801,634456,+,1655
417,WOLB.0323.00041,1,982576,984231,-,1655
417,WOLB.0323.00023,1,1147232,1148903,+,1671
417,WOLB.0323.00024,1,1857400,1859056,-,1656
417,WOLB.0323.00064,1,1395407,1397078,+,1671
417,WOLB.0323.00030,1,1510805,1512476,-,1671
417,WOLB.0323.00043,1,257882,259537,+,1655
417,WOLB.0323.00018,1,295113,296793,+,1680
417,WOLB.0323.00010,1,263914,265567,+,1653
417,WOLB.0323.00128,1,259366,261021,+,1655
417,WOLB.0323.00070,1,257881,259536,+,1655
417,WOLB.0323.00042,1,272864,274545,+,1681
417,WOLB.0323.00014,1,260394,262049,+,1655
417,WOLB.0323.00096,1,1020479,1022134,-,1655
418,WOLB.0323.00002,1,277384,278175,+,791
418,WOLB.0323.00138,1,1338826,1339637,-,811
418,WOLB.0323.00132,1,89986,90825,+,839
418,WOLB.0323.00143,1,869463,870302,-,839
418,WOLB.0323.00106,1,869466,870305,-,839
418,WOLB.0323.00121,1,262428,263244,+,816
418,WOLB.0323.00103,1,1022636,1023447,-,811
418,WOLB.0323.00107,1,1021203,1022014,-,811
418,WOLB.0323.00060,1,781948,782787,+,839
418,WOLB.0323.00060,1,1641776,1642543,+,767
418,WOLB.0323.00031,1,1190535,1191374,+,839
418,WOLB.0323.00023,1,1164110,1164921,+,811
418,WOLB.0323.00023,1,1834656,1835467,-,811
418,WOLB.0323.00093,1,156508,157318,+,810
418,WOLB.0323.00093,1,1018152,1018937,+,785
418,WOLB.0323.00093,1,1128685,1129495,+,810
418,WOLB.0323.00088,1,296489,297305,+,816
418,WOLB.0323.00024,1,1599073,1599883,+,810
418,WOLB.0323.00064,1,664912,665752,+,840
418,WOLB.0323.00064,1,1412316,1413156,+,840
418,WOLB.0323.00030,1,838732,839572,-,840
418,WOLB.0323.00030,1,1494731,1495571,-,840
418,WOLB.0323.00105,1,1022644,1023455,-,811
418,WOLB.0323.00133,1,333065,333869,-,804
418,WOLB.0323.00084,1,1290876,1291687,-,811
418,WOLB.0323.00021,1,265164,265975,+,811
418,WOLB.0323.00021,1,1003433,1004244,+,811
418,WOLB.0323.00020,1,298832,299648,+,816
418,WOLB.0323.00122,1,269913,270752,+,839
418,WOLB.0323.00032,1,286362,287173,+,811
418,WOLB.0323.00012,1,296474,297290,+,816
418,WOLB.0323.00010,1,280801,281640,+,839
418,WOLB.0323.00010,1,327560,328399,-,839
418,WOLB.0323.00068,1,171057,171868,-,811
418,WOLB.0323.00017,1,262904,263720,+,816
418,WOLB.0323.00001,1,1022644,1023455,-,811
418,WOLB.0323.00100,1,296488,297304,+,816
418,WOLB.0323.00100,1,372065,372881,+,816
418,WOLB.0323.00070,1,274914,275753,+,839
418,WOLB.0323.00070,1,688971,689810,+,839
418,WOLB.0323.00006,1,148268,149107,-,839
418,WOLB.0323.00042,1,289731,290547,+,816
418,WOLB.0323.00014,1,336029,336868,+,839
418,WOLB.0323.00014,1,930553,931364,+,811
418,WOLB.0323.00014,1,989959,990770,+,811
419,WOLB.0323.00002,1,278943,279815,+,872
419,WOLB.0323.00138,1,1335817,1336689,-,872
419,WOLB.0323.00132,1,91593,92465,+,872
419,WOLB.0323.00143,1,867823,868695,-,872
419,WOLB.0323.00106,1,867826,868698,-,872
419,WOLB.0323.00121,1,264012,264884,+,872
419,WOLB.0323.00103,1,1020996,1021868,-,872
419,WOLB.0323.00107,1,1019563,1020435,-,872
419,WOLB.0323.00060,1,783555,784427,+,872
419,WOLB.0323.00060,1,1643311,1644183,+,872
419,WOLB.0323.00031,1,1192142,1193014,+,872
419,WOLB.0323.00023,1,1165689,1166561,+,872
419,WOLB.0323.00023,1,1833016,1833888,-,872
419,WOLB.0323.00093,1,158086,158958,+,872
419,WOLB.0323.00093,1,1130263,1131135,+,872
419,WOLB.0323.00088,1,298073,298945,+,872
419,WOLB.0323.00024,1,1600651,1601523,+,872
419,WOLB.0323.00064,1,666520,667392,+,872
419,WOLB.0323.00064,1,1413924,1414796,+,872
419,WOLB.0323.00030,1,837092,837964,-,872
419,WOLB.0323.00030,1,1493091,1493963,-,872
419,WOLB.0323.00105,1,1021004,1021876,-,872
419,WOLB.0323.00133,1,299350,300222,-,872
419,WOLB.0323.00084,1,1289236,1290108,-,872
419,WOLB.0323.00021,1,266743,267615,+,872
419,WOLB.0323.00021,1,1006381,1007253,+,872
419,WOLB.0323.00020,1,300416,301288,+,872
419,WOLB.0323.00122,1,271520,272392,+,872
419,WOLB.0323.00032,1,289310,290182,+,872
419,WOLB.0323.00012,1,298058,298930,+,872
419,WOLB.0323.00010,1,282408,283279,+,871
419,WOLB.0323.00010,1,325920,326792,-,872
419,WOLB.0323.00068,1,168048,168920,-,872
419,WOLB.0323.00017,1,264488,265360,+,872
419,WOLB.0323.00001,1,1021004,1021876,-,872
419,WOLB.0323.00100,1,298072,298944,+,872
419,WOLB.0323.00100,1,373649,374521,+,872
419,WOLB.0323.00070,1,276521,277393,+,872
419,WOLB.0323.00070,1,690578,691450,+,872
419,WOLB.0323.00006,1,146628,147500,-,872
419,WOLB.0323.00042,1,291316,292188,+,872
419,WOLB.0323.00014,1,337636,338508,+,872
419,WOLB.0323.00014,1,932132,933004,+,872
419,WOLB.0323.00014,1,991538,992410,+,872
420,WOLB.0323.00002,1,283050,283603,+,553
420,WOLB.0323.00132,1,99452,100005,+,553
420,WOLB.0323.00143,1,864054,864609,-,555
420,WOLB.0323.00106,1,864057,864612,-,555
420,WOLB.0323.00121,1,268125,268678,+,553
420,WOLB.0323.00103,1,1016930,1017482,-,552
420,WOLB.0323.00107,1,1015497,1016049,-,552
420,WOLB.0323.00060,1,787652,788205,+,553
420,WOLB.0323.00060,1,1647418,1647971,+,553
420,WOLB.0323.00031,1,1196228,1196783,+,555
420,WOLB.0323.00023,1,1169797,1170341,+,544
420,WOLB.0323.00023,1,1829236,1829779,-,543
420,WOLB.0323.00093,1,162199,162752,+,553
420,WOLB.0323.00093,1,1134378,1134930,+,552
420,WOLB.0323.00088,1,302186,302739,+,553
420,WOLB.0323.00064,1,1419824,1420368,+,544
420,WOLB.0323.00030,1,266416,266960,+,544
420,WOLB.0323.00105,1,1016938,1017490,-,552
420,WOLB.0323.00133,1,295582,296125,-,543
420,WOLB.0323.00084,1,1283681,1284224,-,543
420,WOLB.0323.00021,1,348623,349166,-,543
420,WOLB.0323.00020,1,304529,305082,+,553
420,WOLB.0323.00122,1,275617,276170,+,553
420,WOLB.0323.00032,1,295057,295601,+,544
420,WOLB.0323.00012,1,302171,302725,+,554
420,WOLB.0323.00010,1,286517,287070,+,553
420,WOLB.0323.00010,1,322126,322678,-,552
420,WOLB.0323.00017,1,268601,269154,+,553
420,WOLB.0323.00001,1,1016938,1017490,-,552
420,WOLB.0323.00100,1,302185,302738,+,553
420,WOLB.0323.00100,1,377762,378315,+,553
420,WOLB.0323.00070,1,280629,281173,+,544
420,WOLB.0323.00070,1,694686,695230,+,544
420,WOLB.0323.00006,1,142859,143414,-,555
420,WOLB.0323.00042,1,295429,295982,+,553
420,WOLB.0323.00014,1,341727,342271,+,544
420,WOLB.0323.00014,1,936223,936767,+,544
420,WOLB.0323.00014,1,995629,996173,+,544
421,WOLB.0323.00002,1,284286,285222,+,936
421,WOLB.0323.00132,1,100688,101626,+,938
421,WOLB.0323.00121,1,269361,270305,+,944
421,WOLB.0323.00103,1,1015303,1016247,-,944
421,WOLB.0323.00107,1,1013870,1014814,-,944
421,WOLB.0323.00060,1,788888,789828,+,940
421,WOLB.0323.00060,1,1648654,1649600,+,946
421,WOLB.0323.00023,1,1171024,1171968,+,944
421,WOLB.0323.00023,1,1826024,1826968,-,944
421,WOLB.0323.00093,1,163435,164379,+,944
421,WOLB.0323.00093,1,1135613,1136557,+,944
421,WOLB.0323.00088,1,303422,304366,+,944
421,WOLB.0323.00064,1,1421051,1421995,+,944
421,WOLB.0323.00030,1,267643,268587,+,944
421,WOLB.0323.00105,1,1015311,1016255,-,944
421,WOLB.0323.00133,1,293956,294899,-,943
421,WOLB.0323.00084,1,1282062,1282998,-,936
421,WOLB.0323.00021,1,346996,347940,-,944
421,WOLB.0323.00020,1,305765,306709,+,944
421,WOLB.0323.00122,1,276853,277791,+,938
421,WOLB.0323.00032,1,296284,297220,+,936
421,WOLB.0323.00012,1,303408,304352,+,944
421,WOLB.0323.00010,1,287753,288689,+,936
421,WOLB.0323.00010,1,320520,321444,-,924
421,WOLB.0323.00017,1,269837,270781,+,944
421,WOLB.0323.00001,1,1015311,1016255,-,944
421,WOLB.0323.00100,1,303421,304365,+,944
421,WOLB.0323.00100,1,378998,379942,+,944
421,WOLB.0323.00070,1,281856,282800,+,944
421,WOLB.0323.00070,1,695913,696857,+,944
421,WOLB.0323.00006,1,139921,140855,-,934
421,WOLB.0323.00042,1,296665,297609,+,944
421,WOLB.0323.00014,1,342954,343900,+,946
421,WOLB.0323.00014,1,937450,938396,+,946
421,WOLB.0323.00014,1,996856,997802,+,946
422,WOLB.0323.00002,1,296358,298069,+,1711
422,WOLB.0323.00002,1,777860,779492,-,1632
422,WOLB.0323.00143,1,572888,574519,+,1631
422,WOLB.0323.00106,1,572890,574521,+,1631
422,WOLB.0323.00121,1,281474,283105,+,1631
422,WOLB.0323.00060,1,1660754,1662465,+,1711
422,WOLB.0323.00031,1,212789,214421,-,1632
422,WOLB.0323.00023,1,1184511,1186142,+,1631
422,WOLB.0323.00093,1,175983,177614,+,1631
422,WOLB.0323.00088,1,315565,317196,+,1631
422,WOLB.0323.00024,1,1604772,1606402,+,1630
422,WOLB.0323.00064,1,1434096,1435727,+,1631
422,WOLB.0323.00030,1,280688,282319,+,1631
422,WOLB.0323.00133,1,1203154,1204791,+,1637
422,WOLB.0323.00084,1,1268259,1269891,-,1632
422,WOLB.0323.00021,1,333920,335552,-,1632
422,WOLB.0323.00020,1,317908,319539,+,1631
422,WOLB.0323.00122,1,295297,296928,+,1631
422,WOLB.0323.00012,1,315551,317182,+,1631
422,WOLB.0323.00017,1,281980,283611,+,1631
422,WOLB.0323.00100,1,315564,317195,+,1631
422,WOLB.0323.00100,1,391141,392772,+,1631
422,WOLB.0323.00070,1,291598,293229,+,1631
422,WOLB.0323.00070,1,709364,710995,+,1631
422,WOLB.0323.00006,1,1105139,1106770,+,1631
422,WOLB.0323.00042,1,310793,312424,+,1631
422,WOLB.0323.00014,1,363997,365629,-,1632
422,WOLB.0323.00014,1,950011,951642,+,1631
422,WOLB.0323.00014,1,1009417,1011048,+,1631
423,WOLB.0323.00002,1,300196,300904,+,708
423,WOLB.0323.00002,1,571430,572144,-,714
423,WOLB.0323.00002,1,775027,775741,-,714
423,WOLB.0323.00002,1,1062329,1063043,-,714
423,WOLB.0323.00138,1,47894,48608,-,714
423,WOLB.0323.00138,1,1041566,1042280,-,714
423,WOLB.0323.00132,1,159570,160284,+,714
423,WOLB.0323.00132,1,290202,290910,+,708
423,WOLB.0323.00143,1,576656,577364,+,708
423,WOLB.0323.00106,1,576658,577366,+,708
423,WOLB.0323.00121,1,285244,285958,+,714
423,WOLB.0323.00121,1,657359,658073,-,714
423,WOLB.0323.00121,1,729119,729833,-,714
423,WOLB.0323.00121,1,796370,797084,-,714
423,WOLB.0323.00135,1,1334089,1334771,+,682
423,WOLB.0323.00103,1,1211308,1212016,-,708
423,WOLB.0323.00107,1,1209606,1210255,-,649
423,WOLB.0323.00019,1,1244086,1244794,+,708
423,WOLB.0323.00060,1,200138,200852,-,714
423,WOLB.0323.00060,1,275665,276370,-,705
423,WOLB.0323.00060,1,406059,406734,+,675
423,WOLB.0323.00060,1,1157880,1158594,+,714
423,WOLB.0323.00060,1,1664619,1665294,+,675
423,WOLB.0323.00074,1,209727,210398,+,671
423,WOLB.0323.00074,1,1458067,1458738,-,671
423,WOLB.0323.00120,1,208957,209628,+,671
423,WOLB.0323.00120,1,1438409,1439080,-,671
423,WOLB.0323.00039,1,57844,58558,-,714
423,WOLB.0323.00041,1,212871,213542,+,671
423,WOLB.0323.00041,1,1252944,1253615,-,671
423,WOLB.0323.00031,1,209945,210653,-,708
423,WOLB.0323.00056,1,526074,526788,+,714
423,WOLB.0323.00056,1,1359679,1360366,-,687
423,WOLB.0323.00142,1,460198,460912,+,714
423,WOLB.0323.00142,1,527604,528307,+,703
423,WOLB.0323.00023,1,74990,75704,+,714
423,WOLB.0323.00023,1,151153,151859,+,706
423,WOLB.0323.00023,1,1189683,1190391,+,708
423,WOLB.0323.00023,1,1547814,1548522,-,708
423,WOLB.0323.00023,1,1688668,1689374,-,706
423,WOLB.0323.00023,1,1814350,1815056,-,706
423,WOLB.0323.00153,1,498606,499287,-,681
423,WOLB.0323.00093,1,183504,184212,+,708
423,WOLB.0323.00093,1,1470033,1470747,+,714
423,WOLB.0323.00088,1,319338,320052,+,714
423,WOLB.0323.00024,1,432075,432789,+,714
423,WOLB.0323.00024,1,835033,835747,-,714
423,WOLB.0323.00024,1,922042,922756,-,714
423,WOLB.0323.00024,1,1063826,1064540,-,714
423,WOLB.0323.00024,1,1277036,1277750,-,714
423,WOLB.0323.00024,1,1352880,1353580,-,700
423,WOLB.0323.00024,1,1614445,1615159,+,714
423,WOLB.0323.00024,1,2100545,2101259,-,714
423,WOLB.0323.00064,1,410776,411490,-,714
423,WOLB.0323.00064,1,488142,488856,+,714
423,WOLB.0323.00064,1,706457,707171,-,714
423,WOLB.0323.00064,1,1547716,1548419,+,703
423,WOLB.0323.00064,1,1617812,1618526,+,714
423,WOLB.0323.00030,1,284455,285163,+,708
423,WOLB.0323.00030,1,342558,343266,+,708
423,WOLB.0323.00030,1,534530,535238,-,708
423,WOLB.0323.00030,1,604037,604751,-,714
423,WOLB.0323.00030,1,1092128,1092842,+,714
423,WOLB.0323.00030,1,1300232,1300946,+,714
423,WOLB.0323.00105,1,1211316,1212024,-,708
423,WOLB.0323.00133,1,1206913,1207621,+,708
423,WOLB.0323.00084,1,219369,220083,-,714
423,WOLB.0323.00084,1,1265432,1266131,-,699
423,WOLB.0323.00021,1,331066,331774,-,708
423,WOLB.0323.00021,1,555538,556252,-,714
423,WOLB.0323.00021,1,1180368,1181082,+,714
423,WOLB.0323.00043,1,511898,512579,-,681
423,WOLB.0323.00043,1,619914,620628,+,714
423,WOLB.0323.00043,1,973435,974149,+,714
423,WOLB.0323.00043,1,1140645,1141359,+,714
423,WOLB.0323.00043,1,1590725,1591433,-,708
423,WOLB.0323.00020,1,321678,322392,+,714
423,WOLB.0323.00122,1,299054,299768,+,714
423,WOLB.0323.00122,1,1095068,1095776,+,708
423,WOLB.0323.00004,1,456660,457363,+,703
423,WOLB.0323.00004,1,525169,525872,+,703
423,WOLB.0323.00011,1,1242920,1243634,-,714
423,WOLB.0323.00032,1,37737,38451,+,714
423,WOLB.0323.00032,1,1184983,1185691,-,708
423,WOLB.0323.00012,1,319321,320035,+,714
423,WOLB.0323.00018,1,765428,766142,+,714
423,WOLB.0323.00018,1,926023,926737,+,714
423,WOLB.0323.00025,1,430006,430714,-,708
423,WOLB.0323.00010,1,512352,513065,+,713
423,WOLB.0323.00010,1,888687,889308,+,621
423,WOLB.0323.00128,1,565646,566360,-,714
423,WOLB.0323.00128,1,640372,641086,-,714
423,WOLB.0323.00128,1,790275,790989,-,714
423,WOLB.0323.00128,1,1099120,1099834,+,714
423,WOLB.0323.00158,1,438785,439499,-,714
423,WOLB.0323.00158,1,1179636,1180339,+,703
423,WOLB.0323.00017,1,285750,286464,+,714
423,WOLB.0323.00017,1,532320,533023,+,703
423,WOLB.0323.00104,1,453797,454500,-,703
423,WOLB.0323.00007,1,886077,886791,+,714
423,WOLB.0323.00007,1,963905,964581,+,676
423,WOLB.0323.00007,1,1107985,1108693,+,708
423,WOLB.0323.00001,1,1211316,1212024,-,708
423,WOLB.0323.00100,1,319334,320048,+,714
423,WOLB.0323.00100,1,394911,395625,+,714
423,WOLB.0323.00100,1,702940,703648,-,708
423,WOLB.0323.00100,1,764174,764882,-,708
423,WOLB.0323.00100,1,960296,961010,-,714
423,WOLB.0323.00070,1,295352,296066,+,714
423,WOLB.0323.00070,1,476207,476921,-,714
423,WOLB.0323.00070,1,519350,520064,-,714
423,WOLB.0323.00070,1,713132,713846,+,714
423,WOLB.0323.00070,1,865650,866364,-,714
423,WOLB.0323.00070,1,1169928,1170642,-,714
423,WOLB.0323.00070,1,1206175,1206889,+,714
423,WOLB.0323.00070,1,1277915,1278629,+,714
423,WOLB.0323.00006,1,1108907,1109615,+,708
423,WOLB.0323.00042,1,314563,315277,+,714
423,WOLB.0323.00042,1,567900,568614,+,714
423,WOLB.0323.00042,1,950610,951324,+,714
423,WOLB.0323.00042,1,1106523,1107237,+,714
423,WOLB.0323.00042,1,1205525,1206239,-,714
423,WOLB.0323.00042,1,1723561,1724275,-,714
423,WOLB.0323.00119,1,1245318,1246026,-,708
423,WOLB.0323.00149,1,9972,10675,-,703
423,WOLB.0323.00149,1,1262510,1263213,+,703
423,WOLB.0323.00014,1,274671,275379,+,708
423,WOLB.0323.00014,1,359116,359830,-,714
423,WOLB.0323.00014,1,953786,954500,+,714
423,WOLB.0323.00014,1,1013192,1013906,+,714
423,WOLB.0323.00014,1,1135090,1135804,+,714
423,WOLB.0323.00014,1,1312792,1313468,+,676
423,WOLB.0323.00096,1,223739,224410,+,671
423,WOLB.0323.00096,1,1444318,1444989,-,671
424,WOLB.0323.00002,1,306668,307507,+,839
424,WOLB.0323.00143,1,583125,583964,+,839
424,WOLB.0323.00106,1,583127,583966,+,839
424,WOLB.0323.00121,1,293188,294027,+,839
424,WOLB.0323.00060,1,657018,657857,-,839
424,WOLB.0323.00060,1,1674098,1674937,+,839
424,WOLB.0323.00031,1,203345,204184,-,839
424,WOLB.0323.00023,1,157581,158420,+,839
424,WOLB.0323.00023,1,1196175,1197014,+,839
424,WOLB.0323.00093,1,189996,190835,+,839
424,WOLB.0323.00093,1,480027,480866,-,839
424,WOLB.0323.00088,1,325771,326610,+,839
424,WOLB.0323.00064,1,495749,496587,+,838
424,WOLB.0323.00064,1,1625407,1626245,+,838
424,WOLB.0323.00030,1,1309789,1310627,+,838
424,WOLB.0323.00133,1,475763,476602,-,839
424,WOLB.0323.00084,1,1255817,1256652,-,835
424,WOLB.0323.00021,1,323157,323996,-,839
424,WOLB.0323.00020,1,328113,328952,+,839
424,WOLB.0323.00122,1,312843,313682,+,839
424,WOLB.0323.00012,1,325756,326595,+,839
424,WOLB.0323.00010,1,680375,681214,-,839
424,WOLB.0323.00010,1,1251759,1252598,-,839
424,WOLB.0323.00017,1,292185,293024,+,839
424,WOLB.0323.00100,1,325768,326607,+,839
424,WOLB.0323.00100,1,401345,402184,+,839
424,WOLB.0323.00070,1,302964,303803,+,839
424,WOLB.0323.00070,1,719557,720396,+,839
424,WOLB.0323.00006,1,1115376,1116215,+,839
424,WOLB.0323.00042,1,320998,321837,+,839
424,WOLB.0323.00014,1,351379,352218,-,839
424,WOLB.0323.00014,1,960261,961100,+,839
424,WOLB.0323.00014,1,1019667,1020506,+,839
425,WOLB.0323.00002,1,307581,308325,+,744
425,WOLB.0323.00143,1,584038,584782,+,744
425,WOLB.0323.00106,1,584040,584784,+,744
425,WOLB.0323.00121,1,294101,294845,+,744
425,WOLB.0323.00060,1,656200,656944,-,744
425,WOLB.0323.00060,1,1675037,1675755,+,718
425,WOLB.0323.00031,1,202527,203271,-,744
425,WOLB.0323.00023,1,158496,159238,+,742
425,WOLB.0323.00023,1,1197090,1197832,+,742
425,WOLB.0323.00093,1,190909,191653,+,744
425,WOLB.0323.00093,1,479209,479951,-,742
425,WOLB.0323.00088,1,326684,327428,+,744
425,WOLB.0323.00064,1,496661,497405,+,744
425,WOLB.0323.00064,1,1626319,1627063,+,744
425,WOLB.0323.00030,1,1310701,1311445,+,744
425,WOLB.0323.00133,1,474957,475689,-,732
425,WOLB.0323.00084,1,1254995,1255737,-,742
425,WOLB.0323.00021,1,322339,323083,-,744
425,WOLB.0323.00020,1,329026,329770,+,744
425,WOLB.0323.00122,1,313756,314500,+,744
425,WOLB.0323.00012,1,326669,327413,+,744
425,WOLB.0323.00010,1,679563,680300,-,737
425,WOLB.0323.00010,1,1250948,1251685,-,737
425,WOLB.0323.00017,1,293098,293842,+,744
425,WOLB.0323.00100,1,326681,327425,+,744
425,WOLB.0323.00100,1,402258,403002,+,744
425,WOLB.0323.00070,1,303877,304621,+,744
425,WOLB.0323.00070,1,720470,721214,+,744
425,WOLB.0323.00006,1,1116289,1117032,+,743
425,WOLB.0323.00042,1,321911,322655,+,744
425,WOLB.0323.00014,1,961174,961918,+,744
425,WOLB.0323.00014,1,1020580,1021324,+,744
426,WOLB.0323.00002,1,309131,310151,+,1020
426,WOLB.0323.00143,1,585585,586605,+,1020
426,WOLB.0323.00106,1,585587,586607,+,1020
426,WOLB.0323.00121,1,295642,296662,+,1020
426,WOLB.0323.00060,1,654401,655412,-,1011
426,WOLB.0323.00060,1,1677979,1678999,+,1020
426,WOLB.0323.00031,1,200704,201724,-,1020
426,WOLB.0323.00023,1,161523,162552,+,1029
426,WOLB.0323.00023,1,1198638,1199640,+,1002
426,WOLB.0323.00093,1,192459,193467,+,1008
426,WOLB.0323.00093,1,477383,478412,-,1029
426,WOLB.0323.00088,1,328225,329245,+,1020
426,WOLB.0323.00064,1,498193,499214,+,1021
426,WOLB.0323.00064,1,1627851,1628872,+,1021
426,WOLB.0323.00030,1,1312233,1313253,+,1020
426,WOLB.0323.00133,1,473141,474169,-,1028
426,WOLB.0323.00084,1,1253175,1254204,-,1029
426,WOLB.0323.00021,1,320521,321542,-,1021
426,WOLB.0323.00020,1,330567,331571,+,1004
426,WOLB.0323.00122,1,316391,317402,+,1011
426,WOLB.0323.00012,1,328210,329230,+,1020
426,WOLB.0323.00010,1,677748,678768,-,1020
426,WOLB.0323.00010,1,1249134,1250153,-,1019
426,WOLB.0323.00017,1,294639,295659,+,1020
426,WOLB.0323.00100,1,328222,329242,+,1020
426,WOLB.0323.00100,1,403799,404819,+,1020
426,WOLB.0323.00070,1,305418,306438,+,1020
426,WOLB.0323.00070,1,722011,723031,+,1020
426,WOLB.0323.00006,1,1117835,1118855,+,1020
426,WOLB.0323.00042,1,323452,324472,+,1020
426,WOLB.0323.00014,1,962715,963744,+,1029
426,WOLB.0323.00014,1,1022121,1023150,+,1029
427,WOLB.0323.00002,1,310152,310989,+,837
427,WOLB.0323.00143,1,586606,587475,+,869
427,WOLB.0323.00106,1,586608,587477,+,869
427,WOLB.0323.00121,1,296663,297532,+,869
427,WOLB.0323.00060,1,653524,654399,-,875
427,WOLB.0323.00060,1,1679000,1679878,+,878
427,WOLB.0323.00031,1,199834,200702,-,868
427,WOLB.0323.00023,1,162553,163431,+,878
427,WOLB.0323.00023,1,1199641,1200469,+,828
427,WOLB.0323.00093,1,193481,194336,+,855
427,WOLB.0323.00093,1,476504,477381,-,877
427,WOLB.0323.00088,1,329246,330115,+,869
427,WOLB.0323.00064,1,499215,500091,+,876
427,WOLB.0323.00064,1,1628873,1629749,+,876
427,WOLB.0323.00030,1,1313254,1314130,+,876
427,WOLB.0323.00133,1,472282,473139,-,857
427,WOLB.0323.00084,1,1252298,1253173,-,875
427,WOLB.0323.00021,1,319651,320519,-,868
427,WOLB.0323.00122,1,317403,318279,+,876
427,WOLB.0323.00012,1,329231,330100,+,869
427,WOLB.0323.00010,1,676871,677746,-,875
427,WOLB.0323.00010,1,1248256,1249132,-,876
427,WOLB.0323.00017,1,295660,296529,+,869
427,WOLB.0323.00100,1,329243,330112,+,869
427,WOLB.0323.00100,1,404820,405689,+,869
427,WOLB.0323.00070,1,306439,307308,+,869
427,WOLB.0323.00070,1,723032,723910,+,878
427,WOLB.0323.00006,1,1118856,1119725,+,869
427,WOLB.0323.00042,1,324473,325342,+,869
427,WOLB.0323.00014,1,963745,964614,+,869
427,WOLB.0323.00014,1,1023151,1024020,+,869
428,WOLB.0323.00002,1,312557,314943,+,2386
428,WOLB.0323.00143,1,589008,591415,+,2407
428,WOLB.0323.00106,1,589010,591417,+,2407
428,WOLB.0323.00060,1,644253,646653,+,2400
428,WOLB.0323.00060,1,1681397,1683801,+,2404
428,WOLB.0323.00031,1,195894,198301,-,2407
428,WOLB.0323.00023,1,164899,167291,+,2392
428,WOLB.0323.00093,1,199658,202065,+,2407
428,WOLB.0323.00093,1,467819,470232,-,2413
428,WOLB.0323.00084,1,1246045,1248446,-,2401
428,WOLB.0323.00122,1,323237,325638,+,2401
428,WOLB.0323.00070,1,725380,727793,+,2413
428,WOLB.0323.00006,1,1121258,1123665,+,2407
428,WOLB.0323.00014,1,966096,968502,+,2406
428,WOLB.0323.00014,1,1025502,1027908,+,2406
429,WOLB.0323.00002,1,315923,316839,+,916
429,WOLB.0323.00143,1,592395,593311,+,916
429,WOLB.0323.00106,1,592397,593313,+,916
429,WOLB.0323.00060,1,647644,648558,+,914
429,WOLB.0323.00060,1,1684787,1685696,+,909
429,WOLB.0323.00031,1,193998,194914,-,916
429,WOLB.0323.00023,1,168265,169184,+,919
429,WOLB.0323.00093,1,203047,203961,+,914
429,WOLB.0323.00093,1,465917,466831,-,914
429,WOLB.0323.00084,1,1244139,1245059,-,920
429,WOLB.0323.00122,1,326624,327543,+,919
429,WOLB.0323.00070,1,728768,729693,+,925
429,WOLB.0323.00006,1,1124645,1125561,+,916
429,WOLB.0323.00014,1,969495,970411,+,916
429,WOLB.0323.00014,1,1028901,1029817,+,916
430,WOLB.0323.00002,1,318925,320171,+,1246
430,WOLB.0323.00143,1,595397,596643,+,1246
430,WOLB.0323.00106,1,595399,596644,+,1245
430,WOLB.0323.00031,1,190665,191911,-,1246
430,WOLB.0323.00006,1,1127647,1128893,+,1246
431,WOLB.0323.00002,1,320421,321586,+,1165
431,WOLB.0323.00143,1,596893,598058,+,1165
431,WOLB.0323.00106,1,596894,598059,+,1165
431,WOLB.0323.00060,1,1689269,1690434,+,1165
431,WOLB.0323.00031,1,189251,190416,-,1165
431,WOLB.0323.00023,1,172689,173858,+,1169
431,WOLB.0323.00093,1,207415,208575,+,1160
431,WOLB.0323.00093,1,461136,462296,-,1160
431,WOLB.0323.00093,1,1260752,1261917,+,1165
431,WOLB.0323.00006,1,1129143,1130308,+,1165
432,WOLB.0323.00002,1,323014,324329,+,1315
432,WOLB.0323.00143,1,598140,599455,+,1315
432,WOLB.0323.00106,1,598141,599457,+,1316
432,WOLB.0323.00060,1,1690516,1691832,+,1316
432,WOLB.0323.00031,1,187852,189169,-,1317
432,WOLB.0323.00093,1,1261999,1263315,+,1316
432,WOLB.0323.00006,1,1130390,1131706,+,1316
433,WOLB.0323.00002,1,324331,324905,+,574
433,WOLB.0323.00143,1,599457,600031,+,574
433,WOLB.0323.00106,1,599459,600033,+,574
433,WOLB.0323.00060,1,1691834,1692408,+,574
433,WOLB.0323.00031,1,187277,187851,-,574
433,WOLB.0323.00093,1,210997,211571,+,574
433,WOLB.0323.00093,1,459520,460094,-,574
433,WOLB.0323.00093,1,1263317,1263891,+,574
433,WOLB.0323.00006,1,1131708,1132282,+,574
434,WOLB.0323.00002,1,324906,325865,+,959
434,WOLB.0323.00143,1,600032,600991,+,959
434,WOLB.0323.00106,1,600034,600993,+,959
434,WOLB.0323.00060,1,1692409,1693368,+,959
434,WOLB.0323.00031,1,186316,187275,-,959
434,WOLB.0323.00093,1,1263892,1264851,+,959
434,WOLB.0323.00006,1,1132283,1133242,+,959
435,WOLB.0323.00002,1,326401,328077,+,1676
435,WOLB.0323.00060,1,1693910,1695586,+,1676
435,WOLB.0323.00093,1,213043,214713,+,1670
435,WOLB.0323.00093,1,456378,458048,-,1670
435,WOLB.0323.00093,1,1265381,1267051,+,1670
436,WOLB.0323.00002,1,328078,328684,+,606
436,WOLB.0323.00060,1,1695587,1696193,+,606
436,WOLB.0323.00093,1,214714,215320,+,606
436,WOLB.0323.00093,1,454567,455182,-,615
436,WOLB.0323.00093,1,1267052,1267658,+,606
437,WOLB.0323.00002,1,330662,331604,+,942
437,WOLB.0323.00143,1,606179,607129,+,950
437,WOLB.0323.00106,1,606180,607130,+,950
437,WOLB.0323.00060,1,1698174,1699125,+,951
437,WOLB.0323.00031,1,180177,181127,-,950
437,WOLB.0323.00023,1,181273,182221,+,948
437,WOLB.0323.00093,1,217304,218252,+,948
437,WOLB.0323.00093,1,451636,452584,-,948
437,WOLB.0323.00093,1,1269642,1270590,+,948
437,WOLB.0323.00006,1,1138192,1139142,+,950
438,WOLB.0323.00002,1,333422,335328,+,1906
438,WOLB.0323.00143,1,608945,610853,+,1908
438,WOLB.0323.00106,1,608946,610854,+,1908
438,WOLB.0323.00060,1,1700950,1702858,+,1908
438,WOLB.0323.00031,1,176452,178361,-,1909
438,WOLB.0323.00023,1,184044,185927,+,1883
438,WOLB.0323.00093,1,220065,221973,+,1908
438,WOLB.0323.00093,1,447914,449823,-,1909
438,WOLB.0323.00093,1,1272403,1274311,+,1908
438,WOLB.0323.00006,1,1140958,1142866,+,1908
439,WOLB.0323.00002,1,335441,336999,+,1558
439,WOLB.0323.00143,1,610966,612524,+,1558
439,WOLB.0323.00106,1,610967,612525,+,1558
439,WOLB.0323.00060,1,1702971,1704529,+,1558
439,WOLB.0323.00031,1,174782,176339,-,1557
439,WOLB.0323.00023,1,186040,187598,+,1558
439,WOLB.0323.00093,1,222086,223644,+,1558
439,WOLB.0323.00093,1,446244,447801,-,1557
439,WOLB.0323.00093,1,1274424,1275982,+,1558
439,WOLB.0323.00006,1,1142979,1144537,+,1558
440,WOLB.0323.00002,1,337000,337693,+,693
440,WOLB.0323.00143,1,612525,613218,+,693
440,WOLB.0323.00106,1,612526,613219,+,693
440,WOLB.0323.00060,1,1704530,1705223,+,693
440,WOLB.0323.00031,1,174088,174780,-,692
440,WOLB.0323.00093,1,223645,224338,+,693
440,WOLB.0323.00093,1,445550,446242,-,692
440,WOLB.0323.00093,1,1275983,1276676,+,693
440,WOLB.0323.00006,1,1144538,1145231,+,693
441,WOLB.0323.00002,1,339190,340803,+,1613
441,WOLB.0323.00143,1,614715,616328,+,1613
441,WOLB.0323.00106,1,614716,616329,+,1613
441,WOLB.0323.00060,1,1706707,1708324,+,1617
441,WOLB.0323.00031,1,170977,172590,-,1613
441,WOLB.0323.00093,1,1278160,1279777,+,1617
441,WOLB.0323.00010,1,659234,660861,-,1627
441,WOLB.0323.00010,1,1229811,1231438,-,1627
441,WOLB.0323.00006,1,1146728,1148341,+,1613
442,WOLB.0323.00002,1,341499,342376,+,877
442,WOLB.0323.00002,1,784437,785332,+,895
442,WOLB.0323.00138,1,1331073,1331966,-,893
442,WOLB.0323.00132,1,214897,215792,+,895
442,WOLB.0323.00121,1,333797,334683,+,886
442,WOLB.0323.00060,1,624093,624988,-,895
442,WOLB.0323.00023,1,195833,196719,+,886
442,WOLB.0323.00023,1,1235976,1236862,+,886
442,WOLB.0323.00093,1,231889,232775,+,886
442,WOLB.0323.00093,1,437113,437999,-,886
442,WOLB.0323.00088,1,365213,366099,+,886
442,WOLB.0323.00064,1,18139,19034,+,895
442,WOLB.0323.00064,1,1487773,1488668,-,895
442,WOLB.0323.00030,1,1393285,1394180,-,895
442,WOLB.0323.00133,1,82679,83565,-,886
442,WOLB.0323.00084,1,1227947,1228840,-,893
442,WOLB.0323.00021,1,284606,285492,-,886
442,WOLB.0323.00021,1,1011104,1011997,+,893
442,WOLB.0323.00020,1,334991,335877,+,886
442,WOLB.0323.00122,1,344904,345799,+,895
442,WOLB.0323.00122,1,657902,658795,+,893
442,WOLB.0323.00012,1,366365,367251,+,886
442,WOLB.0323.00025,1,118490,119376,-,886
442,WOLB.0323.00010,1,657639,658525,-,886
442,WOLB.0323.00010,1,1228215,1229101,-,886
442,WOLB.0323.00068,1,510730,511623,-,893
442,WOLB.0323.00017,1,332798,333684,+,886
442,WOLB.0323.00100,1,366381,367267,+,886
442,WOLB.0323.00100,1,441958,442844,+,886
442,WOLB.0323.00070,1,743448,744334,+,886
442,WOLB.0323.00006,1,591780,592666,-,886
442,WOLB.0323.00042,1,362547,363433,+,886
442,WOLB.0323.00014,1,984275,985161,+,886
442,WOLB.0323.00014,1,1043681,1044567,+,886
443,WOLB.0323.00002,1,344828,346038,+,1210
443,WOLB.0323.00093,1,1319121,1320340,+,1219
444,WOLB.0323.00002,1,347298,348003,+,705
444,WOLB.0323.00093,1,1321600,1322305,+,705
445,WOLB.0323.00002,1,380567,381238,+,671
445,WOLB.0323.00088,1,397745,398416,+,671
445,WOLB.0323.00043,1,1293493,1294165,-,672
445,WOLB.0323.00020,1,367523,368194,+,671
445,WOLB.0323.00035,1,323236,323907,+,671
445,WOLB.0323.00012,1,398897,399568,+,671
445,WOLB.0323.00010,1,1193945,1194617,-,672
445,WOLB.0323.00128,1,304629,305300,+,671
445,WOLB.0323.00104,1,325636,326307,+,671
445,WOLB.0323.00100,1,474490,475161,+,671
445,WOLB.0323.00070,1,369356,370027,+,671
445,WOLB.0323.00042,1,395082,395753,+,671
445,WOLB.0323.00014,1,399869,400540,+,671
446,WOLB.0323.00002,1,484320,484859,+,539
446,WOLB.0323.00023,1,1380729,1381268,+,539
446,WOLB.0323.00093,1,281385,281925,-,540
446,WOLB.0323.00008,1,118782,119320,+,538
446,WOLB.0323.00024,1,644099,644638,+,539
446,WOLB.0323.00043,1,1189877,1190416,-,539
446,WOLB.0323.00018,1,444205,444744,+,539
446,WOLB.0323.00128,1,1004810,1005349,-,539
446,WOLB.0323.00070,1,821203,821742,+,539
446,WOLB.0323.00014,1,503482,504021,+,539
447,WOLB.0323.00002,1,506052,506819,+,767
447,WOLB.0323.00056,1,434741,435508,+,767
447,WOLB.0323.00021,1,812863,813630,+,767
447,WOLB.0323.00043,1,484289,485056,+,767
447,WOLB.0323.00035,1,422862,423629,+,767
447,WOLB.0323.00010,1,440974,441742,-,768
447,WOLB.0323.00007,1,986071,986839,-,768
447,WOLB.0323.00070,1,568872,569639,+,767
447,WOLB.0323.00042,1,691120,691887,+,767
447,WOLB.0323.00014,1,1263338,1264106,-,768
448,WOLB.0323.00002,1,535243,536649,+,1406
448,WOLB.0323.00138,1,1417017,1418423,+,1406
448,WOLB.0323.00138,1,1508770,1510176,+,1406
448,WOLB.0323.00060,1,383244,384650,+,1406
448,WOLB.0323.00056,1,1405082,1406488,-,1406
448,WOLB.0323.00023,1,1659249,1660655,-,1406
448,WOLB.0323.00064,1,356043,357449,-,1406
448,WOLB.0323.00043,1,1074738,1076144,-,1406
448,WOLB.0323.00032,1,1366573,1367979,-,1406
448,WOLB.0323.00010,1,714034,715440,-,1406
448,WOLB.0323.00068,1,1216463,1217869,-,1406
448,WOLB.0323.00128,1,545845,547251,-,1406
448,WOLB.0323.00070,1,1303494,1304900,+,1406
448,WOLB.0323.00014,1,1162017,1163423,+,1406
449,WOLB.0323.00002,1,537003,537728,+,725
449,WOLB.0323.00138,1,1418777,1419502,+,725
449,WOLB.0323.00138,1,1510530,1511255,+,725
449,WOLB.0323.00060,1,385004,385729,+,725
449,WOLB.0323.00056,1,1404003,1404729,-,726
449,WOLB.0323.00023,1,1658170,1658896,-,726
449,WOLB.0323.00064,1,354964,355690,-,726
449,WOLB.0323.00043,1,1073659,1074384,-,725
449,WOLB.0323.00032,1,1365494,1366220,-,726
449,WOLB.0323.00010,1,712955,713681,-,726
449,WOLB.0323.00128,1,544766,545492,-,726
449,WOLB.0323.00070,1,1305254,1305979,+,725
449,WOLB.0323.00014,1,1163777,1164502,+,725
450,WOLB.0323.00002,1,537908,538818,+,910
450,WOLB.0323.00138,1,1419682,1420611,+,929
450,WOLB.0323.00138,1,1511435,1512345,+,910
450,WOLB.0323.00060,1,385909,386819,+,910
450,WOLB.0323.00056,1,1402913,1403824,-,911
450,WOLB.0323.00023,1,1657080,1657991,-,911
450,WOLB.0323.00064,1,353874,354785,-,911
450,WOLB.0323.00043,1,1072569,1073480,-,911
450,WOLB.0323.00032,1,1364404,1365315,-,911
450,WOLB.0323.00010,1,711865,712776,-,911
450,WOLB.0323.00128,1,543676,544587,-,911
450,WOLB.0323.00070,1,1306159,1307069,+,910
450,WOLB.0323.00014,1,1164682,1165592,+,910
451,WOLB.0323.00002,1,540790,542223,+,1433
451,WOLB.0323.00138,1,1421187,1422621,+,1434
451,WOLB.0323.00138,1,1512940,1514373,+,1433
451,WOLB.0323.00060,1,314739,316173,-,1434
451,WOLB.0323.00060,1,387414,388847,+,1433
451,WOLB.0323.00039,1,377126,378566,-,1440
451,WOLB.0323.00056,1,560819,562258,+,1439
451,WOLB.0323.00056,1,1400886,1402319,-,1433
451,WOLB.0323.00023,1,1655052,1656486,-,1434
451,WOLB.0323.00064,1,351846,353280,-,1434
451,WOLB.0323.00084,1,188593,190027,-,1434
451,WOLB.0323.00043,1,659522,660955,+,1433
451,WOLB.0323.00043,1,1070535,1071975,-,1440
451,WOLB.0323.00122,1,1129390,1130829,+,1439
451,WOLB.0323.00122,1,1465343,1466776,+,1433
451,WOLB.0323.00032,1,1362381,1363815,-,1434
451,WOLB.0323.00010,1,709836,711269,-,1433
451,WOLB.0323.00128,1,541648,543082,-,1434
451,WOLB.0323.00070,1,794454,795888,-,1434
451,WOLB.0323.00070,1,1234134,1235567,+,1433
451,WOLB.0323.00070,1,1307664,1309097,+,1433
451,WOLB.0323.00042,1,1136039,1137472,+,1433
451,WOLB.0323.00014,1,1167564,1168997,+,1433
452,WOLB.0323.00002,1,542313,542878,+,565
452,WOLB.0323.00138,1,1422707,1423272,+,565
452,WOLB.0323.00138,1,1514463,1515028,+,565
452,WOLB.0323.00060,1,314094,314649,-,555
452,WOLB.0323.00060,1,388937,389502,+,565
452,WOLB.0323.00056,1,1400232,1400796,-,564
452,WOLB.0323.00023,1,1654398,1654962,-,564
452,WOLB.0323.00064,1,351192,351756,-,564
452,WOLB.0323.00043,1,1069890,1070440,-,550
452,WOLB.0323.00032,1,1361727,1362291,-,564
452,WOLB.0323.00010,1,709182,709746,-,564
452,WOLB.0323.00128,1,540994,541558,-,564
452,WOLB.0323.00070,1,793809,794364,-,555
452,WOLB.0323.00070,1,1309187,1309752,+,565
452,WOLB.0323.00042,1,1137562,1138118,+,556
452,WOLB.0323.00014,1,1169087,1169652,+,565
453,WOLB.0323.00002,1,547605,548323,+,718
453,WOLB.0323.00138,1,4705,5422,-,717
453,WOLB.0323.00138,1,10242,10960,+,718
453,WOLB.0323.00021,1,371362,372080,+,718
453,WOLB.0323.00021,1,513720,514437,-,717
453,WOLB.0323.00118,1,1002247,1002965,+,718
453,WOLB.0323.00032,1,1503550,1504267,-,717
453,WOLB.0323.00068,1,1202769,1203486,-,717
453,WOLB.0323.00128,1,535549,536266,-,717
453,WOLB.0323.00070,1,1314479,1315197,+,718
453,WOLB.0323.00042,1,1154393,1155110,-,717
453,WOLB.0323.00014,1,1174379,1175097,+,718
454,WOLB.0323.00002,1,548541,549852,+,1311
454,WOLB.0323.00043,1,865300,866611,+,1311
454,WOLB.0323.00010,1,423487,424717,-,1230
454,WOLB.0323.00128,1,534019,535330,-,1311
454,WOLB.0323.00070,1,1315415,1316726,+,1311
454,WOLB.0323.00014,1,1177627,1178938,+,1311
455,WOLB.0323.00002,1,573490,577961,+,4471
455,WOLB.0323.00060,1,202215,206684,+,4469
455,WOLB.0323.00039,1,59912,64371,+,4459
455,WOLB.0323.00056,1,520257,524727,-,4470
455,WOLB.0323.00093,1,1464219,1468687,-,4468
455,WOLB.0323.00018,1,920209,924678,-,4469
455,WOLB.0323.00128,1,567706,572177,+,4471
455,WOLB.0323.00070,1,1272098,1276568,-,4470
455,WOLB.0323.00014,1,1129273,1133741,-,4468
456,WOLB.0323.00002,1,579556,581913,+,2357
456,WOLB.0323.00060,1,208279,210635,+,2356
456,WOLB.0323.00056,1,516305,518661,-,2356
456,WOLB.0323.00093,1,1460273,1462623,-,2350
456,WOLB.0323.00018,1,916265,918613,-,2348
456,WOLB.0323.00128,1,573772,576144,+,2372
456,WOLB.0323.00070,1,1266188,1268544,-,2356
456,WOLB.0323.00014,1,1125321,1127677,-,2356
457,WOLB.0323.00002,1,583351,583992,+,641
457,WOLB.0323.00060,1,212073,212714,+,641
457,WOLB.0323.00056,1,514225,514866,-,641
457,WOLB.0323.00093,1,1456608,1457249,-,641
457,WOLB.0323.00018,1,913264,913905,-,641
457,WOLB.0323.00128,1,577582,578223,+,641
457,WOLB.0323.00070,1,1264105,1264749,-,644
457,WOLB.0323.00014,1,1123241,1123882,-,641
458,WOLB.0323.00002,1,601063,601714,+,651
458,WOLB.0323.00002,1,1097922,1098573,+,651
458,WOLB.0323.00138,1,1015,1669,+,654
458,WOLB.0323.00138,1,13996,14649,-,653
458,WOLB.0323.00138,1,156930,157581,+,651
458,WOLB.0323.00132,1,128885,129539,-,654
458,WOLB.0323.00132,1,799495,800149,+,654
458,WOLB.0323.00121,1,684085,684739,+,654
458,WOLB.0323.00135,1,1138947,1139598,+,651
458,WOLB.0323.00135,1,1185186,1185836,-,650
458,WOLB.0323.00135,1,1205290,1205941,+,651
458,WOLB.0323.00135,1,1215139,1215789,-,650
458,WOLB.0323.00103,1,557131,557785,+,654
458,WOLB.0323.00103,1,1373031,1373679,+,648
458,WOLB.0323.00107,1,557129,557783,+,654
458,WOLB.0323.00107,1,1371458,1372106,+,648
458,WOLB.0323.00060,1,305321,305972,+,651
458,WOLB.0323.00056,1,494079,494729,-,650
458,WOLB.0323.00056,1,1292060,1292710,-,650
458,WOLB.0323.00142,1,424192,424842,-,650
458,WOLB.0323.00142,1,500952,501602,-,650
458,WOLB.0323.00023,1,243333,243986,-,653
458,WOLB.0323.00023,1,437251,437905,+,654
458,WOLB.0323.00023,1,1507952,1508606,+,654
458,WOLB.0323.00023,1,1644906,1645557,+,651
458,WOLB.0323.00153,1,536715,537369,+,654
458,WOLB.0323.00088,1,535534,536188,+,654
458,WOLB.0323.00008,1,425549,426202,-,653
458,WOLB.0323.00008,1,659791,660444,-,653
458,WOLB.0323.00064,1,376202,376853,+,651
458,WOLB.0323.00064,1,1516365,1517018,-,653
458,WOLB.0323.00030,1,565781,566432,+,651
458,WOLB.0323.00030,1,1057852,1058505,-,653
458,WOLB.0323.00105,1,557140,557794,+,654
458,WOLB.0323.00105,1,1373186,1373834,+,648
458,WOLB.0323.00084,1,96616,97269,-,653
458,WOLB.0323.00084,1,255472,256123,+,651
458,WOLB.0323.00021,1,377547,378197,-,650
458,WOLB.0323.00021,1,455868,456518,-,650
458,WOLB.0323.00021,1,590617,591271,+,654
458,WOLB.0323.00021,1,798072,798726,+,654
458,WOLB.0323.00021,1,1218776,1219429,-,653
458,WOLB.0323.00043,1,580982,581632,-,650
458,WOLB.0323.00043,1,908395,909045,-,650
458,WOLB.0323.00122,1,1062531,1063184,-,653
458,WOLB.0323.00122,1,1427318,1427968,-,650
458,WOLB.0323.00122,1,1437935,1438586,+,651
458,WOLB.0323.00004,1,421757,422407,-,650
458,WOLB.0323.00004,1,497414,498064,-,650
458,WOLB.0323.00011,1,5357,6010,-,653
458,WOLB.0323.00032,1,4732,5385,-,653
458,WOLB.0323.00032,1,1416610,1417264,+,654
458,WOLB.0323.00032,1,1497432,1498083,+,651
458,WOLB.0323.00032,1,1533051,1533704,-,653
458,WOLB.0323.00032,1,1550908,1551561,-,653
458,WOLB.0323.00010,1,855760,856413,-,653
458,WOLB.0323.00010,1,1280102,1280715,+,613
458,WOLB.0323.00068,1,535660,536310,-,650
458,WOLB.0323.00068,1,963063,963717,+,654
458,WOLB.0323.00128,1,599207,599864,+,657
458,WOLB.0323.00158,1,398094,398745,+,651
458,WOLB.0323.00158,1,471181,471832,+,651
458,WOLB.0323.00017,1,498511,499161,-,650
458,WOLB.0323.00017,1,575035,575685,-,650
458,WOLB.0323.00104,1,485429,486083,+,654
458,WOLB.0323.00007,1,930069,930722,-,653
458,WOLB.0323.00001,1,557140,557794,+,654
458,WOLB.0323.00001,1,1373186,1373834,+,648
458,WOLB.0323.00070,1,487226,487877,+,651
458,WOLB.0323.00070,1,618219,618870,+,651
458,WOLB.0323.00070,1,1113868,1114519,+,651
458,WOLB.0323.00070,1,1241907,1242557,-,650
458,WOLB.0323.00042,1,1152317,1152968,+,651
458,WOLB.0323.00149,1,1235966,1236619,-,653
458,WOLB.0323.00014,1,569469,570119,-,650
458,WOLB.0323.00014,1,839765,840415,-,650
459,WOLB.0323.00002,1,602619,604118,+,1499
459,WOLB.0323.00002,1,1099478,1100977,+,1499
459,WOLB.0323.00138,1,2581,4080,+,1499
459,WOLB.0323.00138,1,11585,13083,-,1498
459,WOLB.0323.00132,1,126481,127979,-,1498
459,WOLB.0323.00056,1,491668,493166,-,1498
459,WOLB.0323.00056,1,1289649,1291147,-,1498
459,WOLB.0323.00142,1,421788,423286,-,1498
459,WOLB.0323.00023,1,239349,240847,-,1498
459,WOLB.0323.00023,1,438805,440304,+,1499
459,WOLB.0323.00008,1,423146,424644,-,1498
459,WOLB.0323.00084,1,94205,95703,-,1498
459,WOLB.0323.00021,1,453464,454962,-,1498
459,WOLB.0323.00021,1,592176,593675,+,1499
459,WOLB.0323.00021,1,799631,801130,+,1499
459,WOLB.0323.00021,1,1216372,1217870,-,1498
459,WOLB.0323.00122,1,1424914,1426412,-,1498
459,WOLB.0323.00122,1,1439491,1440990,+,1499
459,WOLB.0323.00118,1,442322,443821,+,1499
459,WOLB.0323.00118,1,1003591,1005089,-,1498
459,WOLB.0323.00004,1,419353,420851,-,1498
459,WOLB.0323.00032,1,2321,3819,-,1498
459,WOLB.0323.00032,1,1418176,1419675,+,1499
459,WOLB.0323.00032,1,1530640,1532138,-,1498
459,WOLB.0323.00032,1,1548497,1549995,-,1498
459,WOLB.0323.00010,1,1281661,1283160,+,1499
459,WOLB.0323.00068,1,964629,966128,+,1499
459,WOLB.0323.00128,1,600769,602268,+,1499
459,WOLB.0323.00158,1,472737,474236,+,1499
459,WOLB.0323.00017,1,496107,497605,-,1498
459,WOLB.0323.00007,1,927658,929156,-,1498
459,WOLB.0323.00070,1,488782,490281,+,1499
459,WOLB.0323.00070,1,619775,621274,+,1499
459,WOLB.0323.00070,1,1115424,1116923,+,1499
459,WOLB.0323.00070,1,1239503,1241001,-,1498
459,WOLB.0323.00014,1,567065,568563,-,1498
459,WOLB.0323.00014,1,837361,838859,-,1498
460,WOLB.0323.00002,1,606548,607692,+,1144
460,WOLB.0323.00128,1,398612,399756,+,1144
460,WOLB.0323.00070,1,663274,664417,-,1143
460,WOLB.0323.00014,1,833787,834930,-,1143
461,WOLB.0323.00002,1,609466,610567,+,1101
461,WOLB.0323.00128,1,401530,402631,+,1101
461,WOLB.0323.00070,1,660398,661499,-,1101
461,WOLB.0323.00014,1,830911,832012,-,1101
462,WOLB.0323.00002,1,611471,612003,+,532
462,WOLB.0323.00121,1,635795,636319,+,524
462,WOLB.0323.00121,1,775653,776191,+,538
462,WOLB.0323.00135,1,1114152,1114677,-,525
462,WOLB.0323.00019,1,213200,213733,-,533
462,WOLB.0323.00074,1,518640,519179,-,539
462,WOLB.0323.00120,1,504811,505350,-,539
462,WOLB.0323.00039,1,240056,240588,+,532
462,WOLB.0323.00041,1,1111681,1112219,+,538
462,WOLB.0323.00056,1,549692,550217,-,525
462,WOLB.0323.00056,1,1342517,1343050,-,533
462,WOLB.0323.00023,1,94875,95390,-,515
462,WOLB.0323.00023,1,1520644,1521176,+,532
462,WOLB.0323.00093,1,1559575,1560113,+,538
462,WOLB.0323.00008,1,414806,415339,-,533
462,WOLB.0323.00024,1,814848,815390,+,542
462,WOLB.0323.00024,1,1333576,1334108,+,532
462,WOLB.0323.00064,1,1569351,1569876,-,525
462,WOLB.0323.00030,1,515301,515839,+,538
462,WOLB.0323.00084,1,197974,198498,+,524
462,WOLB.0323.00043,1,645482,646007,-,525
462,WOLB.0323.00043,1,1162365,1162890,-,525
462,WOLB.0323.00122,1,1456871,1457396,-,525
462,WOLB.0323.00032,1,70298,70823,-,525
462,WOLB.0323.00018,1,945487,946020,-,533
462,WOLB.0323.00010,1,366189,366709,+,520
462,WOLB.0323.00128,1,403535,404067,+,532
462,WOLB.0323.00100,1,941088,941626,+,538
462,WOLB.0323.00070,1,658962,659495,-,533
462,WOLB.0323.00042,1,590204,590743,-,539
462,WOLB.0323.00042,1,1128666,1129191,-,525
462,WOLB.0323.00119,1,75309,75841,+,532
462,WOLB.0323.00014,1,829475,830008,-,533
462,WOLB.0323.00096,1,1149585,1150123,+,538
463,WOLB.0323.00002,1,624640,625717,+,1077
463,WOLB.0323.00043,1,395454,396531,+,1077
463,WOLB.0323.00018,1,519130,520174,+,1044
463,WOLB.0323.00010,1,1014617,1015694,-,1077
463,WOLB.0323.00128,1,1106766,1107843,-,1077
463,WOLB.0323.00070,1,1438667,1439744,-,1077
463,WOLB.0323.00042,1,1612232,1613309,+,1077
463,WOLB.0323.00014,1,1450619,1451696,-,1077
464,WOLB.0323.00002,1,668699,670515,+,1816
464,WOLB.0323.00138,1,1092762,1094589,-,1827
464,WOLB.0323.00121,1,763566,765394,+,1828
464,WOLB.0323.00060,1,232323,234148,+,1825
464,WOLB.0323.00039,1,65267,67092,+,1825
464,WOLB.0323.00023,1,113422,115246,-,1824
464,WOLB.0323.00024,1,1318553,1320378,+,1825
464,WOLB.0323.00084,1,53850,55677,-,1827
464,WOLB.0323.00011,1,18911,20739,+,1828
464,WOLB.0323.00011,1,1275713,1277540,-,1827
464,WOLB.0323.00018,1,892062,893886,-,1824
464,WOLB.0323.00068,1,1188373,1190201,+,1828
464,WOLB.0323.00128,1,392756,394584,+,1828
464,WOLB.0323.00128,1,752602,754430,+,1828
464,WOLB.0323.00007,1,851094,852918,-,1824
464,WOLB.0323.00070,1,555235,557060,+,1825
464,WOLB.0323.00070,1,787085,788913,+,1828
464,WOLB.0323.00149,1,42425,44253,+,1828
465,WOLB.0323.00002,1,670690,671312,+,622
465,WOLB.0323.00138,1,1091965,1092587,-,622
465,WOLB.0323.00121,1,765569,766191,+,622
465,WOLB.0323.00060,1,234323,234953,+,630
465,WOLB.0323.00039,1,67267,67889,+,622
465,WOLB.0323.00023,1,112616,113247,-,631
465,WOLB.0323.00024,1,1320553,1321178,+,625
465,WOLB.0323.00084,1,53053,53675,-,622
465,WOLB.0323.00122,1,1412246,1412876,-,630
465,WOLB.0323.00011,1,20914,21536,+,622
465,WOLB.0323.00011,1,1274916,1275538,-,622
465,WOLB.0323.00018,1,891264,891887,-,623
465,WOLB.0323.00068,1,1190376,1190998,+,622
465,WOLB.0323.00128,1,394759,395381,+,622
465,WOLB.0323.00128,1,754605,755227,+,622
465,WOLB.0323.00007,1,850297,850919,-,622
465,WOLB.0323.00070,1,557235,557859,+,624
465,WOLB.0323.00070,1,789088,789710,+,622
465,WOLB.0323.00149,1,44428,45050,+,622
466,WOLB.0323.00002,1,681003,683251,+,2248
466,WOLB.0323.00002,1,1137740,1139988,-,2248
466,WOLB.0323.00039,1,231324,233571,+,2247
466,WOLB.0323.00064,1,734025,736272,-,2247
466,WOLB.0323.00030,1,1155122,1157368,-,2246
466,WOLB.0323.00084,1,83067,85313,-,2246
466,WOLB.0323.00021,1,524787,527034,+,2247
466,WOLB.0323.00021,1,810023,812271,+,2248
466,WOLB.0323.00043,1,921931,924177,-,2246
466,WOLB.0323.00118,1,989637,991883,-,2246
466,WOLB.0323.00128,1,611154,613402,+,2248
466,WOLB.0323.00070,1,630143,632391,+,2248
466,WOLB.0323.00070,1,841699,843947,+,2248
466,WOLB.0323.00014,1,887299,889547,-,2248
466,WOLB.0323.00014,1,1077660,1079908,-,2248
467,WOLB.0323.00002,1,692826,693532,+,706
467,WOLB.0323.00132,1,651392,652123,-,731
467,WOLB.0323.00121,1,1073039,1073770,-,731
467,WOLB.0323.00135,1,824000,824737,+,737
467,WOLB.0323.00019,1,603430,604169,-,739
467,WOLB.0323.00039,1,1243239,1243978,+,739
467,WOLB.0323.00142,1,950880,951611,-,731
467,WOLB.0323.00023,1,1728700,1729431,+,731
467,WOLB.0323.00064,1,302194,302925,+,731
467,WOLB.0323.00030,1,930256,930987,-,731
467,WOLB.0323.00043,1,780625,781397,+,772
467,WOLB.0323.00122,1,759671,760402,-,731
467,WOLB.0323.00004,1,948896,949627,-,731
467,WOLB.0323.00011,1,317258,317989,-,731
467,WOLB.0323.00128,1,883094,883866,-,772
467,WOLB.0323.00158,1,221745,222476,-,731
467,WOLB.0323.00017,1,936500,937231,-,731
467,WOLB.0323.00070,1,983031,983803,-,772
467,WOLB.0323.00119,1,574415,575154,+,739
467,WOLB.0323.00149,1,895138,895869,+,731
467,WOLB.0323.00014,1,731899,732671,+,772
468,WOLB.0323.00002,1,693980,694699,+,719
468,WOLB.0323.00132,1,650224,650944,-,720
468,WOLB.0323.00121,1,1071899,1072621,-,722
468,WOLB.0323.00135,1,825155,825877,+,722
468,WOLB.0323.00019,1,600889,601611,-,722
468,WOLB.0323.00039,1,1245788,1246510,+,722
468,WOLB.0323.00142,1,948637,949359,-,722
468,WOLB.0323.00023,1,1729849,1730567,+,718
468,WOLB.0323.00064,1,303346,304068,+,722
468,WOLB.0323.00030,1,929113,929835,-,722
468,WOLB.0323.00043,1,781845,782564,+,719
468,WOLB.0323.00122,1,757428,758150,-,722
468,WOLB.0323.00004,1,946653,947375,-,722
468,WOLB.0323.00011,1,316118,316840,-,722
468,WOLB.0323.00128,1,880824,881530,-,706
468,WOLB.0323.00158,1,219502,220224,-,722
468,WOLB.0323.00017,1,935360,936082,-,722
468,WOLB.0323.00070,1,981864,982583,-,719
468,WOLB.0323.00119,1,576973,577695,+,722
468,WOLB.0323.00149,1,896287,897009,+,722
468,WOLB.0323.00014,1,733119,733838,+,719
469,WOLB.0323.00002,1,732330,733273,+,943
469,WOLB.0323.00010,1,613864,614807,-,943
469,WOLB.0323.00128,1,651081,652023,-,942
469,WOLB.0323.00070,1,772441,773384,+,943
470,WOLB.0323.00002,1,738106,738704,+,598
470,WOLB.0323.00138,1,33498,34109,-,611
470,WOLB.0323.00138,1,1110774,1111385,-,611
470,WOLB.0323.00132,1,174369,174980,+,611
470,WOLB.0323.00060,1,261211,261813,-,602
470,WOLB.0323.00074,1,228954,229563,+,609
470,WOLB.0323.00074,1,495381,495990,+,609
470,WOLB.0323.00120,1,228184,228793,+,609
470,WOLB.0323.00120,1,481552,482161,+,609
470,WOLB.0323.00039,1,42578,43188,-,610
470,WOLB.0323.00041,1,1233779,1234388,-,609
470,WOLB.0323.00041,1,1409291,1409900,-,609
470,WOLB.0323.00142,1,544038,544640,+,602
470,WOLB.0323.00023,1,8791,9393,+,602
470,WOLB.0323.00023,1,448349,448951,-,602
470,WOLB.0323.00023,1,1604013,1604615,-,602
470,WOLB.0323.00023,1,1630769,1631371,-,602
470,WOLB.0323.00023,1,1665988,1666590,-,602
470,WOLB.0323.00093,1,1159862,1160470,+,608
470,WOLB.0323.00024,1,501972,502574,-,602
470,WOLB.0323.00024,1,1015012,1015614,+,602
470,WOLB.0323.00064,1,362747,363349,-,602
470,WOLB.0323.00064,1,393909,394511,-,602
470,WOLB.0323.00133,1,532329,532949,-,620
470,WOLB.0323.00122,1,1113997,1114595,+,598
470,WOLB.0323.00122,1,1409148,1409750,-,602
470,WOLB.0323.00004,1,541603,542205,+,602
470,WOLB.0323.00018,1,780665,781267,+,602
470,WOLB.0323.00128,1,778538,779132,-,594
470,WOLB.0323.00158,1,1196070,1196672,+,602
470,WOLB.0323.00104,1,437464,438066,-,602
470,WOLB.0323.00070,1,640423,641021,-,598
470,WOLB.0323.00149,1,1278943,1279545,+,602
470,WOLB.0323.00014,1,537459,538057,-,598
470,WOLB.0323.00014,1,878669,879267,+,598
470,WOLB.0323.00096,1,1172774,1173383,-,609
470,WOLB.0323.00096,1,1425153,1425762,-,609
471,WOLB.0323.00002,1,751112,751820,+,708
471,WOLB.0323.00043,1,1029091,1029799,+,708
471,WOLB.0323.00010,1,343934,344641,-,707
471,WOLB.0323.00128,1,705116,705823,-,707
471,WOLB.0323.00070,1,672793,673501,+,708
471,WOLB.0323.00014,1,914374,915082,+,708
472,WOLB.0323.00002,1,846302,846913,+,611
472,WOLB.0323.00143,1,501770,502380,+,610
472,WOLB.0323.00106,1,501773,502383,+,610
472,WOLB.0323.00031,1,284929,285539,-,610
472,WOLB.0323.00043,1,693128,693739,+,611
472,WOLB.0323.00128,1,949876,950487,-,611
472,WOLB.0323.00070,1,1157588,1158199,+,611
472,WOLB.0323.00006,1,1034211,1034821,+,610
472,WOLB.0323.00014,1,597219,597830,+,611
473,WOLB.0323.00002,1,929735,930292,+,557
473,WOLB.0323.00043,1,836406,836964,+,558
473,WOLB.0323.00128,1,740523,741080,-,557
473,WOLB.0323.00070,1,926096,926653,-,557
473,WOLB.0323.00014,1,790337,790894,+,557
474,WOLB.0323.00002,1,954768,956417,+,1649
474,WOLB.0323.00043,1,861142,862793,+,1651
474,WOLB.0323.00010,1,845430,847081,-,1651
474,WOLB.0323.00128,1,718029,719677,-,1648
474,WOLB.0323.00070,1,903602,905250,-,1648
474,WOLB.0323.00014,1,811740,813389,+,1649
475,WOLB.0323.00002,1,960846,961516,+,670
475,WOLB.0323.00138,1,124777,125447,+,670
475,WOLB.0323.00132,1,780712,781381,-,669
475,WOLB.0323.00121,1,566200,566870,+,670
475,WOLB.0323.00135,1,1064634,1065303,-,669
475,WOLB.0323.00019,1,763444,764114,+,670
475,WOLB.0323.00060,1,147618,148275,+,657
475,WOLB.0323.00039,1,81734,82404,+,670
475,WOLB.0323.00056,1,1258073,1258742,-,669
475,WOLB.0323.00056,1,1374644,1375314,+,670
475,WOLB.0323.00142,1,656360,657030,+,670
475,WOLB.0323.00023,1,1704136,1704806,+,670
475,WOLB.0323.00153,1,509376,510046,+,670
475,WOLB.0323.00093,1,1071061,1071730,-,669
475,WOLB.0323.00088,1,621675,622344,-,669
475,WOLB.0323.00008,1,1027949,1028619,+,670
475,WOLB.0323.00024,1,430428,431097,-,669
475,WOLB.0323.00064,1,421690,422360,+,670
475,WOLB.0323.00030,1,419734,420404,+,670
475,WOLB.0323.00084,1,230969,231639,+,670
475,WOLB.0323.00021,1,399567,400237,+,670
475,WOLB.0323.00021,1,1170874,1171543,-,669
475,WOLB.0323.00043,1,962684,963353,-,669
475,WOLB.0323.00020,1,561415,562084,-,669
475,WOLB.0323.00122,1,996069,996738,-,669
475,WOLB.0323.00118,1,1032094,1032764,+,670
475,WOLB.0323.00004,1,657463,658133,+,670
475,WOLB.0323.00011,1,1196397,1197066,-,669
475,WOLB.0323.00035,1,556790,557459,-,669
475,WOLB.0323.00032,1,1466666,1467336,+,670
475,WOLB.0323.00012,1,625779,626448,-,669
475,WOLB.0323.00010,1,879757,880426,-,669
475,WOLB.0323.00068,1,1009251,1009921,+,670
475,WOLB.0323.00158,1,1288005,1288675,+,670
475,WOLB.0323.00017,1,646181,646851,+,670
475,WOLB.0323.00104,1,573452,574121,-,669
475,WOLB.0323.00007,1,954205,954874,-,669
475,WOLB.0323.00100,1,880457,881126,-,669
475,WOLB.0323.00070,1,876747,877417,+,670
475,WOLB.0323.00042,1,554385,555054,-,669
475,WOLB.0323.00042,1,758804,759474,+,670
475,WOLB.0323.00119,1,414578,415247,-,669
475,WOLB.0323.00149,1,1184838,1185507,-,669
475,WOLB.0323.00014,1,865116,865785,-,669
476,WOLB.0323.00002,1,961517,962188,+,671
476,WOLB.0323.00138,1,125448,126119,+,671
476,WOLB.0323.00132,1,780040,780710,-,670
476,WOLB.0323.00121,1,566871,567542,+,671
476,WOLB.0323.00135,1,1063962,1064632,-,670
476,WOLB.0323.00019,1,764115,764786,+,671
476,WOLB.0323.00060,1,149649,150334,+,685
476,WOLB.0323.00039,1,82405,83076,+,671
476,WOLB.0323.00056,1,1257402,1258071,-,669
476,WOLB.0323.00056,1,1375315,1375985,+,670
476,WOLB.0323.00142,1,657031,657702,+,671
476,WOLB.0323.00023,1,1704807,1705478,+,671
476,WOLB.0323.00153,1,510047,510718,+,671
476,WOLB.0323.00093,1,1070392,1071059,-,667
476,WOLB.0323.00088,1,621003,621673,-,670
476,WOLB.0323.00008,1,1028620,1029288,+,668
476,WOLB.0323.00024,1,429756,430426,-,670
476,WOLB.0323.00064,1,422361,423032,+,671
476,WOLB.0323.00030,1,420405,421076,+,671
476,WOLB.0323.00084,1,231640,232310,+,670
476,WOLB.0323.00021,1,400238,400909,+,671
476,WOLB.0323.00021,1,1170202,1170872,-,670
476,WOLB.0323.00043,1,962013,962682,-,669
476,WOLB.0323.00020,1,560743,561413,-,670
476,WOLB.0323.00122,1,995397,996067,-,670
476,WOLB.0323.00118,1,1032765,1033436,+,671
476,WOLB.0323.00004,1,658134,658805,+,671
476,WOLB.0323.00011,1,1195725,1196395,-,670
476,WOLB.0323.00035,1,556118,556788,-,670
476,WOLB.0323.00032,1,1467337,1468008,+,671
476,WOLB.0323.00012,1,625107,625777,-,670
476,WOLB.0323.00010,1,879085,879755,-,670
476,WOLB.0323.00068,1,1009922,1010593,+,671
476,WOLB.0323.00158,1,1288676,1289347,+,671
476,WOLB.0323.00017,1,646852,647523,+,671
476,WOLB.0323.00104,1,572780,573450,-,670
476,WOLB.0323.00007,1,953533,954203,-,670
476,WOLB.0323.00100,1,879785,880455,-,670
476,WOLB.0323.00070,1,877418,878089,+,671
476,WOLB.0323.00042,1,553716,554383,-,667
476,WOLB.0323.00042,1,759475,760146,+,671
476,WOLB.0323.00119,1,413906,414576,-,670
476,WOLB.0323.00149,1,1184166,1184836,-,670
476,WOLB.0323.00014,1,864447,865114,-,667
477,WOLB.0323.00002,1,986849,987550,+,701
477,WOLB.0323.00143,1,729338,730043,+,705
477,WOLB.0323.00106,1,729339,730044,+,705
477,WOLB.0323.00031,1,57261,57965,-,704
477,WOLB.0323.00093,1,750175,750885,+,710
477,WOLB.0323.00008,1,602192,602902,+,710
477,WOLB.0323.00133,1,55180,55884,-,704
477,WOLB.0323.00043,1,445061,445765,-,704
477,WOLB.0323.00025,1,225148,225857,-,709
477,WOLB.0323.00010,1,968115,968820,+,705
477,WOLB.0323.00128,1,459910,460614,-,704
477,WOLB.0323.00070,1,1391618,1392323,+,705
477,WOLB.0323.00006,1,54055,54759,-,704
477,WOLB.0323.00014,1,1403593,1404298,+,705
478,WOLB.0323.00002,1,1029250,1029926,+,676
478,WOLB.0323.00132,1,797288,797980,+,692
478,WOLB.0323.00121,1,681878,682570,+,692
478,WOLB.0323.00135,1,1136740,1137432,+,692
478,WOLB.0323.00135,1,1187352,1188044,-,692
478,WOLB.0323.00135,1,1203083,1203775,+,692
478,WOLB.0323.00135,1,1217305,1217997,-,692
478,WOLB.0323.00060,1,170395,171087,+,692
478,WOLB.0323.00074,1,316573,317269,+,696
478,WOLB.0323.00074,1,323630,324328,-,698
478,WOLB.0323.00074,1,458859,459557,-,698
478,WOLB.0323.00120,1,300647,301345,-,698
478,WOLB.0323.00120,1,445030,445728,-,698
478,WOLB.0323.00041,1,1166087,1166785,+,698
478,WOLB.0323.00041,1,1445724,1446422,+,698
478,WOLB.0323.00041,1,1580967,1581665,+,698
478,WOLB.0323.00056,1,1395670,1396362,+,692
478,WOLB.0323.00142,1,503118,503810,-,692
478,WOLB.0323.00088,1,533327,534019,+,692
478,WOLB.0323.00024,1,2132627,2133319,+,692
478,WOLB.0323.00064,1,373947,374639,+,692
478,WOLB.0323.00043,1,583196,583888,-,692
478,WOLB.0323.00043,1,910609,911301,-,692
478,WOLB.0323.00122,1,1064700,1065392,-,692
478,WOLB.0323.00004,1,499580,500272,-,692
478,WOLB.0323.00011,1,7526,8218,-,692
478,WOLB.0323.00018,1,736095,736787,-,692
478,WOLB.0323.00025,1,121668,122360,+,692
478,WOLB.0323.00158,1,395887,396579,+,692
478,WOLB.0323.00017,1,579165,579857,-,692
478,WOLB.0323.00100,1,736901,737515,+,614
478,WOLB.0323.00100,1,798135,798749,+,614
478,WOLB.0323.00070,1,1056412,1057088,+,676
478,WOLB.0323.00042,1,1150043,1150735,+,692
478,WOLB.0323.00149,1,1238135,1238827,-,692
478,WOLB.0323.00014,1,1231252,1231928,-,676
478,WOLB.0323.00096,1,1204719,1205421,-,702
478,WOLB.0323.00096,1,1216104,1216802,+,698
478,WOLB.0323.00096,1,1351333,1352031,+,698
479,WOLB.0323.00002,1,1031792,1032853,+,1061
479,WOLB.0323.00138,1,163661,164725,+,1064
479,WOLB.0323.00132,1,124181,125243,-,1062
479,WOLB.0323.00121,1,830678,831739,+,1061
479,WOLB.0323.00153,1,473826,474887,+,1061
479,WOLB.0323.00088,1,488532,489593,+,1061
479,WOLB.0323.00008,1,421003,422024,-,1021
479,WOLB.0323.00024,1,805906,806970,+,1064
479,WOLB.0323.00064,1,686650,687711,+,1061
479,WOLB.0323.00030,1,303931,304993,-,1062
479,WOLB.0323.00021,1,1143150,1144215,-,1065
479,WOLB.0323.00020,1,458300,459361,+,1061
479,WOLB.0323.00012,1,489674,490735,+,1061
479,WOLB.0323.00068,1,528515,529580,-,1065
479,WOLB.0323.00104,1,575456,576517,+,1061
479,WOLB.0323.00100,1,565267,566328,+,1061
479,WOLB.0323.00100,1,621919,622980,+,1061
479,WOLB.0323.00070,1,1058954,1060015,+,1061
480,WOLB.0323.00002,1,1035819,1036418,+,599
480,WOLB.0323.00138,1,167698,168293,+,595
480,WOLB.0323.00132,1,120617,121216,-,599
480,WOLB.0323.00121,1,834705,835304,+,599
480,WOLB.0323.00153,1,477853,478452,+,599
480,WOLB.0323.00088,1,492559,493158,+,599
480,WOLB.0323.00008,1,417491,418038,-,547
480,WOLB.0323.00024,1,809970,810553,+,583
480,WOLB.0323.00064,1,690677,691276,+,599
480,WOLB.0323.00030,1,300367,300966,-,599
480,WOLB.0323.00030,1,455508,456103,+,595
480,WOLB.0323.00030,1,733310,733903,+,593
480,WOLB.0323.00030,1,1114930,1115515,-,585
480,WOLB.0323.00133,1,522879,523464,+,585
480,WOLB.0323.00021,1,1139583,1140178,-,595
480,WOLB.0323.00020,1,462327,462926,+,599
480,WOLB.0323.00004,1,551303,551901,+,598
480,WOLB.0323.00032,1,60275,60873,+,598
480,WOLB.0323.00032,1,1517404,1518002,-,598
480,WOLB.0323.00012,1,493701,494300,+,599
480,WOLB.0323.00068,1,524948,525543,-,595
480,WOLB.0323.00158,1,1205770,1206368,+,598
480,WOLB.0323.00104,1,427768,428366,-,598
480,WOLB.0323.00104,1,579483,580082,+,599
480,WOLB.0323.00100,1,569294,569893,+,599
480,WOLB.0323.00100,1,625946,626545,+,599
480,WOLB.0323.00100,1,681952,682537,+,585
480,WOLB.0323.00100,1,743186,743771,+,585
480,WOLB.0323.00070,1,498583,499181,+,598
480,WOLB.0323.00070,1,1062981,1063580,+,599
480,WOLB.0323.00149,1,1332773,1333371,+,598
481,WOLB.0323.00002,1,1050196,1051012,+,816
481,WOLB.0323.00138,1,39707,40523,+,816
481,WOLB.0323.00138,1,1033379,1034195,+,816
481,WOLB.0323.00132,1,298545,299337,-,792
481,WOLB.0323.00121,1,786509,787325,+,816
481,WOLB.0323.00060,1,191735,192549,+,814
481,WOLB.0323.00060,1,334152,334975,+,823
481,WOLB.0323.00142,1,535668,536484,-,816
481,WOLB.0323.00023,1,1678948,1679767,+,819
481,WOLB.0323.00023,1,1804556,1805375,+,819
481,WOLB.0323.00153,1,490594,491410,+,816
481,WOLB.0323.00093,1,1251310,1252121,+,811
481,WOLB.0323.00024,1,1623695,1624529,-,834
481,WOLB.0323.00064,1,402612,403431,+,819
481,WOLB.0323.00030,1,526172,526988,+,816
481,WOLB.0323.00122,1,1106157,1106976,-,819
481,WOLB.0323.00004,1,533233,534049,-,816
481,WOLB.0323.00018,1,773580,774402,-,822
481,WOLB.0323.00018,1,934258,935069,-,811
481,WOLB.0323.00010,1,521636,522469,-,833
481,WOLB.0323.00010,1,896922,897755,-,833
481,WOLB.0323.00128,1,632022,632865,+,843
481,WOLB.0323.00158,1,1187700,1188516,-,816
481,WOLB.0323.00104,1,445620,446436,+,816
481,WOLB.0323.00007,1,901243,902043,-,800
481,WOLB.0323.00100,1,694694,695527,+,833
481,WOLB.0323.00100,1,755928,756761,+,833
481,WOLB.0323.00100,1,951944,952760,+,816
481,WOLB.0323.00070,1,1214279,1215090,-,811
481,WOLB.0323.00042,1,959865,960699,-,834
481,WOLB.0323.00042,1,1114642,1115453,-,811
481,WOLB.0323.00042,1,1196150,1196984,+,834
481,WOLB.0323.00042,1,1714186,1715020,+,834
481,WOLB.0323.00149,1,1796,2612,+,816
481,WOLB.0323.00149,1,1270573,1271389,-,816
482,WOLB.0323.00002,1,1051972,1052535,+,563
482,WOLB.0323.00138,1,41493,42049,+,556
482,WOLB.0323.00138,1,1035165,1035721,+,556
482,WOLB.0323.00132,1,297010,297567,-,557
482,WOLB.0323.00121,1,788308,788854,+,546
482,WOLB.0323.00060,1,193523,194086,+,563
482,WOLB.0323.00060,1,335948,336504,+,556
482,WOLB.0323.00142,1,534141,534698,-,557
482,WOLB.0323.00023,1,1680740,1681296,+,556
482,WOLB.0323.00023,1,1806348,1806904,+,556
482,WOLB.0323.00153,1,492380,492947,+,567
482,WOLB.0323.00093,1,1253099,1253655,+,556
482,WOLB.0323.00024,1,1622168,1622732,-,564
482,WOLB.0323.00064,1,404418,404972,+,554
482,WOLB.0323.00064,1,1554252,1554809,-,557
482,WOLB.0323.00030,1,527971,528517,+,546
482,WOLB.0323.00122,1,1104615,1105170,-,555
482,WOLB.0323.00004,1,531706,532263,-,557
482,WOLB.0323.00018,1,772053,772610,-,557
482,WOLB.0323.00018,1,932720,933277,-,557
482,WOLB.0323.00010,1,520109,520673,-,564
482,WOLB.0323.00010,1,895385,895932,-,547
482,WOLB.0323.00128,1,633838,634394,+,556
482,WOLB.0323.00158,1,1186173,1186730,-,557
482,WOLB.0323.00104,1,447406,447962,+,556
482,WOLB.0323.00007,1,899713,900270,-,557
482,WOLB.0323.00100,1,696500,697063,+,563
482,WOLB.0323.00100,1,757734,758297,+,563
482,WOLB.0323.00100,1,953743,954289,+,546
482,WOLB.0323.00070,1,1212741,1213298,-,557
482,WOLB.0323.00006,1,808334,808897,+,563
482,WOLB.0323.00042,1,958338,958902,-,564
482,WOLB.0323.00042,1,1113104,1113661,-,557
482,WOLB.0323.00042,1,1197947,1198510,+,563
482,WOLB.0323.00042,1,1715983,1716546,+,563
482,WOLB.0323.00149,1,3582,4138,+,556
482,WOLB.0323.00149,1,1269046,1269603,-,557
483,WOLB.0323.00002,1,1054584,1055568,+,984
483,WOLB.0323.00074,1,224646,225630,-,984
483,WOLB.0323.00120,1,223876,224860,-,984
483,WOLB.0323.00041,1,1237711,1238695,+,984
483,WOLB.0323.00096,1,1429085,1430069,+,984
484,WOLB.0323.00002,1,1056105,1056703,+,598
484,WOLB.0323.00121,1,722915,723490,+,575
484,WOLB.0323.00019,1,183209,183792,+,583
484,WOLB.0323.00060,1,1165782,1166379,-,597
484,WOLB.0323.00056,1,466898,467496,-,598
484,WOLB.0323.00142,1,466541,467131,-,590
484,WOLB.0323.00024,1,1748534,1749124,+,590
484,WOLB.0323.00064,1,480130,480698,+,568
484,WOLB.0323.00064,1,714615,715198,-,583
484,WOLB.0323.00030,1,1134202,1134800,-,598
484,WOLB.0323.00021,1,546289,546879,+,590
484,WOLB.0323.00043,1,1148542,1149146,-,604
484,WOLB.0323.00004,1,463003,463593,-,590
484,WOLB.0323.00011,1,1236716,1237291,+,575
484,WOLB.0323.00158,1,432581,433156,+,575
484,WOLB.0323.00017,1,538660,539250,-,590
484,WOLB.0323.00007,1,967098,967688,-,590
484,WOLB.0323.00119,1,105250,105848,-,598
485,WOLB.0323.00002,1,1065090,1066075,+,985
485,WOLB.0323.00132,1,287183,288167,-,984
485,WOLB.0323.00060,1,1154862,1155846,-,984
485,WOLB.0323.00074,1,1460800,1461787,+,987
485,WOLB.0323.00120,1,1441142,1442129,+,987
485,WOLB.0323.00041,1,1255677,1256664,+,987
485,WOLB.0323.00024,1,926842,927827,+,985
485,WOLB.0323.00024,1,1355626,1356613,+,987
485,WOLB.0323.00064,1,1614796,1615780,-,984
485,WOLB.0323.00030,1,339549,340533,-,984
485,WOLB.0323.00030,1,1297213,1298197,-,984
485,WOLB.0323.00043,1,1594749,1595734,+,985
485,WOLB.0323.00032,1,1189091,1190076,+,985
485,WOLB.0323.00128,1,1096102,1097086,-,984
485,WOLB.0323.00070,1,1172666,1173636,+,970
485,WOLB.0323.00042,1,947589,948573,-,984
485,WOLB.0323.00042,1,1208275,1209260,+,985
485,WOLB.0323.00042,1,1726311,1727296,+,985
485,WOLB.0323.00014,1,271653,272637,-,984
485,WOLB.0323.00096,1,1447051,1448038,+,987
486,WOLB.0323.00002,1,1069918,1070981,+,1063
486,WOLB.0323.00132,1,282275,283330,-,1055
486,WOLB.0323.00060,1,1149952,1151016,-,1064
486,WOLB.0323.00024,1,933692,934756,+,1064
486,WOLB.0323.00024,1,1360471,1361536,+,1065
486,WOLB.0323.00024,1,1774619,1775683,-,1064
486,WOLB.0323.00024,1,2174261,2175325,+,1064
486,WOLB.0323.00064,1,1609886,1610950,-,1064
486,WOLB.0323.00030,1,334639,335703,-,1064
486,WOLB.0323.00030,1,1292296,1293360,-,1064
486,WOLB.0323.00043,1,1528415,1529479,-,1064
486,WOLB.0323.00032,1,1195431,1196495,+,1064
486,WOLB.0323.00010,1,1257186,1258250,+,1064
486,WOLB.0323.00128,1,1091184,1092249,-,1065
486,WOLB.0323.00007,1,447569,448632,-,1063
486,WOLB.0323.00042,1,942679,943743,-,1064
486,WOLB.0323.00042,1,1213106,1214170,+,1064
486,WOLB.0323.00042,1,1731142,1732206,+,1064
487,WOLB.0323.00002,1,1074106,1075052,+,946
487,WOLB.0323.00023,1,1486530,1487474,+,944
487,WOLB.0323.00093,1,913240,914186,-,946
487,WOLB.0323.00024,1,937873,938819,+,946
487,WOLB.0323.00024,1,1770556,1771502,-,946
487,WOLB.0323.00030,1,330585,331531,-,946
487,WOLB.0323.00030,1,427836,428774,+,938
487,WOLB.0323.00021,1,627351,628297,+,946
487,WOLB.0323.00043,1,1524352,1525298,-,946
487,WOLB.0323.00032,1,1199612,1200558,+,946
487,WOLB.0323.00010,1,873608,874554,-,946
487,WOLB.0323.00010,1,1261359,1262304,+,945
487,WOLB.0323.00128,1,1086571,1087517,-,946
487,WOLB.0323.00007,1,443496,444442,-,946
487,WOLB.0323.00100,1,719204,720150,+,946
487,WOLB.0323.00100,1,780438,781384,+,946
487,WOLB.0323.00070,1,1037625,1038571,+,946
487,WOLB.0323.00042,1,938616,939562,-,946
487,WOLB.0323.00042,1,1217287,1218233,+,946
487,WOLB.0323.00042,1,1735323,1736269,+,946
487,WOLB.0323.00014,1,1252623,1253569,-,946
488,WOLB.0323.00002,1,1079287,1079900,+,613
488,WOLB.0323.00070,1,603917,604530,+,613
488,WOLB.0323.00070,1,1188775,1189389,-,614
489,WOLB.0323.00002,1,1135012,1135512,+,500
489,WOLB.0323.00039,1,235691,236191,-,500
489,WOLB.0323.00064,1,731306,731806,+,500
489,WOLB.0323.00030,1,1152403,1152903,+,500
489,WOLB.0323.00084,1,78696,79196,+,500
489,WOLB.0323.00021,1,529253,529753,-,500
489,WOLB.0323.00043,1,919212,919712,+,500
489,WOLB.0323.00118,1,986918,987418,+,500
489,WOLB.0323.00128,1,615630,616130,-,500
489,WOLB.0323.00070,1,634619,635119,-,500
489,WOLB.0323.00070,1,846175,846675,-,500
489,WOLB.0323.00014,1,884571,885071,+,500
489,WOLB.0323.00014,1,1074932,1075432,+,500
490,WOLB.0323.00002,1,1135513,1136107,+,594
490,WOLB.0323.00064,1,731807,732401,+,594
490,WOLB.0323.00030,1,1152904,1153498,+,594
490,WOLB.0323.00084,1,79197,79791,+,594
490,WOLB.0323.00021,1,528657,529251,-,594
490,WOLB.0323.00043,1,919713,920307,+,594
490,WOLB.0323.00118,1,987419,988013,+,594
490,WOLB.0323.00128,1,615034,615628,-,594
490,WOLB.0323.00070,1,634023,634617,-,594
490,WOLB.0323.00070,1,845579,846173,-,594
490,WOLB.0323.00014,1,885072,885666,+,594
490,WOLB.0323.00014,1,1075433,1076027,+,594
491,WOLB.0323.00002,1,1248067,1248724,+,657
491,WOLB.0323.00093,1,1404362,1405013,-,651
491,WOLB.0323.00043,1,1327243,1327900,+,657
491,WOLB.0323.00010,1,1378511,1379169,+,658
491,WOLB.0323.00128,1,1234725,1235383,+,658
491,WOLB.0323.00070,1,1566640,1567297,+,657
491,WOLB.0323.00014,1,1579656,1580313,+,657
492,WOLB.0323.00002,1,1433711,1434554,+,843
492,WOLB.0323.00132,1,1102335,1103178,+,843
492,WOLB.0323.00103,1,476018,476877,-,859
492,WOLB.0323.00107,1,476016,476875,-,859
492,WOLB.0323.00074,1,1009697,1010558,+,861
492,WOLB.0323.00074,1,1012844,1013701,-,857
492,WOLB.0323.00120,1,997567,998424,-,857
492,WOLB.0323.00041,1,637782,638639,+,857
492,WOLB.0323.00023,1,978958,979817,+,859
492,WOLB.0323.00093,1,1721433,1722292,-,859
492,WOLB.0323.00008,1,35635,36494,+,859
492,WOLB.0323.00024,1,2046828,2047670,+,842
492,WOLB.0323.00064,1,1012097,1012948,+,851
492,WOLB.0323.00030,1,126358,127209,-,851
492,WOLB.0323.00105,1,476022,476881,-,859
492,WOLB.0323.00133,1,861138,861989,-,851
492,WOLB.0323.00043,1,1711106,1711949,-,843
492,WOLB.0323.00018,1,1254693,1255536,-,843
492,WOLB.0323.00010,1,1559228,1560071,+,843
492,WOLB.0323.00128,1,1489859,1490702,-,843
492,WOLB.0323.00001,1,476022,476881,-,859
492,WOLB.0323.00070,1,1753713,1754556,-,843
492,WOLB.0323.00042,1,1247248,1248099,-,851
492,WOLB.0323.00014,1,1770488,1771331,-,843
492,WOLB.0323.00096,1,676271,677128,+,857
493,WOLB.0323.00002,1,1483180,1484618,+,1438
493,WOLB.0323.00135,1,272978,274415,-,1437
493,WOLB.0323.00103,1,126122,127560,+,1438
493,WOLB.0323.00107,1,126121,127559,+,1438
493,WOLB.0323.00060,1,1603285,1604723,+,1438
493,WOLB.0323.00056,1,90789,92227,+,1438
493,WOLB.0323.00093,1,237826,239263,-,1437
493,WOLB.0323.00105,1,126121,127559,+,1438
493,WOLB.0323.00043,1,1662860,1664297,-,1437
493,WOLB.0323.00010,1,1614764,1616203,+,1439
493,WOLB.0323.00128,1,1448207,1449644,-,1437
493,WOLB.0323.00007,1,1407757,1409194,-,1437
493,WOLB.0323.00001,1,126121,127559,+,1438
493,WOLB.0323.00070,1,1794015,1795453,+,1438
493,WOLB.0323.00042,1,1499762,1501199,-,1437
493,WOLB.0323.00014,1,670733,672170,-,1437
494,WOLB.0323.00002,1,1491068,1491599,+,531
494,WOLB.0323.00132,1,1295217,1295746,+,529
494,WOLB.0323.00143,1,37402,37933,-,531
494,WOLB.0323.00106,1,37403,37934,-,531
494,WOLB.0323.00103,1,432788,433317,+,529
494,WOLB.0323.00107,1,432786,433315,+,529
494,WOLB.0323.00019,1,112994,113524,-,530
494,WOLB.0323.00074,1,992178,992709,-,531
494,WOLB.0323.00120,1,983564,984095,-,531
494,WOLB.0323.00039,1,888163,888694,+,531
494,WOLB.0323.00041,1,652111,652642,+,531
494,WOLB.0323.00031,1,799872,800403,-,531
494,WOLB.0323.00024,1,969104,969634,-,530
494,WOLB.0323.00064,1,1259268,1259796,+,528
494,WOLB.0323.00030,1,1649848,1650376,-,528
494,WOLB.0323.00105,1,432791,433320,+,529
494,WOLB.0323.00133,1,821696,822227,+,531
494,WOLB.0323.00043,1,1655887,1656418,-,531
494,WOLB.0323.00025,1,933415,933932,+,517
494,WOLB.0323.00128,1,1441226,1441757,-,531
494,WOLB.0323.00001,1,432791,433320,+,529
494,WOLB.0323.00070,1,1801976,1802507,+,531
494,WOLB.0323.00006,1,661811,662342,+,531
494,WOLB.0323.00119,1,175518,176048,+,530
494,WOLB.0323.00014,1,663752,664283,-,531
494,WOLB.0323.00096,1,690600,691131,+,531
495,WOLB.0323.00002,1,1525358,1526061,+,703
495,WOLB.0323.00093,1,1711235,1711934,-,699
495,WOLB.0323.00133,1,108732,109430,-,698
495,WOLB.0323.00043,1,1496011,1496714,-,703
495,WOLB.0323.00010,1,1591733,1592420,+,687
495,WOLB.0323.00128,1,1405776,1406479,-,703
495,WOLB.0323.00070,1,1836266,1836969,+,703
495,WOLB.0323.00042,1,1522414,1523117,-,703
495,WOLB.0323.00014,1,629275,629978,-,703
496,WOLB.0323.00138,1,29438,30306,+,868
496,WOLB.0323.00060,1,797029,797898,-,869
496,WOLB.0323.00023,1,481262,482131,-,869
496,WOLB.0323.00023,1,1819600,1820468,+,868
496,WOLB.0323.00024,1,847740,848609,-,869
496,WOLB.0323.00024,1,943296,944165,-,869
496,WOLB.0323.00024,1,1072973,1073842,-,869
496,WOLB.0323.00024,1,2183680,2184549,-,869
496,WOLB.0323.00021,1,782430,783299,-,869
496,WOLB.0323.00043,1,1120835,1121703,+,868
496,WOLB.0323.00043,1,1519013,1519881,+,868
496,WOLB.0323.00122,1,286064,286933,-,869
496,WOLB.0323.00032,1,1184,2052,+,868
496,WOLB.0323.00032,1,19041,19909,+,868
496,WOLB.0323.00032,1,1205035,1205904,-,869
496,WOLB.0323.00032,1,1402086,1402955,-,869
496,WOLB.0323.00032,1,1547360,1548228,+,868
496,WOLB.0323.00032,1,1565217,1566085,+,868
496,WOLB.0323.00068,1,947427,948296,-,869
496,WOLB.0323.00128,1,1080071,1080939,+,868
496,WOLB.0323.00007,1,437284,438152,+,868
496,WOLB.0323.00070,1,539202,540071,-,869
496,WOLB.0323.00070,1,1043033,1043902,-,869
496,WOLB.0323.00070,1,1096125,1096994,-,869
496,WOLB.0323.00014,1,854287,855155,+,868
496,WOLB.0323.00014,1,1247277,1248145,+,868
497,WOLB.0323.00138,1,44765,45452,+,687
497,WOLB.0323.00138,1,1038437,1039124,+,687
497,WOLB.0323.00056,1,529209,529895,-,686
497,WOLB.0323.00142,1,530739,531425,-,686
497,WOLB.0323.00064,1,1550851,1551537,-,686
497,WOLB.0323.00030,1,345631,346302,-,671
497,WOLB.0323.00043,1,623070,623756,-,686
497,WOLB.0323.00004,1,528304,528990,-,686
497,WOLB.0323.00032,1,1181854,1182541,+,687
497,WOLB.0323.00158,1,1182771,1183457,-,686
497,WOLB.0323.00104,1,450678,451365,+,687
497,WOLB.0323.00100,1,699811,700498,+,687
497,WOLB.0323.00100,1,761045,761732,+,687
497,WOLB.0323.00070,1,1281050,1281736,-,686
497,WOLB.0323.00149,1,6853,7540,+,687
497,WOLB.0323.00149,1,1265645,1266331,-,686
497,WOLB.0323.00014,1,277821,278507,-,686
497,WOLB.0323.00014,1,1138214,1138900,-,686
498,WOLB.0323.00138,1,49946,50809,+,863
498,WOLB.0323.00138,1,1043618,1044481,+,863
498,WOLB.0323.00132,1,157368,158232,-,864
498,WOLB.0323.00121,1,659411,660274,+,863
498,WOLB.0323.00121,1,731171,732035,+,864
498,WOLB.0323.00074,1,207504,208356,-,852
498,WOLB.0323.00120,1,206734,207586,-,852
498,WOLB.0323.00041,1,210648,211500,-,852
498,WOLB.0323.00142,1,458005,458869,-,864
498,WOLB.0323.00142,1,525407,526270,-,863
498,WOLB.0323.00023,1,72794,73666,-,872
498,WOLB.0323.00023,1,148952,149815,-,863
498,WOLB.0323.00064,1,1545519,1546382,-,863
498,WOLB.0323.00030,1,1089925,1090788,-,863
498,WOLB.0323.00021,1,557578,558441,+,863
498,WOLB.0323.00021,1,1178168,1179031,-,863
498,WOLB.0323.00004,1,454467,455331,-,864
498,WOLB.0323.00004,1,522972,523835,-,863
498,WOLB.0323.00011,1,1244972,1245836,+,864
498,WOLB.0323.00032,1,35524,36388,-,864
498,WOLB.0323.00010,1,946834,947679,-,845
498,WOLB.0323.00128,1,642417,643279,+,862
498,WOLB.0323.00128,1,792327,793191,+,864
498,WOLB.0323.00158,1,440828,441692,+,864
498,WOLB.0323.00158,1,1177439,1178302,-,863
498,WOLB.0323.00017,1,530123,530986,-,863
498,WOLB.0323.00007,1,961662,962525,-,863
498,WOLB.0323.00070,1,478252,479115,+,863
498,WOLB.0323.00070,1,521401,522264,+,863
498,WOLB.0323.00070,1,1203981,1204844,-,863
498,WOLB.0323.00042,1,565705,566569,-,864
498,WOLB.0323.00042,1,1104310,1105174,-,864
498,WOLB.0323.00149,1,12009,12873,+,864
498,WOLB.0323.00149,1,1260312,1261176,-,864
498,WOLB.0323.00096,1,221516,222368,-,852
499,WOLB.0323.00138,1,55369,56535,+,1166
499,WOLB.0323.00138,1,1049041,1050207,+,1166
499,WOLB.0323.00121,1,738579,739745,+,1166
499,WOLB.0323.00074,1,201772,202945,-,1173
499,WOLB.0323.00074,1,351492,352671,-,1179
499,WOLB.0323.00120,1,201002,202175,-,1173
499,WOLB.0323.00120,1,329821,331000,-,1179
499,WOLB.0323.00041,1,192725,193898,-,1173
499,WOLB.0323.00041,1,204916,206089,-,1173
499,WOLB.0323.00041,1,1137739,1138918,+,1179
499,WOLB.0323.00041,1,1553959,1555138,+,1179
499,WOLB.0323.00142,1,450287,451460,-,1173
499,WOLB.0323.00023,1,1558221,1559400,+,1179
499,WOLB.0323.00021,1,564994,566160,+,1166
499,WOLB.0323.00021,1,1172228,1173401,-,1173
499,WOLB.0323.00004,1,446749,447922,-,1173
499,WOLB.0323.00011,1,1252380,1253546,+,1166
499,WOLB.0323.00010,1,451983,453149,+,1166
499,WOLB.0323.00017,1,522405,523578,-,1173
499,WOLB.0323.00070,1,1198242,1199415,-,1173
499,WOLB.0323.00149,1,17441,18607,+,1166
499,WOLB.0323.00149,1,1254571,1255744,-,1173
499,WOLB.0323.00096,1,215784,216957,-,1173
499,WOLB.0323.00096,1,1322990,1324169,+,1179
500,WOLB.0323.00138,1,57370,58049,+,679
500,WOLB.0323.00138,1,1051042,1051721,+,679
500,WOLB.0323.00132,1,150009,150688,-,679
500,WOLB.0323.00121,1,666968,667647,+,679
500,WOLB.0323.00121,1,740583,741262,+,679
500,WOLB.0323.00074,1,200255,200934,-,679
500,WOLB.0323.00120,1,199485,200164,-,679
500,WOLB.0323.00039,1,283001,283680,-,679
500,WOLB.0323.00041,1,191208,191887,-,679
500,WOLB.0323.00041,1,203399,204078,-,679
500,WOLB.0323.00142,1,447674,448353,-,679
500,WOLB.0323.00142,1,518041,518720,-,679
500,WOLB.0323.00023,1,62824,63503,-,679
500,WOLB.0323.00023,1,136964,137643,-,679
500,WOLB.0323.00024,1,426910,427589,-,679
500,WOLB.0323.00030,1,1078808,1079487,-,679
500,WOLB.0323.00021,1,1167667,1168346,-,679
500,WOLB.0323.00004,1,444136,444815,-,679
500,WOLB.0323.00004,1,515606,516285,-,679
500,WOLB.0323.00011,1,1254384,1255063,+,679
500,WOLB.0323.00010,1,453987,454659,+,672
500,WOLB.0323.00128,1,799888,800567,+,679
500,WOLB.0323.00158,1,380977,381656,+,679
500,WOLB.0323.00017,1,520895,521574,-,679
500,WOLB.0323.00007,1,951563,952242,-,679
500,WOLB.0323.00070,1,530903,531582,+,679
500,WOLB.0323.00070,1,1196730,1197409,-,679
500,WOLB.0323.00042,1,551986,552665,-,679
500,WOLB.0323.00042,1,1096929,1097608,-,679
500,WOLB.0323.00149,1,19447,20126,+,679
500,WOLB.0323.00149,1,1253059,1253738,-,679
500,WOLB.0323.00014,1,862717,863396,-,679
500,WOLB.0323.00096,1,214267,214946,-,679
501,WOLB.0323.00138,1,58135,58786,+,651
501,WOLB.0323.00138,1,1051807,1052458,+,651
501,WOLB.0323.00132,1,149271,149923,-,652
501,WOLB.0323.00121,1,667733,668384,+,651
501,WOLB.0323.00121,1,741348,741999,+,651
501,WOLB.0323.00074,1,199517,200169,-,652
501,WOLB.0323.00120,1,198747,199399,-,652
501,WOLB.0323.00039,1,282263,282915,-,652
501,WOLB.0323.00041,1,190470,191122,-,652
501,WOLB.0323.00041,1,202661,203313,-,652
501,WOLB.0323.00142,1,446936,447588,-,652
501,WOLB.0323.00142,1,517303,517955,-,652
501,WOLB.0323.00023,1,62086,62738,-,652
501,WOLB.0323.00023,1,136226,136878,-,652
501,WOLB.0323.00024,1,426172,426824,-,652
501,WOLB.0323.00030,1,1078070,1078722,-,652
501,WOLB.0323.00021,1,1166929,1167581,-,652
501,WOLB.0323.00004,1,443398,444050,-,652
501,WOLB.0323.00004,1,514868,515520,-,652
501,WOLB.0323.00011,1,1255149,1255800,+,651
501,WOLB.0323.00018,1,822746,823391,+,645
501,WOLB.0323.00010,1,454745,455396,+,651
501,WOLB.0323.00128,1,800653,801304,+,651
501,WOLB.0323.00158,1,381742,382393,+,651
501,WOLB.0323.00017,1,520157,520809,-,652
501,WOLB.0323.00007,1,950825,951477,-,652
501,WOLB.0323.00070,1,531668,532319,+,651
501,WOLB.0323.00070,1,1195992,1196644,-,652
501,WOLB.0323.00042,1,551248,551900,-,652
501,WOLB.0323.00042,1,1096191,1096843,-,652
501,WOLB.0323.00149,1,20212,20863,+,651
501,WOLB.0323.00149,1,1252321,1252973,-,652
501,WOLB.0323.00014,1,861985,862637,-,652
501,WOLB.0323.00096,1,213529,214181,-,652
502,WOLB.0323.00138,1,78689,79406,+,717
502,WOLB.0323.00138,1,1072361,1073078,+,717
502,WOLB.0323.00138,1,1520530,1521248,-,718
503,WOLB.0323.00138,1,85423,85975,+,552
503,WOLB.0323.00121,1,522468,523020,+,552
503,WOLB.0323.00103,1,1299678,1300187,+,509
503,WOLB.0323.00107,1,1297941,1298450,+,509
503,WOLB.0323.00074,1,837197,837707,+,510
503,WOLB.0323.00120,1,822187,822697,+,510
503,WOLB.0323.00041,1,800798,801307,-,509
503,WOLB.0323.00142,1,613400,613952,+,552
503,WOLB.0323.00105,1,1299686,1300195,+,509
503,WOLB.0323.00133,1,1213682,1214194,+,512
503,WOLB.0323.00084,1,47929,48480,-,551
503,WOLB.0323.00021,1,449134,449685,-,551
503,WOLB.0323.00122,1,1042457,1043008,-,551
503,WOLB.0323.00118,1,416780,417290,+,510
503,WOLB.0323.00004,1,615606,616158,+,552
503,WOLB.0323.00011,1,26107,26659,+,552
503,WOLB.0323.00032,1,1423445,1423997,+,552
503,WOLB.0323.00068,1,969898,970450,+,552
503,WOLB.0323.00158,1,1246148,1246700,+,552
503,WOLB.0323.00017,1,602118,602670,+,552
503,WOLB.0323.00001,1,1299686,1300195,+,509
503,WOLB.0323.00042,1,505353,505863,+,510
503,WOLB.0323.00149,1,1226813,1227364,-,551
503,WOLB.0323.00096,1,838670,839179,-,509
504,WOLB.0323.00138,1,88045,88632,+,587
504,WOLB.0323.00132,1,759943,760530,-,587
504,WOLB.0323.00143,1,622954,623541,+,587
504,WOLB.0323.00106,1,622955,623542,+,587
504,WOLB.0323.00121,1,525090,525677,+,587
504,WOLB.0323.00031,1,163765,164352,-,587
504,WOLB.0323.00142,1,616022,616609,+,587
504,WOLB.0323.00023,1,235738,236325,-,587
504,WOLB.0323.00064,1,1448957,1449544,+,587
504,WOLB.0323.00133,1,1216320,1216907,+,587
504,WOLB.0323.00084,1,45272,45859,-,587
504,WOLB.0323.00021,1,446477,447064,-,587
504,WOLB.0323.00122,1,1038697,1039284,-,587
504,WOLB.0323.00118,1,419418,420005,+,587
504,WOLB.0323.00004,1,618228,618815,+,587
504,WOLB.0323.00011,1,28729,29316,+,587
504,WOLB.0323.00032,1,1426067,1426654,+,587
504,WOLB.0323.00018,1,847820,848398,+,578
504,WOLB.0323.00068,1,972520,973107,+,587
504,WOLB.0323.00158,1,1248770,1249357,+,587
504,WOLB.0323.00017,1,604740,605300,+,560
504,WOLB.0323.00006,1,1154961,1155548,+,587
504,WOLB.0323.00042,1,507982,508569,+,587
504,WOLB.0323.00149,1,1224156,1224743,-,587
505,WOLB.0323.00138,1,149002,149915,+,913
505,WOLB.0323.00093,1,670430,671343,+,913
505,WOLB.0323.00084,1,247544,248457,+,913
505,WOLB.0323.00021,1,385213,386125,-,912
505,WOLB.0323.00043,1,943336,944248,-,912
505,WOLB.0323.00032,1,1489504,1490417,+,913
505,WOLB.0323.00068,1,543326,544238,-,912
506,WOLB.0323.00138,1,155253,155999,+,746
506,WOLB.0323.00023,1,244925,245671,-,746
506,WOLB.0323.00023,1,435567,436313,+,746
506,WOLB.0323.00153,1,534989,535735,+,746
506,WOLB.0323.00084,1,253795,254541,+,746
506,WOLB.0323.00021,1,379129,379875,-,746
506,WOLB.0323.00032,1,1495755,1496501,+,746
506,WOLB.0323.00068,1,537242,537988,-,746
507,WOLB.0323.00138,1,158878,159385,+,507
507,WOLB.0323.00132,1,801438,801944,+,506
507,WOLB.0323.00121,1,686028,686534,+,506
507,WOLB.0323.00135,1,1140887,1141393,+,506
507,WOLB.0323.00135,1,1183391,1183896,-,505
507,WOLB.0323.00135,1,1207230,1207736,+,506
507,WOLB.0323.00135,1,1213343,1213849,-,506
507,WOLB.0323.00103,1,559076,559582,+,506
507,WOLB.0323.00107,1,559074,559580,+,506
507,WOLB.0323.00060,1,307270,307776,+,506
507,WOLB.0323.00142,1,499156,499662,-,506
507,WOLB.0323.00153,1,538666,539173,+,507
507,WOLB.0323.00088,1,537477,537983,+,506
507,WOLB.0323.00064,1,1514560,1515067,-,507
507,WOLB.0323.00030,1,567721,568227,+,506
507,WOLB.0323.00105,1,559085,559591,+,506
507,WOLB.0323.00084,1,257420,257927,+,507
507,WOLB.0323.00021,1,375742,376249,-,507
507,WOLB.0323.00122,1,1060735,1061241,-,506
507,WOLB.0323.00004,1,495618,496124,-,506
507,WOLB.0323.00011,1,3561,4067,-,506
507,WOLB.0323.00032,1,1499380,1499887,+,507
507,WOLB.0323.00010,1,853956,854463,-,507
507,WOLB.0323.00068,1,533855,534362,-,507
507,WOLB.0323.00158,1,400034,400540,+,506
507,WOLB.0323.00017,1,573239,573745,-,506
507,WOLB.0323.00104,1,487373,487879,+,506
507,WOLB.0323.00001,1,559085,559591,+,506
507,WOLB.0323.00149,1,1234170,1234676,-,506
508,WOLB.0323.00138,1,159503,160081,+,578
508,WOLB.0323.00132,1,802062,802640,+,578
508,WOLB.0323.00121,1,686652,687230,+,578
508,WOLB.0323.00135,1,1141511,1142089,+,578
508,WOLB.0323.00135,1,1182696,1183274,-,578
508,WOLB.0323.00135,1,1207854,1208432,+,578
508,WOLB.0323.00135,1,1212656,1213226,-,570
508,WOLB.0323.00103,1,559700,560278,+,578
508,WOLB.0323.00107,1,559698,560276,+,578
508,WOLB.0323.00060,1,307894,308472,+,578
508,WOLB.0323.00142,1,498461,499039,-,578
508,WOLB.0323.00023,1,1646831,1647395,+,564
508,WOLB.0323.00153,1,539291,539869,+,578
508,WOLB.0323.00088,1,538101,538679,+,578
508,WOLB.0323.00064,1,1513865,1514443,-,578
508,WOLB.0323.00030,1,568345,568923,+,578
508,WOLB.0323.00105,1,559709,560287,+,578
508,WOLB.0323.00084,1,258045,258623,+,578
508,WOLB.0323.00021,1,375047,375625,-,578
508,WOLB.0323.00122,1,1060040,1060618,-,578
508,WOLB.0323.00004,1,494923,495501,-,578
508,WOLB.0323.00011,1,2866,3444,-,578
508,WOLB.0323.00032,1,1500005,1500583,+,578
508,WOLB.0323.00010,1,853261,853839,-,578
508,WOLB.0323.00068,1,533160,533738,-,578
508,WOLB.0323.00158,1,400658,401236,+,578
508,WOLB.0323.00017,1,572544,573122,-,578
508,WOLB.0323.00104,1,487997,488575,+,578
508,WOLB.0323.00001,1,559709,560287,+,578
508,WOLB.0323.00149,1,1233475,1234053,-,578
509,WOLB.0323.00138,1,160181,161855,+,1674
509,WOLB.0323.00132,1,802740,804402,+,1662
509,WOLB.0323.00121,1,687330,688992,+,1662
509,WOLB.0323.00135,1,1142189,1143851,+,1662
509,WOLB.0323.00135,1,1180933,1182595,-,1662
509,WOLB.0323.00135,1,1208532,1210194,+,1662
509,WOLB.0323.00135,1,1221331,1222993,+,1662
509,WOLB.0323.00103,1,560378,562050,+,1672
509,WOLB.0323.00107,1,560376,562048,+,1672
509,WOLB.0323.00060,1,308572,310246,+,1674
509,WOLB.0323.00142,1,496698,498360,-,1662
509,WOLB.0323.00023,1,1647495,1649167,+,1672
509,WOLB.0323.00153,1,539969,541642,+,1673
509,WOLB.0323.00088,1,538779,540441,+,1662
509,WOLB.0323.00064,1,1512091,1513764,-,1673
509,WOLB.0323.00030,1,569023,570685,+,1662
509,WOLB.0323.00105,1,560387,562059,+,1672
509,WOLB.0323.00084,1,258723,260397,+,1674
509,WOLB.0323.00021,1,373273,374946,-,1673
509,WOLB.0323.00122,1,1058218,1059939,-,1721
509,WOLB.0323.00004,1,493160,494822,-,1662
509,WOLB.0323.00011,1,1103,2765,-,1662
509,WOLB.0323.00032,1,1500683,1502357,+,1674
509,WOLB.0323.00068,1,531386,533059,-,1673
509,WOLB.0323.00158,1,401336,402998,+,1662
509,WOLB.0323.00017,1,570781,572443,-,1662
509,WOLB.0323.00104,1,489615,491279,+,1664
509,WOLB.0323.00001,1,560387,562059,+,1672
509,WOLB.0323.00149,1,1231712,1233374,-,1662
510,WOLB.0323.00138,1,195844,196384,+,540
510,WOLB.0323.00132,1,424158,424697,-,539
510,WOLB.0323.00121,1,474934,475474,-,540
510,WOLB.0323.00135,1,1239823,1240363,+,540
510,WOLB.0323.00060,1,88514,89054,-,540
510,WOLB.0323.00074,1,830251,830791,-,540
510,WOLB.0323.00120,1,816212,816752,-,540
510,WOLB.0323.00041,1,806742,807282,+,540
510,WOLB.0323.00056,1,414232,414772,-,540
510,WOLB.0323.00142,1,400749,401289,-,540
510,WOLB.0323.00088,1,476793,477333,-,540
510,WOLB.0323.00064,1,158347,158887,-,540
510,WOLB.0323.00030,1,775666,776207,-,541
510,WOLB.0323.00084,1,292320,292860,+,540
510,WOLB.0323.00021,1,773392,773932,-,540
510,WOLB.0323.00020,1,446561,447105,-,544
510,WOLB.0323.00004,1,398314,398854,-,540
510,WOLB.0323.00011,1,1149459,1149999,-,540
510,WOLB.0323.00035,1,402284,402824,-,540
510,WOLB.0323.00032,1,1344906,1345446,-,540
510,WOLB.0323.00012,1,477935,478479,-,544
510,WOLB.0323.00068,1,423354,423894,+,540
510,WOLB.0323.00158,1,494734,495274,+,540
510,WOLB.0323.00017,1,473965,474505,-,540
510,WOLB.0323.00104,1,405626,406166,-,540
510,WOLB.0323.00007,1,1016679,1017219,+,540
510,WOLB.0323.00100,1,553528,554072,-,544
510,WOLB.0323.00149,1,66349,66889,+,540
510,WOLB.0323.00096,1,844614,845154,+,540
511,WOLB.0323.00138,1,282000,283673,+,1673
511,WOLB.0323.00121,1,389486,391159,-,1673
511,WOLB.0323.00135,1,198790,200454,+,1664
511,WOLB.0323.00060,1,1497287,1498963,+,1676
511,WOLB.0323.00074,1,604627,606291,+,1664
511,WOLB.0323.00120,1,590798,592462,+,1664
511,WOLB.0323.00041,1,1024570,1026234,-,1664
511,WOLB.0323.00056,1,163584,165250,-,1666
511,WOLB.0323.00142,1,314195,315871,-,1676
511,WOLB.0323.00088,1,158542,160206,-,1664
511,WOLB.0323.00084,1,377378,379054,+,1676
511,WOLB.0323.00021,1,687199,688875,-,1676
511,WOLB.0323.00020,1,160885,162549,-,1664
511,WOLB.0323.00122,1,1241852,1243528,+,1676
511,WOLB.0323.00118,1,316530,318203,-,1673
511,WOLB.0323.00004,1,312863,314539,-,1676
511,WOLB.0323.00011,1,1064017,1065693,-,1676
511,WOLB.0323.00035,1,158540,160204,-,1664
511,WOLB.0323.00032,1,1241577,1243253,+,1676
511,WOLB.0323.00012,1,158527,160191,-,1664
511,WOLB.0323.00068,1,448308,449981,+,1673
511,WOLB.0323.00158,1,579049,580725,+,1676
511,WOLB.0323.00017,1,388487,390163,-,1676
511,WOLB.0323.00104,1,160841,162505,-,1664
511,WOLB.0323.00007,1,1334713,1336389,+,1676
511,WOLB.0323.00100,1,158541,160205,-,1664
511,WOLB.0323.00149,1,150665,152341,+,1676
511,WOLB.0323.00096,1,1062473,1064137,-,1664
512,WOLB.0323.00138,1,1117195,1117723,+,528
512,WOLB.0323.00132,1,170286,170919,-,633
512,WOLB.0323.00056,1,449317,449845,+,528
512,WOLB.0323.00030,1,593412,593940,+,528
512,WOLB.0323.00070,1,507487,508015,+,528
513,WOLB.0323.00138,1,1121455,1122069,+,614
513,WOLB.0323.00132,1,165936,166570,-,634
513,WOLB.0323.00121,1,651033,651670,+,637
513,WOLB.0323.00121,1,722231,722864,+,633
513,WOLB.0323.00135,1,1340547,1341176,-,629
513,WOLB.0323.00103,1,1202953,1203589,+,636
513,WOLB.0323.00107,1,1201258,1201894,+,636
513,WOLB.0323.00019,1,182522,183158,+,636
513,WOLB.0323.00060,1,269351,269988,+,637
513,WOLB.0323.00060,1,1166417,1167052,-,635
513,WOLB.0323.00074,1,219363,219999,-,636
513,WOLB.0323.00120,1,218593,219229,-,636
513,WOLB.0323.00039,1,51534,52148,+,614
513,WOLB.0323.00041,1,1243343,1243979,+,636
513,WOLB.0323.00041,1,1603209,1603845,+,636
513,WOLB.0323.00056,1,453567,454196,+,629
513,WOLB.0323.00056,1,467532,468168,-,636
513,WOLB.0323.00056,1,533918,534555,-,637
513,WOLB.0323.00056,1,1187418,1187996,+,578
513,WOLB.0323.00142,1,467167,467800,-,633
513,WOLB.0323.00023,1,81460,82074,-,614
513,WOLB.0323.00023,1,1539998,1540627,+,629
513,WOLB.0323.00093,1,704132,704769,+,637
513,WOLB.0323.00093,1,1437962,1438591,+,629
513,WOLB.0323.00093,1,1477525,1478154,-,629
513,WOLB.0323.00008,1,401770,402406,-,636
513,WOLB.0323.00008,1,700407,701043,+,636
513,WOLB.0323.00008,1,737037,737673,+,636
513,WOLB.0323.00024,1,826448,827084,+,636
513,WOLB.0323.00024,1,1055283,1055897,+,614
513,WOLB.0323.00024,1,1269620,1270257,+,637
513,WOLB.0323.00024,1,1346519,1347133,+,614
513,WOLB.0323.00024,1,1721725,1722361,-,636
513,WOLB.0323.00024,1,1747847,1748483,+,636
513,WOLB.0323.00024,1,2094198,2094835,+,637
513,WOLB.0323.00064,1,479443,480079,+,636
513,WOLB.0323.00064,1,715234,715870,-,636
513,WOLB.0323.00030,1,348786,349423,-,637
513,WOLB.0323.00030,1,597663,598292,+,629
513,WOLB.0323.00030,1,1099576,1100205,-,629
513,WOLB.0323.00030,1,1134836,1135472,-,636
513,WOLB.0323.00105,1,1202961,1203597,+,636
513,WOLB.0323.00084,1,212983,213620,+,637
513,WOLB.0323.00021,1,545602,546238,+,636
513,WOLB.0323.00021,1,1186580,1187209,-,629
513,WOLB.0323.00043,1,628761,629390,-,629
513,WOLB.0323.00043,1,1149184,1149819,-,635
513,WOLB.0323.00043,1,1579078,1579715,+,637
513,WOLB.0323.00043,1,1601131,1601768,-,637
513,WOLB.0323.00122,1,826720,827357,+,637
513,WOLB.0323.00004,1,463629,464262,-,633
513,WOLB.0323.00011,1,1236032,1236665,+,633
513,WOLB.0323.00032,1,44099,44733,-,634
513,WOLB.0323.00032,1,1177228,1177865,+,637
513,WOLB.0323.00128,1,783989,784623,+,634
513,WOLB.0323.00158,1,431897,432530,+,633
513,WOLB.0323.00017,1,539286,539919,-,633
513,WOLB.0323.00007,1,451071,451708,-,637
513,WOLB.0323.00007,1,967724,968360,-,636
513,WOLB.0323.00007,1,1121089,1121725,-,636
513,WOLB.0323.00001,1,1202961,1203597,+,636
513,WOLB.0323.00070,1,469842,470471,+,629
513,WOLB.0323.00070,1,513223,513852,+,629
513,WOLB.0323.00070,1,1287241,1287870,-,629
513,WOLB.0323.00042,1,577170,577799,-,629
513,WOLB.0323.00119,1,105884,106520,-,636
513,WOLB.0323.00014,1,280979,281616,-,637
513,WOLB.0323.00014,1,1144405,1145034,-,629
513,WOLB.0323.00014,1,1320036,1320673,-,637
513,WOLB.0323.00096,1,1434717,1435353,+,636
514,WOLB.0323.00138,1,1166367,1166996,+,629
514,WOLB.0323.00121,1,872625,873239,+,614
514,WOLB.0323.00060,1,500599,501213,+,614
514,WOLB.0323.00074,1,435673,436288,-,615
514,WOLB.0323.00120,1,421844,422459,-,615
514,WOLB.0323.00041,1,1468992,1469608,+,616
514,WOLB.0323.00056,1,653539,654153,+,614
514,WOLB.0323.00142,1,747789,748403,+,614
514,WOLB.0323.00093,1,740284,740900,+,616
514,WOLB.0323.00088,1,706091,706705,+,614
514,WOLB.0323.00084,1,1404578,1405191,-,613
514,WOLB.0323.00021,1,887061,887675,+,614
514,WOLB.0323.00020,1,647002,647616,+,614
514,WOLB.0323.00122,1,890592,891207,-,615
514,WOLB.0323.00004,1,747783,748397,+,614
514,WOLB.0323.00011,1,116842,117456,+,614
514,WOLB.0323.00035,1,643227,643841,+,614
514,WOLB.0323.00032,1,169043,169657,+,614
514,WOLB.0323.00012,1,710193,710807,+,614
514,WOLB.0323.00068,1,565471,566100,+,629
514,WOLB.0323.00158,1,19530,20144,+,614
514,WOLB.0323.00017,1,735392,736006,+,614
514,WOLB.0323.00104,1,679648,680262,+,614
514,WOLB.0323.00007,1,690978,691591,-,613
514,WOLB.0323.00100,1,1028641,1029255,+,614
514,WOLB.0323.00149,1,1095671,1096284,-,613
514,WOLB.0323.00096,1,1239372,1239988,+,616
515,WOLB.0323.00138,1,1168139,1168795,+,656
515,WOLB.0323.00121,1,873965,874618,+,653
515,WOLB.0323.00060,1,502353,503009,+,656
515,WOLB.0323.00056,1,655293,655949,+,656
515,WOLB.0323.00142,1,749129,749782,+,653
515,WOLB.0323.00088,1,707838,708491,+,653
515,WOLB.0323.00084,1,1402778,1403434,-,656
515,WOLB.0323.00021,1,888818,889474,+,656
515,WOLB.0323.00020,1,648749,649402,+,653
515,WOLB.0323.00004,1,749123,749776,+,653
515,WOLB.0323.00011,1,118182,118835,+,653
515,WOLB.0323.00035,1,644974,645627,+,653
515,WOLB.0323.00032,1,170800,171456,+,656
515,WOLB.0323.00012,1,711940,712593,+,653
515,WOLB.0323.00010,1,1004366,1005004,-,638
515,WOLB.0323.00068,1,567243,567899,+,656
515,WOLB.0323.00158,1,20870,21523,+,653
515,WOLB.0323.00017,1,736732,737385,+,653
515,WOLB.0323.00104,1,681395,682048,+,653
515,WOLB.0323.00007,1,689181,689837,-,656
515,WOLB.0323.00100,1,1030388,1031041,+,653
515,WOLB.0323.00149,1,1094291,1094944,-,653
516,WOLB.0323.00138,1,1185242,1186358,+,1116
516,WOLB.0323.00121,1,890006,891125,+,1119
516,WOLB.0323.00135,1,959006,960122,-,1116
516,WOLB.0323.00142,1,765163,766282,+,1119
516,WOLB.0323.00023,1,347842,348958,-,1116
516,WOLB.0323.00084,1,1385216,1386332,-,1116
516,WOLB.0323.00021,1,905921,907037,+,1116
516,WOLB.0323.00122,1,561378,562497,+,1119
516,WOLB.0323.00004,1,765164,766283,+,1119
516,WOLB.0323.00011,1,134223,135342,+,1119
516,WOLB.0323.00032,1,187888,189004,+,1116
516,WOLB.0323.00068,1,584672,585788,+,1116
516,WOLB.0323.00158,1,38014,39133,+,1119
516,WOLB.0323.00017,1,753876,754990,+,1114
516,WOLB.0323.00042,1,1637783,1638902,+,1119
516,WOLB.0323.00149,1,1077785,1078904,-,1119
517,WOLB.0323.00138,1,1332691,1333419,+,728
517,WOLB.0323.00084,1,1229565,1230293,+,728
517,WOLB.0323.00021,1,1009650,1010378,-,728
517,WOLB.0323.00068,1,512348,513076,+,728
518,WOLB.0323.00138,1,1371774,1373093,+,1319
518,WOLB.0323.00121,1,952772,954092,-,1320
518,WOLB.0323.00060,1,747949,749269,-,1320
518,WOLB.0323.00056,1,738600,739920,-,1320
518,WOLB.0323.00142,1,826422,827742,-,1320
518,WOLB.0323.00008,1,372915,374234,+,1319
518,WOLB.0323.00084,1,1323823,1325142,+,1319
518,WOLB.0323.00021,1,969976,971296,-,1320
518,WOLB.0323.00122,1,628089,629409,-,1320
518,WOLB.0323.00004,1,826423,827743,-,1320
518,WOLB.0323.00011,1,196991,198311,-,1320
518,WOLB.0323.00032,1,251810,253130,-,1320
518,WOLB.0323.00068,1,647077,648397,-,1320
518,WOLB.0323.00158,1,99273,100593,-,1320
518,WOLB.0323.00017,1,816233,817553,-,1320
518,WOLB.0323.00007,1,604727,606046,+,1319
518,WOLB.0323.00149,1,1014816,1016135,+,1319
519,WOLB.0323.00138,1,1382884,1383401,+,517
519,WOLB.0323.00121,1,944250,944768,-,518
519,WOLB.0323.00103,1,842834,843390,+,556
519,WOLB.0323.00107,1,841408,841964,+,556
519,WOLB.0323.00060,1,737744,738285,-,541
519,WOLB.0323.00074,1,21028,21593,-,565
519,WOLB.0323.00120,1,21023,21588,-,565
519,WOLB.0323.00041,1,21024,21589,-,565
519,WOLB.0323.00056,1,728418,728936,-,518
519,WOLB.0323.00142,1,817900,818418,-,518
519,WOLB.0323.00093,1,1003646,1004210,+,564
519,WOLB.0323.00008,1,379614,380178,+,564
519,WOLB.0323.00105,1,842844,843400,+,556
519,WOLB.0323.00084,1,1333163,1333680,+,517
519,WOLB.0323.00021,1,961438,961956,-,518
519,WOLB.0323.00122,1,620649,621167,-,518
519,WOLB.0323.00004,1,817901,818419,-,518
519,WOLB.0323.00011,1,188469,188987,-,518
519,WOLB.0323.00032,1,243272,243790,-,518
519,WOLB.0323.00018,1,709620,710137,+,517
519,WOLB.0323.00010,1,808479,808997,-,518
519,WOLB.0323.00068,1,638539,639057,-,518
519,WOLB.0323.00158,1,90751,91269,-,518
519,WOLB.0323.00017,1,806608,807126,-,518
519,WOLB.0323.00007,1,614059,614600,+,541
519,WOLB.0323.00001,1,842844,843400,+,556
519,WOLB.0323.00149,1,1024140,1024657,+,517
519,WOLB.0323.00096,1,27712,28277,-,565
520,WOLB.0323.00138,1,1460212,1461536,+,1324
520,WOLB.0323.00121,1,507277,508601,+,1324
520,WOLB.0323.00074,1,527766,529102,-,1336
520,WOLB.0323.00120,1,513937,515273,-,1336
520,WOLB.0323.00041,1,1101758,1103094,+,1336
520,WOLB.0323.00041,1,1615958,1617268,+,1310
520,WOLB.0323.00142,1,597002,598326,-,1324
520,WOLB.0323.00084,1,171678,173002,+,1324
520,WOLB.0323.00021,1,500131,501455,+,1324
520,WOLB.0323.00004,1,599208,600532,-,1324
520,WOLB.0323.00032,1,94087,95411,-,1324
520,WOLB.0323.00068,1,1164387,1165711,+,1324
520,WOLB.0323.00158,1,1229750,1231074,-,1324
520,WOLB.0323.00017,1,585720,587044,-,1324
520,WOLB.0323.00149,1,1314206,1315530,+,1324
520,WOLB.0323.00149,1,1355119,1356443,-,1324
520,WOLB.0323.00096,1,1139662,1140998,+,1336
521,WOLB.0323.00138,1,1481214,1481719,+,505
521,WOLB.0323.00023,1,474106,474611,-,505
521,WOLB.0323.00021,1,840011,840515,-,504
521,WOLB.0323.00035,1,450020,450524,-,504
521,WOLB.0323.00032,1,1394978,1395482,-,504
521,WOLB.0323.00032,1,1572689,1573194,+,505
521,WOLB.0323.00068,1,1244921,1245425,-,504
521,WOLB.0323.00070,1,1088966,1089470,-,504
521,WOLB.0323.00042,1,719231,719735,-,504
522,WOLB.0323.00132,1,32580,33214,+,634
522,WOLB.0323.00143,1,1241048,1241658,-,610
522,WOLB.0323.00106,1,1241051,1241661,-,610
522,WOLB.0323.00031,1,729991,730601,-,610
522,WOLB.0323.00024,1,2021896,2022529,-,633
522,WOLB.0323.00122,1,35024,35634,+,610
522,WOLB.0323.00118,1,32568,33179,+,611
522,WOLB.0323.00006,1,548682,549292,-,610
523,WOLB.0323.00132,1,107006,107831,+,825
523,WOLB.0323.00070,1,702087,702912,+,825
524,WOLB.0323.00132,1,151972,152616,+,644
524,WOLB.0323.00121,1,665026,665670,-,644
524,WOLB.0323.00142,1,520018,520662,+,644
524,WOLB.0323.00023,1,67374,68018,+,644
524,WOLB.0323.00023,1,142606,143250,+,644
524,WOLB.0323.00004,1,517583,518227,+,644
524,WOLB.0323.00128,1,797960,798604,-,644
524,WOLB.0323.00007,1,956247,956891,+,644
524,WOLB.0323.00100,1,713555,714199,-,644
524,WOLB.0323.00100,1,774789,775433,-,644
524,WOLB.0323.00070,1,528979,529623,-,644
524,WOLB.0323.00042,1,1098906,1099550,+,644
525,WOLB.0323.00132,1,177028,177604,+,576
525,WOLB.0323.00122,1,1406523,1407099,-,576
526,WOLB.0323.00132,1,181563,182098,+,535
526,WOLB.0323.00023,1,1597799,1598346,-,547
526,WOLB.0323.00084,1,148245,148792,+,547
527,WOLB.0323.00132,1,184580,187149,+,2569
527,WOLB.0323.00023,1,1592761,1595344,-,2583
527,WOLB.0323.00084,1,151247,153814,+,2567
528,WOLB.0323.00132,1,189280,190201,+,921
528,WOLB.0323.00023,1,1589997,1590921,-,924
528,WOLB.0323.00084,1,154068,154993,+,925
529,WOLB.0323.00132,1,191764,192446,+,682
529,WOLB.0323.00093,1,1395665,1396346,+,681
529,WOLB.0323.00030,1,507499,508182,-,683
529,WOLB.0323.00133,1,63588,64269,+,681
529,WOLB.0323.00035,1,474693,475376,-,683
529,WOLB.0323.00012,1,543682,544365,-,683
529,WOLB.0323.00100,1,619240,619923,-,683
529,WOLB.0323.00100,1,675892,676575,-,683
530,WOLB.0323.00132,1,192618,194008,+,1390
530,WOLB.0323.00093,1,1396518,1397883,+,1365
530,WOLB.0323.00030,1,505938,507328,-,1390
530,WOLB.0323.00133,1,64441,65822,+,1381
530,WOLB.0323.00035,1,473132,474522,-,1390
530,WOLB.0323.00012,1,542121,543511,-,1390
530,WOLB.0323.00100,1,617679,619069,-,1390
530,WOLB.0323.00100,1,674331,675721,-,1390
531,WOLB.0323.00132,1,211096,212090,+,994
531,WOLB.0323.00143,1,721176,721961,-,785
531,WOLB.0323.00106,1,721177,721962,-,785
531,WOLB.0323.00031,1,65343,66128,+,785
531,WOLB.0323.00006,1,62136,62921,+,785
532,WOLB.0323.00132,1,261999,262591,+,592
532,WOLB.0323.00143,1,397360,397952,-,592
532,WOLB.0323.00143,1,969385,969969,-,584
532,WOLB.0323.00106,1,397363,397955,-,592
532,WOLB.0323.00106,1,969388,969972,-,584
532,WOLB.0323.00135,1,403713,404305,-,592
532,WOLB.0323.00135,1,1302098,1302690,+,592
532,WOLB.0323.00060,1,810437,811029,-,592
532,WOLB.0323.00060,1,1131727,1132319,+,592
532,WOLB.0323.00074,1,173544,174136,+,592
532,WOLB.0323.00120,1,172774,173366,+,592
532,WOLB.0323.00041,1,166790,167382,+,592
532,WOLB.0323.00031,1,389358,389950,+,592
532,WOLB.0323.00031,1,1090868,1091451,+,583
532,WOLB.0323.00093,1,1036634,1037226,-,592
532,WOLB.0323.00024,1,558499,559091,+,592
532,WOLB.0323.00024,1,909992,910584,-,592
532,WOLB.0323.00024,1,960295,960887,-,592
532,WOLB.0323.00024,1,976619,977199,+,580
532,WOLB.0323.00024,1,999328,999920,+,592
532,WOLB.0323.00030,1,1273913,1274505,+,592
532,WOLB.0323.00133,1,307519,308111,-,592
532,WOLB.0323.00122,1,836842,837434,-,592
532,WOLB.0323.00032,1,1217241,1217833,-,592
532,WOLB.0323.00010,1,761100,761692,-,592
532,WOLB.0323.00128,1,1066786,1067378,+,592
532,WOLB.0323.00007,1,424153,424745,+,592
532,WOLB.0323.00007,1,1077908,1078500,+,592
532,WOLB.0323.00006,1,249344,249928,-,584
532,WOLB.0323.00006,1,792166,792758,+,592
532,WOLB.0323.00042,1,923042,923634,+,592
532,WOLB.0323.00042,1,1233215,1233807,-,592
532,WOLB.0323.00042,1,1751251,1751843,-,592
532,WOLB.0323.00014,1,262358,262950,+,592
532,WOLB.0323.00096,1,187556,188148,+,592
533,WOLB.0323.00132,1,311997,313275,+,1278
533,WOLB.0323.00143,1,957884,959112,-,1228
533,WOLB.0323.00106,1,957887,959115,-,1228
533,WOLB.0323.00121,1,299799,301077,+,1278
533,WOLB.0323.00135,1,392778,394056,-,1278
533,WOLB.0323.00103,1,1448345,1449623,+,1278
533,WOLB.0323.00107,1,1446772,1448050,+,1278
533,WOLB.0323.00060,1,672108,673386,+,1278
533,WOLB.0323.00031,1,1101661,1102953,+,1292
533,WOLB.0323.00023,1,1202789,1203975,+,1186
533,WOLB.0323.00093,1,1236545,1237823,-,1278
533,WOLB.0323.00088,1,332384,333662,+,1278
533,WOLB.0323.00024,1,784568,785846,+,1278
533,WOLB.0323.00024,1,1469476,1470754,-,1278
533,WOLB.0323.00064,1,502349,503626,+,1277
533,WOLB.0323.00064,1,1632007,1633284,+,1277
533,WOLB.0323.00030,1,1316387,1317665,+,1278
533,WOLB.0323.00105,1,1448499,1449777,+,1278
533,WOLB.0323.00133,1,468713,469984,-,1271
533,WOLB.0323.00021,1,316105,317383,-,1278
533,WOLB.0323.00043,1,1563674,1564952,-,1278
533,WOLB.0323.00043,1,1615894,1617172,+,1278
533,WOLB.0323.00032,1,1163210,1164488,-,1278
533,WOLB.0323.00012,1,332367,333645,+,1278
533,WOLB.0323.00025,1,548050,549325,-,1275
533,WOLB.0323.00017,1,298796,300074,+,1278
533,WOLB.0323.00007,1,464452,465730,+,1278
533,WOLB.0323.00001,1,1448499,1449777,+,1278
533,WOLB.0323.00100,1,332379,333657,+,1278
533,WOLB.0323.00100,1,407956,409234,+,1278
533,WOLB.0323.00070,1,309576,310854,+,1278
533,WOLB.0323.00006,1,237857,239135,-,1278
533,WOLB.0323.00042,1,327609,328887,+,1278
533,WOLB.0323.00014,1,294350,295628,+,1278
534,WOLB.0323.00132,1,329114,330696,+,1582
534,WOLB.0323.00143,1,940450,942032,-,1582
534,WOLB.0323.00106,1,940453,942035,-,1582
534,WOLB.0323.00121,1,327068,328649,+,1581
534,WOLB.0323.00135,1,375356,376939,-,1583
534,WOLB.0323.00103,1,1465449,1467031,+,1582
534,WOLB.0323.00107,1,1463876,1465458,+,1582
534,WOLB.0323.00031,1,1118805,1120386,+,1581
534,WOLB.0323.00088,1,358484,360065,+,1581
534,WOLB.0323.00024,1,1133171,1134752,+,1581
534,WOLB.0323.00064,1,11798,13379,+,1581
534,WOLB.0323.00064,1,528439,530020,+,1581
534,WOLB.0323.00105,1,1465603,1467185,+,1582
534,WOLB.0323.00133,1,451281,452862,-,1581
534,WOLB.0323.00012,1,359636,361217,+,1581
534,WOLB.0323.00017,1,326069,327650,+,1581
534,WOLB.0323.00001,1,1465603,1467185,+,1582
534,WOLB.0323.00100,1,359652,361233,+,1581
534,WOLB.0323.00100,1,435229,436810,+,1581
534,WOLB.0323.00006,1,220423,222005,-,1582
534,WOLB.0323.00042,1,355822,357403,+,1581
535,WOLB.0323.00132,1,330698,332079,+,1381
535,WOLB.0323.00143,1,939066,940449,-,1383
535,WOLB.0323.00106,1,939069,940452,-,1383
535,WOLB.0323.00121,1,328651,330032,+,1381
535,WOLB.0323.00135,1,373973,375355,-,1382
535,WOLB.0323.00103,1,1467033,1468414,+,1381
535,WOLB.0323.00107,1,1465460,1466841,+,1381
535,WOLB.0323.00074,1,1449191,1450572,-,1381
535,WOLB.0323.00120,1,1429533,1430914,-,1381
535,WOLB.0323.00041,1,221037,222417,+,1380
535,WOLB.0323.00031,1,1120388,1121771,+,1383
535,WOLB.0323.00088,1,360067,361448,+,1381
535,WOLB.0323.00024,1,1134754,1136135,+,1381
535,WOLB.0323.00064,1,13381,14762,+,1381
535,WOLB.0323.00064,1,530022,531403,+,1381
535,WOLB.0323.00105,1,1467187,1468568,+,1381
535,WOLB.0323.00133,1,449895,451280,-,1385
535,WOLB.0323.00012,1,361219,362600,+,1381
535,WOLB.0323.00017,1,327652,329033,+,1381
535,WOLB.0323.00001,1,1467187,1468568,+,1381
535,WOLB.0323.00100,1,361235,362616,+,1381
535,WOLB.0323.00100,1,436812,438193,+,1381
535,WOLB.0323.00006,1,219038,220422,-,1384
535,WOLB.0323.00042,1,357405,358786,+,1381
535,WOLB.0323.00096,1,231908,233288,+,1380
536,WOLB.0323.00132,1,332081,333048,+,967
536,WOLB.0323.00132,1,784831,785784,-,953
536,WOLB.0323.00143,1,938100,939064,-,964
536,WOLB.0323.00106,1,938103,939067,-,964
536,WOLB.0323.00121,1,330034,331001,+,967
536,WOLB.0323.00135,1,373005,373972,-,967
536,WOLB.0323.00103,1,1468416,1469383,+,967
536,WOLB.0323.00107,1,1466843,1467810,+,967
536,WOLB.0323.00074,1,1448223,1449190,-,967
536,WOLB.0323.00120,1,1428565,1429532,-,967
536,WOLB.0323.00041,1,222419,223386,+,967
536,WOLB.0323.00031,1,1121773,1122737,+,964
536,WOLB.0323.00088,1,361450,362417,+,967
536,WOLB.0323.00024,1,1136137,1137104,+,967
536,WOLB.0323.00064,1,14764,15722,+,958
536,WOLB.0323.00064,1,531405,532363,+,958
536,WOLB.0323.00105,1,1468570,1469537,+,967
536,WOLB.0323.00133,1,448927,449894,-,967
536,WOLB.0323.00012,1,362602,363569,+,967
536,WOLB.0323.00017,1,329035,330002,+,967
536,WOLB.0323.00001,1,1468570,1469537,+,967
536,WOLB.0323.00100,1,362618,363585,+,967
536,WOLB.0323.00100,1,438195,439162,+,967
536,WOLB.0323.00006,1,218072,219036,-,964
536,WOLB.0323.00042,1,358788,359755,+,967
536,WOLB.0323.00096,1,233290,234257,+,967
537,WOLB.0323.00132,1,541555,542083,+,528
537,WOLB.0323.00135,1,861677,862206,-,529
537,WOLB.0323.00074,1,30332,30855,-,523
537,WOLB.0323.00120,1,30327,30850,-,523
537,WOLB.0323.00041,1,30327,30850,-,523
537,WOLB.0323.00093,1,992936,993475,-,539
537,WOLB.0323.00088,1,788882,789411,-,529
537,WOLB.0323.00020,1,729778,730307,-,529
537,WOLB.0323.00035,1,726784,727313,-,529
537,WOLB.0323.00012,1,792984,793513,-,529
537,WOLB.0323.00104,1,764403,764932,-,529
537,WOLB.0323.00100,1,1111432,1111961,-,529
537,WOLB.0323.00096,1,37016,37539,-,523
538,WOLB.0323.00132,1,710883,711668,+,785
538,WOLB.0323.00060,1,885149,885922,+,773
538,WOLB.0323.00056,1,933222,933995,+,773
538,WOLB.0323.00024,1,697118,697903,-,785
538,WOLB.0323.00010,1,1310502,1311275,+,773
538,WOLB.0323.00007,1,350648,351421,-,773
539,WOLB.0323.00132,1,770756,772620,+,1864
539,WOLB.0323.00135,1,1073280,1075107,-,1827
539,WOLB.0323.00041,1,1586828,1588692,-,1864
539,WOLB.0323.00142,1,583399,585231,+,1832
539,WOLB.0323.00088,1,542692,544558,-,1866
539,WOLB.0323.00008,1,742646,744507,+,1861
539,WOLB.0323.00043,1,459084,460951,-,1867
539,WOLB.0323.00020,1,475872,477738,-,1866
539,WOLB.0323.00118,1,1065893,1067760,-,1867
539,WOLB.0323.00004,1,585605,587437,+,1832
539,WOLB.0323.00035,1,477807,479673,-,1866
539,WOLB.0323.00012,1,546796,548662,-,1866
539,WOLB.0323.00018,1,723267,725132,+,1865
539,WOLB.0323.00010,1,952938,954806,+,1868
539,WOLB.0323.00128,1,481405,483271,+,1866
539,WOLB.0323.00104,1,493527,495393,-,1866
539,WOLB.0323.00100,1,801474,803340,-,1866
539,WOLB.0323.00070,1,1376434,1378301,+,1867
539,WOLB.0323.00014,1,1388411,1390277,+,1866
540,WOLB.0323.00132,1,782458,783112,+,654
540,WOLB.0323.00056,1,1370206,1370864,-,658
540,WOLB.0323.00023,1,1702401,1703059,-,658
540,WOLB.0323.00153,1,507641,508299,-,658
540,WOLB.0323.00064,1,419955,420613,-,658
540,WOLB.0323.00084,1,228404,229062,-,658
540,WOLB.0323.00043,1,964431,965090,+,659
540,WOLB.0323.00070,1,874208,874866,-,658
541,WOLB.0323.00132,1,793342,793847,+,505
541,WOLB.0323.00121,1,677932,678437,+,505
541,WOLB.0323.00142,1,507251,507755,-,504
541,WOLB.0323.00088,1,529381,529886,+,505
541,WOLB.0323.00064,1,370001,370506,+,505
541,WOLB.0323.00030,1,632726,633231,+,505
541,WOLB.0323.00122,1,1071522,1072026,-,504
541,WOLB.0323.00004,1,504817,505320,-,503
541,WOLB.0323.00158,1,391941,392446,+,505
541,WOLB.0323.00149,1,1242268,1242772,-,504
